一	yiaa
乙	yivv
二	eraa
十	uial
丁	dkal
丁	vgal
厂	ihap
七	qiav
卜	buld
卜	bold
八	bapn
人	rfpn
入	rupn
儿	erpv
匕	bipv
几	jipv
九	jqpv
刁	dnva
了	leal
了	lnal
刀	dcvp
力	livp
乃	ndvp
又	yzvn
三	sjae
干	gjau
于	yuau
亏	kvak
工	gsaa
土	tuua
士	uiua
才	cdup
下	xxab
寸	cyud
大	daar
大	ddar
丈	vhan
与	yuva
万	wjav
万	moav
上	uhba
小	xnlb
口	kzla
山	ujkl
巾	jbkl
千	qmpu
乞	qipv
川	irpl
亿	yirv
个	gerl
夕	xipd
久	jqdn
么	meps
么	maps
么	ycps
勺	ucbd
凡	fjjd
丸	wjld
及	jipn
广	gldi
亡	whwv
门	mfdv
丫	yabl
义	yidx
之	vidn
尸	uivp
己	jikv
已	yikv
巳	sikv
弓	gsvv
子	zila
卫	wwea
也	yevv
女	nvva
刃	rfdd
飞	fwvd
习	xivd
叉	iayd
马	mava
乡	xlvp
丰	fgsl
王	what
开	kdac
井	jkca
天	tmad
夫	fuer
元	yraw
无	wuay
无	moay
云	yyas
专	vrts
丐	gdav
扎	vafv
扎	zafv
艺	yicv
木	muur
五	wuaw
支	viuy
厅	tkid
不	buab
犬	qrdd
太	tddd
区	qukx
区	oukx
历	liil
歹	ddax
友	yzuy
尤	yzyd
匹	pike
车	ieau
车	juau
巨	jukk
牙	yagp
屯	tyav
屯	vyav
戈	geyp
比	bibb
互	huah
切	qpqd
瓦	waad
止	vilb
少	ucxp
曰	ytka
日	rika
中	vskl
贝	bwkr
冈	ghkx
内	nwkr
水	uvln
见	jmke
午	wupu
牛	nqpu
手	uzpy
气	qipv
毛	mcpv
壬	rfpt
升	ugpc
夭	ycpd
长	ihpn
长	vhpn
仁	rfre
什	uiru
什	ufru
片	pmpv
仆	purb
化	hxrb
仇	izrj
仇	qqrj
币	bipj
仍	rgrn
仅	jbry
斤	jbil
爪	vcin
爪	vxin
反	fjiy
介	jprl
父	fubx
从	csrr
仑	lyrb
今	jbrv
凶	xskx
分	ffbd
乏	fapv
公	gsbs
仓	chrv
月	ytke
氏	uipv
氏	vipv
勿	wubp
欠	qmdr
风	fgjx
丹	djkd
匀	yybd
乌	wupa
勾	gzbs
凤	fgjy
六	lqwb
文	wfwx
亢	khwj
方	fhwv
火	hobr
为	wwld
斗	dzud
忆	yixv
计	jiyu
订	dkyd
户	hudu
认	rfyr
冗	rsbj
讥	jiyj
心	xbdd
尺	iiun
引	ybgl
丑	izvt
巴	basl
孔	kszv
队	dver
办	bjld
以	yilr
允	yyse
予	yusl
邓	dgye
劝	qryl
双	ulyy
书	uuvd
幻	hryv
玉	yuwd
刊	kjgd
未	wwam
末	moam
示	uiex
击	jifk
打	dafd
巧	qngk
正	vgav
扑	pufb
卉	hvuc
扒	bafb
扒	pafb
功	gsgl
扔	rgfn
去	quts
甘	gjca
世	uicv
艾	aicx
艾	yicx
古	guuk
节	jpce
本	bfma
术	uumd
术	vumd
可	kedk
丙	bkan
左	zoug
厉	liiw
石	uiak
石	djak
右	yzuk
布	buuj
夯	hhdl
戊	wugp
龙	lsyp
平	pkau
灭	mpah
轧	gaiv
轧	yaiv
轧	vaiv
东	dsax
卡	kaub
卡	qxub
北	bwlb
占	vjbk
凸	tula
卢	lubu
业	yela
旧	jqlo
帅	uklj
归	gvle
旦	djoa
目	muke
且	qpoa
且	juoa
叶	yeku
叶	xpku
甲	jxtl
申	uftl
叮	dkkd
电	dmyv
号	hckk
田	tmku
由	yzlt
只	vikb
叭	bakb
史	uikn
央	yhkr
兄	xske
叽	jikj
叼	dnkd
叫	jnkj
叩	kzke
叨	dckd
叨	tckd
另	lkkl
叹	tjky
冉	rjkt
皿	mbka
凹	aola
凹	wala
囚	qqkr
四	sike
生	ugpf
矢	uipd
失	uipf
乍	vape
禾	hepm
丘	qqja
付	furc
仗	vhrv
代	ddry
仙	xmru
们	mfrm
仪	yiry
白	bdpo
仔	zdrz
仔	zirz
他	tary
斥	iijd
瓜	gxin
乎	hupl
丛	csra
令	lkrs
用	yskf
甩	ukyv
印	ybpe
尔	erdx
乐	lepx
乐	ytpx
乐	lcpx
句	jubk
句	gzbk
匆	csbd
册	ceka
卯	mcpe
犯	fjqv
外	wdxb
处	iuwb
冬	dswd
鸟	nnna
鸟	dnna
务	wuwl
包	bcbs
饥	jiuj
主	vuwt
市	uiwj
立	liwb
冯	fgdm
冯	pkdm
玄	xrwy
闪	ujmr
兰	ljbs
半	bjbf
汁	vidu
汇	hvdk
头	tzdd
汉	hjdy
宁	nkbd
穴	xtbb
它	tabb
讨	tcyc
写	xpby
让	rhyu
礼	lipv
训	xyyi
议	yiyy
必	bixp
讯	xyyu
记	jiyj
永	ysdu
司	sivk
尼	niub
民	mbvv
弗	fugl
弘	hsgs
出	iuuu
辽	lnzl
奶	ndnn
奴	nuny
召	vcdk
召	ucdk
加	jxlk
皮	pipy
边	bmzl
孕	yynz
发	fafy
圣	ugyt
对	dvyc
台	tdsk
矛	mcyp
纠	jqsj
母	mumd
幼	yzyl
丝	sisa
邦	bhfe
式	uiyg
迂	yuzy
刑	xkkd
戎	rsgu
动	dsyl
扛	khfg
扛	ghfg
寺	sitc
吉	jitk
扣	kzfk
考	kclk
托	tofq
老	lclb
巩	gsgf
圾	jitj
执	vifw
扩	kofg
扫	scfe
地	dity
地	dety
场	ihtp
扬	yhfp
耳	erol
芋	yucy
共	gscb
芒	mhcw
亚	yaay
芝	vicv
朽	xqmk
朴	pumb
朴	pnmb
朴	pomb
机	jimj
权	qrmy
过	gozc
臣	ifkl
吏	lign
再	zdar
协	xpub
西	xiak
压	yaid
厌	yjiq
戌	xuwa
在	zdut
百	bdab
有	yzuo
存	cyuz
而	eral
页	yeab
匠	jlkj
夸	kxdk
夺	dodc
灰	hvuh
达	dazd
列	lpdd
死	sidb
成	igwv
夹	jxar
夹	gaar
夷	yiar
轨	gvij
邪	xpye
邪	yeye
尧	ycyw
划	hxgd
迈	mdzw
毕	bibu
至	vigt
此	civb
贞	vfbb
师	uilj
尘	ifxt
尖	jmxd
劣	lpul
光	glxe
当	dhxe
早	zcou
吁	xuky
吁	yuky
吐	tukt
吓	xxkx
吓	hekx
虫	isvd
曲	qukc
团	trkc
吕	lvkk
同	tskk
吊	dnkj
吃	iikv
因	ybkd
吸	xikj
吗	makm
吆	ycky
屿	yuuy
屹	yiuv
岁	svux
帆	fjjf
回	hvkk
岂	qiuj
则	zebd
刚	ghkd
网	whkx
肉	rznr
年	nmpf
朱	vupw
先	xmne
丢	dqpq
廷	tkzt
舌	ueqk
竹	vugg
迁	qmzq
乔	qnyl
迄	qizv
伟	wwrw
传	vrrv
传	irrv
乒	pkqp
乓	phqd
休	xqrm
伍	wurw
伏	furq
优	yzry
臼	jqpa
伐	farg
延	yjzv
仲	vsrv
件	jmrn
任	rfrt
伤	uhrl
价	jxrj
价	jprj
伦	lyrl
份	ffrf
华	hxru
仰	yhre
仿	fhrf
伙	horh
伪	wwrw
自	zipo
伊	yiry
血	xppm
血	xtpm
向	xlpk
似	sirr
似	uirr
后	hzik
行	xkrd
行	hhrd
行	hgrd
舟	vzpd
全	qrrw
会	hvry
会	kkry
杀	uaxm
合	herk
合	gerk
兆	vced
企	qirv
众	vsrr
爷	yefe
伞	sjru
创	ilrd
肌	jioj
肋	leol
肋	lwol
朵	dojm
杂	zajm
危	wwdv
旬	xybo
旨	vibo
旭	xujo
负	fudb
匈	xsbx
名	mkxk
各	gewk
多	doxx
争	vgdy
色	sedb
色	uddb
壮	vllt
冲	isdv
妆	vlln
冰	bkdu
庄	vlgt
庆	qkgd
亦	yiwb
刘	lqwd
齐	qiwl
交	jnwf
衣	yiwy
次	cidq
产	ijwi
决	jtdg
亥	hdwr
充	iswy
妄	whwn
闭	bimc
问	wfmk
闯	ilmm
羊	yhbf
并	bkbk
关	grbt
米	mibm
灯	dghd
州	vzdl
汗	hjdg
污	wudk
江	jldg
汛	xydu
池	iidy
汝	rudn
汤	thdp
汤	uhdp
忙	mhxw
兴	xkxb
宇	yuby
守	uzbc
宅	vdbq
字	zibz
安	anbn
讲	jlyj
讳	hvyw
军	jybi
讶	yayy
许	xuyu
讹	eeyb
论	lyyl
讼	ssyg
农	nsby
讽	fgyf
设	ueyu
访	fhyf
诀	jtyg
寻	xyec
那	nave
那	nwve
迅	xyzu
尽	jbid
导	dcsc
异	yijc
弛	iigy
孙	syzx
阵	vfei
阳	yheo
收	uzjw
阶	jpej
阴	ybeo
防	fhef
奸	jmng
如	runk
妇	fune
妃	fwnj
好	hcnz
她	tany
妈	manm
戏	xiyg
羽	yuxx
观	gryj
欢	hryq
买	mdad
红	hssg
红	gssg
驮	tomd
驮	domd
纤	xmsq
纤	qmsq
驯	xymi
约	ytsu
约	ycsu
级	jisj
纪	jisj
驰	iimy
纫	rfsr
巡	xyzv
寿	uzfc
弄	nswc
弄	lswc
麦	mdfw
玖	jqwj
玛	mawm
形	xkkp
进	jbzj
戒	jpgc
吞	tytk
远	yrzy
违	wwzw
韧	rfwr
运	yyzy
扶	fuff
抚	fufw
坛	tjty
技	jifv
坏	hktb
抠	kzfq
扰	rcfy
扼	eefv
拒	jufj
找	vcfg
批	pifb
址	vitv
扯	iefv
走	zztz
抄	icfu
贡	gsgb
汞	gsgu
坝	batb
攻	gsgw
赤	iitb
折	vefj
折	uefj
抓	vxfv
扳	bjfy
抡	lyfl
扮	bjff
抢	qlfv
孝	xnlz
坎	kjtq
均	jyty
抑	yife
抛	pcfl
投	tzfu
坟	fftw
坑	kgtj
抗	khfj
坊	fhtf
抖	dzfd
护	hufh
壳	ketj
壳	qntj
志	vitx
块	kktg
扭	nqfi
声	ugtu
把	bafb
报	bcfy
拟	nifr
却	qtqe
抒	uufy
劫	jpql
芙	fucf
芜	wucw
苇	wwcw
芽	yacy
花	hxcb
芹	qbcj
芥	jpcj
芬	ffcf
苍	chcv
芳	fhcf
严	yjai
芦	luch
芯	xbcx
劳	lccl
克	keux
芭	bacb
苏	sucb
杆	gjmg
杠	ghmg
杜	dumt
材	cdmc
村	cymc
杖	vhmv
杏	xkmk
杉	ujmp
杉	uamp
巫	wugr
极	jimj
李	limz
杨	yhmp
求	qqud
甫	fuuy
匣	xxkj
更	ggan
束	uugr
吾	wuwk
豆	dzab
两	llar
酉	yzxa
丽	liad
医	yiku
辰	ifiy
励	liil
否	fzbk
否	pibk
还	hdzb
还	hrzb
尬	gayj
歼	jmdq
来	ldam
连	lmzi
轩	xrig
步	buvu
卤	lubx
坚	jmlt
肖	xnxo
旱	hjog
盯	dkod
呈	igkw
时	uioc
吴	wukt
助	vuql
县	xmqs
里	litt
呆	ddkm
吱	vikv
吱	zikv
吠	fwkq
呕	oukq
园	yrky
旷	klog
围	wwkw
呀	yaky
吨	dykt
足	zukz
邮	yzye
男	njtl
困	kykm
吵	icku
串	irkl
员	yrkb
员	yykb
呐	nakn
呐	nekn
听	tkkj
吟	ybkv
吩	ffkf
呛	qlkv
吻	wfkw
吹	ivkq
呜	wukw
吭	hhkj
吭	kgkj
吧	bakb
邑	yikb
吼	hzkv
囤	dykt
囤	tykt
别	bpkd
吮	uyky
岖	quuq
岗	ghux
帐	vhji
财	cdbc
针	vfju
钉	dkjd
牡	munt
告	gcnk
我	woga
乱	lruv
利	lihd
秃	tuhj
秀	xqhn
私	sihs
每	mwpm
兵	bkqb
估	gurg
体	tirb
何	herk
佐	zorg
佑	yzrk
但	djrd
伸	ufru
佃	dmrt
佃	tmrt
作	zorv
伯	bdrb
伯	borb
伶	lkrs
佣	ysry
低	diru
你	nirx
住	vurv
位	wwrl
伴	bjrb
身	ufzc
皂	zcbq
伺	sirk
伺	cirk
佛	forf
佛	furf
囱	cspw
近	jbzj
彻	ierd
役	yiru
返	fjzy
余	yurm
希	xixj
坐	zotr
谷	gubk
妥	tovn
含	hjrk
邻	lbre
岔	iafu
肝	gjog
肛	ghog
肚	duot
肘	vzoc
肠	ihop
龟	gvdd
龟	jydd
龟	qqdd
甸	dmbt
免	mmde
狂	klqw
犹	yzqy
狈	bwqb
角	jndy
角	jtdy
删	ujcd
条	tnwm
彤	tsdp
卵	lrpd
灸	jqjh
岛	dcnu
刨	pcbd
刨	bcbd
迎	ykze
饭	fjuy
饮	ybuq
系	xipx
系	jipx
言	yjwk
冻	dsdd
状	vllq
亩	muwt
况	kldx
床	ilgm
库	kugi
庇	bigb
疗	lnbl
吝	lbwk
应	ykga
这	vezw
这	vwzw
冷	lgds
庐	lugh
序	xugy
辛	xblu
弃	qiwc
冶	yedk
忘	whwx
闰	rymw
闲	xmmm
间	jmmo
闷	mfmx
判	pjbd
兑	dvbx
灶	zcht
灿	cjhu
灼	vohu
弟	dibd
汪	whdw
沐	mudm
沛	pwdu
汰	tddt
沥	lidl
沙	uadu
汽	qidq
沃	wody
沦	lydl
汹	xsdx
泛	fjdf
沧	chdv
没	mwdu
没	modu
沟	gzdg
沪	hudh
沈	ufde
沉	ifdj
沁	qbdx
怀	hkxb
忧	yzxy
忱	ifxe
快	kkxg
完	wjby
宋	ssbm
宏	hsbs
牢	lcbn
究	jqbj
穷	qsbl
灾	zdbh
良	lldg
证	vgyv
启	qihk
评	pkyp
补	bupb
初	iupd
社	uept
祀	sips
识	uiyv
识	viyv
诈	vayv
诉	suyi
罕	hjbg
诊	vfyp
词	ciyk
译	yiyf
君	jyyk
灵	lkeh
即	jige
层	cguy
屁	piub
尿	nnuu
尿	svuu
尾	wwum
尾	yium
迟	iizi
局	juuk
改	gdjw
张	vhgi
忌	jijx
际	jieu
陆	luej
陆	lqej
阿	aaek
阿	eeek
陈	ifed
阻	zueq
附	fuec
坠	vvet
妓	jinv
妙	mnnu
妖	ycny
姊	zind
妨	fhnf
妒	dunh
努	nunl
忍	rfrx
劲	jbjl
劲	jkjl
矣	yisu
鸡	jiyn
纬	wwsw
驱	qumq
纯	iyst
纱	uasu
纲	ghsx
纳	nasn
驳	bomx
纵	zssr
纷	ffsf
纸	visu
纹	wfsw
纺	fhsf
驴	lvmh
纽	nqsi
奉	fgif
玩	wjwy
环	hrwb
武	wugv
青	qkfo
责	zefb
现	xmwj
玫	mwww
表	bnfy
规	gvfj
抹	mofw
抹	mafw
卦	gxtb
坷	ketk
坯	pitp
拓	tafu
拓	tofu
拢	lsfl
拔	bafy
坪	pktp
拣	jmfd
坦	tjtd
担	djfd
坤	kytu
押	yafj
抽	izfy
拐	gkfl
拖	tofy
者	velo
拍	pdfb
顶	dkdy
拆	idfi
拎	lbfs
拥	ysfy
抵	difu
拘	jufj
势	uifl
抱	bcfb
拄	vufv
垃	latl
拉	lafl
拦	ljfl
幸	xktg
拌	bjfb
拧	nkfd
拂	fuff
拙	vofi
招	vcfk
坡	potp
披	pifp
拨	bofy
择	zeff
择	vdff
抬	tdfk
拇	mufm
拗	aofl
拗	nqfl
其	qicb
其	jicb
取	quey
茉	mocw
苦	kucg
昔	xico
苛	keck
若	rock
茂	mccw
苹	pkcp
苗	mnct
英	ykcy
苟	gzcj
苑	yrcv
苞	bccb
范	fjcv
直	viuq
茁	voci
茄	qpck
茄	jxck
茎	jkcj
苔	tdck
茅	mccm
枉	whmw
林	lbmm
枝	vimv
杯	bwmb
枢	uumq
柜	gvmj
柜	jumj
枚	mwmw
析	ximj
板	bjmy
松	ssmg
枪	qlmv
枫	fgmf
构	gzmg
杭	hhmj
杰	jpmh
述	uuzu
枕	vfme
丧	shty
或	hoga
画	hxat
卧	woib
事	uigy
刺	ciud
枣	zcud
雨	yuad
卖	mdud
郁	yuue
矾	fjuf
矿	klug
码	maum
厕	ceid
奈	nddu
奔	bfdc
奇	qidk
奇	jidk
奋	ffdt
态	tdtx
欧	ouqq
殴	ouqu
垄	lslt
妻	qiun
轰	hsiy
顷	qkby
转	vriv
斩	vjij
轮	lyil
软	rriq
到	dcgd
非	fwls
叔	uuuy
歧	qivv
肯	kfvo
齿	iivr
些	xpve
卓	vobu
虎	huhj
虏	luhl
肾	uflo
贤	xmlb
尚	uhxk
旺	whow
具	juqb
味	wwkw
果	gotm
昆	kyob
国	goky
哎	aikx
咕	gukg
昌	ihoo
呵	hekk
呵	kekk
畅	ihup
明	mkoo
易	yiow
咙	lskl
昂	ahoe
迪	dizy
典	dmqb
固	gukg
忠	vsvx
呻	ufku
咒	vzkj
咋	vakv
咋	zakv
咋	zekv
咐	fukc
呼	hukh
鸣	mkkn
咏	ysky
呢	nekb
呢	nikb
咄	doki
咖	kakk
咖	gakk
岸	anug
岩	yjuu
帖	tpjv
罗	losx
帜	vijv
帕	pajb
岭	lkus
凯	kduj
败	bdbw
账	vhbi
贩	fjby
贬	bmbf
购	gzbg
贮	vubv
图	tukd
钓	dnju
制	vind
知	viuk
迭	dpzf
氛	ffqf
垂	ivqt
牧	munw
物	wunw
乖	gkqb
刮	gxud
秆	gjhg
和	hehk
和	hohk
和	huhk
季	jihz
委	wwhn
秉	bkqr
佳	jxrt
侍	uirc
岳	ytqu
供	gsrg
使	uirl
例	lird
侠	xxrj
侥	jnrw
侥	ycrw
版	bjpy
侄	virt
侦	vfrb
侣	lvrk
侧	cerd
侧	vdrd
凭	pkrj
侨	qnrl
佩	pwrj
货	horb
侈	iirx
依	yiry
卑	bwpu
的	debu
的	dibu
迫	pozb
迫	pdzb
质	viib
欣	xbjq
征	vgrv
往	whrv
爬	pavb
彼	birp
径	jkrj
所	sohj
舍	uerg
金	jbrb
刹	iaxd
刹	uaxd
命	mkre
肴	ycxo
斧	fufj
爸	bafb
采	cdvm
觅	mivj
受	uzvy
乳	ruvv
贪	tjrb
念	nmrx
贫	pbfb
忿	fffx
肤	fuof
肺	fwou
肢	viov
肿	vsov
胀	vhoi
朋	pgoo
股	guou
肮	ahoj
肪	fhof
肥	fwob
服	fuoy
胁	xpob
周	vzkk
昏	hyuo
鱼	yuda
兔	tudd
狐	huqg
忽	huwx
狗	gzqj
狞	nkqd
备	bwwt
饰	uiuj
饱	bcub
饲	siuk
变	bmwy
京	jkwx
享	xlwz
庞	phgl
店	dmgv
夜	yeww
庙	mngy
府	fugc
底	digu
疟	ntbe
疟	ycbe
疙	gebv
疚	jqbj
剂	jiqd
卒	zuwu
卒	cuwu
郊	jnwe
庚	gggr
废	fwgy
净	jkdy
盲	mhwo
放	fhfw
刻	kewd
育	yuwo
氓	mhwm
氓	mgwm
闸	vamj
闹	ncmj
郑	vgbe
券	qrjd
券	xrjd
卷	jrjv
单	djbu
单	ijbu
单	ujbu
炬	juhj
炒	ichu
炊	ivhq
炕	khhj
炎	yjhh
炉	luhh
沫	modw
浅	qmdj
法	fadq
泄	xpdu
沽	gudg
河	hedk
沾	vjdv
泪	lwdo
沮	judq
油	yzdy
泊	bodb
泊	podb
沿	yjdk
泡	pcdb
注	vudv
泣	qidl
泞	nkdd
泻	xpdy
泌	bidb
泌	midb
泳	ysdy
泥	nidb
沸	fwdf
沼	vcdk
波	bodp
泼	pody
泽	zedf
治	vidk
怔	vgxv
怯	qpxq
怖	buxj
性	xkxu
怕	paxb
怜	lmxs
怪	gkxt
怡	yixk
学	xtxz
宝	bcby
宗	zsbu
定	dkbz
宠	isbl
宜	yibq
审	ufbu
宙	vzby
官	grbl
空	ksbg
帘	lmbj
宛	wjbv
实	uibd
试	uiyg
郎	lhle
诗	uiyc
肩	jmho
房	fhhf
诚	igyi
衬	ifpc
衫	ujpp
视	uipj
祈	qipj
话	hxyu
诞	djyv
诡	gvyv
询	xyyo
该	gdyr
详	xlyy
建	jmzy
肃	suyb
录	lueu
隶	liyu
帚	vzej
屉	tiuu
居	juug
届	jpuy
刷	uxud
屈	quui
弧	hugg
弥	migx
弦	xmgx
承	igln
孟	mgzm
陋	lzen
陌	moeb
孤	guzg
陕	ujej
降	jlef
降	xlef
函	hjku
限	xmeg
妹	mwnw
姑	gung
姐	jpnq
姓	xknu
妮	ninb
始	uink
姆	munm
迢	tnzk
驾	jxlm
叁	sjss
参	cjsp
参	ufsp
参	cfsp
艰	jmyg
线	xmsj
练	lmsd
组	zusq
绅	ufsu
细	xist
驶	uimu
织	visv
驹	jumj
终	vssd
驻	vumv
绊	bjsb
驼	tomb
绍	ucsk
绎	yisf
经	jksj
贯	grmb
契	qifd
契	xpfd
贰	eryb
奏	zzit
春	iyio
帮	bhfj
玷	dmwv
珍	vfwp
玲	lkws
珊	ujwc
玻	bowp
毒	dufm
型	xkkt
拭	uifg
挂	gxft
封	fgtc
持	iifc
拷	kcfk
拱	gsfg
项	xlgy
垮	kxtk
挎	kxfk
城	igti
挟	xpfj
挠	ncfw
政	vgvw
赴	futb
赵	vctx
挡	dhfe
拽	vkfy
哉	zdgk
挺	tkft
括	kofu
垢	gztk
拴	urfw
拾	uifk
挑	tnfv
垛	dotm
指	vifo
垫	dmft
挣	vgfy
挤	jifq
拼	pbfk
挖	wafv
按	anfn
挥	hvfi
挪	nofe
拯	vgfi
某	mzgm
甚	ufcb
荆	jkcd
茸	rsce
革	gecu
茬	iact
荐	jmcz
巷	xlgs
巷	hhgs
带	ddcj
草	cccu
茧	jmci
茵	ybcy
茶	iacm
荒	hlci
茫	mhcw
荡	dhcp
荣	rscm
荤	hyci
荧	ykch
故	gugw
胡	hugo
荫	ybco
荔	licl
南	njug
南	naug
药	yccu
标	bnmu
栈	vjmj
柑	gjmg
枯	kumg
柄	bkmn
栋	dsmd
相	xlmo
查	iamd
查	vamd
柏	bdmb
柏	bomb
栅	vamc
栅	ujmc
柳	lqme
柱	vumv
柿	uimj
栏	ljml
柠	nkmd
树	uumc
勃	boul
要	ycxn
柬	jmur
咸	xmwk
威	wwwn
歪	wdbv
研	yjuk
砖	vruv
厘	liil
厚	hziz
砌	qiud
砌	qpud
砂	uauu
泵	bguu
砚	yjuj
砍	kjuq
面	mmao
耐	ndec
耍	uxen
牵	qmdn
鸥	ouqn
残	cjdj
殃	yhdy
轴	vziy
轻	qkij
鸦	yayn
皆	jpbb
韭	jqfa
背	bwbo
战	vjvg
点	dmvh
虐	nthe
临	lblk
览	ljlj
竖	uull
省	uguo
省	xkuo
削	xtxd
削	xnxd
尝	ihxy
昧	mwow
盹	dyot
是	uioz
盼	pjof
眨	vaof
哇	wakt
哄	hskg
哑	yaky
显	xmoy
冒	mcoo
冒	mooo
映	ykoy
星	xkou
昨	zoov
咧	lpkd
昭	vcok
畏	wwty
趴	pazb
胃	wwto
贵	gvvb
界	jptj
虹	hsig
虾	xxix
蚁	yiiy
思	sitx
思	sdtx
蚂	maim
虽	svki
品	pbkk
咽	yjky
咽	yeky
骂	makm
勋	xykl
哗	hxku
咱	zjkz
咱	zakz
响	xlkk
哈	hakk
哆	dokx
咬	yckf
咳	kekr
咳	hdkr
咪	mikm
哪	neke
哪	nake
哪	nwke
哟	yoku
炭	tjuh
峡	xxuj
罚	fasd
贱	jmbj
贴	tpbv
贻	yibk
骨	gugo
幽	yzuy
钙	gdjg
钝	dyjt
钞	icju
钟	vsjv
钢	ghjx
钠	najn
钥	ycjo
钥	ytjo
钦	qbjq
钧	jyjy
钩	gzjg
钮	nqji
卸	xpve
缸	ghfg
拜	bduf
看	kjuo
矩	juuj
毡	vjmv
氢	qkqj
怎	zfvx
牲	ugnu
选	xrze
适	uizu
适	kozu
秒	mnhu
香	xlho
种	vshv
种	ishv
秋	qqhh
科	kehd
重	isql
重	vsql
复	fupw
竿	gjvg
段	drpu
便	bmrg
便	pmrg
俩	lxrl
俩	llrl
贷	ddrb
顺	uyiy
修	xqrp
俏	qnro
保	bcrm
促	curz
俄	eerw
俐	lird
侮	wurm
俭	jmrq
俗	surg
俘	furz
信	xbrk
皇	hlbw
泉	qrbu
鬼	gvps
侵	qbry
禹	yupd
侯	hzru
追	vvzl
俊	jyrw
盾	dyio
待	ddrc
徊	hkrk
衍	yjrd
律	lvry
很	hfrg
须	xupy
叙	xury
剑	jmqd
逃	tczv
食	uirg
食	yirg
食	sirg
盆	pffm
胚	pwop
胧	lsol
胆	djod
胜	ugou
胞	bcob
胖	phob
胖	pjob
脉	mdoy
脉	mooy
胎	tdok
勉	mmdl
狭	xxqj
狮	uiqj
独	duqi
狰	vgqy
狡	jnqf
狱	yuqq
狠	hfqg
贸	mcpb
怨	yrxx
急	jidx
饵	erue
饶	rcuw
蚀	uiui
饺	jnuf
饼	bkuk
峦	lrwu
弯	wjwg
将	jllc
将	qllc
奖	jlld
哀	aiyk
亭	tkwd
亮	llwj
度	dugy
度	dogy
迹	jizb
庭	tkgt
疮	ilbv
疯	fgbf
疫	yibu
疤	babb
咨	zidk
姿	zidn
亲	qblm
亲	qklm
音	yblo
帝	diwj
施	uify
闺	gvmt
闻	wfme
闽	mbmi
阀	famg
阁	gemk
差	iayg
差	idyg
差	ciyg
养	yhbl
美	mwyd
姜	jlyn
叛	pjby
送	sszt
类	lwmd
迷	mizm
籽	zimz
娄	lzmn
前	qmbd
首	uzbz
逆	nizn
兹	ziby
总	zsbx
炼	lmhd
炸	vahv
烁	uohl
炮	pchb
炮	bchb
炫	xrhx
烂	ljhl
剃	tibd
洼	wadt
洁	jpdk
洪	hsdg
洒	sadx
柒	qidm
浇	jndw
浊	vodi
洞	dsdk
测	cedd
洗	xide
活	hodu
派	pddy
洽	qxdk
染	rjdm
洛	lodk
浏	lqdd
济	jidq
洋	yhdy
洲	vzdv
浑	hydi
浓	nsdy
津	jbdy
恃	uixc
恒	hgxd
恢	hvxh
恍	hlxe
恬	tmxu
恤	xuxm
恰	qxxk
恼	ncxx
恨	hfxg
举	juxf
觉	jtxj
觉	jnxj
宣	xrbd
宦	hrbi
室	uibt
宫	gsbk
宪	xmbe
突	tubq
穿	irby
窃	qpbd
客	kebk
诫	jpyc
冠	grbc
诬	wuyr
语	yuyk
扁	bmhc
扁	pmhc
袄	aopy
祖	zupq
神	ufpu
祝	vupx
祠	cipk
误	wuyt
诱	yzyn
诲	hvym
说	uoyx
说	uvyx
说	ytyx
诵	ssyy
垦	kfgt
退	tvzg
既	jigw
屋	wuut
昼	vzid
屏	pkuk
屏	bkuk
屎	uium
费	fwfb
陡	dzez
逊	xyzx
眉	mwuo
孩	hdzr
陨	yyeb
除	iuem
险	xmeq
院	yrey
娃	want
姥	lcnl
姥	munl
姨	yiny
姻	ybny
娇	jnnl
姚	ycnv
娜	nane
娜	none
怒	nunx
架	jxlm
贺	helb
盈	yknm
勇	yssl
怠	ddsx
癸	gvbt
蚤	zcii
柔	rzmm
垒	lwst
绑	bhse
绒	rssu
结	jpsk
绕	rcsw
骄	jnml
绘	hvsy
给	gwsk
给	jisk
绚	xrso
骆	lomk
络	losk
络	lcsk
绝	jtsb
绞	jnsf
骇	hdmr
统	tssy
耕	gglj
耘	yyly
耗	hclm
耙	palb
耙	balb
艳	yjfb
泰	tdiu
秦	qbih
珠	vuww
班	bjwl
素	sufx
匿	nikk
蚕	cjti
顽	wjyy
盏	vjjm
匪	fwkf
捞	lcfl
栽	zdgm
捕	buff
埂	ggtg
捂	wufk
振	vffi
载	zdgi
赶	gjtg
起	qitj
盐	yjtm
捎	ucfo
捍	hjfg
捏	npft
埋	mdtl
埋	mjtl
捉	vofz
捆	kyfm
捐	jrfo
损	syfb
袁	yrty
捌	bafd
都	dzle
都	dule
哲	vefk
逝	uizj
捡	jmfq
挫	cofr
换	hrfd
挽	wjfe
挚	vifu
热	refh
恐	ksgx
捣	dcfu
壶	huty
捅	tsfy
埃	aitu
挨	aifu
耻	iiev
耿	ggeh
耽	djee
聂	npey
恭	gsgx
莽	mhcc
莱	ldcl
莲	lmci
莫	mocd
莉	licd
荷	heck
获	hocq
晋	jbyo
恶	eeyx
恶	wuyx
莹	ykcy
莺	ykcn
真	vfub
框	klmw
梆	bhme
桂	gvmt
桔	jumk
桔	jpmk
栖	ximx
栖	qimx
档	dhme
桐	tsmk
株	vumw
桥	qnml
桦	hxmu
栓	urmw
桃	tcmv
格	gemk
桩	vlmt
校	xnmf
校	jnmf
核	hemr
核	humr
样	yhmy
根	gfmg
索	soux
哥	gekk
速	suzu
逗	dzzb
栗	lixm
贾	jxxb
贾	guxb
酌	voyu
配	pwyj
翅	iivx
辱	ruic
唇	iyik
夏	xxbw
砸	zauj
砰	pgup
砾	liul
础	iuui
破	poup
原	yrix
套	tcds
逐	vuzu
烈	lpdh
殊	uudw
殉	xydo
顾	guiy
轿	jnil
较	jnif
顿	dyty
顿	duty
毙	bibb
致	vigw
柴	idvm
桌	vobm
虑	lvhx
监	jmlm
紧	jblx
党	dhxx
逞	igzw
晒	udox
眠	mmom
晓	xnow
哮	xnkz
唠	lckl
鸭	yajn
晃	hloe
哺	bukf
晌	uhok
剔	tiod
晕	yyoi
蚌	bgif
蚌	bhif
畔	pjtb
蚣	gsig
蚊	wfiw
蚪	dzid
蚓	ybil
哨	ucko
哩	likl
圃	pukf
哭	kukq
哦	ookw
哦	eekw
恩	enyx
鸯	yhyn
唤	hrkd
唁	yjkk
哼	hgkl
唧	jike
啊	aakk
唉	aiku
唆	sokw
罢	basq
峭	qnuo
峨	eeuw
峰	fguf
圆	yrkb
峻	jyuw
贼	zwbu
贿	hvbo
赂	lubk
赃	zhbt
钱	qmjj
钳	qmjg
钻	zrjv
钾	jxjj
铁	tpjf
铃	lkjs
铅	qmjk
缺	qtfg
氧	yhqy
氨	anqn
特	tenc
牺	xinx
造	zczk
乘	igqr
乘	ugqr
敌	diuw
秤	ighp
租	zuhq
积	jihv
秧	yhhy
秩	vihf
称	ifhx
称	ighx
秘	mihb
秘	bihb
透	tzzn
笔	bivm
笑	xnvy
笋	syvy
债	vdrb
借	jpro
值	virq
倚	yirk
俺	anrd
倾	qkry
倒	dcrd
倘	thrk
俱	jurb
倡	ihro
候	hzru
赁	lbrb
俯	furc
倍	bwrk
倦	jrrv
健	jmry
臭	izzq
臭	xqzq
射	ueuc
躬	gsug
息	xizx
倔	jtri
徒	turz
徐	xurm
殷	ybpu
殷	yjpu
舰	jmvj
舱	chvv
般	bjvu
航	hhvj
途	tuzm
拿	naru
耸	ssre
爹	dpfx
舀	ycvj
爱	aivy
豺	idvc
豹	bcvu
颁	bjfy
颂	ssgy
翁	wggx
胰	yioy
脆	cvov
脂	vioo
胸	xsox
胳	gaok
胳	geok
脏	zhot
脐	qioq
胶	jnof
脑	ncox
脓	nsoy
逛	glzw
狸	liql
狼	lhql
卿	qkpg
逢	fgzf
鸵	tonb
留	lqpt
鸳	yrxn
皱	vzdp
饿	eeuw
馁	nwun
凌	lkdw
凄	qidn
恋	lmwx
桨	jllm
浆	jllu
衰	ukyv
衰	cvyv
衷	vsyv
高	gcwk
郭	gowe
席	xigj
准	vydv
座	zogr
症	vgbv
病	bkbn
疾	jibu
斋	vdwe
疹	vfbp
疼	tgbd
疲	pibp
脊	jiro
效	xnww
离	liwn
紊	wfwx
唐	thgk
瓷	cidw
资	zidb
凉	lldx
站	vjlv
剖	pzld
竞	jklx
部	bule
旁	phwf
旅	lvfy
畜	iuxt
畜	xuxt
阅	ytmx
羞	xqyi
羔	gcyh
瓶	pkbw
拳	qrju
粉	ffmf
料	lnmd
益	yibm
兼	jmbb
烤	kchk
烘	hshg
烦	fjhy
烧	uchw
烛	vuhi
烟	yjhy
烙	lchk
烙	lohk
递	dizd
涛	tcdc
浙	vedj
涝	lcdl
浦	pudf
酒	jqdy
涉	uedu
消	xndo
涡	wodn
涡	godn
浩	hcdk
海	hddm
涂	tudm
浴	yudg
浮	fudz
涣	hrdd
涤	didm
流	lqdi
润	rydw
涧	jmdo
涕	tidd
浪	lhdl
浸	jbdy
涨	vhdi
烫	thdh
涩	sedv
涌	ysdy
涌	isdy
悖	bwxz
悟	wuxk
悄	qnxo
悍	hjxg
悔	hvxm
悯	mbxw
悦	ytxx
害	hdbk
宽	krbj
家	jxbu
宵	xnbo
宴	yjbn
宾	bbbb
窍	qnbk
窄	vdbv
容	rsbg
宰	zdbx
案	anbm
请	qkyo
朗	lhlo
诸	vuyo
诺	noyk
读	duyd
读	dzyd
扇	ujhx
诽	fwyf
袜	wapw
袖	xqpy
袍	pcpb
被	bwpp
祥	xlpy
课	keyg
冥	mkbl
谁	uwyv
谁	uvyv
调	dnyk
调	tnyk
冤	yrbt
谅	llyx
谆	vyyz
谈	tjyh
谊	yiyq
剥	bced
剥	boed
恳	kfgx
展	vjuy
剧	juud
屑	xpuo
弱	rogg
陵	lkew
祟	sviu
陶	tcef
陷	xmej
陪	pwek
娱	yunt
娟	jrno
恕	uunx
娥	eenw
娘	nlnl
通	tszy
能	ngsb
难	njyv
预	yuyy
桑	shym
绢	jrso
绣	xqsn
验	yjmq
继	jism
骏	jymw
球	qqwq
琐	sowb
理	liwl
琉	lqwi
琅	lhwl
捧	pgff
堵	duto
措	cofo
描	mnft
域	yuta
捺	nafu
掩	yjfd
捷	jpfz
排	pdff
焉	yjvh
掉	dnfu
捶	ivft
赦	ueiw
堆	dvtv
推	tvfv
埠	butf
掀	xmfq
授	uzfy
捻	nmfx
教	jnlw
掏	tcff
掐	qxfj
掠	ltfx
掂	dmfv
培	pwtk
接	jpfn
掷	vife
控	ksfg
探	tjfm
据	jufg
掘	jtfi
掺	ijfp
掺	ujfp
掺	cjfp
职	viev
基	jict
聆	lkes
勘	kjcl
聊	lnee
娶	quen
著	vuco
著	voco
菱	lkcw
勒	legl
勒	lwgl
黄	hlcb
菲	fwcf
萌	mgco
萝	locx
菌	jych
萎	wwcn
菜	cdcc
萄	tccf
菊	jucm
菩	puck
萍	pkcp
菠	bocp
萤	ykci
营	ykck
乾	qmuv
萧	xncb
萨	saci
菇	gucg
械	xpmc
彬	bbmp
梦	mgmx
婪	ljmn
梗	ggmg
梧	wumk
梢	ucmo
梢	scmo
梅	mwmm
检	jmmq
梳	uumi
梯	timd
桶	tsmy
梭	somw
救	jqqw
曹	ccco
副	fuad
票	pnxu
酝	yyyy
酗	xuyx
厢	xlio
戚	qiwx
硅	gvut
硕	uouy
奢	uedo
盔	kvum
爽	uldx
聋	lsle
袭	xily
盛	ugim
盛	igim
匾	bmkc
雪	xtye
辅	fuif
辆	llil
颅	luby
虚	xuhy
彪	bnhp
雀	qtxv
雀	qnxv
堂	thxt
常	ihxj
眶	klow
匙	iiob
匙	uiob
晨	ifoi
睁	vgoy
眯	miom
眼	yjog
悬	xrqx
野	yely
啪	pakb
啦	lakl
曼	mjoy
晦	hvom
晚	wjoe
啄	voku
啡	fwkf
距	juzj
趾	vizv
啃	kfko
跃	ytzy
略	lttk
蚯	qqiq
蛀	vuiv
蛇	ueib
蛇	yiib
唬	hukj
累	lwtx
鄂	eeke
唱	ihko
患	hrix
啰	lokx
唾	tokt
唯	wwkv
啤	piku
啥	uakg
啸	xnkb
崖	yaut
崎	qiuk
崭	vjuj
逻	lozx
崔	cvuv
帷	wwjv
崩	bguo
崇	isuu
崛	jtui
婴	ykbn
圈	qrkv
圈	jrkv
铐	kcjk
铛	dhje
铛	igje
铝	lvjk
铜	tsjk
铭	mkjk
铲	ijji
银	ybjg
矫	jnul
甜	tmug
秸	jphk
梨	lihm
犁	lihn
秽	hvhx
移	yihx
笨	bfvb
笼	lsvl
笛	divy
笙	ugvu
符	fuvc
第	divd
敏	mbpw
做	zorw
袋	ddry
悠	yzrx
偿	ihry
偶	ourd
偎	wwry
偷	tzrd
您	nbrx
售	uzrk
停	tkrd
偏	pmrc
躯	quuq
兜	dzpe
假	jxry
衅	xbpb
徘	pdrf
徙	xirz
得	derc
得	dwrc
衔	xmrj
盘	pjvm
舶	bovb
船	irvk
舵	dovb
斜	xprd
盒	herm
鸽	gern
敛	lmqw
悉	xicx
欲	yugq
彩	cdcp
领	lkry
脚	jnoe
脖	booz
脯	puof
脯	fuof
豚	tyou
脸	lmoq
脱	toox
象	xldu
够	gzjx
逸	yizt
猜	cdqo
猪	vuqo
猎	lpqo
猫	mcqt
凰	hljw
猖	ihqo
猛	mgqm
祭	jixu
祭	vdxu
馅	xmuj
馆	grul
凑	czdt
减	jmdk
毫	hcwm
烹	pgwh
庶	uugh
麻	magm
庵	angd
痊	qrbw
痒	yhby
痕	hfbg
廊	lhge
康	khgl
庸	ysgo
鹿	lugb
盗	dcdm
章	vhlu
竟	jkle
商	uhwk
族	zufu
旋	xrfz
望	whww
率	lvwu
率	ukwu
阎	yjmj
阐	ijmu
着	veyo
着	vcyo
着	voyo
羚	lkys
盖	gdym
盖	geym
眷	jrjo
粘	nmmv
粘	vjmv
粗	cumq
粒	liml
断	drvj
剪	jmbd
兽	uzbk
焊	hjhg
焕	hrhd
清	qkdo
添	tmdx
鸿	hsdn
淋	lbdm
涯	yadt
淹	yjdd
渠	qudm
渐	jmdj
淑	uudy
淌	thdk
混	hydb
淮	hkdv
淆	xndo
渊	yrdl
淫	ybdt
渔	yudy
淘	tcdf
淳	iydz
液	yedw
淤	yudd
淡	djdh
淀	dmdz
深	ufdm
涮	urdd
涵	hjdu
婆	podn
梁	lldm
渗	ufdp
情	qkxo
惜	xixo
惭	cjxj
悼	dcxu
惧	juxb
惕	tixw
惟	wwxv
惊	jkxx
惦	dmxv
悴	cvxu
惋	wjxv
惨	cjxp
惯	grxb
寇	kzby
寅	ybbb
寄	jibk
寂	jiby
宿	subb
宿	xqbb
窒	vibt
窑	ycbf
密	mibu
谋	mzym
谍	dpym
谎	hlyi
谐	xpyb
袱	fupq
祷	dcpc
祸	hopn
谓	wwyo
谚	yjyp
谜	miym
逮	ddzl
敢	gjew
尉	wwuc
尉	yuuc
屠	tuuo
弹	tjgu
弹	djgu
隋	sveo
堕	doet
堕	hvet
随	sveo
蛋	djzi
隅	yued
隆	lseu
隐	ybex
婚	hyno
婶	ufnu
婉	wjnv
颇	popy
颈	jkjy
颈	ggjy
绩	jisb
绪	xuso
续	xusd
骑	qimk
绰	iosu
绰	icsu
绳	ugsd
维	wwsv
绵	mmsj
绷	bgso
绸	izsk
综	zssu
综	zgsu
绽	vjsz
绿	lvsu
绿	lusu
缀	vvsy
巢	icvg
琴	qbwv
琳	lbwm
琢	vowu
琢	zowu
琼	qswx
斑	bjww
替	tifo
揍	zzft
款	krtq
堪	kjtb
塔	tatk
搭	dafk
堰	yjtn
揩	kdfb
越	yttl
趁	iftp
趋	qute
超	ictk
揽	ljfj
堤	ditz
提	tifz
提	difz
博	bouc
揭	jpfr
喜	xitk
彭	pgtp
揣	ikfe
插	iafj
揪	jqfh
搜	szfy
煮	vulh
援	yrfy
搀	ijfd
裁	cdgy
搁	gefk
搓	cofg
搂	lzfn
搅	jnfj
壹	yitb
握	woft
搔	scfi
揉	rzfm
斯	sicj
期	qico
期	jico
欺	qicq
联	lmet
葫	huco
散	sjcw
惹	recx
葬	zhcc
募	mucl
葛	gecr
董	dscv
葡	pucf
敬	jkcw
葱	cscx
蒋	jlcc
蒂	dicj
落	lock
落	lack
落	lcck
韩	hjuw
朝	icuo
朝	vcuo
辜	gugx
葵	kvct
棒	bhmf
棱	lgmw
棱	lkmw
棋	qimb
椰	yeme
植	vimq
森	sfmm
焚	ffmh
椅	yimk
椒	jnmy
棵	kemg
棍	gymb
椎	vvmv
椎	ivmv
棉	mmmj
棚	pgmo
棕	zsmu
棺	grml
榔	lhme
椭	tomo
惠	hvix
惑	hogx
逼	bizt
粟	suxm
棘	jiuu
酣	hjyg
酥	suyh
厨	iuic
厦	uaiw
厦	xxiw
硬	ykug
硝	xnuo
确	qtuy
硫	lqui
雁	yjiv
殖	vidq
殖	uidq
裂	lpdy
雄	xsuv
颊	jxjy
雳	liyl
暂	zjio
雅	yayv
翘	qnyx
辈	bwfi
悲	bwfx
紫	zivx
凿	zckg
辉	hvxi
敞	ihxw
棠	thxm
赏	uhxb
掌	vhxu
晴	qkoo
睐	ldol
暑	uuoo
最	zvoy
晰	xioj
量	llol
鼎	dkpo
喷	pfkb
喳	vakd
喳	iakd
晶	jkoo
喇	lakd
遇	yuzd
喊	hjkk
遏	eezr
晾	llox
景	jkox
畴	iztc
践	jmzj
跋	bazy
跌	dpzf
跑	pczb
跛	bozp
遗	yizb
遗	wwzb
蛙	wait
蛛	vuiw
蜓	tkit
蜒	yjiv
蛤	geik
蛤	haik
喝	hekr
鹃	jrkn
喂	wwky
喘	irke
喉	hzku
喻	yukd
啼	tikj
喧	xrkd
嵌	qmuq
幅	fujt
帽	mcjo
赋	fubv
赌	dubo
赎	uubd
赐	cibw
赔	pwbk
黑	hwlh
铸	vujc
铺	pujf
链	lmji
销	xnjo
锁	sojb
锄	iujl
锅	gojn
锈	xqjn
锋	fgjf
锌	xbjx
锐	rvjx
甥	ugul
掰	bduu
短	drub
智	viuo
氮	djqh
毯	tjmh
氯	lvqu
鹅	eewn
剩	ugqd
稍	ucho
程	ighw
稀	xihj
税	uvhx
筐	klvw
等	dgvc
筑	vuvf
策	cevu
筛	udvj
筒	tsvk
筏	favg
答	davk
筋	jbvl
筝	vgvy
傲	aorw
傅	furc
牌	pdpu
堡	bcrt
堡	burt
堡	purt
集	jirm
焦	jnrh
傍	bhrf
储	iuro
皓	hcbk
皖	wjby
粤	ytpk
奥	aopd
街	jprt
惩	igrx
御	yure
循	xyro
艇	tkvt
舒	uury
逾	yuzd
番	fjct
番	pjct
释	uicf
禽	qbrn
腊	laoo
腊	xioo
脾	piou
腋	yeow
腔	qlog
腕	wjov
鲁	luyo
猩	xkqu
猬	wwqo
猾	hxqo
猴	hzqu
惫	bwwx
然	rjxh
馈	kvub
馋	ijud
装	vlly
蛮	mjwi
就	jqwy
敦	dvww
敦	dyww
斌	bbwv
痘	dzbb
痢	libd
痪	hrbd
痛	tsby
童	tsll
竣	jylw
阔	komu
善	ujyk
翔	xlyx
羡	xmyq
普	pubo
粪	ffmg
尊	zybc
奠	dmbd
道	dczz
遂	svzu
曾	cgbo
曾	zgbo
焰	yjhj
港	ghds
滞	vidj
湖	hudo
湘	xldo
渣	vadd
渤	bodl
渺	mndu
湿	uidy
温	wfdm
渴	kedr
溃	kvdb
溅	jmdj
滑	hxdo
湃	pddf
渝	yudd
湾	wjdg
渡	dudy
游	yzdz
滋	zidy
渲	xrdd
溉	gddw
愤	ffxb
慌	hlxi
惰	doxo
愕	eexk
愣	lgxf
惶	hlxw
愧	kvxg
愉	yuxd
慨	kdxw
割	gebd
寒	hjbd
富	fubt
寓	yubd
窜	crbi
窝	wobn
窖	jnbk
窗	ilbw
窘	jsbk
遍	bmzc
雇	guhv
裕	yupg
裤	kupi
裙	qypk
禅	ijpu
禅	ujpu
禄	lupu
谢	xpyc
谣	ycyf
谤	bhyf
谦	qmyj
犀	xiun
属	uuuy
属	vuuy
屡	lvun
强	qlgi
强	jlgi
粥	vzgm
粥	yugm
疏	uuvi
隔	geeg
隙	xieo
隘	aiem
媒	mwnm
絮	xunx
嫂	scny
媚	mwno
婿	xuno
登	dgbb
缅	mmsm
缆	ljsj
缉	jise
缎	drsu
缓	hrsy
缔	disj
缕	lvsn
骗	pmmc
编	bmsc
骚	scmi
缘	yrsu
瑟	sewb
鹉	wugn
瑞	rvwe
瑰	gvwg
瑙	ncwx
魂	hyyg
肆	siey
摄	uefy
摸	mofd
填	tmtb
搏	bofc
塌	tatx
鼓	gutv
摆	bdfq
携	xpfn
搬	bjfu
摇	ycff
搞	gcfk
塘	thtk
摊	tjfv
聘	pbek
斟	vfcd
蒜	srcu
勤	qbcl
靴	xtgb
靶	bagb
鹊	qtcn
蓝	ljcm
墓	muct
幕	mucj
蓬	pgcf
蓄	xuct
蒲	pucf
蓉	rscg
蒙	mgcu
蒸	vgch
献	xmuq
椿	iymo
禁	jbmu
楚	iumz
楷	kdmb
楷	jpmb
榄	ljmj
想	xlmx
槐	hkmg
榆	yumd
楼	lzmn
概	gdmw
赖	ldub
酪	lcyk
酬	izyv
感	gjwx
碍	aiuc
碘	dmub
碑	bwuu
碎	svuu
碰	pguy
碗	wjuv
碌	luuu
碌	lquu
尴	gjym
雷	lwyt
零	lkys
雾	wuyl
雹	bcyb
辐	fuit
辑	jiie
输	uuid
督	duuo
频	pbvy
龄	lkvs
鉴	jmlj
睛	jkoo
睹	duoo
睦	muot
瞄	mnot
睫	jpoz
睡	uvot
睬	cdoc
嗜	uiko
鄙	bike
嗦	sokx
愚	yutx
暖	nroy
盟	mgom
歇	xpoq
暗	anoo
暇	xxoy
照	vcoh
畸	jitk
跨	kxzk
跷	qnzw
跳	tnzv
跺	dozm
跪	gvzv
路	luzk
跤	jnzf
跟	gfzg
遣	qmzl
蜈	wuit
蜗	woin
蛾	eeiw
蜂	fgif
蜕	tvix
嗅	xqkq
嗡	wgkx
嗓	shkm
署	uuso
置	visq
罪	zvsf
罩	vcsu
蜀	uusi
幌	hlje
错	cojo
锚	mcjt
锡	xijw
锣	lojx
锤	ivjt
锥	vvjv
锦	jbjj
键	jmjy
锯	jujg
锰	mgjm
矮	aiun
辞	ciux
稚	vihv
稠	izhk
颓	tvhy
愁	izhx
筹	izvc
签	qmvq
简	jmvo
筷	kkvg
毁	hvju
舅	jqjl
鼠	uujv
催	cvrv
傻	uarw
像	xlru
躲	doum
魁	kvgd
衙	yark
微	wwrj
愈	yurx
遥	yczf
腻	niob
腰	ycon
腥	xkou
腮	sdox
腹	fuow
腺	xmou
鹏	pgon
腾	tgom
腿	tvog
鲍	bcyb
猿	yrqy
颖	ykby
触	iudi
解	jpdn
解	xpdn
煞	uadh
雏	iudv
馍	moud
馏	lqut
酱	jlly
禀	bkwu
痹	bibw
廓	koge
痴	iibk
痰	tjbh
廉	lmgj
靖	jklo
新	xblj
韵	yyly
意	yilx
誊	tgjk
粮	llml
数	uumw
数	uomw
煎	jmbh
塑	sunt
慈	cibx
煤	mwhm
煌	hlhw
满	mjdl
漠	modd
滇	dmdb
源	yrdx
滤	lvdx
滥	ljdm
滔	tcdj
溪	xidd
溜	lqdt
漓	lidn
滚	gydg
溢	yidm
溯	sudo
滨	bbdb
溶	rsdg
溺	nidg
溺	nndg
粱	lldm
滩	tjdv
慎	ufxb
誉	yuxk
塞	sdbt
塞	sebt
寞	mobd
窥	kvbj
窟	kubi
寝	qbby
谨	jbyw
褂	gxpb
裸	lopg
福	fupt
谬	mqyp
群	qyyy
殿	dmuu
辟	biux
辟	piux
障	vheu
媳	xinx
嫉	jinu
嫌	xmnj
嫁	jxnu
叠	dpyq
缚	fusc
缝	fgsf
缠	ijsl
缤	bbsb
剿	icvd
剿	jnvd
静	jkfy
碧	biwu
璃	liwn
赘	vvfb
熬	aofh
墙	qltk
墟	xuty
嘉	jxtk
摧	cvfv
赫	heii
截	jpgv
誓	uifk
境	jkte
摘	vdfg
摔	ukfu
撇	ppfw
聚	jueu
慕	mucx
暮	muco
摹	mocu
蔓	mjcy
蔓	wjcy
蔑	mpcd
蔡	cdcu
蔗	vech
蔽	bicw
蔼	aicr
熙	xiih
蔚	wwcc
蔚	yucc
兢	jkux
模	momd
模	mumd
槛	kjmm
槛	jmmm
榴	lqmt
榜	bhmf
榨	vamv
榕	rsmg
歌	gekq
遭	zczo
酵	jnyz
酷	kuyk
酿	nlyl
酸	sryw
碟	dpum
碱	jmuk
碳	tjuh
磁	ciuy
愿	yrix
需	xuye
辖	xxik
辗	nmiy
辗	vjiy
雌	civv
裳	uhxy
裳	ihxy
颗	kegy
瞅	izoh
墅	uult
嗽	szkq
踊	yszy
蜻	qkio
蜡	laio
蝇	ykid
蜘	viik
蝉	ijiu
嘛	makm
嘀	dikg
赚	vrbj
锹	qnjh
锻	drju
镀	dujy
舞	wupf
舔	tmux
稳	wfhx
熏	xyqh
箕	jivb
算	srvc
箩	lovx
管	grvl
箫	xnvb
舆	yujb
僚	lnrx
僧	sgro
鼻	bizw
魄	pobg
魅	mwgw
貌	mcve
膜	mood
膊	booc
膀	bhof
膀	phof
鲜	xmyy
疑	yibz
孵	fulz
馒	mjuy
裹	goyg
敲	qnwy
豪	hcwu
膏	gcwo
遮	vezh
腐	fugr
瘩	dabk
瘟	wfbm
瘦	uzby
辣	laxu
彰	vhlp
竭	jplr
端	drle
旗	qifb
精	jkmo
粹	cvmu
歉	qmjq
弊	bixc
熄	xihx
熔	rshg
煽	ujhx
潇	xndb
漆	qidu
漱	uudq
漂	pndu
漫	mjdy
滴	didg
漾	yhdy
演	yjdb
漏	lzdy
慢	mjxy
慷	khxl
寨	vdbm
赛	sdbb
寡	gxbf
察	iabu
蜜	mibi
寥	lnbp
谭	tjyu
肇	vchy
褐	hepr
褪	tvpg
褪	typg
谱	puyo
隧	sveu
嫩	nfnw
翠	cvxu
熊	xssh
凳	dgbj
骡	lomx
缩	sosb
慧	hvfx
撵	nmfi
撕	sifj
撒	safw
撩	lnfx
趣	quty
趟	thtk
撑	igfu
撮	cofy
撮	zofy
撬	qnfm
播	boft
擒	qbfn
墩	dytw
撞	vlfl
撤	iefw
增	zgto
撰	vrfg
聪	csex
鞋	xpgt
鞍	angn
蕉	jnch
蕊	rvcx
蔬	uuci
蕴	yycm
横	hgmh
槽	ccmo
樱	ykmn
橡	xlmu
樟	vhmu
橄	gjmw
敷	fufw
豌	wjdv
飘	pnxf
醋	cuyo
醇	iyyz
醉	zvyu
磕	keum
磊	lwuu
磅	bhuf
磅	phuf
碾	nmuy
震	vfyi
霄	xnyo
霉	mwym
瞒	mjol
题	tioy
暴	bcou
暴	puou
瞎	xxok
嘻	xikk
嘶	sikj
嘲	icko
嘲	vcko
嘹	lnkx
影	ykop
踢	tizw
踏	tazo
踩	cdzc
踪	zszu
蝶	dpim
蝴	huio
蝠	fuit
蝎	xpir
蝌	keid
蝗	hliw
蝙	bmic
嘿	hwkh
嘱	vuky
幢	vljl
幢	iljl
墨	molt
镇	vfjb
镐	gcjk
镐	hcjk
镑	bhjf
靠	kcnf
稽	jiho
稻	dchj
黎	lihu
稿	gchk
稼	jxhu
箱	xlvo
篓	lzvn
箭	jmvd
篇	pmvc
僵	jlrj
躺	thuk
僻	pirx
德	derx
艘	szvy
膝	xiou
膛	thot
鲤	liyl
鲫	jiye
熟	uuwh
熟	uzwh
摩	mogu
摩	magu
褒	bcym
瘪	bpbl
瘤	lqbt
瘫	tjbv
凛	lbdu
颜	yjwy
毅	yilu
糊	humo
遵	zyzc
憋	bpxx
潜	qmdo
澎	pgdp
潮	icdo
潭	tjdu
鲨	uady
澳	aodd
潘	pjdt
澈	iedw
澜	ljdj
澄	igdb
澄	dgdb
懂	dsxv
憔	qnxh
懊	aoxd
憎	zgxo
额	eeby
翩	pmhx
褥	rupc
谴	qmyl
鹤	hebn
憨	hjex
慰	wwux
劈	piud
履	lvuw
豫	yuyu
缭	lnsx
撼	hjfx
擂	lwft
操	ccfm
擅	ujfd
燕	yjch
蕾	lwct
薯	uuco
薛	xtcx
薇	wwcj
擎	qkcu
薪	xbcj
薄	bocc
薄	bccc
颠	dmuy
翰	hjux
噩	eewk
橱	iumc
橙	igmb
橘	jumk
整	vguv
融	rsgi
瓢	pnxg
醒	xkyu
霍	hoyv
霎	uayn
辙	veiw
冀	jibg
餐	cjdg
嘴	zvky
踱	dozy
蹄	tizj
蹂	rzzm
蟆	maid
螃	phif
器	qikk
噪	zckm
鹦	ykbn
赠	zgbo
默	molq
黔	qmlv
镜	jkje
赞	zjnb
穆	muhp
篮	ljvm
篡	crvs
篷	pgvf
篱	livn
儒	rure
邀	yczw
衡	hgrd
膨	pgop
雕	dnkv
鲸	jkyx
磨	mogu
瘾	ybbx
瘸	qtbr
凝	nkdz
辨	bmxl
辩	bmxy
糙	ccmk
糖	thmk
糕	gcmh
燃	rjhh
濒	bbdy
澡	zcdm
激	jidw
懒	ljxb
憾	hjxx
懈	xpxn
窿	lsbu
壁	biut
避	bizx
缰	jlsj
缴	jnsw
缴	vosw
戴	ddgg
擦	cafu
藉	jico
藉	jpco
鞠	jugm
藏	chci
藏	zhci
藐	mnce
檬	mgmu
檐	yjmk
檀	tjmd
礁	jnuh
磷	lbuf
霜	ulyo
霞	xxyy
瞭	lnox
瞧	qnoh
瞬	uyof
瞳	tsol
瞩	vuoy
瞪	dgob
曙	uuoo
蹋	tazx
蹈	dczj
螺	loix
蟋	xiix
蟀	ukiu
嚎	hcku
赡	ujbk
穗	svhx
魏	wwhg
簧	hlvh
簇	cuvu
繁	fjpx
繁	popx
徽	hvrx
爵	jtvc
朦	mgou
臊	scom
鳄	eeyk
癌	aibu
辫	bmxs
赢	ykwb
糟	zcmo
糠	khml
燥	zchm
懦	noxe
豁	hobg
臀	tyuo
臂	biuo
臂	bwuo
翼	yixg
骤	vzmu
藕	oucd
鞭	bmgg
藤	tgcu
覆	fuxw
瞻	vjok
蹦	bgzo
嚣	xnkk
镰	lmjj
翻	fjcx
鳍	qiyo
鹰	ykgn
瀑	pudu
瀑	bcdu
襟	jbpu
璧	biuy
戳	ioxg
孽	npcz
警	jkck
蘑	mocu
藻	zccm
攀	pjmu
曝	bcou
曝	puou
蹲	dyzc
蹭	cgzo
蹬	dgzb
巅	dmuy
簸	bovp
簿	bovc
簿	buvc
蟹	xpdi
颤	ijwy
颤	vjwy
靡	migf
癣	xrby
瓣	bjxg
羹	ggyd
鳖	bpxy
爆	bchu
疆	jlgj
鬓	bbeb
壤	rhtx
馨	xbto
耀	ycxv
躁	zczm
蠕	ruie
嚼	jnkc
嚼	jtkc
嚷	rhkx
巍	wwug
籍	jivo
鳞	lbyf
魔	mogg
糯	nome
灌	grdv
譬	piuk
蠢	iyii
霸	bayo
露	luyk
露	lzyk
霹	piyx
躏	lbzv
黯	anlo
髓	svgo
赣	gjlb
囊	nhgy
镶	xljx
瓤	rhxg
罐	grfv
矗	iuuq
乂	yipn
乜	mpvv
乜	npvv
兀	wuae
弋	yiyd
孑	jpla
孓	jtln
幺	ycvs
亓	qiaw
韦	wwfv
廿	nmca
丏	mmgl
卅	saai
仄	zeir
厄	eeiv
仃	dkrd
仉	vhrj
仂	lerl
兮	xibk
刈	yixd
爻	ycxx
卞	bmwb
闩	urma
讣	fuyb
尹	ybep
夬	gkvr
爿	pjvl
毋	wump
邗	hjge
邛	qsge
艽	jncj
艿	ndcn
札	vamv
叵	pokk
匝	zakj
丕	piba
匜	yiky
劢	mdwl
卟	bukb
叱	iikb
叻	lekl
仨	sars
仕	uirt
仟	qmrq
仡	gerv
仡	yirv
仫	murm
仞	rfrr
卮	viiv
氐	diud
犰	qqqj
刍	iude
邝	klge
邙	mhwe
汀	tkdd
讦	jpyg
讧	hsyg
讪	ujyu
讫	qiyv
尻	kcuj
阡	qmeq
尕	ganx
弁	bmsc
驭	yumy
匡	klkw
耒	lwfr
玎	dkwd
玑	jiwj
邢	xkke
圩	xuty
圩	wwty
圬	wutk
圭	gvtt
扦	qmfq
圪	getv
圳	vfti
圹	kltg
扪	mffm
圮	pitj
圯	yits
芊	qmcq
芍	uccu
芄	wjcw
芨	jicj
芑	qicj
芎	xscg
芗	xlcx
亘	gfad
厍	ueii
夼	kldi
戍	uuwd
尥	lnyu
乩	jivv
旯	laoj
曳	yeyp
岌	jiuj
屺	qiuj
凼	dhku
囡	njkn
钇	yijv
缶	fzpk
氘	dcql
氖	ndqn
牝	pbnb
伎	jirv
伛	yurq
伢	yary
佤	warw
仵	wuru
伥	ihri
伧	chrv
伧	ifrv
伉	khrj
伫	vurv
囟	xbpx
汆	crru
刖	ytod
夙	sujd
旮	gajo
刎	wfwd
犷	glqg
犸	maqm
舛	irxf
凫	funj
邬	wuwe
饧	xkup
汕	ujdu
汔	qidv
汐	xidx
汲	jidj
汜	sids
汊	iadi
忖	cyxc
忏	ijxq
讴	ouyq
讵	juyj
祁	qipe
讷	neyn
聿	yuyg
艮	gfoy
厾	duvq
阱	jkej
阮	rrey
阪	bjey
丞	igla
妁	uonu
牟	musn
牟	mzsn
纡	yusy
纣	vzsc
纥	gesv
纥	hesv
纨	wjsw
玕	gjwg
玙	yuwy
抟	trfv
抔	pzfb
圻	qitj
圻	ybtj
坂	bjty
坍	tjtd
坞	wutw
抃	bmfb
抉	jtfg
㧐	ssfy
芫	yjcy
芫	yrcy
邯	hjge
芸	yycy
芾	fucu
芾	fwcu
苈	licl
苣	jucj
苣	qucj
芷	vicv
芮	rvcn
苋	xmcj
芼	mccm
苌	ihci
苁	cscr
芩	qbcv
芪	qicu
芡	qmcq
芟	ujcu
苄	bmcb
苎	vucv
苡	yicr
杌	wumw
杓	bnmu
杓	ucmu
杞	qimj
杈	iami
忑	texx
孛	bouz
孛	bwuz
邴	bkbe
邳	pibe
矶	jiuj
奁	lmdq
豕	uiau
忒	teyx
忒	twyx
忒	tvyx
欤	yuyq
轫	rfir
迓	yazy
邶	bwbe
忐	tjux
卣	yzbk
邺	yeye
旰	gjog
呋	fukf
呒	fukw
呒	omkw
呓	yikv
呔	ddkt
呔	tdkt
呖	likl
呃	eekv
旸	yhop
吡	bikb
吡	pikb
町	dktd
町	tktd
虬	qqiv
呗	bwkb
呗	bdkb
吽	hskn
吣	qbkx
吲	ybkl
帏	wwjw
岐	qiuv
岈	yauy
岘	xmuj
岑	cfuv
岚	ljuf
兕	siae
囵	lykl
囫	hukw
钊	vcjd
钋	pojb
钌	lnjl
迕	wuzu
氙	xmqu
氚	irqi
牤	mhnw
佞	nkrn
邱	qqqe
攸	yzrw
佚	yirf
佝	gzrj
佟	tsrd
佗	torb
伽	jxrk
伽	qprk
伽	gark
彷	fhrf
彷	phrf
佘	ueru
佥	qmra
孚	fuvz
豸	vipp
坌	bfft
肟	wook
邸	diue
奂	hrdd
劬	qujl
狄	diqh
狁	yyqy
鸠	jqjn
邹	zzde
饨	tyut
饩	xiuq
饪	rfut
饫	yuuy
饬	iiul
亨	hgwl
庑	wugw
庋	gvgv
疔	dkbd
疖	jpbe
肓	hlwo
闱	wwmw
闳	hsms
闵	mbmw
羌	qlyv
炀	yhhp
沣	fgdf
沅	yrdy
沔	mmdg
沤	oudq
沌	dydt
沌	vrdt
沏	qidd
沚	vidv
汩	gudo
汨	mido
沂	yidj
汾	ffdf
沨	fgdf
汴	bmdb
汶	wfdw
沆	hhdj
沩	wwdw
泐	ledl
怃	wuxw
怄	ouxq
忡	isxv
忤	wuxu
忾	kdxq
怅	ihxi
忻	xbxj
忪	ssxg
忪	vsxg
怆	ilxv
忭	bmxb
忸	nqxi
诂	guyg
诃	heyk
诅	zuyq
诋	diyu
诌	vzye
诏	vcyk
诒	yiyk
孜	zizw
陇	lsel
陀	toeb
陂	bwep
陂	piep
陂	poep
陉	xkej
妍	yjnk
妩	wunw
妪	yunq
妣	binb
妊	rfnt
妗	jbnv
妫	gvnw
妞	nqni
姒	sinr
妤	yuny
邵	ucde
劭	ucdl
刭	jkjd
甬	yssy
邰	tdse
纭	yysy
纰	pisb
纴	rfst
纶	grsl
纶	lysl
纾	uusy
玮	wwww
玡	yawy
玭	pbwb
玠	jpwj
玢	bbwf
玢	ffwf
玥	ytwo
玦	jtwg
盂	yuym
忝	tmtx
匦	gvkj
坩	gjtg
抨	pgfp
拤	qxfb
坫	dmtv
拈	nmfv
垆	lutu
抻	iffu
劼	jptl
拃	vafv
拊	fufc
坼	ieti
坻	ditu
坻	iitu
㧟	kkfk
坨	totb
坭	nitb
抿	mbfm
坳	aotl
耶	yeee
苷	gjcg
苯	bfcb
苤	ppcp
茏	lscl
苫	ujcv
苜	muco
苴	jucq
苒	rjcr
苘	qkck
茌	iict
苻	fucc
苓	lkcs
茚	ybce
茆	mcce
茑	nncn
茓	xtcb
茔	ykct
茕	qscu
茀	fucf
苕	ucck
苕	tnck
枥	liml
枇	pimb
杪	mnmu
杳	ycmo
枧	jmmj
杵	iumu
枨	igmi
枞	csmr
枞	zsmr
枋	fhmf
杻	nqmi
杻	izmi
杷	pamb
杼	vumy
矸	gjug
砀	dhup
刳	kudd
奄	yjdd
瓯	ouqw
殁	modu
郏	jxje
轭	eeiv
郅	vige
鸢	yryn
盱	xuoy
昊	hcot
昙	tjoy
杲	gcom
昃	zeor
咂	zakj
呸	pwkp
昕	xboj
昀	yyoy
旻	mbow
昉	fhof
炅	jsoh
炅	gvoh
咔	kakb
畀	bitw
虮	jiij
咀	jukq
咀	zvkq
呷	xxkj
呷	gakj
黾	mbkd
黾	mmkd
呱	gukg
呱	gxkg
呤	lkks
咚	dskd
咆	pckb
咛	nkkd
呶	ncky
呦	yzkl
咝	siks
岢	keuk
岿	kvue
岬	jxuj
岫	xquy
帙	vijf
岣	gzuj
峁	mcue
刿	gvud
迥	jszk
岷	mbum
剀	kdud
帔	pwjp
峄	yiuf
沓	dauo
沓	tauo
囹	lkks
罔	whkw
钍	tujt
钎	qmjq
钏	irji
钒	fjjf
钕	nvjn
钗	idji
邾	vupe
迮	zezv
牦	mcnm
竺	vuve
迤	yizy
佶	jirk
佬	lcrl
佰	bdrb
侑	yzro
侉	kxrk
臾	yujr
岱	ddru
侗	dsrk
侗	tsrk
侃	kjri
侏	vurw
侩	kkry
佻	tnrv
佾	yiro
侪	idrq
佼	jnrf
佯	yhry
侬	nsry
帛	bobj
阜	fulu
侔	mzrn
徂	curq
刽	gvrd
郄	qpxe
怂	ssrx
籴	dirm
瓮	wggw
戗	qlrg
肼	jkoj
䏝	vrov
肽	tdot
肱	gsos
肫	vyot
剁	dojd
迩	erzx
郇	xybe
郇	hrbe
狙	juqq
狎	xxqj
狍	pcqb
狒	fwqf
咎	jqwk
炙	vixh
枭	xnnm
饯	jmuj
饴	yiuk
冽	lpdd
冼	xmde
庖	pcgb
疠	libw
疝	ujbu
疡	yhbp
兖	yjly
妾	qpln
劾	hewl
炜	wwhw
𬉼	ouhq
炖	dyht
炘	xbhj
炝	qlhv
炔	qthg
泔	gjdg
沭	uudu
泷	uldl
泷	lsdl
泸	ludu
泱	yhdy
泅	qqdr
泗	sids
泠	lkds
泺	lodl
泖	mcde
泫	xrdx
泮	pjdb
沱	todb
泯	mbdm
泓	hsds
泾	jkdj
怙	huxg
怵	iuxu
怦	pgxp
怛	daxd
怏	yhxy
怍	zoxv
㤘	vzxe
怩	nixb
怫	fuxf
怿	yixf
宕	dhbu
穹	qsbg
宓	fubb
宓	mibb
诓	klyw
诔	lwyl
诖	gxyt
诘	jiyk
诘	jpyk
戾	lihq
诙	hvyh
戽	huhd
郓	yybe
衩	iapi
祆	xmpt
祎	yipw
祉	vipv
祇	qipu
诛	vuyw
诜	ufye
诟	gzyk
诠	qryw
诣	yiyo
诤	vgyy
诧	iayq
诨	hyyi
诩	xuyx
戕	qlpg
孢	bczb
亟	jila
亟	qila
陔	gder
妲	dand
妯	vzny
姗	ujnc
帑	thnj
弩	nung
孥	nunz
驽	nunm
虱	uivi
迦	jxzk
迨	ddzk
绀	gjsg
绁	xpsu
绂	fusy
驷	sims
驸	fumc
绉	vzse
绌	iusi
驿	yimf
骀	tdmk
甾	zdvt
珏	jtwy
珐	fawq
珂	kewk
珑	lswl
玳	ddwy
珀	powb
顸	hjgy
珉	mbwm
珈	jxwk
拮	jpfk
垭	yaty
挝	wofc
挝	vxfc
垣	yrtd
挞	tafd
垤	dptt
赳	jqtj
贲	bfub
贲	biub
垱	dhte
垌	tstk
垌	dstk
郝	hcie
垧	uhtk
垓	gdtr
挦	xmfc
垠	ybtg
茜	qmcx
茜	xicx
荚	jxcj
荑	yicy
荑	ticy
贳	uiub
荜	bicu
莒	juck
茼	tsck
茴	hvck
茱	vucw
莛	tkct
荞	qncl
茯	fucq
荏	rfct
荇	xkcd
荃	qrcw
荟	hvcy
荀	xyco
茗	mkck
荠	jicq
荠	qicq
茭	jncf
茨	cicq
垩	eeyt
荥	xkcu
荥	ykcu
荦	locn
荨	xycc
荨	qmcc
荩	jbcd
剋	kwud
荪	sycx
茹	ruck
荬	mdcd
荮	vzcc
柰	ndmu
栉	vime
柯	kemk
柘	vemu
栊	lsml
柩	jqmj
枰	pkmp
栌	lumu
柙	xxmj
枵	xnmk
柚	yzmy
枳	vimv
柞	zomv
柞	vamv
柝	tomi
栀	vimv
柢	dimu
栎	liml
栎	ytml
枸	gzmj
枸	jumj
柈	bjmb
柁	domb
柁	tomb
枷	jxmk
柽	igmt
剌	laud
酊	dkyd
郦	lile
甭	bgby
砗	ieui
砘	dyut
砒	piub
斫	vouj
砭	bmuf
砜	fguf
奎	kvdt
耷	dade
虺	hvwi
殂	cudq
殇	uhdp
殄	tmdp
殆	dddk
轱	guig
轲	keik
轳	luiu
轶	yiif
轸	vfip
虿	idwi
毖	bibb
觇	ijvj
尜	gaxx
哐	klkw
眄	mmog
眍	kzoq
𠳐	bhke
郢	ykke
眇	mnou
眊	mcom
眈	djoe
禺	yutd
哂	ufkx
咴	hvkh
曷	heor
昴	mcoe
昱	yuol
昵	niob
咦	yiky
哓	xnkw
哔	biku
畎	qrtq
毗	pitb
呲	cikb
呲	zikb
胄	vzyo
畋	tmtw
畈	fjty
虼	geiv
虻	mgiw
盅	vsvm
咣	glke
哕	ytkx
哕	hvkx
剐	gxkd
郧	yyke
咻	xqkm
囿	yzko
咿	yiky
哌	pdky
哙	kkky
哚	dokm
咯	gekk
咯	lokk
咯	kakk
咩	mpky
咤	vakq
哝	nsky
哏	gfkg
哞	mzkn
峙	uiuc
峙	viuc
峣	ycuw
罘	fusb
帧	vfjb
峒	dsuk
峒	tsuk
峤	qnul
峤	jnul
峋	xyuo
峥	vguy
贶	klbx
钚	bujb
钛	tdjt
钡	bwjb
钣	bjjy
钤	qmjv
钨	wujw
钫	fhjf
钯	bajb
氡	dsqd
氟	fuqf
牯	gung
郜	gcne
秕	bihb
秭	zihd
竽	yuvy
笈	jivj
笃	duvm
俦	izrc
俨	yjry
俅	qqrq
俪	lird
叟	szjy
垡	fart
牮	jmrn
俣	yurt
俚	lirl
皈	gvby
俑	ysry
俟	siru
俟	qiru
逅	hzzk
徇	xyro
徉	yhry
舢	ujvu
俞	yurd
郗	xixe
俎	zurq
郤	xige
爰	yrvy
郛	fuve
瓴	lkrw
胨	dsod
胪	luou
胛	jxoj
胂	ufou
胙	zoov
胍	gxog
胗	vfop
胝	viou
朐	quoj
胫	jkoj
鸨	bcbn
匍	pubf
狨	rsqu
狯	kkqy
飑	bnfb
狩	uzqc
狲	syqx
訇	hsbk
逄	phzf
昝	zjwo
饷	xluk
饸	heuk
饹	leuk
饹	geuk
胤	ybeo
孪	lrwz
娈	lrwn
弈	yiwc
奕	yiwd
庥	xqgm
疬	libl
疣	yzby
疥	jpbj
疭	zsbr
庠	xlgy
竑	hsls
彦	yjwp
飒	salf
闼	tamd
闾	lvmk
闿	kdmj
阂	hemr
羑	yzyj
迸	bgzk
籼	xmmu
酋	qqby
炳	bkhn
炻	uihu
炽	iihv
炯	jshk
烀	huhh
炷	vuhv
烃	tkhj
洱	erde
洹	hrdd
洧	wwdo
洌	lpdd
浃	jxdj
洇	ybdy
洄	hvdk
洙	vudw
涎	xmdv
洎	jidz
洫	xudm
浍	kkdy
浍	hvdy
洮	tcdv
洵	xydo
浒	hudu
浒	xudu
浔	xydc
浕	jbdd
洳	rudk
恸	tsxl
恓	xixx
恹	yjxq
恫	dsxk
恺	kdxj
恻	cexd
恂	xyxo
恪	kexk
恽	yyxi
宥	yzbo
扃	jshk
衲	napn
衽	rfpt
衿	jbpv
袂	mwpg
祛	qupq
祜	hupg
祓	fupy
祚	zopv
诮	qnyo
祗	vipu
祢	mipx
诰	gcyk
诳	klyw
鸩	vfbn
昶	ihyo
郡	jyye
咫	viiv
弭	mige
牁	kepk
胥	xuzo
陛	biet
陟	vieu
娅	yany
姮	hgnd
娆	rcnw
姝	uunw
姣	jnnf
姘	pbnk
姹	ianq
怼	dvyx
羿	yixc
炱	tdsh
矜	jbmv
矜	qbmv
矜	grmv
绔	kusk
骁	xnmw
骅	hxmu
绗	hhsd
绛	jlsf
骈	pmmk
耖	iclu
挈	qpfu
珥	erwe
珙	gswg
顼	xuwy
珰	dhwe
珩	hgwd
珧	ycwv
珣	xywo
珞	lowk
琤	igwy
珲	hvwi
珲	hywi
敖	aofw
恚	hvtx
埔	butf
埔	putf
埕	igtw
埘	uitc
埙	xytb
埚	gotn
挹	yifb
耆	qilo
耄	mclm
埒	lptc
捋	lvfc
捋	lofc
贽	vifb
垸	yrty
捃	jyfk
盍	heqm
荸	bicz
莆	pucf
莳	uicc
莴	wocn
莪	eecw
莠	yzcn
莓	mwcm
莜	yzcw
莅	licl
荼	tucm
莩	fucz
荽	svcn
莸	yzcy
荻	dich
莘	ufcx
莘	xbcx
莎	uacu
莎	socu
莞	grcy
莞	wjcy
莨	llcl
莨	lhcl
鸪	gugn
莼	iyct
栲	kcmk
栳	lcml
郴	ifme
桓	hrmd
桡	rcmw
桎	vimt
桢	vfmb
桤	qimj
梃	tkmt
栝	komu
栝	gxmu
桕	jqmj
桁	hgmd
桧	hvmy
桧	gvmy
桅	wwmv
栟	bfmk
桉	anmn
栩	xumx
逑	qqzq
逋	buzf
彧	yuga
鬲	geal
豇	jldg
酐	gjyg
逦	lizd
厝	coio
孬	ncbz
砝	fauq
砹	aiux
砺	liuw
砧	vfuv
砷	ufuu
砟	vauv
砼	tsug
砥	diuu
砣	toub
剞	jidd
砻	lslu
轼	uiig
轾	viit
辂	luik
鸫	dsdn
趸	dywz
龀	ifvb
鸬	lubn
虔	qmhw
逍	xnzo
眬	lsol
唛	mdkw
晟	igoi
晟	ugoi
眩	xrox
眙	yiok
哧	iiki
哽	ggkg
唔	wukk
唔	ogkk
唔	onkk
晁	icov
晏	yjon
鸮	xnkn
趵	bczu
趿	tazj
畛	vftp
蚨	fuif
蚜	yaiy
蚍	piib
蚋	rvin
蚬	xmij
蚝	hcim
蚧	jpij
唢	sokb
圄	yukk
唣	zckq
唏	xikj
盎	ahym
唑	zokr
崂	lcul
崃	ldul
罡	ghsv
罟	gusg
峪	yuug
觊	jiuj
赅	gdbr
钰	yujy
钲	vgjv
钴	gujg
钵	bojb
钹	bojy
钺	ytjl
钽	tjjd
钼	mujo
钿	dmjt
钿	tmjt
铀	yzjy
铂	bojb
铄	uojl
铆	mcje
铈	uijj
铉	xrjx
铊	tojb
铊	tajb
铋	bijb
铌	nijb
铍	pijp
䥽	pojy
铎	dojf
氩	yaqy
氤	ybqy
氦	hdqr
毪	mumn
舐	uiuu
秣	mohw
秫	uuhu
盉	hehm
笄	jivk
笕	jmvj
笊	vcvv
笏	huvw
笆	bavb
俸	fgrf
倩	qmro
倩	qkro
俵	bnry
偌	rork
俳	pdrf
俶	iury
俶	tiry
倬	voru
倏	uurq
恁	nfrx
倭	worn
倪	nire
俾	biru
倜	tirk
隼	syru
隽	jrrn
隽	jyrn
倌	grrl
倥	ksrg
臬	npzm
皋	gcbu
郫	pipe
倨	jurg
衄	nvpi
颀	qijy
徕	ldrl
舫	fhvf
釜	fufb
奚	xivd
衾	qbry
胯	kxok
胱	gloe
胴	dsok
胭	yjoy
脍	kkoy
胼	pmok
朕	vfot
脒	miom
胺	anon
鸱	iiun
玺	xidy
鸲	qujn
狷	jrqo
猁	liqd
狳	yuqm
猃	xmqq
狺	ybqk
逖	tizh
桀	jpxm
袅	nnny
饽	bouz
凇	ssdg
栾	lrwm
挛	lrwu
亳	bowq
疳	gjbg
疴	kebk
疸	djbd
疽	jubq
痈	ysby
疱	pcbb
痂	jxbk
痉	jkbj
衮	gyyg
凋	dndk
颃	hhwy
恣	zidx
旆	pwfu
旄	mcfm
旃	vjfd
阃	kymm
阄	jqmd
訚	ybmk
阆	lhml
恙	yhyx
粑	bamb
朔	uono
郸	djbe
烜	xrhd
烨	yehu
烩	hvhy
烊	yhhy
剡	ujhd
剡	yjhd
郯	tjhe
烬	jbhd
涑	sudu
浯	wudk
涞	lddl
涟	lmdi
娑	sodn
涅	npdt
涠	wwdw
浞	vodz
涓	jrdo
浥	yidb
涔	cfdv
浜	bhdb
浠	xidj
浣	hrdy
浚	jydw
浚	xydw
悚	ssxu
悭	qmxt
悝	kvxl
悝	lixl
悒	yixb
悌	tixd
悛	qrxw
宸	ifbi
窈	ycbl
剜	wjbd
诹	zzyy
冢	vsbu
诼	voyu
袒	tjpd
袢	pjpb
祯	vfpb
诿	wwyn
谀	yuyr
谂	ufyx
谄	ijyj
谇	svyu
屐	jiuv
屙	eeuk
陬	zzey
勐	mgzl
奘	vlpd
奘	zhpd
牂	zhpy
蚩	iici
陲	ivet
姬	jini
娠	ufni
娌	linl
娉	pknk
娲	wann
娩	mmne
娴	xmnm
娣	dind
娓	wwnm
婀	eenk
畚	bfst
逡	qyzw
绠	ggsg
骊	limd
绡	xnso
骋	igmk
绥	svsn
绦	tcsm
绨	tisd
骎	qbmy
邕	ysvb
鸶	sisn
彗	hvfe
耜	sill
焘	tcfh
焘	dcfh
舂	isij
琏	lmwi
琇	xqwn
麸	fuff
揶	yefe
埴	vitq
埯	antd
捯	dcfd
掳	lufl
掴	gofy
埸	yitw
埵	dott
赧	njiy
埤	pitu
捭	bdfu
逵	kvzt
埝	nmtx
堋	pgto
堍	tutt
掬	jufm
鸷	vifn
掖	yefw
捽	zofu
掊	pzfk
堉	yuto
掸	djfu
掸	ujfu
捩	lpfq
掮	qmfo
悫	qttx
埭	ddtl
埽	sctj
掇	dofy
掼	grfb
聃	djer
菁	jkco
萁	qicb
菘	sscg
堇	jbcw
萘	ndcu
萋	qicn
菽	uucy
菖	ihco
萜	tpcv
萸	yucr
萑	hrcv
棻	ffcm
菔	fucy
菟	tuct
萏	djcj
萃	cvcu
菏	heck
菹	zucq
菪	dhcu
菅	jmcl
菀	wjcv
菀	yucv
萦	ykcx
菰	gucg
菡	hjcu
梵	fjmf
梿	lmmi
梏	gumk
觋	xigj
桴	fumz
桷	jtmy
梓	zimx
棁	vomx
桫	somu
棂	lkmh
啬	setk
郾	yjke
匮	kvkb
敕	iiuw
豉	iidv
鄄	jrxe
酞	tdyt
酚	ffyf
戛	gabg
戛	jxbg
硎	xkud
硭	mhuw
硒	xiux
硖	xxuj
硗	qnuw
硐	dsuk
硇	ncux
硌	geuk
硌	louk
鸸	eren
瓠	hudg
匏	pcdb
厩	jqiw
龚	gslg
殒	yydb
殓	lmdq
殍	pndz
赉	ldlb
雩	yuyk
辄	veiv
堑	qmit
眭	svot
眦	ziob
啧	zekb
晡	buof
晤	wuok
眺	tnov
眵	iiox
眸	mzon
圊	qkko
喏	nokk
喏	rekk
喵	mnkt
啉	lbkm
勖	xuol
晞	xioj
唵	ankd
晗	hjok
冕	mmoe
啭	vrkv
畦	qitt
趺	fuzf
啮	npkr
跄	qlzv
蚶	hjig
蛄	guig
蛎	liiw
蛆	quiq
蚰	yziy
蛊	guim
圉	yukg
蚱	vaiv
蛉	lkis
蛏	igit
蚴	yzil
啁	vckk
啁	vzkk
啕	tckf
唿	hukx
啐	cvku
唼	uakn
唷	yoko
啖	djkh
啵	bokp
啶	dkkz
啷	lhke
唳	likq
唰	uxkd
啜	ioky
啜	ikky
帻	zejb
崚	lguw
崦	yjud
帼	gojy
崮	guug
崤	xnuo
崆	ksug
赇	qqbq
赈	vfbi
赊	uebu
铑	lcjl
铒	erje
铗	jxjj
铙	ncjw
铟	ybjy
铠	kdjj
铡	vajd
铢	vujw
铣	xije
铣	xmje
铤	dkjt
铤	tkjt
铧	hxju
铨	qrjw
铩	uajm
铪	hajk
铫	dnjv
铫	ycjv
铬	gejk
铮	vgjy
铯	sejb
铰	jnjf
铱	yijy
铳	isjy
铵	anjn
铷	rujk
氪	keqx
牾	wunk
鸹	gxun
秾	nshy
逶	wwzn
笺	jmvj
筇	qsve
笸	povk
笪	davd
笮	zovv
笮	zevv
笠	livl
笥	sivk
笤	tnvk
笳	jxvk
笾	bmvl
笞	iivk
偾	ffrb
偃	yjrn
偕	xprb
偈	jprr
偈	jirr
傀	kvrg
偬	zsrx
偻	lvrn
偻	lzrn
皑	aibj
皎	jnbf
鸻	hgrn
徜	ihrk
舸	gevk
舻	luvu
舴	zevv
舷	xmvx
龛	kjrl
翎	lkrx
脬	pcoz
脘	wjoy
脲	nnou
匐	fubt
猗	yiqk
猡	loqx
猞	ueqg
猝	cuqu
斛	hudd
猕	miqx
馗	kvjz
馃	goug
馄	hyub
鸾	lrwn
孰	uuww
庹	togi
庾	yugr
痔	vibc
痍	yiby
疵	cibb
翊	yilx
旌	jkfu
旎	nifb
袤	mcym
阇	uemo
阇	dumo
阈	yuma
阉	yjmd
阊	ihmo
阋	xime
阍	hymo
阏	eemd
阏	yjmd
羟	qlyj
粝	limw
粕	pomb
敝	bixw
焐	wuhk
烯	xihj
焓	hjhk
烽	fghf
焖	mfhx
烷	wjhy
焗	juhk
渍	zidb
渚	vudo
淇	qidb
淅	xidj
淞	ssdg
渎	dudd
涿	vodu
淖	ncdu
挲	sadu
挲	sodu
挲	uadu
淠	pidw
涸	hedg
渑	mmdd
渑	ugdd
淦	gjdj
淝	fwdb
淬	cvdu
涪	fudk
淙	csdu
涫	grdl
渌	ludu
淄	zidt
惬	qpxj
悻	xkxg
悱	fwxf
惝	ihxk
惝	thxk
惘	whxw
悸	jixz
惆	izxk
惚	huxx
惇	dyxz
惮	djxu
窕	tnbv
谌	ifyb
谌	ufyb
谏	jmyj
扈	huhb
皲	jybp
谑	xtye
裆	dhpe
袷	qxpk
裉	kfpg
谒	yeyr
谔	eeyk
谕	yuyd
谖	xryy
谗	ijyd
谙	anyo
谛	diyj
谝	pmyc
逯	luzu
郿	mwue
隈	wwey
粜	tnim
隍	hlew
隗	kveg
隗	wweg
婧	jkno
婊	bnny
婕	jpnz
娼	ihno
婢	binu
婵	ijnu
胬	nunr
袈	jxly
翌	yixl
恿	yssx
欸	eisq
欸	aisq
绫	lksw
骐	qimb
绮	qisk
绯	fwsf
绱	uhsk
骒	kemg
绲	gysb
骓	vvmv
绶	uzsy
绺	lqsk
绻	qrsv
绾	wjsl
骖	cjmp
缁	zist
耠	holk
琫	bgwf
琵	piwb
琶	pawb
琪	qiwb
瑛	ykwy
琦	qiwk
琥	huwj
琨	kywb
靓	llfj
靓	jkfj
琰	yjwh
琮	cswu
琯	grwl
琬	wjwv
琛	ifwm
琚	juwg
辇	nmfi
鼋	yryd
揳	xpfd
堞	dptm
搽	iafm
揸	vafd
揠	yafn
堙	ybtt
趄	qptq
趄	jutq
揖	yife
颉	jpty
颉	xpty
塄	lgtf
揿	qbfq
耋	dplt
揄	yufd
蛩	qsgi
蛰	vefi
塆	wjtg
摒	bkfk
揆	kvft
掾	yrfu
聒	goeu
葑	fgcc
葚	ufcb
靰	wugw
靸	sagj
葳	wwcn
葺	qice
葸	xicx
萼	eeck
葆	bccm
葩	pacb
葶	tkcd
蒌	lzcn
萱	xrcd
戟	jiug
葭	jxcy
楮	iumo
棼	ffmf
椟	dumd
棹	vcmu
椤	lomx
棰	ivmt
赍	jiub
椋	llmx
椁	gomz
椪	pgmy
棣	diml
椐	jumg
鹁	boun
覃	qbxu
覃	tjxu
酤	guyg
酢	cuyv
酢	zoyv
酡	toyb
鹂	liln
厥	jtiq
殚	djdu
殛	jida
雯	wfyw
雱	phyf
辊	gyib
辋	whiw
椠	qmim
辍	ioiy
辎	ziit
斐	fwfw
睄	ucoo
睑	jmoq
睇	diod
睃	soow
戢	jikg
喋	dpkm
喋	vakm
嗒	dakk
嗒	takk
喃	njkg
喱	likl
喹	kvkt
晷	gvok
喈	jpkb
跖	vizu
跗	fuzc
跞	lizl
跞	lozl
跚	ujzc
跎	tozb
跏	jxzk
跆	tdzk
蛱	jxij
蛲	nciw
蛭	viit
蛳	siij
蛐	quiq
蛔	hvik
蛞	koiu
蛴	qiiq
蛟	jnif
蛘	yhiy
喁	yskd
喟	kvko
啾	jqkh
嗖	szky
喑	ybko
嗟	jpkg
喽	lzkn
嗞	ziky
喀	kakk
喔	ookt
喔	wokt
喙	hvku
嵘	rsum
嵖	iaud
崴	wdun
崴	wwun
遄	irze
詈	lisk
嵎	yuud
崽	zdux
嵬	wwug
嵛	yuud
嵯	coug
嵝	lzun
嵫	ziuy
幄	wojt
嵋	mwuo
赕	djbh
铻	wujk
铼	ldjl
铿	kgjt
锃	zgjw
锂	lijl
锆	gcjk
锇	eejw
锉	cojr
锏	jmjo
锑	tijd
锒	lhjl
锔	jujk
锕	aajk
掣	ienu
矬	cour
氰	qkqo
毳	cvmm
毽	jmmy
犊	dund
犄	jink
犋	junb
鹄	hunn
犍	jmny
犍	qmny
嵇	jihu
黍	uuhu
稃	fuhz
稂	lhhl
筚	bivu
筵	yjvv
筌	qrvw
傣	ddru
傈	lirm
舄	xijh
牍	dupd
傥	thrx
傧	bbrb
遑	hlzw
傩	norv
遁	dyzo
徨	hlrw
媭	xupn
畲	uert
弑	uixg
颌	gery
颌	hery
翕	xirx
釉	yzcy
鹆	yugn
舜	uyvf
貂	dnvk
腈	jkoo
腌	aaod
腌	yjod
腓	fwof
腆	tmob
腴	yuor
腑	fuoc
腚	dkoz
腱	jmoy
鱿	yzyy
鲀	tyyt
鲂	fhyf
颍	ykby
猢	huqo
猹	iaqd
猥	wwqy
飓	jufb
觞	uhdp
觚	gudg
猱	ncqm
颎	jsby
飧	syxg
馇	iaud
馊	szuy
亵	xpyw
脔	lrwr
裒	pzyj
痣	vibx
痨	lcbl
痦	wubk
痞	pibk
痤	cobr
痫	xmbm
痧	uabu
赓	gggb
竦	sslu
瓿	bulw
啻	iiwk
颏	kewy
鹇	xmmn
阑	ljmj
阒	qumq
阕	qtmt
粞	ximx
遒	qqzy
孳	zibz
焯	ichu
焯	vohu
焜	kyhb
焙	bwhk
焱	yjhh
鹈	tibn
湛	vjdb
渫	xpdm
湮	yjdt
湎	mmdm
湜	uidz
渭	wwdo
湍	trde
湫	jndh
湫	qqdh
溲	szdy
湟	hldw
溆	xudy
湲	yrdy
湔	jmdd
湉	tmdu
渥	wodt
湄	mwdo
滁	iudm
愠	yyxm
惺	xkxu
愦	kvxb
惴	vvxe
愀	qnxh
愎	bixw
愔	ybxo
喾	kuxk
寐	mwbw
谟	moyd
扉	fwhf
裢	lmpi
裎	igpw
裥	jmpo
祾	lkpw
祺	qipb
谠	dhyx
幂	mibj
谡	suyw
谥	uiym
谧	miym
遐	xxzy
孱	cjuz
孱	ijuz
弼	bigb
巽	xysg
骘	viem
媪	aonm
媛	yrny
婷	tknd
巯	qqji
翚	hvxi
皴	cyyp
婺	wumn
骛	wumm
缂	kesg
缃	xlso
缄	jmsk
彘	vihb
缇	tisz
缈	mnsu
缌	sisx
缑	gzsu
缒	vvsl
缗	mbso
飨	xlxg
耢	lcll
瑚	huwo
瑁	mcwo
瑜	yuwd
瑗	yrwy
瑄	xrwd
瑕	xxwy
遨	aozw
骜	aofm
韫	yywm
髡	kyew
塬	yrtx
鄢	yjve
趔	lptd
趑	zitq
摅	uufx
摁	enfx
蜇	vefi
搋	ikfj
搪	thfk
搐	iuft
搛	jmfj
搠	uofo
摈	bbfb
彀	gztu
毂	gutu
搦	nofg
搡	shfm
蓁	vfch
戡	kjcg
蓍	uico
鄞	ybce
靳	jbgj
蓐	rucc
蓦	mocm
鹋	mncn
蒽	encx
蓓	bwck
蓖	bicb
蓊	wgcx
蒯	kkcd
蓟	jicd
蓑	socv
蒿	hcck
蒺	jicu
蓠	licn
蒟	jucj
蒡	bhcf
蒹	jmcj
蒴	uoco
蒗	lhcl
蓥	ykcj
颐	yiiy
楔	xpmd
楠	njmg
楂	vamd
楂	iamd
楝	lmmj
楫	jime
楸	qqmh
椴	drmu
槌	ivml
楯	uymo
楯	dymo
皙	ximb
榈	lvmk
槎	iamg
榉	jumf
楦	xrmd
楣	mwmo
楹	ykmm
椽	irmu
裘	qqqy
剽	pnxd
甄	vfxw
酮	tsyk
酰	xmye
酯	viyo
酩	mkyk
蜃	ufii
碛	qiub
碓	dvuv
硼	pguo
碉	dnuk
碚	bwuk
碇	dkuz
碜	ifup
鹌	andn
辏	czit
龃	juvq
龅	bcvb
訾	zivk
粲	cjdm
虞	yuht
睚	yaot
嗪	qbkh
韪	wwow
嗷	aokw
嗉	sukx
睨	nioe
睢	svov
雎	juqv
睥	piou
嘟	duke
嗑	kekm
嗫	npky
嗬	hekk
嗔	ifkb
嗝	gekg
戥	dgog
嗄	aakw
嗄	uakw
煦	xuoh
暄	xrod
遢	tazx
暌	kvot
跬	kvzt
跶	dazd
跸	bizu
跐	cizb
跣	xmze
跹	xmzq
跻	jizq
蛸	xnio
蜊	liid
蜍	iuim
蜉	fuiz
蜣	qliv
畹	wjtv
蛹	ysiy
嗣	sikk
嗯	ogkx
嗯	onkx
嗯	enkx
嗥	hcku
嗲	dxkx
嗳	aiky
嗌	aikm
嗌	yikm
嗍	soko
嗨	hdkm
嗐	hdkk
嗤	iiki
嗵	tsky
罨	yjsd
嵊	ugur
嵩	ssuk
嵴	jiuo
骰	tzgu
锗	vejo
锛	bfjc
锜	qijk
锝	dejc
锞	kejg
锟	kyjb
锢	gujg
锨	xmjq
锩	jrjv
锭	dkjz
锱	zijt
雉	viuv
氲	yyqm
犏	pmnc
歃	uaqq
稞	kehg
稗	bdhu
稔	rfhx
筠	jyvy
筠	yyvy
筢	pavb
筮	uivr
筲	ucvo
筱	xnvw
牒	dppm
煲	bcrh
敫	jnbw
徭	ycrf
愆	qmrx
艄	ucvo
觎	yurj
毹	uurm
貊	movb
貅	xqvm
貉	hcvk
貉	hevk
貉	movk
颔	hjry
腠	czot
腩	njog
腼	mmom
腭	eeok
腧	uuod
塍	igot
媵	ykon
詹	vjdk
鲅	bayy
鲆	pkyp
鲇	nmyv
鲈	luyu
稣	suyh
鲋	fuyc
鲐	tdyk
肄	yiby
鹐	qmdn
飕	szfy
觥	gsde
遛	lqzt
馐	xqui
鹑	iywn
亶	djwd
瘃	vubu
痱	fwbf
痼	gubg
痿	wwbn
瘐	yubr
瘁	cvbu
瘆	ufbp
麂	jilj
裔	yiyk
歆	xblq
旒	lqfi
雍	yswv
阖	hemm
阗	tmmb
阙	qtmq
羧	soyw
豢	hrju
粳	jkmg
猷	yzbq
煳	huho
煜	yuhl
煨	wwhy
煅	drhu
煊	xrhd
煸	bmhc
煺	tvhg
滟	yjdb
溱	qbdh
溱	vfdh
溘	kedm
漭	mhdc
滢	ykdy
溥	pudc
溧	lidm
溽	rudc
裟	uady
溻	tadx
溷	hydu
滗	bidm
滫	xqdo
溴	xqdq
滏	fudb
滃	wgdx
滦	lrdm
溏	thdk
滂	phdf
滓	zidx
溟	mkdl
滪	yudy
愫	suxx
慑	uexy
慊	qmxj
慊	qpxj
鲎	hzxy
骞	qmbm
窦	dzbd
窠	kebg
窣	subu
裱	bnpy
褚	iupo
褚	vupo
裨	bipu
裨	pipu
裾	jupg
裰	dopy
禊	xipd
谩	mjyy
谪	veyg
媾	gznr
嫫	mond
媲	pinb
嫒	ainy
嫔	pbnb
媸	iini
缙	jbso
缜	vfsb
缛	rusc
辔	pwsk
骝	lqmt
缟	gcsk
缡	lisn
缢	yism
缣	jmsj
骟	ujmx
耥	thlk
璈	aoww
瑶	ycwf
瑭	thwk
獒	aofq
觏	gzfj
慝	tekx
嫠	liwn
韬	tcwj
叆	aiyy
髦	mcem
摽	bnfu
墁	mjty
撂	lnfk
摞	lofx
撄	ykfn
翥	vulx
踅	xtfz
摭	vifh
墉	ysto
墒	uhtk
榖	gutu
綦	qicx
蔫	nmch
蔷	qlck
靺	mogw
靼	dagd
鞅	yhgy
靿	ycgl
甍	mgcw
蔸	dzce
蔟	cucu
蔺	lbcv
戬	jmyg
蕖	qucm
蔻	kzcy
蓿	xucb
斡	woud
鹕	hugn
蓼	lncp
蓼	lucp
榛	vfmh
榧	fwmf
榻	tamx
榫	symu
榭	xpmc
槔	gcmu
榱	cvmv
槁	gcmk
槟	bbmb
槟	bkmb
槠	vumo
榷	qtmv
僰	bour
酽	yjyy
酶	mwym
酹	lwyc
厮	siij
碡	vzum
碴	iaud
碣	jpur
碲	diuj
磋	coug
臧	zhvi
豨	xiuj
殡	bbdb
霆	tkyt
霁	jiyq
辕	yriy
蜚	fwfi
裴	pwfy
翡	fwfx
龇	zivb
龈	ybvg
龈	kfvg
睿	rvbo
䁖	lzon
睽	kvot
嘞	lekl
嘞	lwkl
嘈	ccko
嘌	pnku
嘁	qikx
嘎	gakg
暧	aioy
暝	mkol
踌	izzc
踉	llzl
蜞	qiib
蜥	xiij
蜮	yuia
蝈	goiy
蜴	yiiw
蜱	piiu
蜩	tnik
蜷	qriv
蜿	wjiv
螂	lhie
蜢	mgim
嘘	xuky
嘘	uiky
嘡	thkt
鹗	eekn
嘣	bgko
嘤	ykkn
嘚	dekc
嘚	dwkc
嗾	szku
嘧	miku
罴	pish
罱	ljsg
幔	mjjy
嶂	vhuu
幛	vhju
赙	fubc
罂	ykbf
骷	kugg
骶	digu
鹘	gugn
鹘	hugn
锲	qpjd
锴	kdjb
锶	sijx
锷	eejk
锸	iajj
锵	qljc
镁	mwjd
镂	lzjn
犒	kcnk
箐	qkvo
箦	zevb
箧	qpvj
箍	guvj
箸	vuvo
箬	rovk
箅	bivw
箪	djvu
箔	bovb
箜	ksvg
箢	yrvv
箓	luvu
毓	yupi
僖	xirk
儆	jkrw
僳	surm
僭	jmro
劁	qnrd
僮	tsrl
僮	vlrl
魃	bagy
魆	xugl
睾	gcpg
艋	mgvm
鄱	poce
膈	geog
膑	bbob
鲑	gvyt
鲑	xpyt
鲔	wwyo
鲚	jiyq
鲛	jnyf
鲟	xyyc
獐	vhqu
觫	sudu
雒	lowv
夤	ybxb
馑	jbuw
銮	lrwj
塾	uuwt
麽	mogm
瘌	labd
瘊	hzbu
瘘	lzbn
瘙	scbi
廖	lngp
韶	uclk
旖	yifk
膂	lvfo
阚	hjmw
阚	kjmw
鄯	ujye
鲞	xljy
粿	gomg
粼	lbmv
粽	zsmu
糁	sjmp
糁	ufmp
槊	uonm
鹚	cibn
熘	lqht
熥	tghy
潢	hldh
漕	ccdo
滹	hudh
漯	lodx
漯	tadx
漶	hrdx
潋	lmdw
潴	vudo
漪	yidk
漉	ludl
漳	vhdu
漩	xrdz
澉	gjdw
潍	wwdv
慵	ysxo
搴	qmbu
窨	xybo
窨	ybbo
寤	wubk
綮	qihx
綮	qkhx
谮	zfyo
褡	dapk
褙	bwpo
褓	bcpm
褛	lvpn
褊	bmpc
谯	qnyh
谰	ljyj
谲	jtyk
暨	jigd
屣	xiuz
鹛	mwun
嫣	yjnh
嫱	qlnk
嫖	pnnu
嫦	ihnj
嫚	mjny
嫘	lwnx
嫡	ding
鼐	ndno
翟	dixv
翟	vdxv
瞀	mcmo
鹜	wumn
骠	bnmu
骠	pnmu
缥	pnsu
缦	mjsy
缧	lwsx
缨	yksn
骢	csmx
缪	mqsp
缪	mzsp
缪	mnsp
缫	scsg
耦	ould
耧	lzln
瑾	jbww
璜	hlwh
璀	cvwv
璎	ykwn
璁	cswx
璋	vhwu
璇	xrwz
奭	uidb
髯	rjer
髫	tnek
撷	xpfy
撅	jtfq
赭	veio
撸	lufo
鋆	yytj
鋆	jytj
撙	zyfc
撺	crfi
墀	iitn
聩	kveb
觐	jbcj
鞑	dagd
蕙	hvcx
鞒	qngl
蕈	xycu
蕨	jtcq
蕤	rvcu
蕞	zvcy
蕺	jicg
瞢	mgco
蕃	boct
蕃	fjct
蕲	qicj
赜	zeib
槿	jbmw
樯	qlmk
槭	qimx
樗	iumk
樘	thmt
樊	fjmd
槲	humd
醌	kyyb
醅	pwyk
靥	yeim
魇	yjig
餍	yjig
磔	veum
磙	gyug
霈	pwyu
辘	luil
龉	yuvk
龊	iovz
觑	quhj
瞌	keom
瞋	ifob
瞑	mkol
嘭	pgkp
噎	yekb
噶	gakr
颙	ysty
暹	xmzv
噘	jtkq
踔	iozu
踝	hkzg
踟	iizk
踒	wozn
踬	vizb
踮	dmzv
踯	vize
踺	jmzy
踞	juzg
蝽	iyio
蝾	rsim
蝻	njig
蝰	kvit
蝮	fuiw
螋	sziy
蝓	yuid
蝣	yziz
蝼	lzin
噗	pukf
嘬	zoky
颚	eeky
噍	jnkh
噢	ookd
噙	qbkn
噜	luko
噌	cgko
噔	dgkb
颛	vruy
幞	fujf
幡	fjjt
嶙	lbuf
嶝	dgub
骺	hzgk
骼	gegk
骸	hdgr
镊	npjy
镉	gejg
镌	jrjn
镍	npjm
镏	lqjt
镒	yijm
镓	jxju
镔	bbjb
稷	jihw
箴	vfvk
篑	kvvb
篁	hlvw
篌	hzvu
篆	vrvu
牖	yzpf
儋	djrk
徵	virw
磐	pjvu
虢	govj
鹞	ycvn
膘	bnou
滕	tgou
鲠	ggyg
鲡	liyd
鲢	lmyi
鲣	jmyt
鲥	uiyc
鲧	gyyx
鲩	hryy
獗	jtqq
獠	lnqx
觯	vidu
馓	sjuw
馔	vrug
麾	hvgm
廛	ijgt
瘛	iibx
瘼	mobd
瘢	bjbu
瘠	jibo
齑	jiqj
羯	jpyr
羰	thyh
𥻗	iamd
遴	lbzf
糌	zjmo
糍	cimy
糅	rzmm
熜	cshx
熵	uhhk
熠	yihb
澍	uudc
澌	sidj
潸	ujdo
潦	lcdx
潦	lndx
潲	ucdo
鋈	wudj
潟	xidh
潼	tsdl
潺	ijdz
憬	jkxx
憧	isxl
寮	lnbx
窳	yubg
谳	yjyq
褴	ljpm
褟	tapx
褫	iipj
谵	vjyk
熨	yuuh
熨	yyuh
屦	juun
嬉	xink
勰	xplx
戮	luxg
蝥	mcmi
缬	xpsy
缮	ujsk
缯	zgso
骣	ijmz
畿	jigt
耩	jllr
耨	nzlc
耪	phlf
璞	puwf
璟	jkwx
靛	dmfz
璠	fjwt
璘	lbwf
聱	aofe
螯	aofi
髻	jiek
髭	zieb
髹	xqem
擀	gjfg
熹	xith
甏	bgtw
擞	szfw
縠	hutu
磬	qktu
颞	npey
蕻	hscg
鞘	qngo
鞘	ucgo
颟	mjcy
薤	xpcj
薨	hscb
檠	qkcm
薏	yicx
薮	szcw
薜	bicx
薅	hccc
樾	ytml
橛	jtmq
橇	qnmm
樵	qnmh
檎	qbmn
橹	lumo
樽	zymc
樨	ximn
橼	yrmu
墼	jiit
橐	togm
翮	hegx
醛	qryw
醐	huyo
醍	tiyz
醚	miym
磲	quum
赝	yjib
飙	bnqf
殪	yidb
霖	lbym
霏	fwyf
霓	niye
錾	zjij
辚	lbif
臻	vfgh
遽	juzu
氅	ihxm
瞟	pnou
瞠	igot
瞰	kjow
嚄	hoky
嚄	ooky
嚆	hckk
噤	jbku
暾	tyow
蹀	dpzm
踹	ikze
踵	vszv
踽	juzy
蹉	cozg
蹁	pmzc
螨	mjil
蟒	mhic
螈	yrix
螅	xiix
螭	iiin
螠	yiim
螟	mkil
噱	xtku
噱	jtku
噬	uikr
噫	yikx
噻	sdkt
噼	pikx
罹	lisv
圜	hrky
圜	yrky
䦃	vojo
镖	bnju
镗	thjt
镘	mjjy
镚	bgjo
镛	ysjo
镝	dijg
镞	zuju
镠	lqjp
氇	lumo
氆	pumo
憩	qiux
穑	sehk
篝	gzvr
篥	livm
篦	bivb
篪	iivj
篙	gcvk
盥	grjm
劓	yizd
翱	aobx
魉	llgl
魈	xngo
徼	jnrf
歙	uerq
歙	xirq
膳	ujok
膦	lbof
膙	jloi
鲮	lkyw
鲱	fwyf
鲲	kyyb
鲳	ihyo
鲴	guyg
鲵	niye
鲷	dnyk
鲻	ziyt
獴	mgqu
獭	taqb
獬	xpqn
邂	xpzn
鹧	vegn
廨	xpgn
赟	yywb
瘰	lobx
廪	lbgu
瘿	ykbn
瘵	vdbu
瘴	vhbu
癃	lsbu
瘳	izbp
斓	ljwj
麇	qylh
麇	jylh
麈	vulv
嬴	ykwn
壅	yswt
羲	xiyk
糗	qqmq
瞥	ppxo
甑	zgbw
燎	lnhx
燠	yuhd
燔	fjht
燧	svhu
濑	lddb
濉	svdv
潞	ludk
澧	lidb
澹	tjdk
澹	djdk
澥	xpdn
澶	ijdd
濂	lmdj
褰	qmby
寰	hrby
窸	xibx
褶	vepb
禧	xipk
嬖	biun
犟	jlgn
隰	xieh
嬗	ujnd
颡	shyy
缱	qmsl
缲	scsm
缲	qnsm
缳	hrsy
璨	cjwm
璩	quwu
璐	luwk
璪	zcwm
螫	uiii
擤	xkfw
壕	hctu
觳	hutu
罄	qktf
擢	vofv
薹	tdct
鞡	lagl
鞬	jmgy
薷	ruce
薰	xych
藓	xmcy
藁	gccm
檄	ximw
檩	lbmu
懋	mcmx
醢	hdym
翳	yikx
礅	dyuw
磴	dgub
鹩	lndn
龋	quvy
龌	wovt
豳	bbuu
壑	hebt
黻	fuyy
嚏	tikz
嚅	ruke
蹑	npzy
蹒	pjzl
蹊	xizd
蹊	qizd
蟥	hlih
螬	ccio
螵	pniu
疃	trtl
螳	thit
蟑	vhiu
嚓	iaku
嚓	caku
羁	jism
罽	jisd
罾	zgso
嶷	yiuz
黜	iuli
黝	yzll
髁	kegg
髀	bigu
镡	ijju
镡	tjju
镡	xbju
镢	jtjq
镣	lnjx
镦	dvjw
镧	ljjj
镩	crji
镪	qlji
镫	dgjb
罅	xxfh
黏	nmhv
簌	suvq
篾	mpvd
篼	dzve
簖	drvj
簋	gvvm
鼢	ffjf
黛	ddrh
儡	lwrt
鹪	jnrn
鼾	hjzg
皤	pobt
魍	whgw
龠	ytrc
繇	vzvx
繇	ycvx
繇	yzvx
貘	movd
邈	mnze
貔	pivb
臌	guov
膻	djod
膻	ujod
臆	yiox
臃	ysov
鲼	ffyb
鲽	dpym
鳀	tiyz
鳃	sdyx
鳅	qqyh
鳇	hlyw
鳊	bmyc
螽	vsdi
燮	xphy
鹫	jqwn
襄	xlyf
糜	migm
糜	mwgm
縻	migx
膺	ykgo
癍	bjbw
麋	milm
懑	mfdx
濡	rude
濮	pudf
濞	bidw
濠	hcdu
濯	vodv
蹇	jmbz
謇	jmbk
邃	svzu
襁	qlpi
檗	boum
擘	bouu
孺	ruze
隳	hvex
嬷	monm
蟊	mcmi
鹬	yumn
鍪	mzmj
鏊	aofj
鳌	aofy
鬈	qrev
鬃	zseu
瞽	guto
鞯	jmgz
鞨	hegr
鞫	jugk
鞧	qqgy
鞣	rzgm
藜	licu
藠	jncb
藩	fjct
醪	lcyp
蹙	cuwz
礓	jluj
燹	xmuh
餮	tpdg
瞿	quov
曛	xyoh
颢	hcoy
曜	ycov
躇	iuzo
蹚	thzt
鹭	luzn
蟛	pgip
蟪	hvix
蟠	pjit
蟮	ujik
鹮	hrsn
黠	xxlk
黟	yilx
髅	lzgn
髂	qxgk
镬	hojy
镭	lwjt
镯	voji
馥	fuhw
簟	dmvu
簪	zjvo
鼬	yzjy
雠	izry
艟	isvl
鳎	tayx
鳏	gryx
鳐	ycyf
癞	ldbb
癔	yibx
癜	dmbu
癖	pibx
糨	jlmi
蹩	bpxz
鎏	lqdj
懵	mgxo
彝	yihc
邋	lazv
鬏	jqeh
攉	hofv
攒	crfb
攒	zjfb
鞲	gzgr
鞴	bwgy
藿	hocv
蘧	qucu
蘅	hgcd
麓	luml
醮	jnyh
醯	xiym
酃	lkye
霪	ybyt
霭	aiyr
霨	wwyc
黼	fuyf
嚯	hokv
蹰	iuzc
蹶	jtzq
蹽	lnzx
蹼	puzf
蹴	cuzy
蹾	dyzw
蹿	crzi
蠖	hoiy
蠓	mgiu
蟾	ijik
蠊	lmij
黢	qulw
髋	krgj
髌	bbgb
镲	iaju
籀	vzvt
籁	ldvb
齁	hzzj
魑	iign
艨	mgvu
鳓	leyl
鳔	bnyu
鳕	xtye
鳗	mjyy
鳙	ysyo
麒	qilb
鏖	aolj
羸	lwwy
㸆	kchf
瀚	hjdx
瀣	xpdj
瀛	ykdn
襦	rupe
谶	ifyj
襞	biuy
骥	jimg
缵	zrsb
瓒	zjwb
攘	rhfx
蘩	fjcx
蘖	npcm
醴	liyb
霰	xmyw
酆	fgue
矍	jtoy
曦	xiok
躅	vuzi
鼍	tokd
巉	ijut
黩	duld
黥	qklx
黪	cjlp
镳	bnjh
镴	lajv
黧	lihh
纂	zrvx
璺	wfjy
鼯	wujk
臜	zaob
鳜	gvyq
鳝	ujyk
鳟	zyyc
獾	hrqv
孀	ulno
骧	xlmx
瓘	grwv
鼙	pitu
醺	xyyh
礴	bouc
颦	pbvu
曩	nhox
鳢	liyb
癫	dmby
麝	uelc
夔	kvbw
爝	jthc
灏	hcdy
禳	rhpx
鐾	bwuj
羼	ijuy
蠡	lihi
耱	molu
懿	yitx
蘸	vjch
鹳	grcn
霾	mdyl
氍	quom
饕	tckg
躐	lpzv
髑	dugi
镵	ijjt
穰	rhhx
饔	yswg
鬻	yugg
鬟	hrey
趱	zjtb
攫	jtfy
攥	zrfx
颧	qrcy
躜	zrzb
鼹	yjjn
癯	qubv
麟	lblf
蠲	jrbi
蠹	dugi
躞	xpzy
衢	qurv
鑫	xbjj
灞	bado
襻	pjpu
纛	dcfx
鬣	lpev
攮	nhfy
囔	nhky
馕	nhuy
戆	ghlx
戆	vllx
爨	crjh
齉	nhzy
亍	iuad
尢	yzuv
彳	iipr
卬	ahpe
殳	uujy
𠙶	oukl
毌	grml
邘	yuye
戋	jmga
圢	tktd
氕	ppqp
伋	jirj
仝	tsrg
冮	ghdg
氿	gvdj
氿	jqdj
汈	dndd
氾	fjdv
忉	dcxd
宄	gvbj
𬣙	xuyy
讱	rfyr
扞	hjfg
圲	qmtq
圫	totq
芏	duct
芃	pgcf
朳	bamb
朸	liml
𨙸	qive
邨	cyte
吒	vakq
吖	aaky
屼	wuuw
屾	ufuu
辿	ijzu
钆	gajv
仳	pirb
伣	qmrj
伈	xbrx
癿	qpbv
甪	lupy
邠	bbfe
犴	anqg
犴	hjqg
冱	hudh
邡	fhfe
闫	yjms
𬇕	wjdw
汋	vodu
䜣	xbyj
讻	xsyx
𬣞	vuyv
孖	mazz
𬘓	xysi
纩	klsg
玒	hswg
玓	diwu
玘	qiwj
玚	yhwp
刬	ijjd
𫭟	qutq
坜	litl
坉	tytt
扽	dfft
𫭢	lytl
坋	fftf
坋	bftf
扺	vifu
㧑	wwfw
毐	aitm
芰	jicv
芣	fucb
苊	eecv
苉	picp
芘	picb
芘	bicb
芴	wucw
芠	wfcw
𫇭	wwcw
芤	kzcv
杕	domd
杕	dimd
杙	yimy
杄	qmmq
杧	mhmw
杩	mamm
尪	whyw
尨	mglp
尨	mhlp
轪	ddid
𫐄	ytiw
坒	bibt
芈	micf
旴	xuoy
旵	ijou
呙	gokn
㕮	fukf
岍	qmuk
𫵷	liul
岠	juuj
岜	baub
呇	qiuk
冏	jskk
觃	yjjz
岙	aoyu
伾	pirp
㑇	vzre
伭	xrrx
伭	xmrx
佖	birb
伲	nirb
佁	iirk
佁	yirk
飏	yhfp
狃	nqqi
闶	khmj
汧	qmdk
汫	jkdj
𣲘	wudw
𣲗	wwdw
沄	yydy
沘	bidb
𬇙	pwdb
汭	rvdn
㳇	fudf
沇	yjdy
忮	vixv
忳	tyxt
忺	xmxq
𬣡	jmyj
祃	mapm
诇	xsyk
邲	bibe
诎	quyi
诐	biyp
屃	xiub
𫸩	kzgq
岊	jpbu
阽	dmev
䢺	iuie
阼	zoev
妧	wjny
妧	yrny
妘	yyny
𨚕	bmse
纮	hsss
驲	rimo
𫘜	wfmw
纻	vusv
𬘘	djse
𫘝	jtmg
纼	vfsl
玤	bhwf
玞	fuwf
玱	qlwv
玟	wfww
玟	mbww
邽	gvte
邿	uite
坥	qutq
坰	jstk
坬	gxtg
坽	lkts
弆	juqc
耵	dked
䢼	gsge
𦭜	vicv
茋	vicu
苧	nkcd
苾	bicb
苠	mbcm
枅	jimk
㭎	ghmx
枘	rvmn
枍	yimk
矼	ghug
矻	kuuv
匼	kekk
𬨂	qiiu
𬀩	wwow
𬀪	xmoj
旿	wuou
昇	ugoc
昄	bjoy
昒	huow
昈	huoh
咉	yhky
咇	bikb
咍	hdkk
岵	huug
岽	dsud
岨	juuq
岞	zouv
峂	tsud
㟃	siuk
囷	qykh
𬬩	yijy
钐	ujjp
钔	mfjm
钖	yhjp
牥	fhnf
佴	erre
佴	ndre
垈	ddrt
侁	ufre
侹	tkrt
佸	horu
佺	qrrw
隹	vvrv
㑊	yirb
侂	torq
佽	cirq
侘	iarq
郈	hzie
舠	dcvd
郐	kkre
郃	here
攽	bjfw
肭	naon
肸	xiou
肷	qmoq
狉	piqp
狝	xmqx
饳	doui
忞	mbwx
於	yufd
於	wufd
炌	kdhj
炆	wfhw
泙	pkdp
沺	tmdt
泂	jsdk
泜	vidu
泃	judj
泇	jxdk
怊	icxk
峃	xtxu
穸	xibx
祋	dvpu
祊	bgpf
𫍣	tsyk
𬣳	hfyg
𬩽	xyee
鸤	uiun
弢	tcgy
弨	icgk
陑	eree
𬮿	gdej
陎	uuew
𬯀	jieq
卺	jblv
乸	naym
妭	bany
姈	lkns
𫰛	xknj
迳	jkzj
叕	voyy
𬳵	pimp
驵	zhmq
𬳶	jsmk
䌹	jssk
驺	zzme
𫠊	xrmx
绋	fusf
绐	ddsk
砉	hxfu
砉	xufu
耔	zilz
㛃	jpfn
玶	pkwp
珇	zuwq
珅	ufwu
𬍛	liwl
珋	lqwe
玹	xrwx
玹	xmwx
珌	biwb
玿	ucwk
韨	fuwy
垚	yctt
垯	datd
垙	glte
垲	kdtj
埏	ujtv
垍	jitz
耇	gzlj
鿍	ghtf
垎	hetk
垴	nctx
垟	yhty
垞	iatq
挓	vafq
垵	antn
垏	lvty
拶	zafx
拶	zjfx
荖	lccl
荁	hrcd
荙	dacd
荛	rccw
茈	cicb
茈	zicb
茽	vscv
荄	gdcr
茺	iscy
𬜬	mjck
荓	pkck
茳	jlcg
𦰡	nace
𦰡	noce
茛	gfcg
荭	hscg
㭕	qumq
柷	vumx
柷	iumx
柃	lkms
柊	vsmd
枹	bcmb
栐	ysmy
柖	ucmk
郚	wuwe
剅	lzdd
䴓	uibn
迺	ndzx
厖	mhip
砆	fuuf
砑	yauy
砄	jtug
耏	erep
耏	ndep
奓	vadx
䶮	yjlt
轵	viiv
轷	huih
轹	liil
轺	ycik
昺	bkon
𪾢	xmoj
昽	lsol
盷	tmoy
咡	erke
咺	xrkd
昳	dpof
昳	yiof
昣	vfop
哒	dakd
昤	lkos
昫	xuoj
昡	xrox
咥	xikt
昪	bmoc
虷	hjig
虸	ziiz
哃	tskk
峘	hrud
耑	drue
峛	liud
𪨰	quuq
峗	wwuv
峧	jnuf
帡	pkjk
钘	xkjk
𫓧	fujf
钜	jujj
𬬮	ihji
𬬱	jbjj
𬬭	lyjl
钪	khjj
钬	hojh
钭	dzjd
矧	uful
秬	juhj
俫	ldrl
舁	yujc
俜	pkrk
俙	xirj
俍	llrl
垕	hzit
衎	kjrg
舣	yivy
弇	yjrc
侴	hcrd
鸧	chlh
䏡	uiou
胠	quoq
𦙶	guog
胈	baoy
胩	kaob
胣	iioy
朏	fwoi
飐	vjfv
訄	qqjk
饻	xiuy
庤	vigc
疢	ifbh
炣	kehk
炟	dahd
㶲	yshy
洭	kldw
洘	kcdk
洓	qidu
洿	wudk
㳚	xudd
泚	cidb
浈	vfdb
浉	uidj
洸	glde
洑	fudq
洢	yidy
洈	wwdv
洚	jldf
洺	mkdk
洨	xndf
浐	ijdi
㳘	isdy
洴	pkdk
洣	midm
恔	xnxf
恔	jnxf
宬	igbi
窀	vybt
扂	dmhv
袆	hvpw
祏	uipu
祐	yzpk
祕	mipb
叚	xxuy
陧	npet
陞	uget
娀	ssnu
姞	jink
姱	kxnk
姤	gznk
姶	eenk
姽	gvnv
枲	xism
绖	dpst
骃	ybmy
𬘡	ybsy
𬳽	ufme
𬘩	tkst
𫄧	yjsv
彖	trhu
骉	bnmm
恝	jxfx
珪	gvwt
珛	xqwo
珹	igwi
琊	yawe
玼	ciwb
珖	glwe
𪟝	jifl
珽	tkwt
珦	xlwk
珫	iswy
珒	jbwy
𬍤	xywc
珢	ybwg
珕	liwl
珝	xuwx
𫭼	lctl
埗	butu
垾	hjtg
垺	futz
埆	qtty
垿	xuty
埌	lhtl
埇	ysty
莰	kjcq
茝	idci
𬜯	llcl
鄀	roce
莶	xmcq
莝	cocr
䓖	qscl
莙	jyck
栻	uimg
桠	yamy
𬂩	jxmj
桄	glme
梠	lvmk
栴	vjmd
梴	ijmv
栒	xymo
酎	vzyc
酏	yiyy
𫠆	kvvy
砵	boub
砠	juuq
砫	vuuv
砬	laul
硁	kguj
恧	nvex
翃	hsux
郪	qiue
𨐈	glie
辀	vziv
辁	qriw
𬌗	heyk
剕	fwfd
赀	zivb
哢	lskc
晅	xrod
晊	viot
唝	gskb
哳	vakj
哱	bokz
冔	xuoy
晔	yeou
晐	gdor
晖	hvoi
畖	watg
蚄	fhif
蚆	baib
𫑡	mgke
帱	dcjc
帱	izjc
崁	kjuq
峿	wuuk
𪨶	ueui
崄	xmuq
帨	uvjx
崀	lhul
赆	jbbd
𬬸	uuju
钷	pojk
𬬻	luju
𬬹	ufju
𬬿	vcjk
𬭁	mujm
眚	uguo
甡	ufuu
笫	zivd
倻	yere
倴	bfrc
脩	xqro
倮	lorg
倕	ivrt
倞	jkrx
倞	llrx
𫢸	djru
倓	tjrh
倧	zsru
衃	pwpb
虒	siij
舭	bivb
舯	vsvv
舥	pavb
瓞	dpgf
鬯	ihkb
鸰	lkrn
脎	saom
朓	tnov
胲	hdor
虓	xnjj
鱽	dcyd
狴	biqt
峱	ncqu
狻	srqw
眢	yrxo
𫗧	suuu
勍	qkwl
痄	vabv
疰	vubv
痃	xrbx
竘	qulj
羖	guyu
羓	bayb
桊	jrjm
敉	mimw
烠	hvho
烔	tshk
烶	tkht
烻	yjhv
𬊈	xyhc
涍	xndz
浡	bodz
浭	ggdg
浬	lidl
涄	pkdk
涢	yydb
涐	eedw
浰	lidd
浟	yzdw
浛	hjdk
浼	mwde
浲	fgdf
涘	sidu
悈	jpxc
悃	kyxm
悢	llxl
𬒈	qtxu
宧	yibi
窅	ycbo
窊	wabg
窎	dnbn
扅	yihx
扆	yihy
袪	qupq
袗	vfpp
袯	bopy
祧	tnpv
隺	hebv
堲	jigt
疍	djzd
𨺙	niee
陴	pieu
烝	vglh
砮	nunu
㛚	tsny
哿	gelk
翀	isxv
翂	ffxf
剟	doyd
𬳿	tumm
𫄨	iisj
绤	xisg
骍	xkmx
𬘫	hrsy
䂮	ltfu
琎	jbwj
珸	wuwk
珵	igww
琄	xrwo
琈	fuwz
琀	hjwk
珺	jywk
掭	tmfx
堎	lgtw
堐	yatt
埼	qitk
掎	jifk
埫	thtk
埫	uhtk
堌	gutg
晢	vefo
𫮃	ujtu
掞	ujfh
埪	kstg
壸	kyty
㙍	doty
聍	nked
菝	bacy
萚	tocf
菥	xicj
莿	cicd
䓫	qick
勚	yiul
䓬	vocu
萆	bicu
菂	dicu
菍	npcx
菼	tjch
萣	dkcz
䓨	ykcf
菉	lucu
䓛	quci
梼	tcmc
梽	vimx
桲	bomz
梾	ldml
桯	tkmw
梣	ifmv
梌	tumm
桹	lhml
敔	yuww
厣	yjij
硔	hsug
鿎	taud
鿎	daud
硙	wwuj
硚	qnul
硊	hvuv
硍	ybug
勔	mmml
䴕	lpdn
龁	hevv
逴	iozu
唪	fgkf
啫	veko
翈	xxjx
㫰	lhol
晙	jyow
畤	vitc
𬱖	diyy
趼	jmzk
跂	qizv
蛃	bkin
蚲	pkip
𬟽	dsid
蚺	rjir
啴	tjku
啴	ijku
䎃	rjrx
崧	ssug
崟	ybuj
崞	gouz
崒	zuuu
崌	juug
崡	hjuu
铏	xkjd
𫓯	jijt
𫟹	hsjg
铕	yzjo
𫟼	dajd
铖	igji
铘	yeje
铚	vijt
铞	dnjj
铥	dqjq
铴	thjp
牻	mhnp
牿	gunk
稆	lvhk
笱	gzvj
笯	nuvy
偰	xprd
偡	vjrb
鸺	xqrn
偭	mmrm
偲	sirx
偲	cdrx
偁	igrr
㿠	hlbe
鄅	yuye
偓	wort
徛	jirk
衒	xrrx
舳	vuvy
舲	lkvs
鸼	vzvn
悆	yurx
鄃	uure
瓻	iixw
䝙	iuvq
脶	loon
脞	coor
脟	lpoc
䏲	dpod
鱾	jiyj
猇	xnqj
猊	niqe
猄	jkqx
觖	jtdg
𠅤	xiwx
庱	iggw
庼	qkgy
庳	bwgu
痓	iibt
䴔	jnwn
竫	jkly
堃	kyft
阌	wfmy
羝	diyu
羕	yhyy
焆	jrho
烺	lhhl
焌	quhw
焌	jyhw
淏	hcdt
𬇹	gody
淟	tmdb
淜	pgdo
淴	hudx
淯	yudo
湴	bjdy
涴	wodv
涴	yrdv
𬍡	dhdy
㥄	lkxw
惛	hyxo
惔	tjxh
悰	csxu
惙	ioxy
寁	zjbz
逭	hrzl
𬤇	ybyt
𫍯	xmyk
袼	gepk
裈	kypi
祲	jbpy
𬤊	uiyz
𫍲	xnyy
谞	xuyo
艴	fufb
弸	pggo
弶	jlgx
𬯎	tveb
隃	uued
婞	xkng
娵	juny
婼	ronk
媖	ykny
婳	hxnt
婍	qink
婌	uuny
婫	kynb
婤	vznk
婘	qrnv
婠	wjnl
𬘬	qmso
𬘭	ifsm
𬘭	lbsm
𬴂	fwmf
𫘦	tcmf
绹	tcsf
𫟅	llsx
𬘯	vysz
骕	sumb
𫘧	lumu
絜	jpfx
絜	xpfx
珷	wuwv
琲	bwwf
琡	iuwy
琟	wwwv
琔	dmwz
琭	luwu
堾	irto
堼	fgtt
揕	vffb
㙘	yctn
堧	rrtd
喆	vetk
堨	eetr
塅	drtu
堠	hztu
絷	vifx
𪣻	lztn
𡎚	pmtc
葜	qxcd
惎	jicx
萳	njcg
葙	xlco
靬	jmgg
葴	vfck
蒇	ijcb
蒈	kdcb
鄚	mcce
蒉	kvcb
蓇	guco
萩	qqch
蒐	szcg
葰	jycw
葎	lvcy
鄑	ziye
蒎	pdcy
葖	tucq
蒄	grcc
萹	bmcc
棤	qtmo
棽	ufmv
棽	ifmv
棫	yuma
椓	vomu
椑	bwmu
𬃊	vimb
鹀	wugn
椆	izmk
棓	bhmk
棓	bwmk
棬	qrmv
棪	yjmh
椀	wjmv
楗	jmmy
𬷕	bufn
甦	sugu
酦	poyy
觌	diuj
奡	aobl
皕	bibb
硪	wouw
欹	qidq
詟	velk
𫐐	niie
辌	llix
棐	fwfm
龂	ybvj
𬹼	xpvj
黹	viyx
牚	igxy
睎	xioj
晫	voou
晪	tmob
晱	ujoh
𧿹	muzm
蛑	mzin
畯	jytw
斝	jxkd
喤	hlkw
崶	fguc
嵁	kjub
𫶇	dpuj
崾	ycun
嵅	hjuk
崿	eeuk
嵚	qbuq
翙	hvux
𫖮	yiuy
圌	irke
圌	ivke
圐	kukf
赑	bibb
淼	mnuu
赒	vzbk
鿏	mdjw
铹	lcjl
𬭊	dujt
铽	tejx
𨱇	qqjq
𫓶	xrjo
锊	ltjc
锍	lqji
锎	kdjk
𬭎	hsjs
锓	qbjy
犇	bfnn
颋	tkzy
稌	tuhm
筀	gvvt
筘	kzvk
筜	dhve
筥	juvk
筅	xmve
傃	surx
傉	nurc
翛	xnrx
傒	xird
傕	jtrv
舾	xivx
畬	uert
畬	yurt
𫖯	fuvy
脿	bnoy
腘	gooy
䐃	jsoh
腙	zsou
腒	juog
𬱟	wwdy
鲃	bayb
猰	yaqd
𫛭	klqn
猯	trqe
㺄	yuqd
馉	guuo
凓	lidm
鄗	hcwe
𫷷	xbgq
廋	szgy
廆	wwgg
廆	gvgg
鄌	thge
粢	zidm
粢	cidm
遆	tizj
旐	vcfv
𬮱	ybmt
焞	tyhz
𬊤	ijhu
欻	ixhq
欻	xuhq
𣸣	ffdb
溚	tadk
溁	ykdm
湝	jpdb
渰	yjdc
湓	pfdm
㴔	jidx
渟	tkdd
溠	vadg
渼	mwdd
溇	lzdn
湣	mbdo
湑	xudo
溞	scdi
愐	mmxm
愃	xrxd
敩	xtxw
敩	xnxw
甯	nkby
棨	qihm
扊	yjhh
裣	lmpq
祼	grpg
婻	njng
媆	rrnd
媆	nfnd
媞	tinz
㛹	pmng
媓	hlnw
媂	dinj
媄	mwnd
毵	sjsm
矞	yumk
𬴃	homu
𫘨	timz
缊	yysm
缐	xmsu
骙	kvmt
瑃	iywo
瑓	lmwj
瑅	tiwz
瑆	xkwu
䴖	jkfn
瑖	drwu
瑝	hlww
瑔	qrwu
瑀	yuwy
𤧛	diwj
瑳	cowg
瑂	mwwo
嶅	aofu
瑑	vrwu
遘	gzzr
髢	diey
塥	getg
堽	ghtv
赪	igib
摛	iifn
塝	bhtf
搒	bhff
搒	pgff
搌	vjfy
蒱	pucf
蒨	qmco
蓏	locg
蔀	buce
蓢	lhco
蓂	mkcl
蒻	rocg
蓣	yucy
椹	ufmb
椹	vfmb
楪	dpmm
榃	tjmt
榅	wfmm
楒	simx
楞	lgmf
楩	pmmg
榇	ifmm
椸	yimy
楙	mcmm
歅	ybxq
𬪩	nsyy
碃	qkuo
碏	qtuo
𬒔	gguo
碈	mbuo
䃅	diuu
硿	ksug
鄠	huye
辒	wfim
𬨎	yziy
𫐓	rzim
龆	tnvk
觜	zivy
觜	zvvy
䣘	thxe
暕	jmoj
鹍	kyon
𫫇	eekx
㬊	hroy
暅	ggod
跱	vizc
蜐	jpil
蜎	yrio
嵲	npum
赗	fgbo
骱	jpgj
锖	qljo
𫓹	jijb
锘	nojk
锳	ykjy
锧	vijb
锪	hojx
𬭚	dvjz
𬭚	iyjz
锫	pwjk
锬	tjjh
𬭛	bojp
稑	luht
稙	vihq
䅟	cjhp
𬕂	lsvb
筻	ghvg
筼	yyvb
筶	gcvk
筦	grvy
筤	lhvl
傺	iiru
鹎	bwpn
僇	lurp
艅	yuvm
艉	wwvm
谼	hsgg
貆	hrvd
腽	waom
腨	uroe
腯	tuoo
鲉	yzyy
鲊	vayv
鲌	boyb
鲌	bayb
䲟	ybye
𬶋	juyj
𬶍	toyb
鲏	piyp
雊	gzjv
猺	ycqf
飔	sifx
觟	hxdt
𦝼	lvon
馌	yeum
裛	yiyb
廒	aogw
瘀	yubd
瘅	djbu
鄘	ysge
鹒	gggn
鄜	fule
麀	yzlb
鄣	vhle
阘	tamx
𫔶	npmm
煁	ifhb
煃	kvht
煴	yyhm
煋	xkhu
煟	wwho
煓	trhe
滠	uedy
溍	jbdo
溹	sodx
滆	gedg
滉	hlde
溦	wwdj
溵	ybdu
漷	hode
滧	ycdw
滘	jndk
滍	vidi
愭	qixo
慥	zcxk
慆	tcxj
塱	lhlt
𫌀	jipb
裼	tipw
裼	xipw
禋	ybpt
禔	vipz
禘	dipj
禒	xmpu
谫	jmyd
鹔	suyn
𫖳	yyyy
愍	mbmx
嫄	yrnx
媱	ycnf
戤	gdng
勠	luxl
戣	kvbg
𫘪	yrmx
𫘬	ximd
缞	cvsv
耤	jilo
瑧	vfwh
𫞩	mfwl
瑨	jbwo
瑱	vfwb
瑷	aiwy
瑢	rswg
斠	jnfd
摏	isfj
墕	yjth
墈	kjtl
墐	jbtw
墘	qmtv
摴	iufk
銎	qsgj
𡐓	khtl
墚	lltm
撖	hjfw
𪤗	lntp
靽	bjgb
鞁	bwgp
蔌	sucq
蔈	bncu
蓰	xicz
蔹	lmcw
蔊	hjcg
嘏	gugy
榰	vimo
榑	fumc
槚	jxmb
𣗋	dhmx
槜	zvmn
榍	xpmo
疐	viuz
𬸘	yjkn
酺	puyf
酾	udyd
酾	uiyd
酲	igyw
酴	tuym
碶	qiud
䃎	vaux
𬒗	ljuj
碨	wwuy
𥔲	eeuk
碹	xrud
碥	bmuc
劂	jtid
𫚖	civy
䴗	juon
夥	hogx
瞍	szoy
鹖	heon
㬎	xmoh
跽	jizx
蜾	goig
幖	bnju
嶍	xiub
圙	ltkm
𨱏	dajk
锺	vsjv
锼	szjy
锽	hljw
𬭤	hzju
锾	hrjy
锿	aijk
镃	zijy
镄	fwjb
镅	mwjo
馝	bihb
鹙	qqhn
箨	tovf
箖	lbvm
劄	vavd
僬	jnrh
僦	jqry
僔	zyrc
僎	vrrg
槃	pjvm
㙦	xprt
鲒	jpyk
鲕	erye
𫚕	uiyj
鲖	tsyk
鲗	zwyd
鲘	hzyk
鲙	kkyy
𬶐	vcyv
𬶏	wwyv
𩽾	anyn
夐	xsdw
獍	jkqe
飗	lqft
𬸚	ytqn
凘	sidj
廑	jbgw
廑	qbgw
廙	yigg
瘗	yibt
瘥	cobg
瘥	idbg
瘕	jxby
鲝	vayy
鄫	zgbe
熇	hehk
漹	yjdh
漖	jndw
潆	ykdx
漤	ljdn
潩	yidg
漼	cvdv
漴	uldu
漴	isdu
㽏	gjdg
漈	jidu
漋	lsdu
漻	lndp
慬	qbxw
窬	yubd
窭	jubn
㮾	lhlm
𬤝	hvyx
褕	yupd
禛	vfpb
禚	voph
隩	aoed
隩	yued
嫕	yinx
嫭	hunh
嫜	vhnu
嫪	lcnp
𬙂	yjsb
㻬	tuwk
麹	qufm
璆	qqwp
漦	siwu
漦	iiwu
叇	ddyl
墣	putf
墦	fjtt
墡	ujtk
劐	hocd
薁	yucd
蕰	wfcm
蔃	qlci
鼒	zico
槱	yzmh
鹝	yign
磏	qmuj
磏	lmuj
磉	shum
殣	jbdw
慭	yblx
霅	vayk
暵	hjot
暲	vhou
暶	xroz
踦	qizk
踣	bozk
䗖	diij
蝘	yjin
蝲	laid
蝤	qqiy
噇	ilkl
噂	zykc
噀	xykg
罶	lqst
嶲	xiuk
嶓	bout
㠇	jquy
嶟	zyuc
嶒	cguo
镆	mojd
镈	bojc
镋	thjx
镎	naju
𬭩	wgjx
镕	rsjg
稹	vfhb
儇	xrry
皞	hcbu
皛	xnbb
䴘	tiin
艎	hlvw
艏	uzvz
鹟	wggn
𩾃	mmye
鲦	tnym
鲪	jyyk
鲬	ysyy
橥	vuqm
觭	jidk
鹠	lqpn
鹡	jirn
糇	hzmu
糈	xumo
翦	jmbx
鹢	yibn
鹣	jmjn
熛	bnhu
潖	padb
潵	sadw
㵐	jtdq
澂	igdw
澛	ludo
瑬	lqdy
潽	pudo
潾	lbdf
潏	yudk
憭	lnxx
憕	igxb
𬸣	xmbn
戭	yjbg
褯	jppj
禤	xrpx
𫍽	xryy
嫽	lnnx
遹	yuzk
𬴊	lbmf
璥	jkww
璲	svwu
璒	dgwb
憙	xitx
擐	hrfy
鄹	zzee
薳	wwcy
鞔	mjge
黇	tmhv
𬞟	pbcy
蕗	luck
薢	xpcn
蕹	wgcv
橞	hvmx
橑	lnmx
橦	tsml
醑	xuyo
觱	biwy
磡	kjul
𥕢	ccuo
磜	qiuu
豮	ffub
𫟦	sviu
𬺈	yivk
𫠜	nive
鹾	cobg
虤	yjhj
暿	xiok
曌	vcog
曈	tsol
㬚	ieow
蹅	iazd
踶	dizz
䗛	xqio
螗	thik
疁	lqtp
㠓	mguu
幪	mgju
𪩘	yjuq
嶦	ujuk
𬭬	wwje
𨱑	hljh
𬭯	ppjw
馞	bohz
穄	jihu
篚	fwvf
篯	jmvj
簉	zcvk
鼽	qqzj
衠	vyrb
盦	anrm
螣	tgoi
縢	tgox
鲭	qkyo
鲯	qiyb
鲰	zzyy
鲺	uiyi
鲹	ufyp
𫗴	vjud
亸	dowu
癀	hlbh
瘭	bnbu
𬸦	vofn
羱	yryx
糒	bwmy
燋	jnhh
熻	xihx
燊	ufhm
燚	yihh
燏	yuhk
濩	hody
濋	iudz
澪	lkds
澽	judu
澴	hrdy
澭	ysdv
澼	pidx
憷	iuxz
憺	djxk
懔	lbxu
黉	hsxh
嬛	hrny
鹨	lqxn
翯	hexk
𫄷	yisx
璱	sewb
𤩽	hrwq
璬	jnww
璮	tjwd
髽	vxer
擿	tifg
擿	vifg
薿	nicz
薸	pncu
檑	lwmt
櫆	kvmd
檞	jpmn
醨	liyn
繄	yikx
磹	tjuu
磻	pjut
瞫	ufou
瞵	lbof
蹐	jizo
蟏	xnib
㘎	hjkw
𬭳	xijk
镤	pujf
𬭶	hwjh
𫔍	fjjt
镥	lujo
镨	pujo
𬭸	lbjf
𨱔	zyjc
𬭼	svju
𫔎	jtjk
矰	zguo
穙	puhf
穜	tshl
穜	vshl
穟	svhu
簕	levl
簃	yivx
簏	luvl
儦	bnrh
魋	tvgv
斶	iuji
艚	ccvo
𬸪	fjcn
谿	xivg
䲠	iyyo
𬶟	layd
鲾	biyt
𬶠	lmyj
鲿	ihyy
鳁	wfym
鳂	wwyy
鳈	qryu
鳉	jlyc
獯	xyqh
䗪	vegi
馘	goba
襕	ljpj
襚	svpu
𬶨	jigy
螱	wwui
甓	piuw
嬬	rune
嬥	tnnv
𦈡	xuse
𫄸	xysh
瓀	rrwe
釐	xiwl
鬶	gvfg
爇	roch
鞳	tagk
鞮	digz
𬟁	yicn
藟	lwct
藦	mocu
藨	bnch
鹲	mgcn
檫	iamu
黡	yjih
礞	mguu
礌	lwut
𥖨	zcum
蹢	dizg
蹜	suzb
蟫	ybiu
䗴	tkit
嚚	ybkk
髃	yugd
镮	hrjy
镱	yijx
酂	crne
酂	zjne
酂	cone
馧	yyhm
簠	fuvm
簝	lnvx
簰	pdvu
鼫	uiju
鼩	qujj
皦	jnbw
臑	ncoe
䲢	tgoy
鳑	phyf
鳒	jmyj
鹱	huny
鹯	vjwn
癗	lwbt
𦒍	tslx
旞	svfu
翷	lbmx
冁	ijby
䎖	zgbx
瀔	gudu
瀍	ijdt
瀌	bndh
襜	ijpk
䴙	piun
𬙊	most
嚭	pitk
㰀	limu
鬷	zsgw
醭	buyf
蹯	fjzt
蠋	vuii
翾	xrsx
鳘	mbpy
儳	ijrt
儴	rhrx
鼗	tcvv
𬶭	jiyu
𩾌	khyl
鳚	wwyc
鳛	xiyb
麑	nile
麖	jklx
蠃	lowi
彟	hoey
嬿	yjnh
鬒	vfeb
蘘	rhcx
欂	bomc
醵	juyu
颥	ruyy
甗	yjhw
𨟠	qroe
巇	xiug
酅	xiue
髎	lngp
犨	izrn
𬶮	xiyk
𨭉	bjwj
㸌	hohv
爔	xihk
瀱	jidd
瀹	ytdc
瀼	rhdx
瀵	ffdg
襫	uipb
孅	xmnj
骦	ulmo
𬙋	xlsx
耰	yzlw
𤫉	xpwy
瓖	xlwx
鬘	mjey
趯	titv
𬺓	iuvz
罍	lwtf
鼱	jkjo
鳠	huyy
鳡	gjyx
鳣	vjyd
爟	grhv
爚	ythc
灈	qudv
韂	ijgk
糵	npcm
蘼	micf
礵	uluo
鹴	ulyn
躔	ijzt
皭	jnbc
龢	herh
鳤	gryl
亹	mfwq
亹	wwwq
籥	ytvc
鼷	xijd
𫚭	lpyv
玃	jtqy
醾	miym
齇	vazq
觿	xidk
蠼	quiy
屄	biub
肏	ccrr
诶	eiyu
磺	hluh
〇	lkvv
冇	mcuk
珮	pwwj
炁	qiwh
螓	qbih
𪨊	ssur
薙	ticv
囧	jskk
鲶	nmyx
咲	xnkt
祂	tapy
屌	dnuj
𰻝	blzx
丼	jkjd
丼	djjd
挼	rofn
挼	rxfn
菈	lacl
濛	mgdu
