世	tlqk
坐	nxfo
合	mdfu
剑	eufh
石	tnqu
久	ezwy
睛	ejpr
攻	lvlg
待	hbfx
呵	mkuu
支	kgtj
亚	jrqj
树	tidx
质	klwf
划	mqlh
价	eyfe
厉	dlsg
午	gcwl
震	kwjm
纪	elze
休	cofd
窗	salg
型	ckuo
惜	cgcr
托	osva
奶	yryy
介	epfq
占	ksqu
列	dphh
圆	jigf
颜	jqgf
汗	mshl
尖	exqh
油	jthj
俩	dafd
项	cwlf
凉	dqhc
稍	tumr
育	jhgr
附	vibx
豪	mrgy
翼	jlci
伦	dhfi
陷	cube
阶	ehbe
丢	howk
幕	pixe
壁	ilto
绪	chzr
夺	hshx
雾	gijd
壮	kbht
辛	cvdt
摩	pqlt
悠	jxfc
浓	yahm
勒	drxd
喂	gdum
洲	kxhk
翔	cqbc
踏	ornr
旗	anvi
伊	jgfj
姿	nghy
欺	agaf
廷	oknf
尝	szbk
茫	pzxg
堪	uoot
龄	dkkk
箱	cmkp
羊	jzbq
袖	cewj
撤	srvg
湿	tghj
墨	pfmo
径	eafl
莹	jkxj
躯	aetc
扩	uxvl
璃	dngd
尴	loqp
昌	syrr
欠	aubf
播	itvo
仲	kzfk
讯	cxjt
勃	iqtd
魅	pdlg
鸿	mahy
割	lklh
棒	iudv
泣	alhd
矿	ubtl
蓉	faxu
弗	vmkq
宴	jsly
揉	ftvd
枚	phdg
伪	ggfg
雀	aotq
蠢	smss
屑	cptr
嘟	hjub
柯	ukdu
桂	ledo
妄	gugy
冻	hzhh
淑	tjhj
斑	iogg
册	xrwq
艇	oqkf
寡	lflh
竭	ekdk
廉	dble
贸	pwwf
填	oboi
兜	hxwb
缕	dszy
侄	knfo
朦	porp
惫	idgc
犬	abhh
砖	kftk
矣	jfkh
瞥	whip
炒	stmt
嗡	ghuc
膛	ozro
滔	ouhe
桐	oadu
苹	wkxt
翘	aplc
凳	hwhe
邵	twhb
胀	kurs
衍	jnfh
蜀	tczs
祷	htwx
霄	cdjr
挫	xxvo
璇	cigf
勋	csud
虞	jbqo
囚	aygf
蔑	ppxl
菩	wmxu
棚	wodr
芹	asxe
浆	emht
瘫	ooiy
揣	shvb
伺	zlfu
衔	cbfh
敖	qrqg
阱	eqbe
捐	efvr
嗤	sgus
襟	evwc
莺	jjxy
稽	egmr
苟	ldxu
琉	dygk
窟	ujls
钓	hpet
沛	wdhq
唔	gmuu
喀	ueuu
绮	afzu
蹬	hhnh
诛	kjjk
刁	hdkq
唬	mcue
擂	ddvo
瓣	isdt
霎	trjy
迭	hknt
讳	mejg
喳	keuh
悴	xect
橙	sodh
倔	eofs
髓	zzlr
罡	lyzk
迸	iwnu
靴	cyxi
兑	hebb
狙	eeaa
闵	pypc
靡	pnlv
穹	avll
袅	yzwm
茄	akxu
棱	dodg
牡	pcyo
痞	wfiu
彰	kydw
鄂	brub
灶	nwmo
邃	zeny
腑	vcrx
簌	zikf
憧	svcd
瞻	kopu
谴	aqja
阐	snph
瘸	aiif
昵	ylri
鸾	digy
崛	eizs
撮	xsvj
沪	mihm
翡	vgvc
札	kadk
蕃	voxo
簿	iikx
汩	lchr
鲨	tehj
鸥	rxuy
炊	slmf
忏	ssca
捻	yqvc
恺	urce
甥	thtd
唆	zsug
玟	psgc
嗲	hauc
哐	uaug
鳖	ihij
榨	krdk
濒	ivhf
桨	enhd
阉	joph
盅	kvkp
拄	kcvk
卤	dcqc
磐	wqku
怂	zqfc
辄	kdsk
涔	xyhe
噶	laul
垦	ugko
蟾	sqsu
恣	nlhc
酪	dwju
隼	zmft
溥	wchx
雒	dxgq
瞰	uspg
楮	scdr
姣	edyc
渥	gfho
宓	plli
遢	oenc
咝	zguz
颦	wskt
徵	khfg
遛	deno
摒	iavu
耙	irvi
俾	ifft
傥	opfb
豺	sjwx
塾	tmgo
酉	jdqq
匝	neue
罔	gpqg
箴	kqkl
旎	yfvi
笆	ieki
绉	kkzq
叵	wjuu
泱	jyhj
嗳	qbuj
赓	lhlf
饨	ohto
淞	zvhk
宕	hulu
觐	erxe
泫	cchz
鹄	mmly
颢	mwrf
葳	gxxl
伢	jafj
闩	tfpq
帼	lsej
檄	cndg
潋	duhg
嚯	mxum
榔	dzdb
纫	fwzf
卟	icui
赊	tkic
箸	kikr
砥	hfth
蘩	vqxc
啮	ypus
槊	txbd
腓	vhrv
氅	spbp
鸪	ljty
磬	aatu
泷	tyhi
豌	gohk
邳	wgib
唿	mjuc
仟	axfa
悌	olch
鳝	tsbu
汞	lqlt
喑	jvur
湟	mghg
暝	pkri
唢	zpuf
傩	ysfy
蚺	fqsf
舛	sbcq
躅	kmns
桁	modh
苫	toxu
莒	esxu
邰	ojkb
砭	ixtv
铬	lreu
鲧	lmbc
搦	yxvh
鲇	ybbu
蟊	prks
苁	xvxf
笫	nfkw
鲑	llbo
筢	waki
鸹	lzay
褫	sfwe
枋	vydv
逋	ijnv
憷	sicf
錾	nsse
鏊	qwqe
酢	xijk
鸬	dmdy
镪	ames
孥	ymyn
鍪	ptke
戆	ludc
鲂	vzbv
儇	cffm
鹚	xnby
跗	vjnx
绨	onzh
偾	vwff
蠓	pmsp
洳	fihu
郫	wnib
赜	nduf
隳	mlbh
锩	ebek
脬	wurn
荛	frxb
薷	fmxb
闶	uype
罾	nhzr
湓	wyhp
栳	dtdi
阌	gypj
垡	vafo
酾	tajd
毵	zokp
坭	ynoi
胬	ycyf
桊	echd
甓	wltg
鳢	dfbh
洚	ewhq
怊	sucu
簖	hcke
赕	hnim
鲕	bjbb
氽	omft
些	zxkb
句	lxwu
追	hlnq
称	swmc
藏	nuxl
咱	naun
雀	adtq
巷	muxk
泊	wthi
扁	wxmx
揣	oivb
伺	xlfu
嚓	seuc
莞	gnxb
曝	wirt
珩	mzgh
韫	gqgp
珲	mhgs
枞	nvdf
槭	zrdl
佴	bofb
囝	yogn
郄	clcb
缲	zuzd
乐	jwwh
鍉	hgff
込	jenf
䌷	sxzj
劏	oybh
嘥	zauf
郬	ajab
苧	ykxh
屾	tqzz
黇	oxxu
媆	ywyh
噂	nmux
羕	jubj
畖	geol
窣	zjlt
偲	xafc
爇	fxxb
乸	yvjp
俫	djfd
硿	uvtl
㬊	mbrj
筶	lwku
鳤	lbbl
剕	vdvh
跐	xfni
洿	gjhu
渼	pghh
婞	cayt
式	tlll
宫	lvlu
智	kltr
袋	hbfm
释	tlwq
舰	euke
梁	dqhd
郑	kwbb
监	exqp
泳	jqhj
傅	vifx
裂	dphm
健	eufe
磨	pqlu
氏	tlwk
拖	osvj
拒	ehve
朗	dphr
嘻	cguu
豫	jhkc
振	kwvm
饰	tlte
沿	jqhu
卓	ksqt
刑	ckuh
驾	eydp
滋	nghz
愈	jhfc
绩	elzf
麽	pqlp
详	cqjj
勉	pqbd
俱	ehfi
熙	cgub
誓	tlvu
盒	mdfp
琪	angi
夕	cgwh
瑶	jrgv
励	dlsd
膊	iqrx
役	jlfj
寄	ellu
墓	pixo
瞒	pqpd
页	jrqf
逝	tlne
哗	mqut
漆	aght
漏	dkhj
尉	gdtx
涵	mqhm
译	jljq
羡	cubf
翰	mstc
哟	jtut
郡	exjb
揭	ehvk
朕	kwrh
娅	jryj
竖	tiqd
胃	gdor
膝	cgrt
黛	hbfb
逊	cxnc
辨	iudt
拢	dqvi
械	cpdl
溢	jlhp
轿	epsa
拂	vmvv
靖	eadr
循	chfp
枕	kgdk
寇	uklj
俘	vmfn
岭	dqzk
溅	euhl
雁	jssq
践	eunl
兆	kwbh
剥	iudh
悍	mscl
泊	iqhi
仑	dhfi
饼	iqtu
墅	tido
弘	malk
届	eptj
脂	kgrr
蓦	pfxp
沫	pfhp
菁	ejxr
喻	jhuh
谊	jlja
萌	poxr
栈	ksdl
滞	klhe
侣	dsfu
圳	kwos
陋	dkbi
毙	ilii
暮	pixr
澜	dqhe
涌	jqhj
已	jfkk
澈	srhg
棠	ozbd
咙	daui
瀚	mshc
敛	dqfg
盲	pzgp
吏	dlqy
贷	hbff
辟	iltt
履	dstg
仕	tlft
倏	tjfa
谐	ckji
卸	cpgb
奕	jlgh
嬉	cgyu
哮	cpun
熄	cgmc
窍	apla
俞	jbfh
琦	angu
挟	ckve
梨	dnmd
嗅	ceua
祁	anwb
渠	abhd
捅	oqvj
侮	gcfp
拣	eqvh
谣	jrjv
拭	tlvl
胤	jrwk
秩	klmt
熏	cswb
诏	kwju
滥	dshp
歆	cvdf
拙	ksvs
扳	iovj
煎	exbb
唧	egub
婿	chyr
嗜	tlur
讥	egje
娴	cbyd
泻	cphj
撩	ddvc
缴	ezzg
弊	iliq
跺	hxnd
踱	hsnj
匀	jhwh
婪	dqdy
曦	cgrl
矜	evke
吨	hsuo
谍	hkjd
伽	eofu
嗣	zluu
膨	worw
峙	klzx
疙	lkij
挚	klvt
尧	jrlb
辫	iudt
芯	cvxc
澎	wohw
邢	ckub
湛	ksht
蒲	wmxv
嬴	jkgv
袱	vmwa
淇	anhi
寅	jsli
榻	ordc
苇	ggxg
茉	pfxp
晟	twrl
匣	cdue
蟹	cpbs
曳	jrqw
冶	jrhu
筠	jhkh
谕	jhjh
皙	cgdi
咄	hsus
璧	iltj
咔	ueui
聆	dkbk
咨	nghu
奄	jnhh
炙	klwm
翎	dkfc
逾	jbnh
茬	saxo
裔	jlgu
锥	kleq
萤	jkxs
枢	tjdc
募	pixd
拌	isvi
颐	jnuf
皂	nwia
檀	oqdh
掺	sovw
惬	apce
抡	dsvi
焱	jsmm
飙	idac
俨	jnfs
荧	jkxm
俐	dlfh
饺	eztc
垄	dqdo
讼	zzjk
晏	jsry
弈	jlgq
萦	jkxc
羁	egzp
荀	chxr
躇	smnr
冽	dphh
辗	knsm
亵	cpgm
茸	faxb
渝	jbhh
汐	cghc
壕	mrom
鹫	eegy
睽	ubpo
阑	dqpe
炜	ggmg
蹊	cgnh
寐	pdlg
涧	euhr
甭	ioij
笠	dlkd
捺	yrvc
茧	eqxs
曙	tcrr
馅	cute
忒	orcl
痹	iliq
垣	jioh
蛤	masu
捋	dsvx
飓	ehvi
劭	twhd
攸	jxfg
滕	oort
紊	gggc
稠	stmu
炳	iqmi
褒	iugm
钳	abel
茎	ejxl
遐	cdnj
蹋	ornc
枷	eodu
霁	elja
奚	cgwh
樵	aodb
戾	dlma
屹	jlzj
痊	aiig
糜	pnlp
抠	uxvc
诲	mejp
弼	illl
柬	eqqy
浏	dyhh
剁	hxeh
沂	jnhe
帛	iqie
嗬	mkuu
唏	cgue
矶	egte
祺	anwi
羿	jlcq
犁	dnmy
癖	wfit
掣	srkt
矽	cgtc
毓	jhpk
诣	jljr
邯	mqlb
芥	epxe
醺	csjb
佼	ezfc
腼	pqrp
驮	osph
阙	aopf
煦	chrb
幡	voeo
翌	jlcd
毡	kopu
闽	pyps
捍	msvl
桔	ekdu
抉	eivy
碾	yqtm
粼	dspk
啐	xeut
甬	jqkj
稷	elmg
妤	jbyj
撵	yqvs
澹	hshu
钊	kueh
泓	mahk
羚	dkbk
踞	ehnu
曝	iwrt
涣	mchh
俟	zlfh
湮	joho
峦	digz
涓	efhr
掬	eevp
鳌	qrqj
睐	dbpd
卞	iugi
啕	oruv
陇	dqbi
膺	jjlr
呓	jluj
纶	dhzi
垛	hxod
淅	cghe
岌	enze
岱	hbfz
缄	exzl
斓	dqge
翊	jldc
挛	digt
汲	enhe
獒	qrqa
恪	urcu
吒	keua
粱	dqhp
辐	vmso
偕	ckfi
蜴	jlsg
隅	jbbh
孚	vmwn
禺	jbqh
掖	jrvj
畸	egou
晔	jrrt
菡	msxm
昙	oqrk
滤	dhhc
潦	dohc
笈	enke
恿	jqkc
滢	jkhj
窕	ozlk
滇	hxhi
咿	jguj
瘴	kuit
泞	yahh
藐	pzxb
鹦	jjiy
戍	tihl
榭	cpdx
熹	cgtb
岐	anzj
嵬	ghzk
褶	krwi
釜	vciq
磷	dstq
娑	zshy
芋	jhxj
觊	elze
筵	jqkk
涸	mdhu
愫	zicc
鸢	jfly
邺	jrjb
聿	jhkq
鹉	gcky
臆	jlrc
偃	jnfy
郸	hobb
摹	pqxt
苻	vmxx
贲	iltf
潼	oahd
弑	tlcl
匐	vmwo
蟋	cgsc
浒	mcht
阂	mdpf
愠	jxcp
嵇	egmz
谒	jrjk
呤	dauk
槟	ivdi
樟	kydt
蛰	kdvs
阜	viwt
苓	dkxk
臾	jbwy
沏	aghh
蛆	aesa
揄	jbvh
荔	dlxd
闫	jqpz
渤	iqhd
馍	pqth
楣	phdp
蜃	twss
戌	ceql
嶙	dszq
匮	ueuf
敕	sltg
啾	eoum
靼	haxh
沅	jihb
贻	jniu
礴	iqtx
腌	jorh
呷	coue
铝	dseu
蔻	ukxj
濑	dbhf
裟	tehm
唷	jtur
袈	eodm
阏	joph
戊	giwl
攫	eivj
罂	jjiv
酗	chjc
璎	jjgy
觎	jbfe
浚	exhg
煲	iufm
嗥	mrut
嵘	fazd
碱	eqtl
葆	itxd
谆	ksjn
蔺	drxq
缜	kgzi
爻	jrcc
昀	jhrh
噫	jguc
镂	dkey
抨	whvt
坨	osoi
纭	jhzk
恹	joca
榛	kqdm
酵	epjn
銮	dige
佶	enfu
孪	dign
泠	dkhk
砺	dltg
遽	ehny
嗟	ehul
谚	jsjw
闾	dbpu
翦	eqbc
雉	kltq
虱	tgks
锴	urei
赈	kwim
峋	chzr
瘠	enir
佚	jlft
淄	ngho
镳	ideb
喟	ueur
偻	dsfy
兖	jngb
栾	digd
畿	egol
繇	jtwc
魈	cdlr
谲	eiju
雹	irjk
旯	dare
濂	dbhe
颚	bruf
迤	jnnj
彗	mevq
暹	cxnq
僮	kbfd
钺	joel
嘞	dxud
蛹	jqsj
盂	jbjp
瑁	pwgp
堰	jsoy
鄢	jokb
夔	ubbg
燧	zemz
孱	sqtn
漕	xrhr
餮	ophm
鹘	mmly
倨	ehfu
汜	zlhk
颧	aixf
绡	cdzr
郢	jqub
栀	kgdk
岫	cezj
谥	tljp
犄	egyu
辇	yqvs
魑	sgld
鹜	giky
颍	jqif
濠	mrhm
鳗	pqbj
踊	jqnj
柚	jkdj
亟	endq
锺	kvek
莆	wmxv
搽	savc
俪	dlfd
茁	ksxs
韭	ezvq
酩	pqju
娩	pqyp
刎	gggh
扪	pyvp
呶	yruj
佞	yafy
饬	sltd
裨	ilwt
鹂	dndy
徉	jzfj
僖	cgfu
锌	cvet
潞	dihu
阕	aopo
涿	kshy
薜	ilxt
睥	ilpt
滦	dihd
徜	szfu
喙	meuy
嫫	pqyh
瓴	dkfg
犍	exye
臌	lcrj
邙	pzgb
襁	anws
胫	earl
雎	eeaq
荟	mexk
汛	cxht
栎	dldd
砣	osti
烩	memk
拮	ekvu
灏	mwhf
殓	duhq
擢	ksvq
殛	enhq
徇	cxfr
谯	aojb
烊	jzmj
鹗	bruy
秣	pfmp
榷	aodq
庾	jslj
饽	ittn
荥	ckxt
囵	dhgi
睢	zlpq
罹	dnzg
秸	ehmu
邝	ublb
芈	pfqq
暨	eleh
滟	jshi
麋	pnlp
寮	dolc
囫	mmgg
弭	pflb
柑	lodl
圜	migm
儆	eqfg
哓	cdub
酶	phjp
缢	jlzp
鲫	elbb
痔	klix
旃	kovh
猷	jtba
豢	mchy
蝌	ukst
呔	hauo
蓑	zsxm
翳	jluc
殁	pfhj
砧	kqtu
殄	oqhw
辔	wdzu
蜍	smsc
浔	chhx
钜	ehee
趿	oene
鹧	krly
诨	mxjs
掼	lcvf
僭	eufr
汨	plhr
栉	kldb
鸩	kwhy
荞	aoxa
祉	kfwk
桎	kldo
瓯	rxug
偈	elfk
刍	smbq
赝	jssf
唁	jsuu
齑	eggq
狎	cdae
钹	iqej
侩	uofk
帧	kqef
裾	eewu
澍	tihx
崧	zvzk
衾	avfm
羸	dhgv
痍	jnij
猢	mmar
戡	uotl
濯	kshq
莅	dlxd
誊	oohu
亓	anbq
泅	ayhf
桫	zsdt
恽	jxcs
薏	jlxc
痨	drid
蒺	enxh
觞	tybw
忝	oqoh
箔	iqki
酃	dkjb
臬	ypnd
焙	idmu
啖	hsum
鸷	klvy
茔	jkxo
艽	edxe
踅	civf
钾	eaee
跹	cxna
笞	sgku
仵	gcft
苕	ooxu
婺	giky
囿	jkgr
帏	gheg
缦	pszj
轸	kgsw
馔	kcti
槿	eydq
涪	vmhu
塬	jioc
颏	ukgf
柘	krdu
砒	wgti
邶	idib
洌	dphh
衿	evwe
颛	kfzf
柒	aghd
呖	dlud
郅	klkb
茯	vmxa
圄	jsgu
琚	eegu
蛎	dlsg
爿	wqkq
辂	disu
苜	pixp
窠	ukll
辚	dssq
囹	dkgk
撷	ckvf
屐	egtj
疽	eeia
洮	orhk
邛	avlb
碣	ektk
逑	ayna
郾	jnub
钲	khek
遴	dsnq
荠	elxa
荚	edxe
鎏	dyhe
悒	jlci
郗	cgcb
豸	klww
摈	irvi
凫	vmwe
蚨	vmsv
纛	hwhc
畲	tkfo
醮	epjb
酆	vhqb
馏	dyto
莛	okxf
髭	ngsi
龈	jskm
钯	ivei
楹	jkdp
贽	klvf
灞	irhr
钎	axea
欤	jbjf
淝	vhhi
鸶	zgzy
亳	iqga
楫	endb
豕	tfqy
涫	lchl
苎	kixq
仝	oafl
赍	egtf
龅	iukk
诤	kwjk
鬈	aisk
芪	anxt
猞	tkau
挈	apvt
薹	ojxo
拊	vcvx
雠	stft
荩	erxe
恂	chcr
圻	anoe
奁	dbhc
痫	cbid
讦	ekjl
铰	ezec
烯	cgme
踟	snnu
峄	jlzq
吡	ifui
荭	maxl
檫	sadc
鄯	tsbb
酽	jsjs
歙	cgff
骘	klbp
垩	brjo
鄞	jsxb
乩	egkk
幂	plle
沭	tiht
萁	anxi
伧	xyfk
鼋	jibh
钤	abee
矬	xsto
砀	hutw
孳	ngbn
脔	digf
猱	yrad
跸	ilnt
岈	jazj
芾	vmxq
沔	pqhk
蹰	smnx
裢	dbws
郧	jhub
捭	irvt
謇	eqlu
蒹	exxe
缌	zgzc
夤	jsci
鹬	jhky
玢	ivgh
縻	pnlc
洹	mihh
鲠	lmbl
楸	aodm
瀣	cphe
龉	jsku
鬻	jhlq
骐	anpi
膂	dsvr
聃	hobf
蟥	mgsi
怿	jlcq
窳	jsll
蛳	zgse
彘	klki
犰	ayae
荜	ilxt
椋	dqdc
芡	auxf
芩	asxe
螯	qrqs
肄	jliq
娈	digy
圉	jsgt
叻	drud
耋	hkto
邴	iqib
毂	lctj
俳	wjfv
喈	ehui
蓠	dnxd
貘	pfwh
笄	egku
缗	pszr
渑	pqhh
挹	jlvi
镍	yped
锛	iqem
轺	jrsu
杼	kidj
岘	cuze
鲶	ybbc
鲮	dkbg
椹	kqdt
栊	dadi
孢	iunk
郏	edeb
侑	jkfr
澶	sqhh
啭	kcuk
蜉	vmsn
黻	vmjj
跖	knnu
愆	axfc
藿	mxxm
浠	cghe
戋	exqh
黧	dnmb
毖	ilii
槎	sadl
哚	hpud
蜊	dnsh
铙	yreb
漯	dxhc
捌	ievh
溘	urhp
愍	pypc
篁	mgkg
刈	jlch
瓠	mihl
棰	sbds
圪	lkoj
轾	klso
杓	trdt
剀	urzh
餍	jssm
瞽	lctp
芎	csxl
缡	dnzd
捩	dpva
窨	jrlr
幛	kuet
蓊	gmxc
瘢	ioij
汊	srhs
芰	elxj
樨	cgdy
涑	ziht
摭	knvb
钡	idef
凼	hutq
岢	urzu
蕖	abxd
霈	wdjw
铗	edee
欹	aghf
傈	dlfd
渌	diht
壅	jvgo
赀	ngkf
癔	jlic
潆	jkhc
檩	dydc
逯	dint
浞	kshf
菽	tjxj
鸱	sgty
茭	edxc
酰	cxjb
赉	dbdf
霪	jsjf
苴	eexa
粳	ejpl
趵	iwnt
蛩	avls
枥	dldd
笊	kwkk
燠	jhmh
厣	jnse
菰	ljxl
醛	aijg
徼	epfg
裣	dqwq
蓖	ilxi
暾	osrg
訾	nfku
碛	altf
镒	jlep
硖	cdte
溧	dlhd
柢	hfdh
卺	eydk
帙	klet
锞	urel
蘧	abxy
簟	hukt
鞫	eexu
泮	wshi
眭	zlpo
嬖	ilty
砻	dadu
筚	ilkt
醚	pnjp
蚧	epse
螅	cgsc
槠	kjdr
卮	kgwk
顸	molf
筲	tukr
媵	jary
褊	iqwx
簋	lzkp
梃	oqdf
亍	sibk
缒	kezk
刖	jorh
磴	hwth
瘿	jqiy
疖	ehib
迓	jrnj
啉	dsud
硒	cgtc
汔	alhj
蛄	ljsu
伛	jsfc
鞯	exxn
髀	illt
銎	avle
凇	zvhk
檗	iftd
笕	eqke
鲥	tnbx
锍	dzek
嵊	twzs
饧	cktw
佾	jlfr
鲩	mcbb
谳	jsja
棼	vydh
熘	domo
鹕	mmty
蘖	ypxd
剡	jnmh
椐	eedu
髁	ukll
狺	jsau
鲢	dbbs
豳	ivzy
搴	axlt
洫	chhc
螈	jisc
轭	brsk
庋	lzlj
皲	eslj
胝	kgrh
邗	mqlb
跏	eonu
鲋	vibx
罘	vmzi
獍	eaab
硼	wotr
疝	tsiz
潲	twhr
笥	zlku
葸	cfxc
剞	eghh
嘏	lctj
觳	mmtj
桷	eidj
郛	vmwb
疠	dlig
郇	micb
粝	dlpg
埕	soog
鹪	edfy
栌	dmdt
宄	lzle
嫠	dngy
埒	dpox
蹀	hknd
颟	poxf
劬	abed
濞	ilhi
唣	nwua
嗍	zsur
阈	jhpl
鄣	kydb
觯	klbh
鹣	exby
磲	abtd
畋	obog
簏	diki
暌	ubro
尢	jtqk
菔	vmxj
觇	soke
缣	exze
颞	ypbf
鲷	hdbu
芟	toxj
蚴	jksd
檠	akxd
飑	idvk
燔	vqmo
觫	zibt
疃	obod
幞	vmey
苊	brxk
溷	mxhy
鲆	wkbt
掊	wdvu
隈	gxbm
碚	idtu
罱	dnzt
怃	gccg
嵫	ngzz
篼	hxkb
篥	dlkd
陬	nxbj
祓	vmwj
絷	knvc
牾	gcyu
瞢	poxp
缧	dhzc
揠	jrvy
诼	ksjy
嗌	qbup
蛴	ansa
雩	jbju
鹆	jhiy
漶	mchc
廛	sqlo
袷	aowu
甍	poxg
烃	ojml
襻	wswt
躞	cpnj
诖	lfjo
岵	mizu
蝤	aysj
匦	lzue
豇	emhl
桕	eede
崞	lszn
眚	tmtp
蚰	jtsj
轵	kfsi
黹	kfjh
湔	exhh
鞔	pqxp
溆	chhj
钭	hdet
髂	aylu
硪	gftl
潴	kjhr
郐	uofb
屺	afze
胗	kqrw
笪	hakh
枵	cddm
羟	anbl
龆	ooku
沩	ghhg
蛏	shso
悫	aotc
舳	kmkj
忉	huch
蜱	wnst
钒	vqev
蛱	edse
敫	ezig
舯	kvkk
踬	klnf
箅	ilkq
绋	vmzv
濉	zlhq
籼	cxpz
曛	csrb
聱	qrqb
鹁	iqty
硭	pztg
谂	tgjc
炱	ojkm
褰	axlm
鳊	ixbx
鲳	sybr
掎	efvu
屦	ehty
莨	dqxm
莩	vmxn
埤	wnot
螽	kvgs
蜩	oosu
瘗	jlio
莸	jtxj
癍	ioig
啶	hauf
郄	apcb
硎	ckth
髹	cosd
氘	huaq
赙	viix
洎	elhn
卣	jdqq
茈	xnxi
搌	knvm
跽	elnc
渫	cphd
觋	cnge
堙	jvoo
鞒	aoxa
慝	oruc
襞	iltm
瀹	johx
蒇	snxl
艴	vmvi
刭	eqkh
唛	prug
嗪	asum
攉	msvm
毹	tjfp
缂	urzl
鳇	mgbg
仡	lkfj
瓿	iidg
僬	edfb
槔	ludt
滠	trhj
劓	jlnh
俜	wjfk
轹	dlsd
稆	dsmu
蝥	prks
鞴	idxj
柃	dkdk
镘	psej
殪	jlhh
蒡	iuxv
胍	lzrl
骱	eple
跫	avlf
氍	abpp
箢	jfkk
哳	keue
饔	jvgm
戽	mimt
甏	iwtg
墚	dqod
苘	aqxu
觏	lkqe
枧	eqde
桤	agde
酲	sojg
鲣	exbo
裼	cgwg
酎	kkjx
毳	xepp
铪	meeu
胂	twrt
嵴	enzr
泺	dxhd
疬	dlid
涠	ghhg
鹇	cbpy
粢	nghp
劂	eish
苈	dlxd
珧	jrgk
钌	dzed
瓞	hklt
陧	ypbo
鄹	nxbb
砹	qbtc
砘	hxto
螗	ozsu
阼	nxbk
摅	tjvc
苄	iuxi
醵	ehjy
艚	xrkr
夼	uehs
胨	hzrh
鲚	elba
菪	huxu
鐾	idte
滗	ilhp
腈	ejrr
箦	ndkf
橥	kjad
馘	lsbl
蕺	enxl
绠	lmzl
垲	uroe
莶	cxxq
坌	iwio
肀	jhkq
鸲	abey
肼	eqre
枨	sods
鹋	poxy
榍	cpdr
捃	exvu
葙	cmxp
罨	jnzh
锬	oqem
鲻	ngbo
钷	wjeu
眢	jfcp
冱	mihm
蛸	cdsr
掭	ouvh
庳	illt
萆	ilxt
铞	hpee
眍	uxpc
瘭	idic
搋	shve
阽	hubu
鲒	ekbu
锖	amer
蓥	jkxe
垤	hkoo
荬	prxh
谫	eqjh
蓰	cfxf
踺	eune
椠	ausd
廒	qrlg
镓	eoee
舣	jfkj
鼷	cgeh
螬	xrsr
鳙	jvbj
撖	msvg
瞵	dspq
葜	aoxh
楗	eude
贳	tltf
鸺	cofy
骣	snpn
耠	msvu
劐	msxh
蔹	dqxg
舭	ifki
瘕	eaij
膦	drrq
醑	csjr
铟	jveh
疰	kiik
漤	dnhy
碥	iqtx
蓣	jhxf
仂	drfd
癀	mgii
脲	yprt
鼢	vyeh
鳘	pypj
磉	zptd
牮	eufy
菥	cgxe
筻	lukl
鼽	ayne
鲰	nxbj
辁	aisg
瀵	vwhi
苠	psxp
铕	jder
茚	jrxb
彐	elkq
喆	kdtu
丌	egqq
茇	iaxj
挢	ezva
摺	kdvi
咭	eguu
囗	ghqq
後	mkfg
沲	hxhj
渖	tght
缋	mezf
榘	estd
膪	soru
欷	cgcf
飚	idvm
钸	iiee
镙	dsec
镟	ccef
痖	jvij
疋	jvkf
蠛	ppsl
簦	hhkh
舡	sikl
麴	aetp
謦	aatu
鳆	vibg
着	kubp
地	hkoj
没	pfhj
会	uofk
都	hjtb
和	msmu
什	tnft
无	pqqk
其	egqi
色	trbi
强	ewls
车	eeqq
解	cpby
似	tlff
万	pfqw
且	eeqq
落	drxu
数	txpg
奇	eghu
系	elwc
员	jhuf
乐	jowh
喝	jruk
期	egar
六	digi
叶	ckut
露	dkju
呵	ukuu
角	eibj
调	hpju
区	rxuc
佛	vmfv
否	wfiu
恶	gijc
卡	aati
属	kctj
弄	dzgq
射	jrtx
价	epfe
弹	hslh
食	zlfm
著	ksxr
吓	mruc
读	hkjh
伯	irfi
冒	pfqp
罢	wnzk
降	cqbq
抢	shvk
率	togt
艾	jlxc
仇	ayfe
扎	nevk
颤	ksgf
臂	ixtr
氏	kgwk
蛇	jnsi
勒	dxxd
脉	pfrj
乘	tway
召	twhu
汤	tyhw
贾	lccf
莎	zsxt
核	mmdf
柜	esde
咽	jruh
屏	iqtu
咳	mauf
勃	idtd
摄	ypvj
咖	leuu
纤	auza
朴	wodi
拓	orvu
尉	jhtx
殷	jowj
宛	jflk
揭	alvk
柏	iqdi
吁	ceuj
吱	nguj
姥	pcyi
茜	cgxc
厕	zgsh
尿	zltt
叨	ouuh
裳	szbm
兹	xnbz
琢	nsgy
腊	cgrr
敦	hegg
厦	trsg
嘘	tguj
堕	mlbo
辟	wltt
殖	tghk
隋	hxbr
挟	eove
扛	lyvl
涡	lshy
澄	hwhh
券	cchh
缴	kszg
藉	enxr
栖	cgdc
蔚	jhxx
屯	ksqk
淳	kmhn
伽	lefu
靓	eaae
侥	jrfb
褚	krwr
惮	hach
嗒	heuu
茄	eoxu
晟	sorl
蟒	pmsp
棱	dkdg
溺	yphh
掺	xsvw
栅	xrdx
呱	ljul
忒	olcl
蕃	itxo
簿	iqkx
汩	jhhr
啜	souj
泌	ilhi
刨	iwih
汶	pyhc
沓	hatr
椎	sbdq
桔	ebdu
啐	agut
莘	cvxt
澹	oqhu
埔	iiov
颌	mdff
掸	tsvh
崴	gxzl
贲	iqtf
浒	csht
隗	ggbk
匮	leuf
耙	wavi
町	oqoh
戛	leql
诘	enju
桧	ledk
浚	cxhg
颉	edtf
偻	dtfy
郦	kndb
僮	oafd
侗	oafu
熨	jhtm
孱	xstn
鹘	lcly
亟	aldq
裨	wnwt
铤	haef
菀	jxxk
炅	lerm
挝	kzvx
栎	jodd
拮	edvu
乜	phkk
膻	hsrh
谌	twjt
荥	jkxt
圜	jigm
呔	oruo
澍	kihx
噱	eiuy
苕	trxu
貉	mrwu
圩	ceoj
钿	obeo
枸	esdu
嗄	trug
楂	kedh
碣	jrtk
陂	wnbj
綮	afmc
荠	anxa
龈	ugkm
桁	mzdh
圻	jsoe
吡	wfui
歙	trff
帑	ymye
苣	asxe
鲑	ckbo
棹	ksdt
柞	krdk
焯	ksmt
荨	chxx
渑	tohh
坻	snoh
笮	ndkk
杓	iddt
酢	nxjk
苴	saxa
溱	kqhm
鳜	eibf
砬	dltd
觜	ngkj
剡	tsmh
旰	msrl
郇	chcb
濞	wlhi
慊	apce
隳	hxbh
嗌	jlup
哕	meuc
鞔	pwxp
铫	hpek
莨	duxm
浍	mehk
仡	jlfj
酾	tgjd
铪	ukeu
淠	wdhq
瘥	xsil
莶	dqxq
帱	hwex
埏	jqok
和	mmmu
行	mofh
单	tsbq
射	jltx
食	jlfm
咯	dxuu
龟	aobk
咋	nduk
揣	klvb
矜	aske
缪	ptzw
掺	tnvw
栅	todx
挲	teht
轧	jrsk
颉	cktf
繇	jrwc
淖	ksht
貉	pfwu
啁	kuuu
漯	orhc
呙	mkuy
镡	oqet
栝	oqdu
敹	doqg
罥	eczr
丼	eqeh
砳	drtu
垇	qwoq
膖	wyrv
豗	mlqy
烓	gxmo
珄	thgt
暒	akrt
琞	twrj
蕥	jvxj
莀	syxm
莯	pixd
翧	cflc
琂	jqgu
晹	jlrg
昍	cfrr
犼	mdau
玏	drgd
猋	idaa
怹	oofc
埜	jrdo
鿔	lkeu
烎	jsum
屌	hzte
実	tnly
炤	kwmu
桜	jjdy
沢	ndhs
祂	oewj
畑	obmo
咲	cpuh
芶	ldxk
咗	nsul
吔	jkuj
嘢	jruj
喺	cfuc
嗻	kkub
佢	abfe
撚	yqvb
孃	yqym
嗱	yaut
槑	phud
慜	pypc
攞	dsvg
喥	hsuj
〇	dkjj
嚟	dlut
粦	dspq
冧	dsld
嚡	mjuo
㗎	eyud
啩	lfui
嘅	ldue
瞓	vwps
唞	hdut
噃	ituo
揼	iwvt
抦	iqvi
閪	cgpc
啱	jouu
猇	cdae
昤	dkrk
夬	loky
夬	eiky
彳	slwf
祇	anwt
燚	jlmm
晞	cgre
浐	snhs
麀	jxli
鋆	jhoe
煴	jsmp
籥	jokx
倻	jkfb
猺	jrav
滧	jrhg
䲟	jrbb
䗛	cosr
翛	cdfc
滃	gmhc
蕰	gqxp
帨	teeb
圫	osoa
菼	onxm
麹	aepp
鲏	wnbj
杧	pzdg
漋	daht
磏	dbte
筤	dzkm
箖	dskd
櫆	ubdt
骙	ubpo
泂	evhu
漴	tahc
㳘	svhb
儳	sqfo
惛	mscr
玒	magl
垙	laob
楯	hxdp
嘚	hkux
剟	hsjh
萣	haxf
瑳	xsgl
袯	iqwj
坋	iwoh
酂	nscb
酂	xicb
镃	ngez
鄑	ngjb
鄫	nhbb
嗞	nguz
咉	jyuj
靿	jwxd
訚	jspu
栐	jqdj
祐	jkwu
妘	jhyk
缊	jxzp
赟	jsgf
燏	jhmu
遹	jhnu
薁	jhxh
㺄	jsah
滪	jhhf
堉	jhor
澭	jvhj
鄘	jvlb
埇	jqoj
㶲	jzmj
嫄	jiyc
蜎	jfsr
妧	jiyb
湲	jihj
溁	jkhd
䓨	jjxv
甗	jnqg
戭	jnll
蝘	jnsy
漹	johb
墕	jsob
渰	jnhq
弇	jnfq
䶮	jndo
沇	jnhb
觃	jsen
㑊	jlfj
簃	jnkc
宧	jnlq
昳	jlrt
杙	jldl
螠	jlsp
浥	jlhi
飏	jzvw
馌	jrtp
媱	jryv
窅	jtlp
珢	jsgm
嚚	jsuu
慭	jrdc
禋	jvwo
溵	jvhj
歅	jvcf
崟	jsze
硍	jstm
愔	jvcr
猰	jrah
玡	jagj
鲉	jtbj
褕	jbwh
淯	jhhr
玙	jbgj
爚	jomx
珣	chgr
禤	cfwc
琇	cegy
栒	chdr
昫	chru
媭	cewy
敩	cibg
敩	cpbg
峃	cibz
讻	csjc
珛	cegr
脩	cofr
薢	cpxy
㙦	ckfo
絜	ckvc
絜	ekvc
蟏	cdsz
涍	cphn
虓	cdee
恔	cpcc
洨	cohc
鸮	cduy
禒	cqwy
玹	cigz
狝	cqac
伭	cbfz
觿	cgbu
爔	cgml
鳛	cnbi
暿	cgru
嶲	cgzk
傒	cgfh
绤	clzu
窸	cglc
咺	cbuh
咥	cluo
叚	cdkj
鳁	gqbp
鳚	gdbx
薳	ggxm
碨	gdtm
霨	gdjx
鹀	gmgy
涴	gfhk
尪	gyqg
鹟	ghiy
洈	ghhk
晫	ksrt
鳣	kobh
偡	ksft
齇	kena
啫	krur
衠	ksfh
砫	kitk
柷	kidb
柷	sidb
穜	kqmd
僎	kcfi
䓬	ksxt
叕	ksjj
椓	ksdy
棁	ksdb
䦃	kser
飐	knvu
擿	klvu
疐	kltf
榰	kgdr
稙	kgmk
锧	klef
梽	kldc
晊	klro
庤	kllx
鬒	kgsi
葴	kqxl
揕	kwvt
袗	kgww
纼	kwzj
瑱	ougi
䗪	krls
晢	kdvr
曌	kwrl
旐	kwvk
鲝	kvbj
䃎	krtc
溠	krhl
奓	krhc
挓	keva
汋	ksht
禛	kqwi
腨	tcrb
鹴	tajy
嶦	tszu
掞	tsvm
栻	tldl
䏡	tlrc
鸤	tgty
奭	tlqy
侁	tqfb
柖	trdu
棽	sqde
鳀	onbf
鞳	orxu
褟	oewc
葖	ojxa
橦	oadd
烔	oamu
峂	oazh
侂	osfa
淟	oqhi
盷	obph
沺	obho
湉	obhu
榃	oqdo
惔	oqcm
啴	oouh
倓	oqfm
瑅	ongf
俶	olfj
俶	sifj
䣘	ozbb
镋	opeb
䲢	oorj
縢	oorc
螣	oors
梼	ordx
曈	oard
朓	ozrk
晪	oqri
圢	oqoh
阘	orpc
蹜	zinr
傃	zifc
㟃	zgzu
潵	zvhg
靸	zvxe
涘	zlhh
璱	zrgi
漦	sngt
蒻	fxxh
纴	fwzf
萩	aoxm
鞧	aoxj
囷	asgm
灈	abhq
鼩	abeu
竘	asdu
坥	aeoa
棤	xxdr
䓖	avxd
棬	afdk
璆	aygw
鹙	aomy
訄	ayeu
硚	aota
蒨	auxr
蔃	aqxs
碃	aatr
鲯	anbi
磜	altc
棨	afmd
䓫	anxu
郪	agab
踦	agnu
锜	aneu
慬	ascq
袪	aewk
碶	alth
玘	afge
薸	woxc
䥽	wtej
涄	wjhk
荓	wkxu
泙	wkht
洴	wkhu
䴙	wlty
澼	wlht
搒	wovv
淜	wohr
槃	wqkd
芃	woxv
呣	pmup
婻	ysyt
砮	ycyu
耏	ybbw
耏	bjbw
峱	yraz
旻	psrc
祃	prwp
瑂	phgp
愐	pqcp
勔	pqpd
丏	pqqk
蓂	pkxi
洺	pkhu
祕	plwi
楙	pwdd
芼	pwxp
湣	pyhr
忞	psgc
洣	pfhp
剅	dthh
䁖	dxpy
橑	dodc
崚	dozg
饹	lktu
镴	drek
罍	dhov
蕗	dixu
琭	digt
菉	dixt
甪	diwj
䂮	dyvu
瑬	dyhj
鹠	dydy
罶	dzzo
珋	dzgb
镠	dyew
䴕	dphy
漻	dohw
瑓	duge
梿	dbds
悢	dwcm
鸰	dkfy
襕	dqwe
㰀	dndt
塱	dpdo
蓢	dpxr
荖	dtxi
潾	dshq
璘	dsgq
蝲	drsh
飗	dyvo
俍	dqfm
舲	dkkk
勠	dicd
箓	dikt
啰	dsuc
髎	dolw
牁	ukku
鹍	usry
墈	usod
坰	esou
秬	ehme
㛃	ekvy
珺	exgu
焌	exmg
葰	exxg
莙	esxu
鲪	esbu
槚	eadf
筥	esku
崌	eezu
砠	eeta
岨	eeza
弆	esoq
玃	eiaj
玦	eigy
冏	evqu
氿	ezhe
劼	ektd
皭	epix
斠	epqt
䴔	edgy
藠	epxi
暕	eqre
靬	exxl
鞬	exxe
鳉	embx
弶	ewlc
猄	ejac
倞	eafc
汫	eqhe
鱾	efbe
徛	elfu
罽	elzh
殣	erhq
溍	erhr
珒	evgq
䐃	evrm
鳒	exbe
璟	eqgc
漈	elhc
旵	snrz
㬚	srrg
侘	srfa
嵖	sazh
瑃	ssgr
圌	sbgb
圌	sigb
䝙	sjwc
噇	sgud
瀍	sqho
辿	sonz
镵	sqeo
佁	slfu
鲿	szbk
澂	sohg
琤	shgk
珵	sogg
珫	svgb
逴	ssnt
琡	sigj
翀	svck
痓	slio
鲘	mkbu
貆	miwh
峘	mizh
嬛	miym
郈	mkmb
橞	medc
嫭	miym
淴	mjhc
澴	mihm
荁	mixh
鹮	mizy
㸌	mxmm
濩	mxhj
佸	msfu
喤	mgug
暵	msry
蔊	msxl
鸻	mofy
龢	mdfm
鹖	mdry
隺	mrhq
垎	mrou
郃	mdfb
鞨	mdxk
淏	mwho
滉	mbhb
嵅	mqzu
硊	metk
翙	mezc
腘	lsrj
晐	larf
姤	lkyu
珪	llgo
邽	llob
瀔	lchj
唝	lzuf
祼	lcwl
毌	lckq
洸	lahb
鹒	lhly
璠	vqgo
棐	vgvd
洑	vmha
韨	vmgj
芣	vmxi
赗	vwip
崶	vhzx
沨	vhhc
棻	vqxd
榑	vmdx
茀	vmxv
陑	bjbb
祋	hewj
荙	haxh
塅	hcoj
垱	huoh
惇	hscn
䏲	hkrh
㙍	hsoj
琔	hugf
憺	hscu
疍	hskh
蹢	hnnu
踶	hlnf
䃅	hgth
媂	hlye
菂	hlxt
垈	hbfo
鱽	hubh
舠	hukh
杕	hxdh
缞	xlzm
佽	xlff
鸧	xyfy
馞	iqmn
蔈	idxc
昪	iurq
抃	iuvi
昺	iqri
欂	iqdx
糒	idpj
椑	ixdt
镈	iqex
桲	iqdn
哱	itun
砵	itti
僰	iqqf
藨	idxb
儦	idfb
熛	idmc
萹	ixxx
柈	isdi
觱	iluj
珌	ilgi
邲	ilib
坒	ilio
赑	ilif
棓	iudu
玤	iugv
栟	iqdu
枹	iudk
羓	iebi
奡	qwqq
叆	qbbj
匜	jnuj
嶅	qrqz
矞	jhku
遆	onne
憙	cftc
悆	jhfc
龂	jske
郿	phpb
肸	cgrt
鄅	jsjb
霅	krju
鳂	gxbm
邘	jbjb
醾	pnjp
襫	tlwy
襜	sowu
鹝	jlqy
讱	fwjf
翚	mlcs
敔	jsgg
郚	gmgb
裛	jlgm
瑧	kqgm
瑀	jsgj
瓖	cmgm
珸	gmgu
珕	dlgd
璥	eqgg
琎	erge
璬	ezgg
飔	zgvc
菍	ypxc
玓	hlgt
琲	idgv
墘	aboj
埼	anou
埗	iioi
扺	kfvt
扞	msvl
幖	idec
勚	jltd
禔	kgwf
穄	elmc
縠	mmtj
榖	lctj
碏	aotr
饻	cgtm
馉	lctr
饳	hxts
屃	cltf
螱	gdts
甡	tqtt
嵎	jbzh
酅	cgzb
峗	ghzk
滍	klhs
泜	kghh
涢	jhhf
沄	jhhk
潏	jhhu
浟	jthg
潩	jlhi
洢	jghj
湑	chhr
㳚	chhl
澥	cphy
浉	tghe
洓	alhy
汧	axhu
溇	dthy
澪	dkhk
浰	dlhh
浬	dfhd
㵐	eihf
澽	ehhy
浕	erhe
滘	ephu
泇	eohu
瀱	elhh
浛	mqhu
㽏	lshl
浲	vohv
汈	hdhh
浡	iqhn
昣	kgrw
昽	dari
繄	jguc
鄃	tjfb
畬	tkfo
谿	cgwu
姞	enyu
睎	cgpe
枍	jldc
椸	jndj
梠	dsdu
朸	dldd
桹	dzdm
梴	sodk
羱	jibc
闿	urpe
骉	idpp
凘	zghe
凓	dlhd
鹡	enhy
竫	eadk
耤	envr
咍	mauu
㕮	vcuc
咇	ilui
铚	kleo
钘	ckeu
铻	gmeu
艅	jbkc
镮	miem
翷	dspc
缐	cuzt
翈	cdec
熻	cgmc
烻	jsmk
䎖	nhbc
煟	gdmr
烶	oqmf
恓	cgcc
扊	jnmm
虤	jqme
馧	jsmp
穟	zemz
扅	jnmc
䅟	xnmw
馝	ilmi
鄌	ozlb
髃	jblh
靺	pfxp
鞁	idxj
靰	gixb
匼	ukuu
俙	cgfe
伋	enfe
蟫	jsst
䗴	oksf
黡	jnsb
茋	kfxh
蒱	wmxv
糵	ypxp
藦	pqxt
鹲	poxy
鄚	pwxb
蒟	esxu
蓇	ljxr
䢼	lvxb
苾	ilxi
雊	lkeq
皕	ilir
皦	ezig
艎	mgkg
皞	mwit
瑝	mggg
鹢	jlby
攽	ioig
跱	klnx
蹾	hsng
锽	mgeg
筼	jhkf
簰	wjkt
篯	exkl
鹐	axby
的	hkit
一	jgqq
了	dkkk
是	tlrf
不	iiqh
我	gjwl
在	nbqo
人	fywy
有	jdqr
这	krnc
他	oefj
来	djqy
个	lrfq
你	yffc
说	tsjb
上	tuqq
到	hwkh
就	eegj
着	kkbp
大	hrqy
们	pqfp
那	yrkb
么	pkwk
也	jrkk
地	hloj
子	nfkq
下	cyqi
出	sjkq
时	tnrx
看	uswp
要	jwcy
中	kvqq
没	phhj
然	fqwb
里	dfqq
为	gdhh
过	lxnx
自	nlwp
好	mtyn
得	hdfx
去	ahok
可	urqk
会	mefk
天	oxqh
还	mjni
心	cvhh
后	mkwu
以	jfkf
小	czkh
都	hxtb
和	mdmu
对	hejx
想	cndc
能	yoki
起	afoe
之	kghy
手	tdwk
而	bjqq
只	kfui
生	thwq
什	tyft
身	tqww
头	othh
样	judj
多	hscc
己	efkk
家	eoly
面	puqq
开	uaqq
如	fmyu
无	gmqk
现	cuge
很	mgfm
点	hqkb
前	abbh
发	vekj
经	ejzl
情	akcr
把	ivvi
老	dtti
些	chkb
话	mfju
又	jkky
意	jldc
于	jbqk
回	mbgu
笑	cpkj
所	zpwe
眼	jnpm
成	sokl
方	vygw
年	ybwq
见	euqk
当	hybq
女	yskq
真	kqti
两	dnqh
力	dlkw
气	alwk
从	xaff
用	jzwq
长	szwy
动	hzbd
间	expr
国	lsgj
走	ndof
让	fujt
被	idwj
给	lgzu
正	kwqk
问	gwpu
打	hvvh
法	vvhk
才	xjqw
行	ckfh
三	zoqb
定	half
此	xfki
进	erne
将	emhx
同	oaqu
最	nerj
本	igqq
向	cwwu
分	vqih
学	cibn
高	lugu
感	lnuc
怎	ngkc
听	ojue
边	ixnd
作	nxfk
七	agqk
其	anqi
吧	ieui
却	aoob
口	udqq
觉	eibe
啊	qeuu
因	jvgh
白	ijwr
次	xlhf
军	esls
外	gbci
门	pyhk
光	labb
风	vhec
主	kcgo
住	kifk
果	lpqy
与	jsqq
全	aifg
二	boqq
公	lvik
相	cmdp
吗	peup
等	hmkx
别	ikuh
色	zrbi
死	zfhi
张	kyls
太	obhh
日	flgq
少	ttqw
战	kskl
直	kntq
重	kzwq
王	gzqo
脸	dqrq
比	ifii
快	uocy
水	tzky
体	offi
呢	ykui
叫	epuq
西	cgqq
应	jjlq
便	iufl
放	vuvg
马	pvkq
难	yqjq
轻	ajsl
更	lwqy
美	pgbh
关	lfbo
机	egde
接	ehvy
先	cxwb
文	gygc
处	sigi
并	iabu
忘	gugc
完	gqlb
四	zlgb
飞	vxkh
师	tgqe
安	qoly
刚	lylh
跟	lqnm
月	jowb
信	crfu
山	toqq
爱	qbwj
内	ydqh
龙	daqi
空	uvll
带	hbqe
找	ktvl
原	jisc
入	fiwy
连	dbns
吃	sguj
场	spow
平	wkqt
思	zgoc
林	dsdd
使	tffd
由	jtqq
受	tkwj
亲	avdc
命	pafb
目	pigb
强	aqls
任	fwff
路	dinu
车	skqq
今	evfk
海	mrhp
活	mshu
特	oryx
解	ewby
电	huqk
性	cact
表	izqm
许	csjt
黑	mxqb
红	mazl
花	mzxi
转	kbsk
总	nqbc
算	zckq
反	vnwj
满	pnhd
物	giyg
云	jhbk
万	gsqw
至	klqo
通	ovnj
火	mphf
哥	lkqu
五	gcqq
竟	eadb
往	gpfk
量	dwhd
早	ntrt
结	ekzu
怕	wrci
流	dyhk
紧	eyqc
拉	devd
杀	tecc
半	ishq
记	elje
且	awqq
倒	htfh
书	tjkh
度	hilj
微	gxfg
喜	cftu
影	jqrw
谁	tbjq
冷	dmhk
落	dxxu
容	falu
怪	loco
提	onvf
随	zbbr
双	tajj
服	vmrj
哪	yvub
数	tipg
房	vzmv
管	lbkl
周	kxwu
百	irqi
拿	yaft
星	cjrt
系	clwc
般	iokj
必	ilhh
尔	bpbc
血	cowp
条	oogc
整	kmtk
晚	gnrp
民	pskk
帮	iyie
即	enkb
忙	pzcg
交	edgc
暗	qsrr
夫	vjqy
父	viic
冲	svhk
酒	ezhj
保	itfd
片	wuwk
报	iwvj
错	xxer
雪	cbjq
苦	ucxu
若	fxxu
收	txkg
底	hflh
华	mqft
千	axwt
消	cdhr
乐	drwh
跑	wtnk
显	cqrj
嘴	nzuj
断	hcke
求	ayqh
单	hobq
脑	ytrc
楚	scdf
沉	syhe
格	lddu
停	okfh
朝	srtr
族	nmvh
团	oigx
母	pckh
装	kahm
乱	dcak
破	wftj
呀	jeuj
院	jcbb
送	zznh
诉	zijs
围	ghgg
况	ubhb
痛	ozij
梦	pwdc
低	hgfh
持	snvx
穿	sflj
运	jxnk
热	frvb
曾	nhbr
古	lctu
旁	wzgv
怀	mvci
鬼	lzwk
取	asbj
除	smbc
考	uttk
招	kuvu
饭	vstj
朋	worr
掉	hpvt
甚	twak
争	khbk
品	wyuu
故	litg
雷	dhjo
念	yufc
护	mivm
需	cejb
类	ddph
妹	pdyg
左	npql
派	wbhm
谈	oqjm
敌	hnag
跳	opnk
约	jyzt
肯	ugkr
铁	owet
造	nwnu
号	mwuk
掌	kpbt
密	pllz
米	pfhd
简	eqkr
练	duzh
推	olvq
份	vwfh
忍	fgfc
恐	uqlc
皮	wnkj
靠	uwlv
存	xhqn
区	aeuc
买	prkh
社	trwo
挥	mlvs
胡	mmtr
散	zsxg
板	indj
怒	yiyc
苏	zjxi
料	dppt
局	ebtu
图	omgh
岁	zezc
松	zvdk
否	vdiu
恶	brjc
排	wjvv
拍	wavi
哭	ujua
府	vclx
称	shmc
仍	fofy
恩	bqgc
枪	amdk
组	ncza
叹	osuj
查	sadh
春	ssqr
草	xtxt
猛	pmap
土	octq
贵	lekf
换	mcvh
属	tctj
弄	yzgq
翻	vovc
层	xotk
喊	mnul
柔	ftkd
超	suou
科	ukmt
熟	tmgb
肉	fkyf
姑	ljyu
坏	mooi
败	ibig
狼	dzam
哦	bdul
村	xsdx
摸	ptvh
规	llve
握	gfvo
藏	xzxl
宗	nvlc
婆	wqhy
飘	wdcc
养	jpbq
普	wcbr
牛	yywq
仿	vpfv
卖	pbth
朱	kjwg
略	doou
牙	jaqw
搞	ltvu
魂	mhbk
闹	ywpe
蒙	poxy
灯	hhmh
伯	iqfi
菜	xbxd
灭	ppqm
丁	hjqk
杂	naec
彩	xrww
委	ggmy
抗	uuve
尼	ynti
控	uzvl
抽	sxvj
创	sbfh
陪	whbu
尊	nsbx
欧	rxuf
菲	vgxv
折	kdve
傻	tvfg
挑	odvk
森	zqdd
巧	azlk
碰	wwtj
软	fbsf
偏	wxfx
操	xuvd
悄	adcr
残	xqhl
困	uxgd
惨	xncw
批	wgvi
康	uyld
补	icwi
吹	sluf
仇	stfe
塞	zalo
努	ycyd
判	wshh
扎	kevk
滚	lmhm
诺	yxju
苍	xyxk
扫	ztvq
傲	qwfg
庆	aalh
拼	wvvu
嗯	bwuc
宽	ufle
遭	nunr
擦	xevc
赏	tpbf
匆	xvwh
贴	ohiu
插	seve
哎	qauc
票	wpcc
膀	iprv
瑞	fegb
损	zmvf
屁	wlti
妮	ygyi
偶	rdfh
缠	sqzd
痕	myim
劝	acjd
奴	ymyj
扔	fhvy
埋	pjod
乖	lhai
弯	gogl
丧	zutm
染	fnhd
亏	ulbk
趁	swow
脏	nyro
汤	oyhw
桑	zyjd
库	uils
踢	ogng
促	xiff
倩	aufr
瓦	gvqh
娃	gayo
涛	ouhx
砍	untf
愧	ueck
奏	nkqo
允	jmkb
租	njma
窝	gtly
凑	xkho
哇	geuo
丑	sdkq
罚	vazh
搜	zxvj
辱	fcsx
蕾	dgxo
僧	zhfr
矮	qrty
捏	yhvo
昂	qzrb
啪	weui
逆	ylnw
嚷	fpum
捧	wmvv
窜	xcls
沾	kohu
俺	qnfh
崩	ihzr
宰	nrlt
坑	uhoe
俏	apfr
噢	rtuh
倦	ecfk
蕊	fzxc
尿	yptt
伞	znft
喇	dvuh
嗽	zkuf
捆	umvd
眩	ccpz
沁	arhc
蹭	xwnr
忖	xmcx
凹	quqq
袜	grwp
瀑	wiht
攒	nnvf
癌	qjiz
肮	qyre
叟	zdwj
拗	qtvd
诶	bxjh
簪	nokr
臊	zwrd
婀	bkyu
疵	xgii
蒿	muxu
哞	pxuy
怄	rkcc
珐	vrgk
脞	xpro
醭	imjy
南	yett
哦	rful
挼	fsvy
夐	ctbg
嚄	rjuj
道	hwnp
她	oeyj
事	tlqk
知	kgtu
乙	jfkk
声	thtw
但	hsfh
明	pkrr
儿	bjwk
几	efwk
再	nbqf
种	kqmk
实	tnlh
十	tnqq
第	hlkw
神	tywt
做	nxfg
候	mkfh
部	iidb
理	dfgd
像	cwfc
何	mdfu
名	pkcu
东	hvqh
位	gdfd
望	gugg
常	szbe
者	krtr
清	ajhr
李	dfdn
变	iugj
男	yqod
该	lajf
加	eodu
远	jbnb
它	oeli
立	dlgq
金	evfq
城	sool
队	hebf
孩	mjnf
工	lvqq
始	tfyu
新	cvde
兵	ijai
离	dngh
非	vxqq
虽	zlus
似	zlff
干	lsqt
认	fwjf
失	tgwv
士	tltq
惊	ejcc
魔	pqlk
姐	ewya
乎	mjwk
件	eufy
突	ojla
斯	zgae
音	jvdr
指	kfvr
利	dlmh
步	iikw
教	eptg
越	jool
深	tqhd
告	lwwu
象	cwby
传	sifk
钱	abel
言	jqgu
每	pgwp
击	egqq
武	gckl
站	ksdu
奇	anhu
灵	dkkm
刻	urgh
题	onrf
衣	jggm
静	eaak
伤	tyfd
妈	peyp
办	isdh
化	mffi
功	lvld
绝	eizi
业	jrqq
代	hbfl
精	ejpr
弟	hlbw
终	kvzh
近	erne
青	ajqr
界	epoe
司	zgku
欢	mfjf
字	nlln
切	ahah
或	mxql
员	jiuf
根	lqdm
哈	meuu
夜	jrgy
制	klwh
友	jdqj
阿	qebu
息	cgnc
形	ckuw
阵	kwbs
南	yqtt
决	eihy
请	aqjr
各	lrgu
兴	cabi
阳	jzbr
急	enbc
语	jsju
令	dafk
及	enwy
刘	dygh
极	ende
试	tljl
备	idgo
慢	pscj
领	dqff
尽	ersh
准	kmhq
答	haku
众	kzff
视	tlwe
罗	dszc
敢	lnkg
留	dywo
克	urtb
够	lkec
官	lflq
未	gdqy
势	tlvd
句	ehwu
计	eljt
论	dxji
达	hanh
则	ndih
害	mblu
八	iewy
九	ezwk
脚	ezrb
德	hdfc
元	jibb
雨	jsqh
响	cnuu
刀	hukw
确	aotj
玉	jhgh
北	igqi
陈	sybh
市	tlge
喝	mkuk
江	emhl
章	kydt
亮	dwge
客	urlu
照	kwrb
易	jlrg
足	nmuf
依	jgfm
黄	mgxi
修	cofw
台	ojku
球	ayga
包	iuwk
义	jlhc
丝	zgzz
玩	gqgb
复	viwg
楼	dtdy
丽	dlqh
呼	mjum
摇	jrvv
期	agar
英	jjxj
帝	hlge
兄	csub
背	idir
爷	jdib
皇	mgig
六	degi
杨	jzdw
政	kwkg
居	eetu
叶	jrut
校	cpdc
谢	cpjx
细	clzo
产	sngs
睡	teps
希	cgce
速	zint
室	tllo
另	daud
露	diju
异	jlkq
写	cwlj
娘	yqym
级	enze
建	eunq
愿	jcsc
布	iiqe
续	chzh
程	somg
首	tdbp
观	lfje
务	gigd
赶	lnol
忽	mjgc
注	kihk
术	tidh
差	srbl
展	kntm
兰	dqbz
宝	itlj
香	cmmr
斗	hkht
段	hcwj
顿	hxof
角	ezbj
疑	jnif
闪	tnpf
木	pity
调	ooju
爸	irii
线	cuzl
游	jthn
激	eghg
冰	ijht
巴	iekk
您	ysfc
顾	lisf
醒	cqjt
抱	iwvk
淡	hshm
货	mxff
资	nghf
群	ahjj
集	enfd
联	dbbh
商	tygu
节	ekxb
讲	enje
赵	kwoc
病	iaii
卫	gdbq
威	gxyl
继	elzp
渐	euhe
统	oqzb
追	klnq
基	egao
选	cbnb
改	lreg
退	oenm
味	gdug
举	esbq
示	tlbc
历	dlsd
器	aluu
引	jylq
识	tnji
习	cnkh
导	htkx
莫	pfxh
志	kltc
汉	mshj
右	jkqu
严	jqqs
态	oboc
幸	caot
佛	vqfv
议	jljj
止	kftq
块	uooy
守	tdlx
毛	prwk
仅	eyfj
隐	jybc
床	sgld
股	lcrj
班	iogg
礼	dfwk
独	hmas
初	sjwh
福	vmwo
顺	txsf
狂	ugag
默	pfma
巨	ehuq
既	elkk
证	kwjk
烈	dphb
治	klhu
缓	mbzj
费	vdvf
耳	bpqq
医	jguh
寒	mqlh
温	gqhp
担	hovh
余	jbfc
钟	kvek
泪	ddhp
烟	jomh
具	ehqi
毕	ilit
警	eqxu
蓝	dqxp
吸	cgue
陆	dibe
究	eole
抓	kzvk
压	jesh
沙	teht
救	eeag
呆	haud
河	mdhu
迷	pnnp
权	aidj
孙	zsnc
卷	ebhk
毫	mrgp
察	salc
圣	twjo
较	epsc
胜	twrt
遇	jhnh
充	svgb
史	tfqy
堂	ozbo
防	vzbv
据	ehvu
骑	anpu
卡	uvti
助	kiad
京	ejgc
银	jsem
永	jqhy
屋	gjto
须	cewf
副	viqh
刺	xlqh
闻	gypb
境	eaob
禁	erdc
阴	jvbr
共	lzxi
负	vibf
虎	mcqe
逃	ornk
晓	czrb
座	nxlo
雅	jvjq
参	xokw
射	trtx
婚	msyr
险	cqbq
君	esju
坚	exqo
扬	jzvw
按	qsvy
狠	mgam
野	jrdj
秦	asqm
秘	plmi
置	klzk
仙	cxfz
模	pqdh
伸	tqft
波	ithj
假	eafj
齐	angq
舞	gcwq
脱	osrb
广	legw
麻	pald
投	otvj
顶	hqhf
致	klkg
责	ndqf
景	eqrc
营	jkxu
维	ghzq
设	trjj
啦	deud
秀	cemy
眉	phkp
州	kxhq
药	jwxt
承	soky
案	qsld
专	kfqh
偷	oxfh
画	mfqq
吴	gmuo
店	hulu
弹	oqlh
食	tnfm
欲	jhif
抬	ojvu
标	iddc
秋	aomm
良	dqhm
际	elbc
状	kbha
烦	vqmf
摆	irvk
戏	cljl
桌	ksqd
船	siku
短	hbth
某	pdld
付	vifx
演	jnhi
萧	cdxz
封	vhox
田	obgt
唐	ozlu
混	mxhi
虚	ceqj
透	okny
凌	dkhg
嘛	peud
梅	phdp
紫	nfkc
歌	lklf
临	dsqq
毒	hmqp
著	kixr
索	zptc
印	jrwb
寻	chkx
湖	mmhr
劲	erkd
职	knbi
技	elvj
恨	mwcm
杰	ekdb
羽	jscc
咱	nqun
素	ziqc
凡	vqeh
值	knfk
嘿	mxub
宁	yklh
吓	cyuc
兽	tkbu
夏	cyqg
读	hmjh
街	ehfh
胸	csrc
浪	duhm
富	vilo
尚	tubu
宇	jslj
骨	lcqr
纷	vqzh
升	thwq
叔	tjtj
善	tsbu
弱	fxlh
架	eydd
网	gpqc
骂	prup
雄	cvqq
赛	zblf
杯	ixdi
施	tgvj
墙	aqou
环	migi
罪	nezv
柳	dzdb
厅	ojsh
端	hfdb
洞	hzhu
适	tlnu
拥	jvvj
洋	jzhj
肩	exmr
洗	cfhb
借	epfr
免	pqbk
验	jspq
凤	vwej
鱼	jbbq
徐	cbfc
娜	yryb
暴	iwrt
亡	gzgk
讨	otjx
辈	idvs
懂	hqck
腿	ozrm
妙	ppyt
效	cpgg
危	gxbk
优	jxfj
盘	wqkp
套	owhk
趣	ahoj
妖	juyj
束	tiqy
诗	tgjx
迎	jknb
舍	trfu
旧	eeqr
挂	lfvo
笔	ifkp
狗	ldau
鲜	cxbj
纸	kfzt
探	osvd
韩	mqtg
珠	kjgk
归	llqq
挺	oqvf
奋	vwho
硬	jatl
避	ilnt
园	jigb
训	cxjs
勇	jqkd
聊	dobb
庄	kalo
奔	iqhm
镇	kwei
拳	aiht
采	xrwd
研	jqtu
配	wdje
冒	pwqp
虑	dhqc
敬	eaxg
丹	howq
舒	tjfj
蛋	hsks
哼	mhud
宋	zzld
济	elha
妇	viyq
箭	eukh
择	ndvq
犯	vsak
欣	cvef
甲	eaqq
课	urjl
扑	wjvi
燕	jsxb
曲	aeqq
躲	hptd
玄	cigz
幻	mczk
茶	saxc
亿	jlfj
姓	cayt
源	jihc
洛	dxhu
遍	iunx
臣	syuq
弃	algq
犹	jtaj
漂	wdhc
获	mxxa
绿	dhzt
峰	vhzv
俊	exfg
疯	vhic
妻	agqy
恋	dugc
误	gijo
拜	ibwv
伟	ggfg
移	jnmc
纳	yrzy
党	hpbb
罢	irzk
腰	jury
孤	ljnl
闭	ilpx
镜	eaeb
厚	mksn
累	ddoc
昨	nsrk
幽	jxzz
悲	ixvc
丈	kuqy
牌	wjwt
降	ewbq
劳	drxd
省	tmtp
糊	mmpr
馆	lbtl
烧	tumb
谓	gdjr
财	xjix
奈	ybhc
迹	elnj
尸	tgkw
鲁	dcbr
锋	vhev
圈	afgk
撞	kbvd
瞬	txpt
忆	jlcj
盖	lbbp
尤	jtqk
徒	omff
乡	cmkw
概	lbde
户	miht
荡	huxo
艺	jlxj
增	nhor
祖	ncwa
殿	hutj
迅	cxnt
横	modi
范	vsxk
律	dhfq
番	vowo
企	affk
限	cubm
聚	ehby
含	mqfu
凭	wkfe
剧	ehth
碎	zett
躺	optu
缘	jizy
腾	oorp
织	kgzi
抢	anvk
预	jhkf
沈	tghk
替	olvr
孔	uqnk
惑	mxmc
唯	ghuq
率	dhgt
惯	lccf
登	hhkh
互	miqq
盯	hjph
宣	cflh
唱	suur
诚	sojl
剩	twah
咬	jtuc
诸	kjjr
触	sibs
晨	syrm
策	xrky
疼	ooih
漫	pshj
材	xjdx
私	zgmk
吐	ocuo
纯	shzo
艾	qbxc
贝	idqf
谷	lciu
庭	oklf
挡	hpvh
晃	mbrb
吉	entu
仔	nffn
凝	ykhf
鼓	lctj
农	yahm
席	cnle
征	khfk
帅	toqe
缺	ayvy
亦	jlgh
杜	hido
谋	ptjd
胆	hnrh
尘	syqo
闷	pqpc
迟	snns
稳	ggmc
闲	cbpd
灰	mlqm
朵	hped
盛	twsp
晶	ejrr
餐	xoqm
爆	iwmt
娇	edya
侧	xrfh
愣	dwcv
鼻	innq
轮	dhsi
昏	mstr
抖	hdvt
敏	pypg
词	xnju
慌	macm
愤	vwcf
怜	dbck
颤	ssgf
距	ehne
川	sfwq
逼	igno
县	cuak
忧	jxcj
童	oadd
执	knvg
荣	faxd
臂	iltr
逐	kmny
戴	hbil
芒	pzxg
伴	isfi
袭	cndm
供	lvfi
积	egmi
测	xrhh
遥	jrnv
阻	ncba
例	dlfh
睁	khpk
岛	htwz
遗	jnnf
瞪	hwph
慕	pixh
皱	kkbj
博	iqtx
猜	xaar
益	jlbp
净	eahk
泽	ndhq
炼	dumh
鸡	egjy
珍	kqgw
伏	vmfa
绍	twzu
曹	xrqr
爬	waki
丫	jebq
炸	krmk
凶	cscq
郎	dzhb
宿	zilr
怨	jccc
醉	nejt
迫	wfni
革	ldxq
瞧	aopb
奥	qwwh
输	tjsh
莉	dlxh
忠	kvkc
颗	uklf
佳	eofo
旅	dsvm
仁	fyfb
鸟	yzwq
骗	wupx
浩	mwhu
塔	ovou
胖	wuri
枫	vhdc
拔	iavj
赞	nscf
炮	wwmk
凯	urze
邪	ckjb
芳	vyxv
浑	mhhs
堆	hloq
赤	sloh
旋	civf
扭	yzvs
洁	ekhu
浮	vmhn
悉	cgwc
慧	mevc
典	hqqi
评	wkjt
纵	nzzf
莲	dbxs
乌	gjwq
跃	jonj
丰	vhqq
隔	ldbq
抵	hfvh
竹	kmwh
彻	srfh
轰	mvsj
编	ixzx
肚	hiro
御	jhfb
耐	ybbx
惧	ehci
辉	mlbs
扶	vmvv
恢	mlcm
貌	pwwb
额	bdlf
述	tint
录	dikt
鹰	jjly
孟	pwnp
递	hlnh
唇	shsu
暂	nssr
伙	mpfm
琴	asge
踪	nvnc
码	pvtp
尾	ggtp
慰	gdtc
蛇	tdsi
玲	dkgk
晕	jsrs
轩	cfsl
粗	xjpa
掩	jnvh
仰	jpfb
零	dkjk
盟	porp
途	omnc
贼	nhil
洪	mahi
悟	gicu
固	ligu
讶	jrjj
冬	hvgh
滑	mqhr
甜	obal
郁	jhjb
琳	dsgd
辆	dwsd
乃	yrkw
猪	kjar
暖	ybrj
挣	kwvk
旦	hsrq
估	ljfu
坦	onoh
甘	loqq
佩	wdfe
莱	djxd
享	cngn
吼	mduu
构	lkdk
粉	vgph
萨	zrxs
吻	ggug
潜	abhr
瓶	wkbg
戒	epql
毁	mzej
销	cder
迪	hnnj
绕	fwzb
帐	kues
废	vdlj
延	jqnk
敲	adgj
烂	dsmz
曼	psrj
厌	jssa
宜	jnla
羞	cobs
吟	jsue
滴	hghu
爹	hhic
艳	jsvi
晴	akrr
抚	vcvg
缩	zszr
协	ckti
央	jyqy
悔	mzcp
肖	cpbr
脆	xerk
伍	gcfg
寂	ellj
启	afmu
薄	irxx
侯	mtfh
郭	lsgb
鸣	pkuy
倾	ajff
彼	iffj
撒	zvvg
检	eqdq
针	kqet
耀	jwbq
痴	sgiu
姆	pcyp
篇	wxkx
椅	jfdu
厂	spqw
董	hqxk
熊	cvkb
狐	mmal
蒋	enxx
隆	dabt
括	uxvu
潮	srhr
唉	qbuh
穷	avld
聪	xvbc
唤	mcuh
泰	obqt
版	inwj
末	pfqy
焦	edfb
猫	puao
盗	hwhp
侍	tlfx
挤	efva
款	ubtf
拾	tnvu
荒	maxk
域	jhol
搭	hevu
脉	pbrj
授	tkvj
俗	zmfu
融	faqs
狱	jhaa
访	vpjv
桥	aoda
锁	zpef
霸	irjr
牵	axhy
池	snhj
钻	nfeu
港	lphk
喃	yqut
乘	soay
玛	pvgp
奉	vwqq
扯	srvk
岳	joaz
减	eqhl
夹	eoqy
辞	xnat
岸	qszl
岂	afze
屈	aets
恼	ytcc
哲	kdvu
季	elmn
召	kwhu
恭	lvxh
载	nbsl
瘦	tkij
皆	ehii
颇	wtwf
肃	zikh
爽	teqy
吞	osou
惹	frxc
哀	qagm
乔	aojq
铺	wjev
吕	dsuu
奖	enhh
倍	idfu
婷	okyh
牢	drly
扰	ftvj
溜	doho
庞	wzli
臭	skna
悦	jocb
赫	mros
赢	jkgv
跪	lenk
麦	pbqg
枝	kgdj
侠	cdfe
泉	aiit
劫	ekod
炎	jqmm
泥	ynhi
赌	hcir
弓	lvkk
魏	gdmk
罩	kwzt
疾	enih
符	vmkx
垂	sbwq
映	jarj
漠	pfhh
脖	iqrn
饮	jytf
懒	dncf
肤	vjrv
燃	fqmb
祝	kiwb
赖	dbtf
宾	ivli
贾	eacf
喘	sbub
焰	jsme
吵	stut
冥	pkli
鞋	ckxo
逸	jlno
均	esoh
裤	uiws
碗	gntk
航	mzke
姨	jnyj
酸	zfjg
啸	cpuz
阁	ldpu
舌	tdau
冯	vohp
邦	iyqb
钢	lyec
霞	cdjj
泡	wwhk
盾	hxwp
碧	ilgu
援	jivj
忌	elec
抹	pjvp
锐	feeb
喷	wquf
拦	dqvz
嘉	eotu
殊	tjhk
辰	sysm
繁	vqpc
络	dxzu
抛	wuvd
嫁	eyye
咒	kkue
键	euee
恰	aycu
虫	sakh
审	tglt
献	cuta
媚	pdyp
贤	cbqf
葛	lrxk
刹	tech
袁	jiom
摔	thvt
序	chlj
筑	kikv
斜	ckft
涂	omhc
湾	gohl
莎	text
崇	sazc
猎	dpar
梯	ogdh
桃	ordk
豆	hkqq
浅	aqhl
饿	brtl
疲	wnij
搬	iovj
瓜	lzwy
润	fxhg
铃	dkek
蛮	pqgs
蒂	hlxe
拨	itvj
予	jskk
勾	lxwk
惠	meqc
析	cgde
撑	shvt
截	ekql
措	xxvr
币	ilwe
薇	gxxg
督	hjtp
酷	uiju
祥	cqwj
怖	iice
侵	avfj
岩	jqzu
扮	isvh
糟	nupr
盈	jkyp
腹	virg
斩	knse
尺	sfty
签	axkq
稀	cgme
掏	ouvv
夸	uzhu
汽	alha
液	jrhj
姬	egyq
汇	mehu
柱	kidk
粮	dqpm
堡	itfo
仗	kufk
笨	iwki
歉	aubf
甩	tjwk
怔	khck
竞	eadb
祸	mxwy
耶	jkbb
爵	eiwx
诱	jkjy
呜	gjug
穴	cili
黎	dnmt
培	whou
砸	nate
井	eqqq
弥	pnlc
返	vnnj
匹	wfub
啥	tauu
奸	exyl
陌	pfbr
叛	wshj
核	mddf
卧	gfui
幅	vmeo
眨	kvpv
耗	mwvp
洒	zvhc
怡	jncu
卢	dmqt
扣	ukvu
孝	cptn
矛	prkw
氛	vqah
衡	mofh
陶	orbv
购	lkik
汪	gyhg
僵	emfq
疗	doid
妃	vxye
棋	andi
缝	vwzv
咐	viux
泛	vshv
愁	stmc
慈	xnbc
肥	vhri
笼	daki
篮	dqkp
惟	ghcq
柜	lede
捉	ksvf
悬	ciac
霍	mxjq
泄	cpht
咽	jouh
齿	sfkq
秒	pzmt
勤	asxd
屏	wktu
霜	tajp
袍	wrwk
蝶	hksd
祭	elwc
厨	smsx
胁	ckri
劈	wgth
赚	kcie
锦	eyee
尬	lrqe
寺	zlox
贺	mrdf
巾	evqq
描	povo
捕	icvv
陵	dkbg
咳	uduf
扇	tsmc
虹	masl
绵	pbze
撕	zgve
蔡	xbxc
催	xlfq
彭	wotw
宠	sqli
贪	ooff
寸	xxqh
披	wgvj
搂	ddvy
饶	frtb
跌	hhnt
肌	egre
售	tkfu
巡	chnk
抑	jlvb
纹	gyzc
宏	malk
幼	jkzd
萍	wkxt
驻	kipk
丛	xafq
仪	jnfj
俄	bdfl
刃	fwhh
挨	qavh
迈	pbng
违	ghng
辩	iudt
埃	qaoh
艘	zxkj
灾	nalm
渡	hihj
卑	ixwt
雕	hdkq
鼠	tcek
辣	drdt
刷	tzth
艰	exjm
斥	slwh
裙	ahwu
翠	xect
饱	ittk
掠	dovc
询	chjr
赐	xlig
闯	sepp
姚	jryk
瑟	zrgi
渴	urhk
谅	dwjc
串	scqq
沟	lxhk
涉	trhi
咕	ljuu
驶	tfpt
摄	trvj
贫	wsif
辕	jism
婉	gnyk
鹏	wory
姜	emby
碍	qbtx
荷	mrxu
冠	lclx
玫	phgg
裁	xjml
坡	wtoj
邓	hwjb
歪	gaik
乏	vawk
申	tqqq
巫	gjqq
衫	toww
阔	uxpu
韦	ghqq
恍	mecb
贯	lckf
魄	wfik
柄	iqdi
患	mcsc
覆	vicg
蜜	plls
婴	jjiy
锅	lsey
陛	ilbo
遮	kknb
帕	wrei
咖	ueuu
嫌	cbye
胳	lkru
挖	gevj
凄	aghy
爪	kfwy
眠	pbpp
穆	pimw
啡	vxuv
吾	gmgu
坛	oqok
脾	wnrt
恒	moch
屠	omtr
玻	itgj
础	scts
曰	jygq
耸	zqfb
寿	tkqx
驱	aepc
猴	mtah
佣	jvfj
毅	jldj
舅	eeed
铜	oaeu
娟	efyr
眯	pgpp
淫	jshf
吩	vquh
匪	vguv
牧	piyg
诡	lzjk
纤	cxza
腐	vclf
姻	jvyh
晰	cgre
渊	jfhq
亭	okgh
邀	jung
哄	mqui
骚	zups
棵	ukdl
筋	evkd
崔	xlzq
灿	xsmz
捷	ekvf
淋	dshd
辑	ensb
棍	lxdi
绳	tozh
频	wskf
廊	dzlb
畏	gdom
歇	chrf
裹	lpgm
苗	poxo
盼	wsph
咯	uvuu
耍	tfby
煞	trbb
寝	aylj
添	oxhh
嫂	ztyj
纠	eozq
慨	urce
驰	snpj
拐	ljvd
津	evhq
岚	dqzc
浴	jhhu
耻	sfbk
挽	gnvp
誉	jhbu
牲	thyt
乳	fcwk
仓	xyfk
喉	mtuh
逛	lbng
樱	jjdy
兼	exby
戈	lkqh
涯	jaho
铭	pkeu
障	kubt
摊	oovy
跨	ufnu
妥	opwy
晋	erjr
寞	pflh
寨	kblc
污	gjhu
嘲	srur
吊	hpue
乾	abtj
馨	cvtr
嗓	zpud
呈	soug
卿	ajwb
楠	yqdt
籍	enkr
裸	dpwl
链	dues
灌	lchq
昆	usri
畅	sutw
逍	cdnr
帽	pwep
阅	jopb
逗	hknh
蹲	hsnx
踩	xrnd
哑	jvuj
趴	weni
逢	vonv
植	kndk
媒	phyd
韵	jxdh
昭	kuru
尹	jykw
谦	axje
档	hudh
趟	ouou
兔	oibh
订	hajh
朴	wcdi
瞎	copu
鞭	ixxl
斤	evwq
翅	sltc
肠	szrw
慎	twci
盆	wyip
迁	axna
镖	idec
芬	vqxh
崖	jazo
丘	aowq
庙	pplj
潘	woho
颖	jqif
拓	oxvu
娶	asby
纱	tezt
谨	eyjq
珊	togx
仆	wmfi
宙	kklj
叮	hjuh
捂	gcvu
涩	zrhk
诧	srja
柴	sjkd
杆	lodl
坠	kebo
赔	whiu
涨	kphs
薛	cyxt
藤	ooxt
税	temb
枯	ujdu
帘	dble
糖	ozpu
愉	jbch
骄	edpa
糕	lupb
彬	ivdw
愚	jbqc
疏	tjkk
堵	hcor
腕	gsrk
眸	ptpy
芸	jhxk
溪	cghh
殷	jvwj
谎	mejm
鼎	hqpk
稿	ltmu
冤	jflo
症	kwik
狄	hnam
咧	dwuh
湘	cmhp
宛	gnlk
嫩	ywyg
肆	zlsq
憾	mscc
偿	szfk
腔	amrl
哩	dgud
豹	iwwt
瑰	llgk
鉴	euqe
绑	ipzb
潇	cdhz
戚	agcl
澡	nthd
兮	cgik
雯	gyjc
颠	hxtf
狮	tgae
邻	dsfb
契	alvh
骇	mbpf
卜	icqh
伐	vafl
矩	este
烁	txmd
葬	nuxq
诀	eijy
鄙	ifub
鹿	dili
柏	irdi
溃	uehf
舟	kxwh
妆	kahy
躁	nwnd
霉	phjp
侦	kqff
庸	jvlq
筹	stkx
削	cdbh
砰	whtt
耿	lmbm
牺	cgyc
筒	oqku
遂	zenh
旭	cher
胎	oaru
惶	mgcg
叉	sejh
痒	jpij
龟	llbk
儒	fmfb
嫣	joyb
宅	kjla
押	jeve
旨	kfir
浸	erhj
弦	cblz
栏	dqdz
衷	kvgm
刮	lzah
岗	lpzc
赴	vioi
囊	yzqm
斧	vcie
颊	edef
疆	emlq
炉	dmmm
塌	oeoc
乞	afwj
旺	gurg
烤	utmu
贱	euil
狸	dnad
叙	chfj
愕	brcu
叠	hkja
遣	aqnq
晌	tpru
麟	dslq
腥	cjrt
粒	dlpd
拟	yfvf
杖	kudk
芝	kgxk
夷	jnqy
衬	swwx
佐	npfl
巷	cwxk
捡	eqvq
遵	nsnx
塑	zibo
桶	oqdj
泼	wthj
滩	oohy
琼	avgc
昊	mwro
帆	voev
搏	iqvx
颈	eqkf
蹦	iwnr
贞	kqqf
凰	mgeg
哨	twur
拆	savs
茹	fmxu
劣	dptd
嘱	kcuj
沃	gfhj
厢	cmsp
摘	kavu
咋	keuk
坤	usot
俯	vcfx
媳	cnyc
赋	viil
嘶	zgue
贡	lzlf
碌	ditt
匙	snri
谭	oqjt
翁	ghic
辜	ljtt
辅	vcsv
讽	vmjc
呐	yruy
斌	ivgl
辽	dond
窃	aplh
抄	suvt
妒	hiym
吁	jhuj
嗦	zsuc
掀	cxvf
芙	vmxv
祈	anwe
栋	hzdh
吱	kguj
撇	wwvg
胞	iurk
禅	sqwh
妨	vzyv
衰	thgm
挪	ysvb
蓬	woxv
惩	sofc
垃	deod
账	kuis
驳	iqpc
署	tczr
甫	vcqh
顽	gqbf
姥	dtyi
圾	egoe
熬	qrqb
丐	lbqk
茜	auxc
咦	jnuj
厕	xrsh
攀	wodt
彤	oahw
妍	jqyu
拽	kovj
荆	ejxh
妓	elyj
壶	mmtj
於	jbvh
鹤	mrhy
钥	joer
骤	kkpe
渺	pzht
刊	uolh
肢	kgrj
烛	kmms
孕	jxyn
绽	kszf
彦	jsgw
棉	pbde
盔	ulmp
剪	eqbh
诞	hsjk
凛	dyhc
嚣	cduu
笛	hnkj
舱	xykk
罕	mnll
鸭	jeey
债	kbff
噬	tlug
钉	hjeh
躬	lvtl
倚	jffu
咚	hvuh
撼	msvc
佑	jkfu
隶	dlky
拱	lqvi
沐	pihd
菊	ebxp
蜂	vhsv
裕	jhwu
搅	ezve
黯	qsmr
歹	hrqc
蓄	chxo
嘀	hnuu
怯	apck
叨	huuh
纽	yzzs
聘	wrbk
腻	ylrl
彪	idmw
沸	vdhv
氓	pzgp
榜	ipdv
逻	dsnc
壳	udte
储	scfr
憋	ihic
啤	wnut
匠	ewue
昧	pdrg
篷	wokv
烫	ouhm
狡	ezac
轨	lzse
汹	cshc
携	ckvy
磊	dgtu
隙	clbc
摧	xlvq
瞄	popo
胧	dari
趋	aeoq
挠	yrvb
煌	mgmg
擅	tsvh
卒	nmgt
狭	cdae
丸	gqwh
瞅	sdpm
楞	dodv
昔	cgxr
裳	tybm
骆	dxpu
雇	limq
阎	jqpe
骷	ujlu
鸦	jejy
妞	yoys
焚	vydm
谱	wcjr
绘	mezk
梳	tjdk
肿	kqrk
魁	ublt
耽	hobk
擒	asvd
陡	hdbf
璋	kygt
茂	pwxl
蹄	onne
瞳	oapd
髅	dtly
绣	cezy
硕	txtf
肺	vdrq
兹	ngbz
邮	jtjb
嫉	enyh
娱	jbyo
喧	cfuh
沧	xyhk
疚	eeie
盐	jqop
扁	iqmx
搁	lkvu
茅	prxp
坟	vyoc
掐	aove
瑜	jbgh
邱	aoab
茵	jvxh
旷	ubrl
郝	mtob
诈	krjk
粹	xept
琢	ksgy
腊	drrr
钦	avef
宪	culb
锻	hcej
睹	hcpr
郊	edgb
饥	egte
侃	unfk
粘	kopu
媛	jiyj
恳	ugkc
厮	zgse
锤	sbes
淮	mvhq
蔽	ilxg
聂	ypbj
贩	vsij
潭	oqht
翩	wxmc
呻	tqut
枉	gpdg
拘	eevu
煮	kctb
焉	jokb
址	kfok
匕	ifwk
渗	twhw
览	dnqe
敦	hsgg
厦	cysg
蕴	jxxp
冉	fnqq
薪	cvxe
呃	bruk
峻	exzg
荐	euxn
栽	nadl
嚎	mrum
汁	kght
傍	iufv
秃	ojme
磕	uktp
禀	iqgc
珑	dagi
坎	unof
窄	krlk
阮	fbbb
蹈	htne
碑	ixtt
婶	tgyt
煤	phmd
寓	jhlh
倘	opfu
杭	mzde
暇	cdrj
狈	idaf
峡	cdze
芦	dmxm
蔓	psxj
蒸	khxb
禄	diwt
醋	xijr
淌	ophu
姊	nfyw
钩	lxek
妾	apdy
嘎	leul
蝴	mmsr
萝	dsxc
莽	ppxq
弩	ycyl
稚	klmq
徽	mlfg
衙	jafh
咸	cbul
奢	tkhr
罐	lcvq
汝	fchy
敞	spbg
嘘	ceuj
灼	ksmt
姗	toyx
倪	ynfb
咪	pgup
钧	eseh
捣	htvz
燥	nwmd
眶	ubpg
焕	mcmh
酬	stjk
筷	uoku
宵	cdlr
缚	vizx
揪	eovm
蚁	jfsj
丞	sodq
拎	dvvk
梭	zsdg
哧	sgus
棺	lfdl
肝	lorl
剂	elgh
疤	ieii
渔	jbhj
嗔	squi
沮	esha
廖	dplw
虏	dcqd
皓	mwiu
恕	tiyc
虐	yoqq
综	nvzc
瘾	jyic
驴	dbpm
晒	tbrc
卦	lfoi
迦	eonu
陀	osbi
窥	ulle
堕	hxbo
哆	hsuc
葡	wmxv
帖	oheu
垫	huvo
屡	dsty
鹅	bdgy
蛛	kjsk
碟	hktd
狞	ykah
诊	kgjw
揽	dnve
裴	whvm
捞	duvd
铮	khek
萄	orxv
盏	knlp
霆	okjf
喔	gtuo
勿	giww
吭	uhue
淘	orhv
淹	johh
麒	anli
喽	dxuy
栗	dlcd
绷	ihzr
惚	mjcc
桓	midh
坊	vzov
桩	kado
璐	digu
巢	srkl
畜	chgo
兀	giqb
樊	vqdh
锡	cgeg
僻	wlft
絮	chyc
杏	cadu
啧	nduf
磁	xntz
冈	lyqc
逮	hrnd
搓	xsvl
赠	nwir
胶	edrc
脊	efhr
噩	brqq
绰	sxzt
呕	rduc
嚼	eoux
歼	exha
殖	knhk
拧	yqvh
霖	dsjd
驼	ospi
襄	cmgm
惕	olcg
掷	klvb
炽	slmi
惭	xqce
框	ubdg
蝉	sqsh
谜	pnjp
炫	ccmz
塘	ozou
膜	pqrh
亨	mhgd
蚂	pvsp
猩	cjat
滨	ivhi
跋	ianj
藩	voxo
舔	oqah
歧	ankj
隋	zbbr
甄	kqcg
蜡	drsr
缸	lyvl
豁	mxlu
垒	dgko
掘	eivs
屎	tftp
乍	krwq
孽	ypxn
毯	onpm
弧	mmll
槐	mvdk
铠	uree
纲	lyzc
矢	tfwo
扛	uzvl
朽	czdk
匈	cswc
扒	ievi
雍	jvgq
闺	llpo
霓	ynjb
斋	kagb
夭	juwh
沦	dhhi
揍	nkvo
瞟	wzpc
漪	jghu
暑	tcrr
鳞	dsbq
瓷	xnhg
萱	cfxh
株	kjdk
倭	gtfy
鞘	apxr
噜	djur
绞	ezzc
颓	obmf
睿	feqp
噗	wjuy
幢	sged
诅	ncja
涕	olhh
叽	egue
葱	xvxc
婢	ilyt
铸	kiex
剿	ezsh
畔	wsoi
粥	kxll
奎	ubho
绸	stzu
茨	xnxf
岔	sriz
叭	ieui
咆	wruk
梧	gmdu
垮	ufou
澳	qwhh
浙	krhe
甸	huwo
绯	vxzv
鲍	iwbk
厥	eisf
蚊	gysc
鞠	eexp
茗	pkxu
眷	echp
戮	dicl
骏	expg
踹	sonb
漓	dnhd
蝇	jksh
涡	gthy
沌	hxho
凸	ojqq
蚩	sgks
酿	ywjm
唾	oxus
琐	zpgf
犀	cgty
澄	sohh
哉	naul
猾	mqar
窒	kllo
虾	cosc
蝠	vmso
钞	suet
觑	aece
哽	lmul
娥	bdyl
讪	tsjz
耕	lhve
葫	mmxr
暧	qbrj
浇	edhb
嗨	maup
诵	zzjj
疫	jlij
兢	ejtb
箫	cdkz
颅	dmdf
啼	onue
绅	tqzt
杉	todw
券	achh
遁	hxnp
炯	evmu
彷	wzfv
觅	plwe
抿	pyvp
剔	ogrh
稻	hwme
敷	vjvg
怠	hbkc
龚	lvdi
绒	fazl
勺	trwh
函	mqdq
颂	zzif
搀	sovh
擎	akxt
巍	gxzk
脯	vcrv
镶	cmem
寥	dolw
漾	juhj
藉	epxr
逞	smng
膏	lugr
戳	sscl
呛	awuk
叩	ukub
禽	asfd
懊	qwch
懈	cpcy
蛟	edsc
亢	uuge
呸	wxuq
芊	axxa
慑	trcj
跄	awnk
蚀	tnts
栖	agdc
蔚	gdxx
铲	snes
坪	wkot
筝	khkk
顷	aqif
腮	zarc
踉	dwnm
狰	khak
嗖	zxuj
苑	jcxk
秉	iqwy
猿	jiam
堤	hgof
佟	oafh
悯	pycc
唠	drud
憨	molc
肘	kdrx
拇	pcvp
僚	dofc
霹	wgjt
婕	ekyf
禹	jswh
啃	ugur
晖	mlrs
怅	sucs
聋	dadb
拯	kmvs
忿	vwic
韧	fwgf
邹	nxbb
梢	tudr
肋	ddrd
窘	evlu
嵌	auzf
辖	cdsu
浦	wchv
炭	oszm
簇	xikh
螺	dssc
酱	ewhj
屯	ohqk
匡	uaug
冀	elii
陕	tnbe
筱	czkg
叱	slui
淳	shhn
詹	kobu
菱	dkxg
芷	kfxk
惺	cjct
浊	kshs
囔	yyum
朔	txbr
憔	aocb
睫	ekpf
睬	xrpd
鸽	lkfy
臀	ohtr
笙	thkt
戟	eftl
沼	kthu
昕	cvre
蛊	lcsp
煜	jhmd
祀	zlwk
伶	dkfk
荫	jrxr
酥	zjjm
懦	yxcb
厄	brsk
峨	bdzl
轴	ktsj
雳	dljd
卵	dbwh
捶	sbvs
檐	jqdu
棘	enqy
钗	saes
妩	gcyg
炕	uume
偎	gxfm
窦	hklh
蝎	chsk
溶	fahu
幺	jukk
缉	egzb
徊	mvfu
呗	ixuf
衅	crci
砂	tett
舵	hxki
昼	kksh
斟	kqtt
舆	jbwi
椒	eddj
靓	ewae
旬	chwr
厘	dnsd
窑	jrlv
萎	ggxy
涟	dbhs
瘩	haiu
梵	vsdv
侥	ezfb
匿	yluu
镯	kses
徘	wjfv
芽	jaxj
嗷	qrug
庐	dmlm
禾	mday
绊	iszi
蜘	kgsu
憎	nhcr
褚	scwr
嚓	xeuc
珂	ukgu
崽	nrzc
贬	iqiv
惮	hsch
婵	sqyh
嗒	oruu
悸	elcn
晦	merp
涅	ypho
恬	obcu
慷	uycd
渣	kehh
屉	oltt
缭	dozc
绢	eczr
黝	jdmd
赦	trog
悻	cact
祟	zesc
蛙	geso
嵩	zvzu
唰	tzuh
咏	jquj
凿	nrjq
粪	vwpi
噪	nwud
菌	esxm
蝙	ixsx
庶	tilb
邸	hftb
禧	cfwu
旱	msrl
虔	abqc
琛	sqgd
榴	dydo
漱	tihf
忑	orcc
忐	ontc
谬	pejw
蟒	ppsp
钝	hxeo
悚	zqct
廓	uxlb
惘	gpcg
漉	dihi
佬	dtfi
赎	tmih
壤	fpom
忡	svck
倡	sufr
姝	tjyk
竿	lokl
蜷	aisk
嘈	xrur
蚕	xqos
剖	wxdh
颁	ioif
缀	kezj
汀	ojhh
斐	vgvc
懵	pmcp
缪	ppzw
蔷	aqxu
诫	epjl
恤	chcc
馒	pqtj
矫	ezta
橘	ebdu
氧	jpaj
贿	meir
瑾	eygq
烙	dwmu
攘	fpvm
攥	ncvc
汰	obho
溺	ylhh
铅	axeu
芭	iexi
戎	fawl
褐	mrwk
巩	lqlv
吆	juuz
漩	cihf
蒜	zcxc
棕	nvdc
鹃	efuy
帜	klei
搐	sivo
蔼	qrxk
怦	whct
穗	zemc
亩	pcgo
撰	kcvi
绎	jlzq
牟	ptky
梓	nfdt
绚	cczr
阀	vapl
烘	mvmi
惋	gnck
驯	cxps
栩	csdc
墟	ceoj
鬟	mism
褪	oewm
鑫	cvfe
骸	mjlf
峭	apzr
缅	pqzp
洽	ayhu
祯	kqwf
暄	cfrh
韶	trdu
缎	hczj
砚	jste
辙	kdsg
惦	hucu
铛	sheh
枣	ntqh
桦	mfdt
橱	smdx
搔	zuvs
遏	brnk
憬	eqcc
庵	qolh
叼	hduh
嫖	woyc
苛	ukxu
锣	dsec
蹑	ypnj
奠	hubh
秽	memc
殴	rxuj
喋	hkud
糙	xupu
貂	hdwu
揖	jgvb
葵	ubxo
榆	jbdh
眈	hopk
扼	brvk
眺	oppk
孜	ngng
玺	cfbj
偌	fxfu
蹿	xfns
蓓	idxu
弛	snlj
庇	illi
枭	cdwd
螂	dzsb
趾	kfnk
崭	knze
妲	hayh
掂	hxvu
醇	shjn
驿	jlpq
槽	xrdr
镰	dbee
删	toxh
鸳	jfcy
酣	mojl
宦	mcls
筐	uakg
琅	dzgm
湃	wbhv
跷	adnb
栅	krdx
撅	eyvf
煽	tomc
呱	lzul
缰	emzq
猝	xiat
衮	lmgm
肴	jrcr
殆	hbhu
蔬	tjxt
飒	zrdc
婧	eayr
侈	sffc
霏	vxjv
瘟	gqip
芜	gmxg
俭	eqfq
崎	anzu
亥	mbgf
屿	jszj
譬	wltu
畴	stox
杠	ludl
鬓	irsi
鞍	qoxy
钮	yzes
珏	eigj
钰	jhej
傀	uzfk
噔	hhuh
驭	jhpj
靶	ivxi
韬	ouge
恙	jubc
懿	jltc
竺	kmkb
吝	drgu
癫	hxif
嘭	whuw
菇	ljxu
恃	tlcx
瘪	iwii
儡	dgfo
踌	stnx
呦	jxud
榕	fadu
烬	erme
酌	ksjt
丙	iqqy
涎	cbhk
哒	heuh
砌	alth
烨	jrmt
翟	kjcq
噎	jkuh
驹	eepu
噼	wgut
咎	eegu
陨	jmbf
蠕	fmsb
冕	pqqp
雌	xnkq
瑛	jjgj
剃	olbh
掰	iawt
蹙	xicf
橡	cwdc
佯	jzfj
笃	hckp
勘	uotd
稼	eyme
桀	ekcd
锈	ceey
磅	iutv
娄	dtpy
玑	egge
祠	xnwu
娲	geyy
黏	ybmu
珀	wfgi
栓	tfdg
绫	dkzg
邑	jlui
瑕	cdgj
磋	xstl
粟	zicp
薯	tcxr
讷	yrjy
岑	xyze
玮	gggg
娼	syyr
迂	jenj
伎	elfj
鲸	ejbc
坝	irof
铐	uweu
洼	geho
肾	twqr
鸯	jyjy
敝	ilhg
崆	uvzl
扈	mimi
哝	yaum
芮	fexy
卉	metq
靳	erxe
诬	gjjg
婊	izym
裘	ayam
扉	vxmv
疮	saik
巅	hxzf
坞	giog
膳	tsru
剌	drth
鳄	brbu
悼	hwct
毋	gmkq
簸	ijkj
拴	tfvg
嬷	pqyp
稣	zjbm
谏	euje
羹	lhbh
沥	dlhd
蛾	bdsl
瑚	mmgr
熔	famu
惆	stcu
雏	smbq
饷	cntu
燎	domc
熠	jlmi
薰	csxb
籁	dbkf
髦	prsp
迢	oonu
闸	kape
狩	tkax
蜥	cgse
惴	kecb
胯	ufru
侨	aofa
烹	whgb
咣	laub
锄	smed
硝	cdtr
颔	msff
寰	milm
蕉	edxb
蟆	pash
垢	lkou
楷	urdi
忻	cvce
腆	oqri
酋	aybj
赃	nyio
拈	yxvu
抒	tjvj
孰	tmgg
袄	qtwj
褂	lfwi
孺	fmnb
胭	jorh
赘	keqf
嫡	hnyu
礁	edtb
珉	psgp
啜	sxuj
晾	dwrc
隧	zebz
窿	dalt
骋	smpk
嫦	szye
槛	eudp
掳	dcvd
莞	lbxb
瓢	wocl
曜	jwrq
锯	eheu
猖	syar
飕	zxvj
麾	mllp
渍	nlhf
猥	ggam
篝	lxkf
殉	cxhr
蜒	jqsk
皎	ezic
诩	csjc
窖	eplu
咫	kfsi
檬	podp
乒	wjaw
淤	jehh
溯	zihr
凋	hdhu
纺	vpzv
篱	dnkd
泌	plhi
刨	wrih
盎	qujp
咀	esua
挎	ufvu
羔	lubb
殃	jyhj
庚	lhly
淼	pztt
淀	huhf
隘	qbbp
绛	ewzq
缨	jjzy
焘	hwtb
璨	xsgp
跤	ednc
锵	amex
摁	bwvc
嫔	wsyi
臻	kqkm
泯	pyhp
睦	pipo
喵	pduo
缥	wdzc
褥	fiwx
魇	jnsk
汶	gwhc
馋	sqth
渎	hmhh
蜿	gosk
墩	hsog
棣	hldd
沓	ortr
喏	fruu
琶	wagi
缈	pzzt
缔	hlze
酝	jxjk
耷	hehb
拷	utvu
柿	tlde
琵	wngi
蕙	mexc
柠	ykdh
饵	bptb
撂	dpvu
娓	ggyp
乓	wyah
轲	uksu
髯	fqsf
娉	wjyk
圭	lloo
璀	xzgq
苔	ojxu
肪	vzrv
吮	tmub
瞩	kcpj
啄	ksuy
帷	gheq
箍	ljke
蟑	kyst
炖	hxmo
梗	lmdl
捎	tuvr
瞿	abpq
蘑	pqxu
鹊	aoxy
羌	ambk
骼	ldlu
筛	take
鲤	dfbd
羲	cgbl
馈	uetf
伫	kifq
苞	iuxk
铎	hseq
啬	zrtu
舷	cbkz
矗	sitk
匾	iqux
硷	eqtq
谧	pljp
瀛	jkhv
珞	dxgu
衲	yrwy
纬	ggzg
惰	hxcr
嘤	jjuy
谛	hlje
藻	ntxd
啷	dyub
佘	tdfc
黠	cdmu
饲	zltu
虬	aysk
涤	hnhc
骡	dspc
钵	itei
笋	zmkj
舜	txwq
龌	gfko
痰	oqim
蹂	ftnd
恻	xrch
簧	mgki
缤	ivzi
潺	sqhn
獠	doac
筏	vakl
锭	haef
粤	jowk
瞌	ukpp
髻	elsu
琏	dqgs
龊	sxkf
椎	kldq
嵋	phzp
碳	ostm
鸨	itiy
躏	drnd
蜓	oksf
咻	coud
睨	ylpb
鼾	monl
娆	fryb
蜻	ajsr
徨	mgfg
谑	cojy
嚏	oluf
倜	olfu
篡	xckk
晤	giru
肇	kwmq
咂	neue
帚	kdke
瘤	dyio
瞠	shpo
嚅	fmub
怆	sbck
镔	ivei
裆	hywh
腺	curt
骁	cdpb
坷	urou
箐	ejkr
螃	wzsv
冢	kqly
锢	lieu
晁	srrk
蝗	mgsg
烽	vhmv
辘	disi
莘	tqxt
撬	apvp
瓮	gwig
亘	lwqh
篓	ddky
缇	onzf
宸	sylm
鞑	haxh
胄	kkjr
绥	zbzy
笺	exkl
荤	msxs
迄	alnj
慵	jvcj
噤	eruc
幌	meeb
荻	hnxm
跚	tonx
袒	onwh
浣	mchb
榄	dnde
痪	mcih
荼	omxc
晗	mqru
腋	jrrj
骰	otlj
涮	tchh
踵	kqnk
炬	ehme
皑	qjie
瞑	pkpi
渲	cchh
擞	zdvg
赂	diiu
麓	didi
铿	uheo
埔	wcov
噘	eyuf
莓	phxp
怏	jucj
萃	xext
呲	ngui
蹒	wqnd
昱	jhrd
旌	ejvt
摞	dxvc
吠	vdua
濮	wmhy
琬	gngk
谙	qojr
轶	jlst
搪	ozvu
纨	gqzg
皋	luit
霭	qrjk
橄	lndg
嗫	ypuj
踝	mvnl
臧	nysl
璞	wmgy
秧	jymj
翱	qric
逅	mknu
靥	jrsp
壑	mrqo
琰	jngm
叁	zokz
佗	osfi
阖	mdpp
戬	eqjl
垠	jsom
迥	evnu
咛	ykuh
邂	cpny
杞	afde
痘	hkih
藕	rdxh
湄	phhp
媲	wlyi
癞	dbif
砾	dltd
痉	eail
蜕	oesb
椰	jkdb
仨	zefz
纣	kkzx
馁	ygty
镐	lteu
蜈	gmso
窈	jtld
秤	swmt
桢	kqdf
悖	idcn
渭	gdhr
汴	iuhi
桅	ghdk
卯	ptwb
骜	qwqp
琥	mcge
阚	uspg
杵	scdt
坍	oooh
俑	jqfj
侏	kjfk
挲	zsht
覃	oqct
硫	dytk
俸	vwfv
蟠	wqso
弋	jlqh
梆	iydb
驸	vipx
忱	syck
胥	cekr
邬	gjgb
圃	wcgv
徙	cfff
舫	vpkv
嗝	lduq
赣	lsdf
逵	ubno
揩	uavi
霾	pjjd
蔫	yxxb
跛	ijnj
脐	anra
糗	azpa
螳	ozso
哺	icuv
鹭	diny
蚣	lvsk
炀	jzmw
恸	ozcd
隽	ecfy
籽	nfpn
剐	lfuh
鸠	eoey
谄	snje
巳	zlkk
猬	gdar
溟	pkhi
丕	wgiq
峒	hzzu
旖	jfvu
娣	hlyh
盹	hmpo
劾	mdgd
颌	ldff
趔	dpoh
殇	tyhw
噌	xhur
轧	kask
沽	ljhu
龇	ngki
玷	hugu
掸	hnvh
趄	apoa
皖	gnib
杳	jtdr
镀	hiej
匍	wmwv
崴	grzl
岖	aezc
幔	psej
蝈	lssj
镑	iuev
蜗	gtsy
侬	yafm
搡	zpvd
缆	dnze
袂	pdwy
诠	aijg
洵	chhr
犊	hmyh
蟀	tost
邋	denk
瓒	nsgf
荦	dxxy
竣	exdg
骥	elpi
泗	zlhb
痣	klic
胴	hzru
谤	iujv
蘸	ksxb
蛐	aesa
糯	yxpb
绾	gnzl
舀	jtwe
噙	asud
嘣	ihur
诃	mkju
脓	yarm
忪	zvck
咤	krua
捱	qjvo
峥	khzk
濡	fmhb
瑙	ytgc
碉	hdtu
荃	aixg
孵	vjdn
讹	bdji
嗵	ovuj
彝	jnkq
颀	anef
篆	kcky
椭	opdr
淆	cohr
嗑	urup
辎	ngso
踮	hqnu
犷	leal
鳅	aobm
隗	ubbk
锏	eqer
倌	lffl
氤	jvah
馗	ubep
揶	jdvb
胚	wxrq
啻	slgu
夙	zieh
珈	eogu
锹	adem
迩	bpnc
峪	jhzu
菠	itxj
蓟	elxh
馥	vimg
槌	sbdk
燮	cpmj
褛	dswy
豚	ohry
氲	jsap
湍	ofhb
蚱	krsk
殡	irhi
毗	wnoi
诽	vgjv
褴	dqwp
恁	ywfc
蚌	iusv
瘁	xeit
憩	alac
锚	preo
耘	jhvk
鬃	nvsc
祢	pnwc
苒	fnxf
蘅	moxh
鱿	jtbj
町	hjoh
掇	hsvj
坯	wgoq
戛	edql
贮	kiiq
剽	wdch
孬	yuin
衩	svws
镣	dpec
犟	ewly
夥	mplc
斡	gftt
珩	mogh
诘	ekju
潢	mghi
黔	abme
臃	jvrj
轼	tlsl
嘹	douc
阪	inbj
冗	fqle
桧	medk
闳	mapk
皿	pyqq
囡	yogy
辍	sxsj
闰	fxpg
臼	eewq
蹩	ikif
怵	sict
囤	ohgo
蚓	jysj
碴	sath
姒	zlyf
灸	ezem
蚯	aosa
堑	auso
谗	sqjh
箩	dskc
艮	lwkm
粽	nzpc
牒	hkwd
泸	dmht
刽	lefh
锷	breu
诋	hfjh
贰	bofl
坳	qwod
睑	eqpq
葭	eoxj
妪	jhyc
癸	lzko
沣	vhhv
壬	fyaq
箕	egki
颉	ektf
姹	srya
赳	eooq
琮	xagc
焊	msml
淬	xeht
埠	iiot
淙	xahc
孛	idtn
犒	uwyu
茱	kjxk
饪	fwtf
钙	lbel
鲲	usbi
谟	pqjh
馊	zxtj
糠	uypd
骠	idpc
旮	leer
跆	ojnu
潸	tohr
饕	ouum
谀	jbjj
廿	yuqq
绺	dzzu
沱	oshi
囱	xvwg
铳	szeb
袤	pwgm
诌	kxjq
苯	igxi
佻	odfk
泾	ejhl
獗	eiaf
鞅	jyxj
蹶	einf
绔	uizu
洱	bphb
馄	mhti
粲	xsqp
哂	tguc
蔗	krxb
奘	nukh
芍	trxt
腴	jbrj
剜	golh
汾	vyhh
顼	cegf
蜚	vxvs
殒	jmhf
麝	trlx
鹞	jwwy
蚤	ntss
浃	eohe
坂	inoj
忤	gcct
洙	kjhk
祗	kgwh
眦	nlpi
赧	ynoj
佝	lxfu
蒯	ujxh
郦	dldb
硅	llto
玳	hbgl
睾	luwt
螭	sgsd
赁	drff
俅	ayfa
侗	hzfu
骛	gikp
纂	nbkc
厩	eese
萋	agxy
帔	wdej
蓁	kqxm
杈	srds
熨	jxtm
挞	orvh
阗	obpi
钏	sces
煊	cfmh
迳	eanl
缮	tszu
嘁	agul
懑	pwhc
邕	jvki
柩	eede
耆	antr
龛	uofi
饯	eutl
幄	gfeo
爰	jiwj
噻	zauo
诙	mljm
锃	nweg
纰	wgzi
鏖	qrle
氢	ajal
楔	chdh
藜	dnxt
妫	llyg
骧	cmpm
璜	mggi
聒	lsbu
椿	ssdr
谩	psjj
琊	jagb
骅	mqpt
翕	cgfc
仞	fwff
玖	ezge
皈	llij
骊	dnpd
痿	ggiy
芑	afxe
孑	ekkq
撸	djvr
啵	ituj
昶	spjr
篑	uekf
陲	sbbs
樽	nsdx
遨	qrng
舶	iqki
蛀	kisk
琨	usgi
邈	pznb
棂	dkdm
抻	sqvt
铉	ccez
怩	ynci
膘	idrc
忸	yzcs
漳	kyht
仃	hjfh
壹	jgth
黜	sims
巽	cxki
滂	wyhv
戕	amkl
埂	lmol
奂	mcbh
溉	lbhe
猊	ynab
胛	eare
遑	mgng
跻	egna
妗	erye
钛	obeo
岷	pszp
葩	wexi
磺	mgti
魃	ialj
汕	tshz
蠡	dfks
苋	cuxe
肛	lyrl
铤	oqef
桠	jedj
氐	hgth
鲛	edbc
稔	fgmc
锲	apeh
哙	uouk
冼	cqhb
獐	kyat
讧	mzjl
氨	qoay
缯	nhzr
褓	itwd
菀	gnxk
鄱	wqvb
炅	evrm
碜	sgtw
戗	amfl
酊	hjjh
钠	yrey
螓	assm
镌	efey
铀	jtej
羯	ekbk
挝	gtvx
谡	zijg
渚	kchr
逖	olnm
衢	abfh
狒	vdav
骞	axlp
盥	lcwp
睚	japo
祚	nxwk
夯	myhd
驷	zlpb
掴	lsvj
蜞	ansi
乜	ypkk
哔	ilut
荪	zsxc
蹴	xinj
忾	ubca
鸵	osyi
疹	kgiw
韫	jxgp
祛	aewk
膻	torh
黢	aemg
仄	nrsf
唳	dlua
孀	tayp
斫	kste
腚	harf
牍	hmwh
佃	hufo
懋	pwdc
赡	tsiu
镭	dheo
铄	txed
媾	lkyf
嫒	qbyj
佥	axfq
谌	syjt
尕	lvyc
蝼	dtsy
闱	ghpg
篙	luku
逡	asng
膑	irri
隍	mgbg
蕨	eixf
罄	aatv
郓	jxlb
橹	dcdr
诰	lwju
蹇	eqlf
喱	dnud
肓	magr
榈	dbdu
绶	tkzj
瑗	jcgj
槁	ltdu
裱	izwm
牦	pryp
荑	jnxj
滓	nfht
谶	swjl
砝	vvtk
舐	tlat
秆	lnml
荏	fgxf
斛	mmbt
狻	zfag
恫	hzcu
纾	tjzj
锟	usei
粑	iepi
诳	ugjg
鹑	shgy
驽	ymyp
炷	kimk
缙	erzr
徕	djfd
橇	addp
痢	dlih
撺	xfvs
魉	dnld
妊	fwyf
矍	eipj
犸	pvap
庖	wrlk
俎	ncfa
墉	jvoj
藓	cqxj
佰	irfr
觥	lvbb
伉	uufe
牯	lcyu
锨	cxef
轱	ljsu
泵	iwtt
擀	lnvl
绻	abzk
绌	sizs
纥	lkzj
釉	jkwj
讫	aljj
蜇	kkvs
萼	brxu
诮	apjr
胰	jnrj
瘌	drih
瘀	jeih
霰	cujg
弁	iukq
湎	pqhp
蹉	xsnl
醍	onjf
铂	iqei
蓼	dzxw
梏	lidu
祜	miwu
虺	mzqs
嘬	nsuj
疡	jziw
杲	ltrd
煨	gxmm
蛔	mbsu
涝	dwhd
焖	pwmc
魍	gplg
锉	xxeo
跎	osni
娠	tqym
诿	ggjy
殚	hohh
镁	pgeh
胱	larb
痂	eoiu
醐	mmjr
糅	ftpd
岿	ulzl
愎	ilcg
笳	eoku
崂	drzd
踽	esnj
揆	ubvo
鳍	anbr
椁	lpdn
骈	wbpu
勖	chpd
谪	kdju
柁	osdi
狲	zsac
珲	mlgs
蛭	klso
俦	stfx
镫	hweh
鼹	jney
懔	dycc
咩	phuj
韪	ggrg
噱	ciuy
铩	teec
硌	lrtu
俚	dffd
椤	dsdc
脍	uork
淖	ywht
姘	wvyu
聩	uebf
绦	ouzc
铡	kaeh
遒	aynj
蚪	hdst
屙	bktu
葺	alxb
煅	hcmj
悱	vgcv
茕	avxt
靛	huaf
诓	uajg
珥	bpgb
菅	exxl
嶷	jnzf
岬	eaze
舢	tokz
肱	lvrk
逦	dfnd
冁	snbm
蜢	pmsp
莠	jdxy
铨	aieg
胺	qsry
堇	eyxq
瑭	ozgu
芨	egxe
逶	gxny
嶂	kuzt
徭	jrfv
鹌	qohy
狍	wrak
埙	csof
缛	fizx
椽	sidy
酮	oaju
貉	mdwu
糨	ewps
铖	soel
畹	gnok
镝	hgeu
铣	cfeb
舂	svqe
碘	hqti
黍	tcmt
芫	jixb
铢	kjek
赭	kror
氯	dhat
倬	ksft
酡	osji
傣	hrft
缱	aqza
浜	iyhi
篾	ppkl
猕	pnac
桉	qody
蜮	jhsl
骢	xvpc
饴	jntu
圩	ghoj
疱	wwik
橐	osqd
钿	hueo
枸	lddu
貅	cowd
嫱	aqyu
綦	anac
笤	ooku
鼬	jkej
嗄	qaug
卅	zrqq
茏	daxi
艄	tukr
苡	jfxf
伥	syfs
疟	yoiq
骓	klpq
筌	aikg
猁	dlah
珙	lqgi
貊	pfwr
诟	lkju
鬣	dpsk
鼐	ybyh
獭	ovaf
獾	mfaq
赅	laif
擤	cqvi
稗	ibmt
咴	mlum
楂	sadh
氮	hsam
竽	jbkj
勐	pmnd
谔	brju
铧	mqet
铆	pteb
褡	hewu
滁	smhc
陂	ixbj
喁	jauh
湫	aohm
钨	gjeg
綮	aamc
蕲	anxe
稞	ukml
阄	eopl
媪	qtyp
笏	mikg
晷	lzru
宥	jklr
儋	hofu
葶	okxh
阡	axba
粕	wfpi
猗	jgau
睇	hlph
洇	jvhh
虢	lswe
癣	cbij
诒	jnju
踯	knnb
锒	dzem
菖	syxr
虻	posg
苌	szxs
牝	wryi
畦	anoo
腩	ynrt
吖	jeuj
蠹	hiqs
瓤	fzgl
薨	mvxi
訇	mvwu
镊	ypej
陟	klbi
镗	ozeo
樗	sjdu
阆	dupm
罅	cyvm
稹	kgmi
螟	pksi
骝	dypo
蓿	cexr
祧	odwk
擘	iftt
犴	qsal
玎	hjgh
侉	uffu
厝	xxsr
馐	cots
潍	ghhg
兕	zlqb
黩	hmmh
胪	dmrt
抟	oivk
莳	tnxx
毽	eupe
筇	avkb
腱	eure
澧	dfhh
怼	hejc
镞	nmeh
貔	wnwi
嬗	tsyh
醴	dfjh
搠	txvr
杷	wadi
杌	gidb
讴	rxjc
闼	orph
歃	traf
蝮	visg
沆	muhe
烷	gqmb
箜	uvkl
彀	lktj
揿	arvf
茴	mbxu
癯	abiq
衽	fwwf
鲈	dmbt
缟	ltzu
昴	ptrb
廪	dylc
垓	laof
瘙	zwis
黟	jgmc
矾	vqtv
氖	yray
陉	ckbl
耄	pwtp
妯	ktyj
菟	oixo
镛	jvej
镱	jlec
竦	zqdt
鳏	lfbh
飨	cncm
猡	dsac
痼	liiu
讣	viji
馕	yztm
枰	wkdt
黼	vcjv
垅	dqoi
佤	gvfg
妁	txyt
蠃	dpgv
锆	lweu
枇	wndi
垭	jeoj
鹳	lcxy
恚	meoc
盱	cepj
帑	opye
侪	sjfa
穑	zrmu
脶	dsry
煸	ixmx
娌	dfyd
蚋	fesy
缁	ngzo
箬	fxku
樯	aqdu
麂	efle
甑	nwbg
掮	abvr
龃	eska
趸	hmgf
苣	ehxe
萸	jbxj
妣	ifyi
枞	xvdf
疥	epie
啁	kxuu
氰	akar
檑	dhdo
莴	gtxy
禳	fzwm
镏	dyeo
狯	uoak
焐	gimu
莜	jtxg
腭	brru
淦	lshe
荇	caxh
蚝	mrsp
榉	esde
楝	dude
艨	pokp
睃	zspg
鹈	onby
棹	kwdt
庥	cold
柝	oxds
堀	ujos
磔	kdtd
柞	nxdk
泔	lohl
锰	pmep
徂	xmfa
堞	hkod
墀	snoy
薅	muxx
艟	svkd
嵯	xszl
迨	hbnu
篦	ilki
橛	eidf
焯	sumt
趺	vjnv
倥	uqfl
崃	djzd
旒	dyvk
耧	dtvy
庠	cqlj
狴	ilao
钴	lceu
樾	jodl
欸	qrkf
穰	fzmm
耒	dgvy
眙	jnpu
罴	wnzb
怛	hach
缃	cmzp
哏	lyum
逄	wznq
岙	qwjz
沤	rxhc
荨	abxx
铱	jgem
艏	tdkp
薮	zdxg
峤	epza
崤	cozr
蹁	wbnx
蕤	fbxt
璁	xvgc
秫	tmmt
掾	jcvy
祆	cxwo
豉	sfhj
醪	drjw
庑	gclg
茛	lwxm
莼	shxo
筮	tlkg
媸	sgys
阒	ahpa
怫	vmcv
鲔	ggbr
疣	jtij
轳	dmst
鲵	ynbb
熵	tymu
馑	eytq
眇	pzpt
塄	doov
涞	djhd
崮	lizu
诂	lcju
镢	eief
氟	vmav
蔌	zixf
洄	mbhu
郴	sqdb
詈	dlzu
獬	cpay
箧	apke
鳃	zabc
矸	lotl
讵	ehje
璺	gwwj
鞣	ftxd
澌	zghe
耦	rdvh
樘	ozdo
蛉	dksk
箪	hokh
扦	axva
鳟	nsbx
痱	vdiv
殳	tjej
葚	twxt
纡	jezj
翮	mdqc
鲽	hkbd
诔	dgjy
曷	mdrk
髋	ufle
狳	jbac
坻	hfoh
嫘	dhyc
骟	tspc
椴	hcdj
墒	tyou
阋	clpb
牖	jdwv
龋	askj
蠲	efbs
谝	wqjx
悭	axco
鬲	ldqq
撄	jjvy
麸	vjpv
笮	nskk
砷	tqtt
疴	ukiu
锱	ngeo
寤	gilu
糍	xnpz
尻	uute
蹼	wcny
鳕	cbbc
裰	hswj
偬	nqfc
茑	yzxy
榫	zmdt
峁	ptzb
秭	nfmw
鲅	irbj
茼	oaxu
郜	lwlb
旄	prvp
殍	wzhn
碇	hatf
垆	dmot
萘	ybxc
炔	aymy
蟮	tssu
蓍	tgxr
飧	zscm
俣	jsfo
碓	hetq
刿	lezh
孓	eiky
谰	dqje
痧	teit
钚	iiei
槲	mmdt
绐	hbzu
痈	jvij
埚	lsoy
狷	ecar
阍	mspr
螫	tlos
怙	micu
莪	bdxl
痤	xsio
蔸	hxxb
翥	kitc
盍	mdop
黥	akmc
菏	mdxu
诹	nxjj
糌	nopr
舸	lrku
蘼	pnxv
蕈	cxxt
襦	fmwb
膈	ldrq
芏	hixo
畈	vsoj
艉	ggkp
阊	sypr
傧	ivfi
艿	yrxy
攮	ypvm
酚	vqjh
塍	soro
椟	hmdh
氦	mbaf
笸	wjku
疸	hnih
圮	wfoe
篌	mtkh
髡	ussb
谖	cfjj
醯	cgjp
枳	kfdi
髫	oosu
酯	kfjr
缳	mizm
镬	mxej
糁	tqpw
皴	xskj
虼	lrsj
鋈	gihe
溱	ashm
坩	lool
鄄	eccb
郯	oqmb
隰	cnbb
朐	abru
墼	egso
跬	uzno
愀	azcm
鳜	lebf
萑	mixq
遄	sinb
麇	eslm
柰	ybdc
趱	nnof
垸	jcob
裎	sowg
埸	jlog
肽	obro
绀	lszl
倮	dpfl
岜	iezi
谵	koju
鲟	chbx
瘐	jsij
帻	ndef
缵	nbzf
礅	hstg
屣	cftf
缶	vdgq
炻	tnmu
荽	zlxy
砬	datd
锶	zgec
鼍	osuh
跣	cqnb
炝	awmk
驺	nxpq
绂	vmzj
燹	cqqm
缫	zuzl
殂	xmha
嗉	ziuc
铘	jdeb
饫	jhtj
辏	xkso
鼙	wntt
璩	abgy
悛	afcg
褙	idwr
煳	mmmr
尥	dpqt
劢	pbgd
轫	fwsf
苷	loxl
觚	ljbl
萏	hsxe
羝	hgbh
觜	nzkj
喾	uibu
曩	yprm
瑷	qbgj
砗	skts
蚍	wnsi
阃	umpd
溲	zxhj
匏	wrhk
桡	frdb
耨	ykvx
缑	lxzh
愦	uecf
蝾	fasd
榧	vgdv
蚜	jasj
荸	inxn
磙	lmtm
坜	dlod
粜	opsp
滹	mjhm
铍	wnej
麈	kclk
锔	ebeu
蝣	jtsn
柙	cdde
鸫	hvhy
勰	ckdc
鹾	xsdl
扃	esmu
皤	wqio
鲱	vxbv
旰	lsrl
溏	ozhu
溽	fihx
伲	ylfi
锗	krer
悝	ulcd
漭	pphp
痦	giiu
袢	wswi
鳎	ovbc
昝	nngr
滏	vchv
廨	cply
戢	enul
舻	dmkt
彖	ocky
裉	uwwm
蓐	fixx
脘	gnrb
艋	pmkp
嬲	yzod
鹩	doqy
耜	zlvq
坼	sros
尜	laqc
瘊	mtih
墁	psoj
铊	oeei
锂	dfed
蔟	xixh
鲎	mkbj
蠖	mxsj
悃	umcd
谮	nwjr
畀	iloq
裒	wtgm
镲	svec
锝	hdex
蚬	cqse
邡	vyvb
螨	pnsd
怍	nxck
鳐	jrbv
陔	labf
狁	jmab
拶	nevc
汆	xfft
呒	vcug
钼	piep
颡	zpjf
搛	exve
蝰	ubso
眄	pupk
慊	auce
劁	adfh
肫	ksro
崦	jozh
酹	ddjx
胼	wbru
瘳	sxiw
锑	ogeh
蝓	jbsh
舁	jbeq
诜	tqjb
芗	cmxc
焓	mqmu
蒌	dtxy
旆	wdvq
胙	nxrk
浈	kqhf
碡	kxtp
谠	hpjb
埽	zwoe
栲	utdu
踔	ssnt
袼	lkwu
僳	zifp
槭	aldl
鲞	cnhj
桴	vmdn
佧	uvfi
蒉	uexf
囟	crwc
狨	faal
溴	ceha
唑	nxuo
畚	igko
骖	xopw
榇	swdc
癜	huij
堠	mkoh
泖	pthb
浼	pghp
硗	adtb
隹	klfq
哿	lrdu
僦	eefj
馓	zntg
觌	hnte
辊	lmsi
垴	ytoc
醢	mrjp
虮	efse
诎	aejs
绱	tuzu
埘	tnox
蠼	absj
菘	zvxk
圯	jnok
锕	qeeu
戥	hmrl
蚶	mosl
侔	ptfy
砼	oatl
藁	ltxd
呙	lsuy
镡	cset
籴	hnfp
佴	ybfb
杪	pzdt
昃	nrrf
鬏	eosm
耪	wpvv
橼	jidj
爨	xcwm
狃	yzas
嘌	wpuc
畎	aboa
蕞	nexj
羼	sstj
缬	ckzf
哕	jbuc
谇	zejt
氚	sfas
蒽	bqxc
黾	pyuh
铵	qney
鬯	suwi
嗾	zduh
柽	shdo
镉	ldeq
遘	lknf
绲	lmzi
钣	inej
逭	mcnl
觖	eiby
莰	unxf
茌	snxt
疔	hjih
圬	gjou
禊	clwh
虿	sbgs
刳	ujhh
秕	ifmi
葑	vhxx
呋	vjuv
铯	zrei
垧	tpou
洧	gghr
吣	aruc
钪	uuee
浯	gmhu
窬	jblh
埴	knok
惝	spcu
颃	mzgf
蛞	uxsu
镆	pfeh
茺	svxb
蕻	mzxi
嫜	kyyt
囝	eqgn
蒗	duxm
鳔	ipbc
骶	hflh
圹	ubol
敉	pfpg
畛	kgow
晡	ijrv
瞀	pwkp
龀	swki
砉	mzvu
篪	snke
仳	wffi
芄	gqxg
猃	cqaq
甾	nako
髑	hmls
锘	yxeu
裥	eqwr
瘘	dkiy
鲼	vwbf
髌	irli
甯	yalj
鲭	ajbr
腧	tirh
绁	cpzt
崾	jwzy
溻	oehc
氆	wcpr
锸	seee
爝	eimx
笾	ixkd
罟	lczu
铫	jrek
埝	yuoc
芘	wnxi
楦	ccdh
茆	ptxb
钍	oceo
馇	seth
唪	vmuv
纩	ubzl
栝	lzdu
饩	clta
趑	ngof
菹	njxa
醅	wxju
埭	hbod
鞲	lxxf
枘	fedy
庹	opls
毪	pmpy
浍	uohk
笱	ldku
骒	urpl
揸	kevh
邾	kjkb
擐	mcvm
噍	epub
氇	djpr
撙	nmvx
颥	fmjf
鲦	oobc
疳	loil
桄	ladb
踣	iqnu
窭	ehly
矧	tgtj
獯	csab
榱	xldm
苤	wwxq
钋	wtei
蛘	jzsj
黪	xnmw
钕	ysey
氩	jraj
骀	ojpu
锇	bdel
肟	gfru
瘰	dpic
哌	wbum
蜣	amsk
籀	kkko
薤	cpxe
砟	kvtk
嵛	jbzh
忭	iuci
瘛	slic
垌	hzou
蛲	yrsb
锓	ayej
煺	oemm
嘧	pluz
蟛	wosw
陴	wnbt
辋	gpsg
龠	jofx
腠	xkro
堋	woor
黉	mabi
杩	prdp
恧	yhbc
唼	truy
硐	hztu
胲	mrrf
烀	mjmm
忮	klcj
芤	uxxu
鲡	dnbd
檎	asdd
砑	jrtj
氡	hvah
钬	mpem
穸	cglc
骺	mtlu
鹨	decy
瘼	pfih
糈	cspr
岣	ldzu
肷	aqrf
铒	bpeb
蛑	ptsy
坫	huou
酐	lojl
贶	ubib
躜	nfnf
趼	eqnu
锊	doex
舴	ndkk
肭	yrry
碹	ccth
眵	sgpc
蟪	mesc
锼	zxej
吲	jyuj
嶝	hwzh
锾	miej
碲	hlte
茳	emxl
躐	dpnk
嵝	ddzy
厍	trss
鸸	bjby
铽	orel
埯	qnoh
廑	eylq
芴	gixg
硇	yrtc
酴	omjc
堍	oioo
舾	cgkc
舄	cleb
鼗	orkj
筅	cqkb
砜	vhtc
淠	wlhq
圊	ajgr
迕	gcnt
朊	fbrb
躔	sqno
筘	ukku
蠊	dbse
镧	dqee
犏	wxyx
仉	kpfe
瘥	sbil
糇	mtph
蹯	vqno
钫	vyev
礓	emtq
揞	qnvr
铋	ilei
岽	hvzh
羰	oybm
傺	slfc
澉	lnhg
衄	yhcs
锫	wheu
酞	objo
鼯	gmeu
赆	erie
鹛	phpy
窀	kslo
蕹	gwxj
锿	qaem
酤	ljju
蜾	lpsl
恝	edvc
跞	dlnd
蒴	txxr
绗	mzzh
锪	msec
巯	aykk
驵	nppa
瘅	hoih
羧	zsbg
钽	oneh
帱	stex
鹱	miyj
泐	drhd
蝻	ynst
箨	oxkn
瘵	kbic
胩	uvri
钔	pyep
迮	ndnk
耖	swvt
氪	urab
聍	ykbh
赇	ayia
氙	cxaz
猹	saah
篚	vgkv
牿	liyu
埏	took
锎	uaeu
仫	pifp
痄	krik
镦	heeg
耩	envf
铑	dtei
螵	wdsc
钇	jfej
镎	yaet
钐	toew
鹎	ixiy
嚆	muuu
犋	ehyi
鳓	drbd
腽	grrp
瞍	zdpj
萜	ohxu
钆	laek
稂	dzmm
脎	zrrc
耵	hjbh
镅	phep
粞	cgpc
癃	dait
耢	dwvd
铌	ynei
镩	xfes
菝	iaxj
蝽	sssr
镄	vdef
铼	djed
耥	oyvu
缲	adzd
鲐	ojbu
酏	jfjj
戤	lbyl
礞	potp
镨	wcer
耔	nfvn
脒	pfrp
稃	vjmn
喹	ubuo
醌	usji
镥	dcer
痃	ciiz
耱	pfvu
岍	axzu
瘃	kmiy
禚	kswb
铷	fmeu
塥	ldoq
镤	wmey
铈	tlee
螋	zxsj
蒎	wbxm
氕	whaw
铴	oyeo
鲴	libu
鲺	tgbs
铥	hoek
轷	mjsm
铹	dred
荮	kkxx
腙	nvrc
蒈	urxi
乇	oswa
谘	ngju
阢	gibb
坶	pcop
菸	joxh
拚	wvvq
揲	hkvd
揎	cfvh
擗	wfvt
甙	hbll
哜	elua
猓	lpal
猸	phap
馀	jbtc
庀	wfli
弪	eall
缍	hpzs
缏	iuzl
楱	xxdo
榀	wydu
軎	gdsu
搿	ldwt
肜	farw
膣	klro
臁	dbre
熳	psmj
憝	hegc
泶	cibt
砩	vmtv
砦	kbku
礤	xvtc
钶	ukeu
窆	iqlv
虍	mjqa
蚵	ursu
蟓	cwsc
箝	abkl
舨	inkj
糸	plzc
醣	ozju
鳋	zubs
髟	idsw
齄	kenh
的	hgit
了	dzkk
这	kdnc
说	tejb
大	hbqy
那	ydkb
么	pqwk
得	hgfx
还	mini
见	cuqk
长	kpwy
被	wgwj
给	efzu
行	mzfh
种	samk
觉	epbe
重	sawq
呢	ynui
便	wbfl
思	zaoc
亲	aadc
合	lrfu
度	hslj
谁	thjq
传	kcfk
提	hgvf
哪	ydub
血	cwwp
石	hsqu
阿	bkbu
识	klji
单	sqbq
朝	kutr
校	epdc
曾	xobr
术	kmdh
差	xgbl
约	juzt
陆	debe
查	kedh
参	xqkw
秘	ilmi
熟	ttgb
模	pmdh
劲	eakd
适	uxnu
娜	ysyb
暴	wirt
择	kjvq
折	tdve
绿	dizt
省	cqtp
圈	efgk
俩	dnfd
盖	lrbp
番	wowo
仔	nrfn
塞	zrlo
盛	sosp
侧	kafh
遗	gdnf
涌	svhj
宿	czlr
迫	wrni
鸟	hzwq
胖	wqri
炮	iumk
邪	jdjb
膀	wyrv
尾	jftp
薄	iqxx
埋	pqod
括	lzvu
夹	leqy
臭	cena
冯	wkhp
抹	pevp
倩	aafr
繁	wqpc
络	dwzu
刹	srch
堡	icfo
祭	kbwc
赚	ncie
彭	iytw
胳	leru
爪	ktwy
咯	lkuu
嘲	kuur
契	cpvh
卜	itqh
削	cybh
颈	lmkf
拆	xevs
咋	nvuk
碌	dett
匙	tgri
禅	tswh
衰	xlgm
於	gjvh
钥	jwer
剥	itdh
氓	pogp
壳	apte
卒	xigt
苹	whxt
粘	ybpu
拘	lxvu
蔓	gsxj
淌	sphu
综	nwzc
喔	rtuo
吭	mzue
畜	sigo
绰	suzt
嚼	eiux
扒	wavi
鞘	tuxr
幢	kbed
剿	sush
杉	tedw
彷	vpfv
喳	seuh
脯	wmrv
凹	geqq
梢	zwdr
肋	dkrd
矜	lfke
峙	tlzx
呗	ibuf
瀑	iwht
攒	xivf
缪	pezw
烙	dxmu
牟	piky
褪	oxwm
铛	hyeh
拌	wovi
喋	kaud
傀	llfk
翟	hncq
辗	yqsm
磅	wztv
撮	npvj
伎	alfj
蹊	agnh
蛤	ldsu
拗	yevd
楷	ehdi
槛	undp
焘	outb
糜	phlp
棣	hbdd
喏	yxuu
瞿	ehpq
驮	hxph
玟	gygc
箐	aakr
俟	anfh
呲	xgui
纶	lfzi
镐	mweu
阚	mnpg
潦	dthc
挲	zeht
覃	asct
蚣	kvsk
峒	oazu
轧	lask
趄	eeoa
姣	coyc
槟	ijdi
宓	vmli
忪	kvck
徵	kffg
腌	qerh
蚌	iwsv
阏	brph
潢	lahi
囤	hxgo
骠	wppc
佚	hkft
繇	kkwc
奘	kekh
嘞	dkud
纰	ifzi
睥	wlpt
犍	abye
忾	clca
佃	obfo
睢	mlpq
荑	onxj
纥	mdzj
蓼	dixw
泷	dahi
偈	ekfk
柁	hxdi
硌	dxtu
淖	sxht
艽	ayxe
铣	cqeb
芫	jqxb
疟	jwiq
湫	ezhm
诒	hbju
吖	qeuj
犴	moal
伧	sqfk
芾	vdxq
啁	oouu
玢	vqgh
眙	slpu
哏	mgum
峤	aoza
椹	twdt
漯	dghc
窨	cslr
螫	kkos
柢	sndh
糁	znpw
朐	smru
戆	kbdc
麇	ahlm
垸	miob
啉	dqud
桡	yrdb
悝	dfcd
铊	osei
怍	krck
拶	nnvc
肫	shro
尢	gyqk
蒉	uoxf
镡	sqet
黾	pmuh
惝	opcu
砉	cevu
芘	ifxi
栝	uxdu
茈	nfxi
唛	pbug
垌	oaou
堋	iwor
裼	olwg
粢	xghp
廑	aslq
芴	mjxg
跞	dxnd
猹	keah
瘕	coij
说	jojb
着	ksbp
落	dwxu
哪	ygub
差	sabl
参	tqkw
堡	wifo
朴	wtdi
伽	akfu
靓	dwae
褚	kcwr
棣	oldd
泷	tahi
陂	wtbj
黾	pquh
铫	opek
㨄	kxvu
挼	fqvy
仌	ijff
骭	lsll
丼	hneh
嬅	mqym
畊	lhoe
苶	ykxc
朒	yhrf
砯	wjtt
嚱	clul
湦	thht
珃	fngf
焺	thmt
麤	xjli
玽	ldgu
婋	cdye
妉	hoyk
妳	yfyc
跩	kjnj
瑊	exgl
羴	tobj
惢	zpcc
尛	pqcc
玊	zigh
氼	yltf
恏	mwyc
兲	oxgi
巭	ljlv
躾	pgth
雫	yvjc
円	jiqq
喰	xoum
凪	kfek
広	lelk
筊	ezkc
囧	evgk
係	clfc
卌	clqq
揾	gwvp
昰	tlrk
薙	olxk
嗮	zbuc
叒	fxjj
㞗	ayta
靘	aaai
炁	alqb
珮	wdge
呯	wkut
惗	yucc
嫐	ytyy
唸	yuuc
搣	ppvl
擝	phvp
冇	ptqk
躝	dqne
冚	unlz
唓	skus
菓	lpxl
攰	letd
咁	loul
奀	bqih
掟	havf
俤	hlfh
哋	hluj
啲	hgut
肏	xwff
屄	igti
㞎	ivti
粄	inpj
喎	gauu
纮	mazk
昄	inrj
乂	jlwy
彧	jhql
烜	cbmh
湜	tnhf
梣	syde
僔	nmfx
槜	nedy
寁	nnlf
矰	nhtr
慥	nwcu
廙	jlli
垚	jroo
廆	gglk
芠	gyxc
窊	gell
㑇	kkfq
柊	kvdh
瑑	kcgy
陎	tjbk
骦	tapp
墡	tsou
鲹	tqbw
玿	trgu
焞	osmn
㻬	ojgu
猯	ofab
煓	ofmb
萚	oxxn
趯	oloq
慆	ouce
廋	zxlj
璲	zegz
襚	zewz
旞	zevz
鹔	zizy
骕	zipz
㧐	zqvj
瓀	fbgb
䎃	fnfc
驲	flpr
婘	aiyk
杄	axda
愭	ancr
衃	wxci
酦	wtjj
玶	wkgt
蚲	wkst
狉	wgaq
苉	wfxb
弸	wolr
潖	wahi
笯	ymkj
傉	yifx
麑	ynlb
媆	fbyh
迺	yrnc
偭	pqfp
亹	pyga
癗	dgio
垏	dhoq
葎	dhxd
疁	dyow
嫽	doyc
磏	axte
埌	duom
裈	usws
婫	usyi
剋	uxth
矻	ujtj
埪	uvol
斝	eaut
娵	eeyj
麖	ejlc
墐	eroq
欻	szmf
漴	sahc
堾	ssor
韂	ssxu
瓻	sgcg
偁	shff
庱	smlg
茝	srxq
垞	saoa
袆	mlwg
硔	mati
琀	mqgu
垾	msol
侴	sdfh
耇	ldtu
堌	liou
堽	lyok
堨	brok
涐	bdhl
楯	tmdp
嘚	hxux
楪	hkdd
亸	hpgh
亶	hngh
玼	xfgi
摽	ipvc
瀌	idhb
坋	vwoh
倴	iwfm
蚆	iesi
嶟	nszx
鲗	nhbh
璪	ntgd
臜	nerf
崒	nmzt
珇	ncga
鬷	nvqg
疭	nzif
捽	nsvt
酂	xscb
鼒	ngxh
牂	nykj
簉	nwku
倧	nvfc
岞	nxzk
玥	jogr
祎	jgwg
玚	jzgw
玚	sugw
旸	jzrw
耰	jxvg
槱	jddb
鲬	jqbj
妧	gsyb
棪	jndm
嫕	jlyc
昳	hkrt
垟	jzoj
峣	jrzb
堐	jaoo
钖	jzew
彟	jycj
颙	jaqf
媖	jjyj
愃	cfch
噀	cxui
谞	cejr
垿	choj
珝	csgc
魆	cell
茓	cixi
翾	cfzc
暶	cirf
衒	ccfh
瑄	cfgh
滫	czhr
偰	cpfh
皛	czii
孅	cxyl
㬎	cqrb
玹	cbgz
忺	cxcf
伭	cifz
挦	cbvx
珦	cwgu
煋	cjmt
铏	ckeh
巇	cgzl
釐	cggd
嶍	cnzi
枲	cfkd
郤	clib
潟	clhb
伈	cyfc
炘	cvme
昡	ccrz
䜣	cvje
屼	gizb
踒	gtny
坬	geol
㧑	ggvg
珷	gcgl
峿	gmzu
旿	gcrt
偓	gffo
椀	gndk
婠	goyl
塆	gool
辒	gqsp
榅	gqdp
炆	gymc
髽	kzso
纻	kizq
䏝	kfrk
劄	kakh
鲊	kvbk
烝	khdb
婤	kxyu
鸼	kxky
辀	kxsk
㤘	kkcq
穜	oamd
茽	kzxk
鹯	kogy
栴	kodh
擿	ogvu
畤	klox
暲	kyrt
瑱	kwgi
詟	kddu
沚	kfhk
拃	kvvk
阇	tdpr
睄	twpr
婌	tmyj
礵	tatp
晱	tnrm
邿	tgob
陞	thbo
瞫	tgpt
珅	tqgt
燊	tqmd
瘆	twiw
昇	thrt
隃	tibh
棽	tqde
腯	omrp
鲖	oabu
嬥	ozyq
媞	onyf
蹚	oyno
嘡	oyuo
熥	ohmj
弢	oulj
魋	oblq
璮	ongh
坉	ohoo
鲀	ohbo
稌	ommc
梌	omdc
颋	oqnf
桯	ojdg
珽	oqgf
侹	oqff
啴	snuh
䴘	ogwy
绹	orzv
渟	okhh
㛚	oqyj
磹	oqtt
鿎	ovth
蒐	zxxk
甦	zjlt
娀	zvyl
溹	zphc
楒	zgdc
偲	zgfc
虒	zgwe
溞	zuhs
汭	fehy
瑢	fagu
堧	fioh
鄀	fxxb
婼	fxyu
蘘	fzxm
瀼	fzhm
嬬	fmyb
镕	faeu
儴	fzfm
玱	amgk
婍	afyu
拤	advi
胠	aerk
㭕	aedk
埆	aooj
鳈	aibt
瑔	aigt
佺	aifg
癿	akik
伣	aufe
圲	axoa
勍	akgd
跂	annj
呇	aftu
嵚	avzf
骎	avpj
䓛	aexs
抔	wtvi
穙	wmmy
鳑	wzbv
雱	wyjv
玭	wsgi
酺	wmjv
潽	wjhr
楩	wbdl
㛹	wbyl
磻	wqto
伾	wgfq
搒	iuvv
椪	wwdj
墣	wmoy
呣	ptup
嚄	msuj
秾	yamm
杻	yzds
杻	sdds
萳	yqxt
薿	yfxf
嵲	ypzd
齉	yunm
臑	ywrb
嫚	psyj
牤	pyyg
㠓	pozp
鿏	pbeg
媄	pgyh
牻	pzyw
尨	pzqw
尨	poqw
厖	pzsw
幪	poep
獴	pmap
眊	pwpp
碈	pstr
孖	penn
鬘	pqsj
圙	dogp
脟	dprx
姈	dkyk
祾	dkwg
峛	dfzh
㫰	durm
崀	duzm
饹	dktu
梾	djdd
鞡	dexd
瞭	dppc
礌	dhto
澛	dchr
僇	difw
稑	dimo
哢	dzuy
蓏	dpxl
簝	dokc
憭	dzcc
蹽	ddnc
辌	dqsc
㥄	dkcg
坽	dkok
醨	dnjd
㮾	dpdd
烺	dpmm
堎	dwog
簕	drkd
嫪	dwyw
藟	dgxo
眬	dapi
壸	umtj
焜	usmi
姱	uzyu
煃	uzmo
鲙	uobk
㧟	ujvu
崁	uszf
洘	uthu
堃	usvo
戣	ubkl
圐	ujgv
洭	uahg
嵁	uozt
衎	usfh
磡	ustd
硁	uhtl
炣	urmu
炌	ubme
㸆	uwmv
晙	exrg
䌹	evzu
㠇	eezj
膙	enrs
畯	exog
䴗	ebpy
腒	eeru
泃	eehu
岠	ehze
焗	ebmu
傕	eifq
砄	eity
焆	efmr
氿	lzhe
檞	ewdy
湝	ehhi
悈	epcl
玠	epge
峧	edzc
鼱	ejer
䴖	ejay
蹐	ennr
惎	elac
堲	eneo
祲	erwj
䲠	ssbr
倕	sbfs
惙	sxcj
巉	sqzo
弨	sulu
蹅	svnh
犨	sxfy
濋	schf
摴	sjvu
䢺	sjsb
摛	sgvd
胣	sfrj
憕	soch
赪	shof
牚	swbj
珹	sogl
宬	soll
疢	swim
瞋	sqpi
椆	stdu
婳	mfym
昒	mjrg
媓	mgyg
姮	moyh
垕	mkmo
觟	mfbo
鳠	mibj
鄠	mijb
昈	mirm
谼	maii
翃	maqc
竑	madk
吽	mvuy
㘎	mnug
崡	mqzm
熇	mrmu
龁	mdkj
饸	mdtu
盉	mdmp
嗐	mbuu
鄗	mwgb
虷	mqsl
翯	mrcu
齁	mxnu
爟	lcmq
矼	lytl
浭	lhhl
荄	laxf
暅	lwrh
鬶	llvq
羖	lcbj
蒄	lfxx
瓘	lcgq
琯	lbgl
鳡	lnbc
玕	logl
㭎	lydc
冮	lyhl
滆	ldhq
筀	leko
粿	lppl
鿍	luoq
馃	lptl
朏	vgrs
簠	vckp
鄜	vjlb
琈	vmgn
砆	vjtv
玞	vjgv
㳇	vihc
墦	vqoo
堼	mwoo
豮	vyqf
翂	vqch
牥	vyyv
昉	vprv
咡	boub
耑	hfzb
绖	hkzo
窎	hply
扂	humu
髢	hnsj
珰	hygh
璒	hhgh
扽	hwvo
叇	hbbd
炟	hamh
厾	hjkk
瑖	hcgj
埵	hpos
鞮	hgxf
轪	hbsh
捯	hrvh
跶	henh
䗖	hlse
垯	heoh
邨	xsob
悰	xacc
嶒	xozr
漼	xzhq
熜	xvmc
莝	xxxo
莿	xlxh
泚	xfhi
俵	ipfm
蛃	iqsi
鲾	igbo
塝	iuov
琫	imgv
胈	iarj
妭	iayj
祊	ihwv
镚	iwer
蔀	iixb
嶓	itzo
鲌	iqbi
脿	izrm
靽	isxi
湴	ishj
诐	iljj
佖	ilfi
邠	ivib
鲃	iebi
犇	iqyy
朳	iedi
隩	qwbh
璈	qrgg
唵	qnuh
卬	qzwb
盦	qofp
垵	qooy
毐	qrtg
舥	weki
褯	epwe
䴓	tgqy
诇	ctju
琄	ccgr
瑆	cjgt
琟	ghgq
瑨	ergr
㙘	juoy
埫	opou
垍	elon
垺	vmon
赒	kxiu
冔	csqj
揳	chvh
摏	svve
忳	ohco
祏	tnwu
禘	hlwe
嚭	wftu
豨	cgqe
硙	ghte
崄	cqzq
崿	brzu
溦	gxhg
漖	ephg
漷	mphb
氾	vqhk
溚	ovhu
沘	ifhi
晅	cbrh
旴	cerj
嬿	jsyb
姽	lzyk
姶	bryu
棫	jhdl
枅	egdu
骃	jvph
骍	cjpt
哃	oauu
鼫	tneu
锳	jjej
斶	sies
帡	wkeu
刬	sslh
燋	edmb
烠	mbmr
煁	symt
扆	jfmm
庼	aqlf
珖	lagb
虸	nfsn
蠋	kmss
蜐	eksd
蚄	vysv
㿠	mbib
颎	evif
岊	ekiz
羑	jdbe
筦	lbkb
筜	hykh
觭	egbu
