戔	aaaa
淺	aaaa
剗	aaaj
㳀	aaao
虦	aach
㴺	aach
波	aaco
涏	aadx
㵛	aaen
淇	aafo
㴣	aafy
㨇	aaht
濝	aaih
洋	aaio
划	aaja
剘	aajf
㵉	aajf
㓟	aajv
㴢	aakb
㶙	aakl
㳦	aald
㵜	aalr
㶃	aalx
淢	aanf
浯	aanm
㵄	aanu
盞	aasm
滶	aast
澌	aate
㶝	aatu
錃	aatw
碆	aavd
湛	aavv
婆	aaxc
㶂	aaxg
㵈	aaxx
㳲	aayd
涰	abbb
沢	abbo
漨	abce
渱	abcf
澅	abcf
浲	abcg
潘	abcm
澢	abcm
源	abdo
滍	abfb
湰	abfl
灙	abfm
灗	abfu
溞	abib
漟	abif
汊	abii
沋	abii
㳗	abii
㵃	abin
浕	abjo
泈	abjo
㳔	abkf
泽	abkg
浝	abki
泏	ablv
蜝	abmf
浊	abmo
沖	abmo
蛍	abmo
滚	abmx
洛	abnm
㦴	abnm
潪	abnr
渷	abnw
滾	abnx
洚	aboa
涤	abof
滩	abpr
汷	abqo
汌	abro
㴽	abup
汉	abxo
濜	abxs
収	abxv
浰	acaj
派	acaq
淫	acat
淨	acbb
泿	acbo
溋	acbs
汳	acbx
㵽	accc
㴲	acch
㶟	acch
灅	acci
瀘	accs
濦	accu
濾	accu
譱	accy
汏	acdo
漞	acdw
	acep
㳠	acep
灂	acfk
澒	acfm
江	acfo
渨	acfo
洿	acfs
溭	acgb
澽	acgd
㳩	acgf
㴂	acgi
沣	acgo
洉	achf
滮	achk
瀩	achm
淲	achq
浹	achw
溪	acic
漯	acih
㶉	acio
鸂	acir
滟	acjk
㴞	acjr
浮	acjv
㳵	acjv
㐢	acjv
㳶	acjv
湲	ackb
澎	acke
澍	ackf
浖	ackf
㶁	ackh
渭	ackm
渀	acll
滸	acll
湫	acmi
沺	acmo
㵞	acmu
溾	acmx
㳒	acmx
㵙	acnm
灤	acno
灣	acnq
澞	acnu
溵	acob
漺	acoo
鸿	acoq
㴎	acpg
潔	acph
㵮	acqf
潦	acqh
潲	acqk
溿	acqk
潙	acqx
㴡	acrm
渏	acrn
鴻	acrr
淹	acrv
渓	actg
淠	acud
滤	acup
㴓	acup
湱	acvd
㵔	acvf
㶆	acvf
溗	acvh
滹	acvl
滛	acvt
潩	acwf
浽	acxc
涹	acxc
諅	acyf
潻	acyl
滔	acyr
滠	adbb
㵵	adbi
淈	adbl
汜	adbo
滜	adcl
灄	addd
㵿	addd
㴋	addg
淶	addo
灈	addp
潠	addw
瀙	addw
渒	adel
漳	adfm
灨	adfm
頲	adfm
㶊	adfm
瀒	adfn
洱	adfo
㴐	adfv
颋	adfy
溦	adhs
㶌	adic
溇	adio
濼	adio
潺	adjj
瀧	adka
湇	adkm
灟	adlb
湨	adld
湶	adlm
㳮	adlm
漽	adlu
瀶	adlx
渥	adma
漏	admf
泪	admo
滯	admp
懘	admu
㴷	admw
埿	adni
涪	adnm
澔	adnn
泥	adnq
漑	adnr
濎	adob
浘	adot
涮	adpa
淿	adpm
濉	adpr
㶜	adqa
㴮	adqk
泊	adro
潚	adrr
滝	adrv
湟	adsg
泦	adsq
澂	adss
澵	adte
渺	adtk
濫	adts
灠	adtw
潳	advf
池	advo
激	advs
㳧	advv
澱	adwb
潼	adwm
涀	adwq
覚	adwq
廷	adxt
泣	adyo
㴊	aeba
溯	aebu
涎	aeed
澁	aeee
渄	aefh
泔	aefo
漠	aefo
澳	aegc
沄	aego
浅	aego
溢	aegs
澚	aegs
澧	aehe
灔	aehk
沚	aeho
濊	aeho
灎	aehs
滋	aeii
濨	aeiu
湚	aeiv
汑	aeja
溓	aejg
湔	aeka
湴	aekj
潽	aekr
浒	aell
漗	aelu
浀	aemo
㪨	aenb
歚	aenl
善	aenm
渪	aenn
泚	aenq
敾	aens
鄯	aenw
湈	aeof
涉	aeok
瀕	aeom
濒	aeoy
濗	aepm
溮	aepp
滏	aeqe
溉	aera
潨	aesi
洫	aesm
泆	aetg
渉	aetk
㵚	aetw
泲	aevr
渊	aewj
㳇	aewo
渋	aewy
濃	aexo
泛	aexp
湅	afah
洌	afaj
潈	afaq
澑	afcm
湙	afdc
洂	afdg
㴒	afdl
淒	afdx
洀	afeo
漕	afer
㶔	affc
法	affo
涱	affo
溤	affo
㶠	affr
瀤	affx
濔	afgm
澭	afgp
㶎	afhe
淬	afhl
沍	afhn
沆	afhq
瀊	afhs
澴	afhx
滀	afic
潫	afih
溼	afii
泫	afin
澤	afir
沔	afjv
瀀	afkb
渜	afkc
㿵	afkc
潀	afkh
液	afki
洏	afkm
澟	aflc
汙	aflf
漛	afll
濇	afln
盓	afls
澶	aflu
湏	afmm
頗	afmm
䫏	afmm
㵋	afmm
潶	afmo
濁	afob
沫	afof
漓	afom
淃	afon
灕	afop
沛	afpm
沞	afpm
鲎	afqo
渔	afqo
洟	afqy
涇	afrc
涷	afrh
澛	afrm
洦	afrm
浭	afro
污	afsa
溘	afsm
洹	afum
湎	afum
濖	afvf
澼	afwy
瀱	afxa
㵝	afxn
㳖	afxq
瀼	afxx
颇	afym
渕	agaj
沷	agbi
浺	agbm
泱	agcd
㵦	agce
戎	agda
㴘	agdm
㳢	agdr
浵	agfk
洒	agfo
浻	aggn
洞	aghf
湉	aght
涿	agii
淍	agin
浂	agio
漖	agjs
涍	agjv
洧	agkm
洕	agkm
滃	agmh
洃	agmi
汯	agmx
㳂	agmx
泂	agnm
㳓	agnm
㳣	agnq
涗	agnw
㳍	agpm
洘	agsa
浃	agso
沃	agto
涶	agto
鋈	agtw
瀦	agvf
汃	agwo
觉	agwq
浴	agyn
汭	agyw
瀸	ahaf
湪	ahaq
溄	ahbk
涺	ahbo
没	ahbx
灃	ahce
灧	ahck
湢	ahcm
灩	ahcs
㵹	ahef
㵇	ahef
浢	ahei
潂	ahek
㴻	ahek
洬	ahfd
澜	ahfh
湍	ahfk
潭	ahfm
滅	ahfm
浗	ahfo
㵯	ahfr
浇	ahfw
瀜	ahgb
湠	ahgm
滆	ahgr
淟	ahgw
漝	ahhd
溰	ahhe
減	ahhf
㵤	ahhh
漻	ahhk
濢	ahhl
瀥	ahhn
濯	ahhp
䀊	ahhs
澸	ahhu
瀷	ahhw
瀈	ahhx
湮	ahif
㳚	ahii
汎	ahii
渞	ahio
漴	ahip
盕	ahis
淥	ahll
涔	ahlw
峃	ahmo
汕	ahmo
沿	ahnm
溧	ahof
沨	ahow
漂	ahpg
㵱	ahpk
漼	ahpr
㴥	ahqk
㲹	ahqo
㶚	ahqu
潉	ahrj
涧	ahrm
润	ahsg
活	ahto
漰	ahuu
潥	ahwi
㴗	ahxc
漄	ahxi
涼	ahyo
淁	ahyo
澾	aiae
㿹	aiae
瀋	aibc
㴳	aibi
浪	aicb
瀗	aicu
浾	aidg
基	aiff
演	aifg
濱	aifm
汢	aifo
淀	aifs
渲	aifu
淩	aigb
淕	aigi
浤	aigm
汫	aigo
澄	aihe
綦	aihk
㵳	aihk
洼	aiif
濥	aiig
湗	aiik
涴	aiio
卪	aiiv
澆	aiiw
洔	aikf
㴼	aikr
涋	aild
㳤	aili
洸	ailo
溌	ailw
㸃	ailx
汴	ainf
洺	ainm
㴦	ainn
沱	ainq
溒	ainx
濅	aiob
浨	aiof
滐	aioo
瀏	aipa
溜	aipc
淙	aipg
涫	aipm
潑	aiqb
汐	aiqo
溈	aiqx
泞	airf
涬	airi
渖	airj
㵓	aism
涞	aiso
濵	aitm
泑	aiuc
淧	aiue
湀	aiug
滵	aiuh
沩	aiui
澝	aiul
濘	aiur
㵥	aius
浶	aiut
滨	aivg
泳	aivi
滱	aiwb
漃	aiwb
浣	aiwg
滓	aiwy
洝	aixc
瀉	aiyx
沘	ajao
㲺	ajao
浄	ajbb
㳅	ajdo
湝	ajdr
淋	ajfo
泟	ajfo
漹	ajfx
涣	ajgc
渙	ajgc
滳	ajgn
滴	ajgx
滼	ajhi
沵	ajhk
漜	ajif
汣	ajii
㵫	ajjr
潸	ajkm
淯	ajkm
澈	ajks
㳰	ajld
㪸	ajlf
㳆	ajlf
澥	ajlu
渧	ajmp
滂	ajmv
㳪	ajnm
柒	ajof
㳿	ajof
㴔	ajou
沏	ajpc
澿	ajpg
澘	ajrm
沎	ajro
敩	ajst
学	ajvo
汓	ajvo
濋	ajvs
湩	ajwm
沦	ajwo
㳘	ajwq
漤	ajxc
澹	ajxc
浐	ajxd
濓	ajxg
滻	ajxl
洈	ajxo
淊	ajyr
浌	akaa
澲	akag
㶋	akal
㳝	akat
㳞	akbm
泾	akcf
涖	akdy
沠	akeo
㳡	akep
瀆	akfm
沬	akgw
洊	akjv
泭	akkf
濮	akki
洑	akld
朞	akmf
涢	akmo
涜	akmw
洁	aknm
湺	akno
㳜	akof
洢	akpb
灇	akrb
瑬	aksi
潎	akst
鎏	aktw
瀛	akui
灜	akui
濤	akvk
㿬	akvv
溣	akwp
濧	akyk
流	akyo
漍	alaf
瀐	alaf
渽	alan
溨	alao
㵶	alap
瀻	alaw
溊	albb
涠	albg
汥	albx
洇	alcd
涳	alcf
㴱	alcq
戒	alda
㵠	aldl
㴭	aldm
汱	aldo
沲	aldv
潏	alen
渘	aleo
汩	alff
㵰	alfg
瀚	alfh
濣	alfl
澦	alfm
汁	alfo
澣	alfq
潮	alfu
漧	alfv
滪	alfy
溷	algd
㴄	algg
湳	algr
沾	alho
漥	alii
洲	alij
瀿	aljh
塰	alji
海	aljn
泋	alld
湥	alld
汻	allf
渁	allm
潌	alma
㵅	almm
泶	almo
浛	alnm
洄	alnm
溛	aloe
涃	alof
㶅	aloj
泬	aloo
灚	alow
濆	alpm
欺	alqf
㳄	alqo
涾	alrm
湃	alsg
㴏	alsg
盜	alsm
泩	alto
惉	alup
淰	alup
漡	alur
沑	alvo
㵲	alvo
㳬	alvs
汔	alvv
汚	alvv
潿	alvv
潕	alvx
汵	alwo
涸	alxf
汿	alxo
溶	alyn
溫	alys
泅	alyw
濺	amaa
㦶	amaa
測	amaj
泧	amao
洷	amao
泼	ambi
涘	ambt
澨	amch
渗	amck
㵢	amcm
灁	amdl
㵺	amdl
瀄	amea
澐	ameg
灍	amel
泻	amff
㦯	amff
㶒	amff
溕	amfg
瀾	amfh
濡	amfk
㴴	amfv
浚	amgb
㶘	amhf
沉	amhq
濶	amht
渎	amjc
瀮	amjf
㶄	amjy
㳙	amkm
㴰	amkn
㳎	amld
㶈	ammb
瀠	ammh
淡	ammi
瀅	ammi
滲	ammk
濴	amml
㴉	amml
㵕	amml
濙	ammm
灒	ammm
瀯	ammn
沮	ammo
浿	ammo
澠	ammo
濚	ammo
濳	ammr
㶕	ammr
灐	ammt
澇	ammu
瀴	ammx
濄	amne
治	amnm
渦	amnm
澪	amnq
㵡	amod
澖	amof
滗	amot
瀖	ampr
㴶	ampr
灞	amqu
浑	amra
溟	amrb
溍	amrm
澗	amrm
瀃	amrr
潤	amsg
㴛	amst
灀	amtf
洗	amto
鍌	amtw
潷	amub
㵍	amup
㵎	amuq
洠	amut
潣	amuy
沇	amwq
沈	amwq
漊	amxc
渾	amxf
皹	amxf
灛	amxl
浓	amxq
㴸	amyw
㵼	amyx
羴	anai
滄	anbn
㵀	anbt
漶	anbu
湌	ancb
溠	ancf
湒	andf
濈	andi
湤	andv
逜	anep
或	anff
㳼	anfl
㰲	anfl
䰥	anfm
惑	anfu
涡	angy
瀁	anic
游	anjv
涓	ankm
浥	ankv
㶛	anlg
戓	anma
吾	anmf
溳	anmm
滿	anmm
懣	anmu
喾	annm
浩	annm
営	annm
漌	anno
灘	annp
漢	annt
㳭	anof
㳏	anow
濰	anpr
泠	anqx
渑	anrv
䢩	anse
戜	ansg
浧	ansg
浞	ansh
塣	ansi
湓	ansm
敔	anst
洖	anug
溬	anvm
渫	anvo
漩	anvs
泄	anvv
㐚	anvv
㳾	anvv
汾	anwo
況	anwq
郚	anwv
澏	anxh
澡	anxo
泖	aoav
沒	aobx
瀔	aocb
濲	aocb
潯	aock
渹	aocy
泡	aodb
皰	aodb
湐	aodr
泒	aoeo
棊	aoff
泍	aoff
沐	aofo
栄	aofo
㳈	aofo
滖	aofx
淸	aogf
淆	aogk
淞	aogm
滈	aogn
浠	aogp
瀫	aoib
溸	aoih
汋	aoii
沭	aoii
溎	aoii
潹	aojf
潡	aojs
淳	aojv
漷	aojw
瀞	aokb
涁	aoke
浔	aokf
濪	aokk
清	aokm
㵾	aokw
汹	aolv
浸	aomb
濠	aomg
湸	aomh
漬	aomm
㴆	aomp
渟	aomr
沟	aomx
潱	aone
泃	aonm
氾	aono
洶	aool
漈	aopg
渿	aopg
鸴	aoqo
沕	aore
洵	aorm
湻	aorm
㳷	aorr
淴	aoru
㴤	aory
㳹	aosg
䀀	aosm
泙	aoso
淅	aote
汮	aoty
渣	aoum
涥	aouv
灪	aovk
淘	aovt
㳐	aovv
淗	aowi
㲼	aowo
㶇	aoxg
漆	aoyl
渍	aoym
㶍	apai
潒	apaq
潃	apbk
渡	apbx
㵌	apcd
渵	apcm
㴕	apct
潇	apdg
泷	apdo
瀟	apdr
瀓	apds
灆	apds
㵟	apds
㽏	apef
淽	apeh
漇	apes
㴀	apex
瀎	apfi
㵏	apfl
濭	apfs
渶	apgc
澕	apgg
渃	apgn
梁	apgo
沶	apgo
粱	apgw
潝	aphh
漎	aphs
涩	apie
澀	apie
㲽	apii
涊	apiu
瀺	apji
㳸	apjr
㵁	apky
澓	aplb
渰	apld
準	aplf
漭	apll
瀢	apme
灡	apmh
潰	apmm
泗	apmo
沼	apnm
濸	apnn
㵩	apno
潗	apof
濍	apou
濩	appb
溚	appw
漁	apqo
㙙	apri
瀂	aprm
渮	aprn
澫	aprn
淮	apro
沜	apro
㵧	aprv
洐	apsg
汘	apto
淓	apvy
洽	apwo
浼	apwq
㶓	apxd
满	apxh
潐	apxo
㵂	apxo
灌	apxp
懑	apxu
灢	apxx
溃	apym
㴙	apyr
瀳	apyx
渳	aqdf
㵒	aqdm
沸	aqdr
漲	aqff
瀰	aqfm
淔	aqfo
㴖	aqfo
㴚	aqgd
澻	aqge
淌	aqgn
汗	aqgo
皯	aqgv
滇	aqgw
泺	aqhk
潧	aqir
涨	aqit
纼	aqjj
泮	aqkg
消	aqkm
㳽	aqlh
涌	aqlm
慂	aqlu
湧	aqlu
㳕	aqmg
溑	aqmm
泓	aqmx
漒	aqnb
涚	aqnw
潍	aqpr
渢	aqqo
涕	aqqr
泎	aqto
溺	aqtt
渆	aqxa
洴	aqxg
湭	aqyf
澊	aqyk
㶖	arbf
滫	arbk
滌	arbo
鼝	arcb
淄	arcm
㿳	arcm
㵊	ardb
涟	arep
漫	arfb
㿸	arfb
湽	arfc
㳨	arfd
滭	arff
㴿	arfm
汀	arfo
澷	arfv
㶞	arfx
湡	argn
洡	argo
溻	arhh
灝	arhm
灏	arhy
澋	arhy
涅	arif
溡	arik
滉	aril
灦	arim
濕	arix
混	arja
湿	arkj
湦	arlt
㫷	armf
汨	armo
㴩	arnk
河	arnm
滒	arnn
㵆	arnn
㗟	arnn
灉	arnp
瀽	arns
淉	arof
㵣	arol
渇	aron
渴	arov
涆	arqg
䳢	arrf
鳪	arrl
淐	arrm
淵	arro
漅	arro
鴬	arro
潛	arrr
灊	arrr
温	arsm
浟	arst
滺	arsu
渐	arte
淏	arug
渂	aruy
洩	arve
濐	arvf
乼	arvv
瀑	arwl
溩	arxo
注	aryo
溂	asaj
汅	asao
螯	asbm
謷	ascy
䵅	asdb
聱	asdf
遨	asep
驁	asff
瀬	asfm
䫨	asfm
涑	asfo
鳌	asfq
汪	asgo
嶅	ashm
摮	asht
汍	asii
㿪	asii
瀨	asjm
濑	asjy
獒	asld
㳥	asld
㳃	aslf
㳺	aslj
漱	aslq
盀	asml
贅	asmm
鼇	asmm
湜	asmo
㳑	asmo
嗸	asnm
染	asof
鰲	aspq
湁	aspw
氿	asqo
鷔	asrr
濏	asse
潖	assk
潄	asst
浙	aste
敖	astg
㳊	asto
收	astv
鏊	astw
㥿	asup
骜	asvn
嫯	asxc
熬	asxo
赘	asym
蟴	atbm
漪	atcn
湄	atdm
渻	atdm
溏	atdn
㴑	ateb
斯	atef
濂	ateg
沂	ateo
逤	atep
濛	atfg
湘	atfo
浉	atfp
鲨	atfq
裟	atfx
峾	athm
挲	atht
垽	atif
潆	atih
泝	atii
泯	atja
㽄	atja
灖	atjf
湣	atjr
涛	atkf
沙	atko
㶐	atku
澬	atlm
滑	atmo
䣉	atnk
溁	atof
桬	atof
㲚	atot
鯊	atpq
滢	atsi
滥	atsm
滧	atst
滽	attj
漮	attl
濽	attm
潜	attr
涝	atuc
㸺	atut
硰	atvd
潴	atvf
乷	atvv
瀍	atwi
淦	atwo
娑	atxc
瀇	atxg
洨	atyo
㲿	atyo
浏	auaj
津	aubo
涒	aubo
労	auco
氻	auco
㵬	aucs
濞	aucu
泸	audb
济	audr
湕	audx
泌	auee
㳴	auei
㴵	aues
淖	aufm
浦	aufo
洍	aufo
㴨	augi
洙	augw
㶀	auhk
瀣	auif
堻	auif
洆	auif
㴁	auig
澯	auiw
溥	aukf
淂	aukf
淝	aukv
溴	auld
添	aulk
滷	aulu
濬	aumd
㴍	aumi
湞	aumm
泹	aumo
㴠	aunl
泇	aunm
㵑	aunm
㴯	aunr
滦	auof
㴪	auof
璗	auoi
燙	auom
湯	auor
盪	auos
惎	aupf
忢	aupf
沁	aupo
湾	auqb
期	auqf
汲	auqo
㳉	auqo
洎	auro
済	aurr
汼	auto
㴧	auup
淜	auuq
涵	auwl
㴫	auwv
㜑	auxc
㵻	auyb
浈	auym
汶	auyo
決	auyw
戡	avaa
潞	avbn
滘	avcn
碁	avdf
沰	avdo
澉	avds
汈	avff
䫖	avfm
渚	avfo
浜	avgw
泀	avhf
㴈	avhm
泜	avii
夦	avii
泤	aviy
斟	avjl
汛	avlf
卙	avlf
泘	avlf
歁	avlq
㳌	avmo
滞	avmp
㽎	avmw
深	avof
浫	avqg
汦	avqo
汤	avre
烫	avrm
涽	avrm
㳋	avro
湑	avsk
尠	avtk
㪛	avub
勘	avuc
甚	avvf
㐞	avvf
㐏	avvf
湋	avvo
㲸	avvo
㵭	avxo
淤	avyj
汸	avyo
漋	awbl
㶏	awcu
瀵	awcw
港	awdb
㴹	awep
洪	awfo
瀡	awge
沅	awgo
淪	awgp
淑	awhb
潾	awio
洣	awio
澮	awir
渝	awka
浳	awkm
浬	awmo
潋	awms
溆	awob
潊	awob
涂	awof
塗	awoi
漵	awos
淛	awpa
濻	awpm
潅	awpr
㳱	awrm
涐	awto
鍙	awtw
泐	awuc
澺	awup
滁	awwo
滰	awwq
洮	awwy
澰	awxh
濹	awxi
㶑	awxl
瀌	awxo
瀹	awxp
㵸	awxp
瀲	awxs
漉	awyo
湆	awyo
㳯	awyo
汇	axao
瀝	axce
汝	axco
㵴	axdf
㵐	axel
漣	axep
沽	axfo
湂	axfs
満	axgh
溝	axgi
汧	axgo
洓	axhk
洅	axif
溹	axih
涯	axii
漙	axik
潓	axiu
灑	axiw
㴾	axjs
渤	axju
浡	axjv
潵	axks
洰	axlb
溽	axlk
漘	axlk
渌	axll
滣	axln
渠	axlo
浱	axlo
油	axmo
㵖	axnh
洳	axnm
㖳	axnn
漚	axnx
沤	axow
濿	axpn
滙	axpr
㴟	axrj
潬	axrl
㳻	axrm
涄	axsa
洭	axsg
聻	axtd
漸	axte
壍	axti
魙	axtm
嬱	axtx
䤔	axty
沥	axuc
湖	axuq
瀭	axwa
湹	axwm
㳳	axwq
㴌	axxf
黉	axxg
潢	axxg
汒	axyo
㳁	axyw
测	ayaj
沌	ayao
涭	aybx
渼	aycd
涙	aycd
湼	aycf
溱	ayct
汰	aydo
浍	ayeg
溅	ayeg
灋	ayff
酒	ayfo
澙	ayfx
㴜	aygp
涻	ayhg
漾	ayii
溲	ayjb
湵	ayji
沴	ayke
㴬	aykf
淎	aykg
淚	ayld
溙	ayll
㴃	aylm
滬	aynk
淭	ayof
沧	ayon
潟	ayox
沪	aypo
湷	ayrm
濟	ayrr
洤	aysg
㵪	aytl
汽	ayto
湊	ayug
滊	aywi
汄	aywo
淣	aywq
溔	ayxo
㳛	ayyw
䗃	baaa
戏	baax
蜓	badx
蟮	baen
蜞	bafm
蛘	baim
虲	balm
处	balq
蜮	banf
㰶	banl
咎	banm
昝	barm
蟖	bate
㝿	bavd
虯	bavm
蚾	bavm
蟝	baxo
剟	bbba
叕	bbbb
敠	bbbb
茻	bbbb
蝃	bbbb
厵	bbbd
逫	bbbe
欼	bbbl
歠	bbbl
叠	bbbm
蚇	bbbm
蟲	bbbm
顙	bbbm
䫎	bbbm
桑	bbbo
毲	bbbo
鵽	bbbr
敪	bbbs
蠱	bbbs
芔	bbbv
釈	bbbw
叒	bbbx
颡	bbby
㯩	bbby
䗦	bbce
蜂	bbcg
蟠	bbcm
蟷	bbcm
螈	bbdm
螳	bbif
蛏	bbif
蚘	bbii
释	bbkg
蛖	bbki
䖦	bblv
䂐	bblv
蚛	bbmm
䖵	bbmm
蜘	bbnm
蛒	bbnm
蟐	bbpm
㪿	bbte
蟋	bbup
艸	bbvv
㕜	bbxm
双	bbxx
㕛	bbxx
蜊	bcaj
劏	bcaj
蟍	bcao
䖰	bcaq
蛝	bcbm
艰	bcbx
蜏	bccc
蠝	bccc
螔	bcch
蠦	bccs
蠭	bceb
䗬	bceb
㷭	bcem
逢	bcep
螁	bcep
劃	bcfa
畫	bcff
虹	bcfm
㞇	bcfo
蚌	bcgm
夆	bcgq
翻	bchh
䗂	bchq
蛺	bchw
螇	bcic
螺	bcih
蝰	bcii
㽆	bcja
㽃	bcja
蝌	bcjl
蜉	bcjv
蝯	bckb
蟛	bcke
蛶	bckf
蝟	bckm
畵	bclv
當	bcml
备	bcmq
番	bcmw
螝	bcmx
蟢	bcnm
䘎	bcnq
㼕	bcoe
尮	bcof
䗮	bcoo
蟟	bcqh
蟡	bcqx
㞆	bcrn
䗁	bcrn
鷭	bcrr
㞄	bcrv
勫	bcuc
惫	bcup
飜	bcvd
蠩	bcvf
鄱	bcwv
矮	bcxc
蜲	bcxc
㞂	bcxc
邍	bcxe
㶻	bcxo
韬	bcyr
蠼	bddb
蠷	bddp
蟤	bddw
蜱	bdel
蟑	bdfm
䎹	bdfw
蝼	bdib
蠬	bdka
蠾	bdlb
螮	bdmp
蚭	bdnq
蟶	bdns
蟰	bdrr
蝗	bdsg
尷	bdts
虵	bdvm
蜆	bdwq
覌	bdwq
䂓	bdwq
蝍	beav
蜒	beed
甞	befl
蚶	befm
蟆	befm
䖮	begn
螠	begs
螆	beii
䗹	beiu
虴	beja
尲	bejg
螊	bejg
䗒	bekj
螕	belj
蟌	belu
蛐	bemm
蟕	benl
蝺	benn
䂑	benq
䗋	beof
迟	bepb
蠥	bepb
违	bepg
孼	bepj
迚	bepm
櫱	bepo
螄	bepp
㔎	bepp
糱	bepw
辥	bepw
䗄	bete
蛈	betg
蚥	bewm
蛚	bfaj
䖼	bfav
蚩	bfbm
䗵	bfcf
螬	bfer
矪	bfet
螞	bffm
䗅	bffm
㞢	bffv
蜶	bfhl
蚢	bfhq
蠉	bfhx
䘃	bfif
蟀	bfil
蚿	bfin
蠌	bfir
釋	bfir
蝡	bfkc
虶	bflf
㝼	bflf
㚅	bflt
蟺	bflu
黨	bfml
蜽	bfmm
蝢	bfmm
蟔	bfmm
順	bfmm
願	bfmm
矲	bfmn
蠋	bfob
螭	bfom
蜷	bfon
蛦	bfqy
蛵	bfrc
蝀	bfrh
旹	bfrm
蛨	bfrm
䀌	bfrs
䗘	bfsm
蜨	bfts
蜐	bfuc
蝒	bfum
䣣	bfwv
妛	bfxc
裳	bfxq
蠰	bfxx
顺	bfym
韨	bgbi
蛂	bgbi
㝾	bgcf
蝐	bgdm
䖶	bgdm
矫	bgdr
蝄	bgex
蚒	bgfy
蚺	bgif
蜩	bgin
蛕	bgkm
蚦	bglg
螉	bgmh
㞀	bgmi
蚣	bgmx
矯	bgnn
蟜	bgnn
蛯	bgnq
螧	bgnr
蛻	bgnw
蛧	bgoo
䖫	bgqg
蛱	bgsm
矨	bgtt
蚬	bgwq
观	bgwq
蚋	bgyw
䘋	bhaf
牚	bhal
蚜	bham
蝝	bhaq
䂕	bhaq
蜛	bhbm
蝠	bhcm
短	bhei
蟫	bhfm
蛷	bhfm
蛲	bhfw
蝛	bhfx
螎	bhgr
螘	bhhe
蟉	bhhk
蠗	bhhp
蛡	bhhx
矬	bhif
䗎	bhif
䖠	bhii
蝆	bhkg
螵	bhpg
蠵	bhpn
䖹	bhqg
虮	bhqm
処	bhqq
掌	bhtl
蛞	bhtm
䗩	bhwh
蟽	biae
蚤	bibm
蜋	bicb
螛	bicn
䘆	bicu
䖳	biej
螂	biew
螾	bifg
堂	bifl
蠙	bifm
頚	bifm
蝊	bifs
蝖	bifu
圣	bifx
䗀	bigb
䗳	bihe
尤	biid
蟣	biid
蛙	biif
蜿	biio
蛥	biiq
㗬	biiq
蟯	biiw
叉	biix
䗏	bimb
䂒	binm
蛇	binq
蚁	biow
䗜	bipc
䗆	bipm
䂔	biri
蚴	biuc
䗿	biur
䖾	biwg
䣘	biwv
瓽	bjal
蚍	bjam
蟙	bjar
螽	bjbb
蝔	bjdr
䶱	bjem
蚽	bjff
䗼	bjfm
䗡	bjfx
螪	bjgn
蜌	bjif
蜟	bjkm
蚪	bjlf
蠏	bjlu
蝜	bjmm
螃	bjmv
尽	bjob
冬	bjoq
䧷	bjpr
䳉	bjrr
蜢	bjsm
虸	bjvm
㐑	bjvv
尰	bjwm
蝩	bjwm
蟾	bjxc
尯	bjxo
蛫	bjxo
蜭	bjyr
䖣	bkem
㣊	bkeq
䖞	bkfm
对	bkfx
尨	bkii
蚹	bkkf
䗱	bkni
蛣	bknm
蛜	bkpb
䗔	bkub
怼	bkup
蚆	bkvm
蚮	bkwa
蟘	bkwm
䖻	bkym
蟈	blaf
䘂	blaf
蠘	blap
蝦	blbb
蚑	blbx
䖓	blch
蜠	blct
蝚	bleo
䪼	blfm
蝻	blgr
蛅	blhm
欪	bllq
螲	blma
㝽	blmd
蛔	blnm
蛿	blnm
㞊	blpb
䄐	blpd
祟	blpg
㱁	blpl
蟦	blpm
䳳	blpr
㰩	blqm
欢	blqx
蝮	blrb
蝈	blsi
﨡	bltm
㔘	bluc
䖡	blvm
蜁	blvs
虼	blvv
出	blvv
蟱	blvx
粜	blwi
蚙	blwm
糶	blwp
䢺	blwv
䗴	bmad
蛭	bmam
䗻	bmea
䘊	bmfi
蠕	bmfk
㶳	bmib
䗊	bmmi
賞	bmml
蛆	bmmm
蛽	bmmm
蠅	bmmm
蠑	bmmo
蟧	bmmu
蠳	bmmx
蝸	bmnm
螟	bmrb
䀆	bmsm
蛑	bmut
兖	bmwq
螻	bmxc
䗗	bmxg
衮	bmxq
㓢	bnaj
螥	bnbn
䗭	bnbu
㞉	bncf
聟	bndf
虾	bnfm
頟	bnfm
䵹	bnfm
咫	bngw
蜗	bngy
䎊	bnhh
蝣	bnjv
蜎	bnkm
洜	bnlm
蟎	bnmm
鼅	bnmm
䝷	bnmm
各	bnmq
知	bnmt
䗢	bnne
螼	bnno
㲛	bnot
雒	bnpr
蛉	bnqx
智	bnrm
嘗	bnrm
鵅	bnrr
蝇	bnrv
䚐	bnrw
敋	bnst
㪾	bnte
蜈	bnug
㤩	bnup
蝶	bnvo
蜣	bnvv
蚡	bnwm
兗	bnwq
㞣	bnwv
袞	bnxq
䣽	bnyf
夅	boaq
蟳	bock
蜔	bocm
蚫	bodb
蛌	boem
逄	boep
棠	bofl
蚞	bofm
条	bofq
蜙	bogm
䖷	bogp
蝋	bohk
螦	boih
尥	boii
虳	boii
蝳	bojn
蜳	bojv
蜻	bokm
蝬	bolb
蠔	bomg
蝏	bomr
蚼	bonm
鸡	boqx
䖲	borm
䗓	boru
蚲	bosm
蜥	bote
蚝	botm
蚐	boty
蜪	bovt
䗇	bowi
蟓	bpaq
蝂	bpcb
蠎	bpcl
虭	bpcm
蟏	bpdg
蠨	bpdr
䗯	bpep
蠛	bpfi
蠴	bpfv
蝧	bpgc
雟	bpgn
蜹	bpgy
䗥	bphs
韧	bpii
蟒	bpll
常	bpml
尵	bpmm
蛁	bpnm
䂏	bpnm
蠂	bpno
蠖	bppb
矱	bppb
䗨	bpqm
蜼	bprm
蠇	bprn
雉	bprt
䗶	bprv
䧽	bprw
难	bprx
㦂	bpup
蛤	bpwm
螨	bpxh
蟅	bpxo
蟭	bpxo
蠸	bpxp
虷	bqgm
矰	bqir
矧	bqjj
蚓	bqjj
蛸	bqkm
蛹	bqlm
蜕	bqnw
蝉	bqrl
蚱	bqtm
蛢	bqxg
蝤	bqyf
䗛	brbk
螩	brbo
螏	brbt
䗑	brdy
蟃	brfb
虰	brfm
䗾	brix
蜫	brja
蠟	brlf
䗌	brlt
書	brmb
蚎	brmm
蚵	brnm
㞁	brnq
蜾	brof
蟂	brof
㞅	brof
蠍	brol
蜴	bror
蝎	brov
蜵	brrm
䗉	brrm
䳋	brrm
鴙	brrt
蝿	brrv
鳮	brrx
韫	brsm
蝹	brsm
螐	brxo
蛀	brym
蝲	bsaj
尪	bsgd
蚟	bsgm
㞷	bsgv
䟫	bshl
盅	bsmm
蛊	bsmm
蝭	bsmm
蝞	btdm
螗	btdn
蝷	bteb
蠊	bteg
蚚	btem
蠓	btfg
蛳	btfp
蚨	btgm
蚸	btii
䗫	btjf
䖢	btkm
蠀	btlm
尳	btmd
螖	btmm
蝾	btof
尴	btsm
䗤	bttj
䗧	bttl
蛟	btym
务	bucq
劝	bucx
蛴	budr
䖩	buee
蜅	bufm
蛛	bugw
䗚	bukf
螑	buld
昼	bumb
晝	bumb
蜖	bumm
䖧	bumm
蝪	buor
愿	bupd
忠	bupm
悉	bupw
蚏	buqm
螅	buup
蛠	buuu
蜬	buwl
蚊	buym
蚗	buyw
䖨	bvdm
蝫	bvfm
蚳	bvii
䖬	bvmm
䗖	bvmp
蚂	bvnm
蚔	bvqm
蚯	bvrm
蝑	bvsk
虬	bvvm
蚄	bvym
蚖	bwgm
蜦	bwgp
䗲	bwio
夈	bwiq
蝓	bwka
蜍	bwof
党	bwql
蛾	bwtm
䗷	bwup
邓	bwvx
䖴	bwwy
螰	bwym
蠮	bxbh
䗈	bxdm
蟩	bxel
蛄	bxfm
蛼	bxfm
蚈	bxgm
蟵	bxhk
蟪	bxiu
矩	bxlb
蚷	bxlb
榘	bxlo
蜄	bxlo
蚰	bxmm
賮	bxmm
釉	bxmw
蚅	bxon
蠣	bxpn
䘈	bxpu
蝘	bxrc
蟬	bxrl
蜡	bxrm
䖱	bxsg
盡	bxsm
蛎	bxta
螹	bxte
蝴	bxuq
蟥	bxxg
㐮	bxxq
虻	bxym
蛃	bxyw
螓	byct
蚧	bydr
尬	bydr
蠄	byfm
蝙	bygp
㞈	bygp
螋	byjb
蜯	bykg
蜧	byld
赏	byml
䗰	bymm
䘱	bynx
蝽	byrm
蠐	byrr
蜺	bywq
蟻	bywt
諓	caaa
䖽	cabm
覛	cadw
誔	cadx
䅍	cadx
䵩	cafm
稘	caft
諆	cafy
䄾	cagd
羍	caid
詳	caiy
㓚	cajf
利	cajt
䚯	cajy
誡	cald
訃	caly
稢	canf
㚜	canf
㽣	canf
語	canm
梨	caof
䱘	capq
奫	carr
謸	cast
鋫	catw
㸒	catw
䚾	caty
悡	caup
犁	caut
卭	cavf
皷	cavf
秛	cavt
諶	cavv
訆	cavy
詖	cavy
㴝	cayl
䛮	cban
畷	cbbb
諁	cbbb
爭	cbbw
詜	cbbx
訳	cbby
譒	cbcm
譡	cbcm
謜	cbdy
返	cbep
讜	cbfm
處	cbhq
諬	cbic
嵇	cbih
嵆	cbih
訍	cbii
訧	cbii
稽	cbir
㛷	cbix
詘	cblv
种	cbmt
䜇	cbmx
訲	cbmy
䌎	cbnh
㨼	cbnh
略	cbnm
畧	cbnm
詻	cbnm
䅂	cbnm
夼	cbrd
甽	cbrm
訓	cbry
戤	cbsa
盈	cbsm
䛈	cbty
䛱	cbup
夃	cbxc
反	cbxe
穣	cbxx
譲	cbxx
誗	ccaj
䆌	ccbc
畈	ccbx
䛀	ccbx
詪	ccby
誘	cccc
讄	cccc
㠭	cccc
䅎	cccc
疉	ccch
纍	ccch
謕	ccch
壘	ccci
壨	ccci
㽮	cccl
畾	cccm
疊	cccm
櫐	ccco
氎	ccco
㲲	ccco
鸓	cccr
䴎	cccr
䴑	cccr
秀	ccct
䄧	ccct
穩	cccu
譿	cccu
㔣	cccu
罍	cccv
礨	cccv
譶	cccy
䚮	cccy
夶	ccdd
㚐	ccdd
透	ccep
穱	ccfk
頺	ccfm
誇	ccfs
訌	ccfy
稷	ccgb
謖	ccgb
稱	ccgi
遞	cche
詬	cchf
歋	cchl
讞	cchl
䫢	cchm
䴘	ccho
	ccho
虒	cchq
諕	cchq
䛢	cchq
鷉	cchr
誣	cchw
㽠	cchw
䛟	cchw
謑	ccic
謻	ccii
稲	ccjr
稃	ccjv
諼	cckb
㽟	cckf
譃	cckj
稩	cckm
膚	cckm
謂	cckm
䛻	ccld
奋	ccmd
畕	ccmm
謯	ccmm
謉	ccmx
譆	ccnm
彗	ccob
䛶	ccof
熭	ccom
慧	ccou
穏	ccou
㥯	ccou
稧	ccpc
䜍	ccqh
譌	ccqx
䅨	ccrm
畸	ccrn
䛴	ccrn
㽢	ccrv
䅖	ccrv
䛳	ccrv
㪭	ccsb
盧	ccsm
顱	ccsm
鸕	ccsr
㔧	ccsu
秝	cctt
訸	ccty
虜	ccuc
慮	ccup
諰	ccup
勴	ccuu
譇	ccvf
謼	ccvl
謡	ccvt
穓	ccwf
諉	ccxc
䅗	ccxc
䅑	ccxc
謔	ccxf
䛺	ccyd
稻	ccyr
謟	ccyr
誩	ccyy
㿴	cdav
誳	cdbl
諏	cdbx
䜂	cdcl
讘	cddd
㪺	cddl
䅘	cddt
譔	cddw
誺	cddy
稗	cdel
諀	cdel
㽡	cdel
耷	cdfd
誀	cdfy
穆	cdhk
䆍	cdka
䆈	cdle
穉	cdlu
䜄	cdlu
稖	cdnm
秜	cdnq
䛏	cdnq
鼐	cdob
䅏	cdot
䛲	cdpm
夰	cdrd
䄸	cdrt
諻	cdsg
䅣	cdsg
譤	cdvs
䄬	cdvt
訑	cdvy
穜	cdwm
疃	cdwm
覓	cdwq
誢	cdwq
䅐	cdwq
稺	cdwy
謘	cdwy
誕	ceed
誹	cefh
詌	cefy
謨	cefy
䜒	cegc
夽	cegd
謚	cegs
䅬	cegs
秐	cegt
奯	ceho
穢	ceho
䄳	ceht
訨	cehy
稵	ceii
㽧	ceii
秅	ceja
託	ceja
稴	cejg
謙	cejg
譾	cekh
諩	cekj
謭	cekp
譜	cekr
䛂	celd
䛜	celo
謥	celu
龝	cemm
訿	cenq
謀	ceof
退	cepb
辸	cepc
达	cepd
這	cepy
穊	cera
秩	cetg
詄	cetg
秭	cevr
穠	cexo
譨	cexo
奒	ceyw
畡	ceyw
該	ceyw
䜚	cfae
諫	cfah
䅀	cfaj
疅	cfcf
爵	cfek
䜊	cfer
稏	cfft
詓	cffy
䛫	cffy
䛩	cffy
穪	cfgm
稡	cfhl
誶	cfhl
秔	cfhq
㽘	cfhq
譞	cfhx
稸	cfic
畻	cfif
詃	cfin
譯	cfir
䆁	cfir
䜡	cfkb
稬	cfkc
㣏	cfke
䛔	cfkm
巵	cfkv
訏	cflf
䖉	cflf
䄨	cflf
穡	cfln
譠	cflu
䆄	cflu
項	cfmm
䅡	cfmm
䆉	cfmn
䆀	cfmt
畏	cfoc
秣	cfof
㭐	cfof
㭆	cfof
謧	cfom
䅻	cfom
卮	cfon
䅚	cfon
䄺	cfqy
誙	cfrc
諌	cfrh
䅫	cfrh
穞	cfrm
稉	cfro
奭	cfrr
刳	cfsa
夸	cfsa
匏	cfsd
綔	cfsh
㰭	cfsl
瓠	cfso
鴮	cfsr
	cfst
䲣	cfst
郀	cfsw
誱	cfts
奤	cfum
䜑	cfup
畩	cfxq
穂	cfxu
穰	cfxx
讓	cfxx
项	cfym
劇	cgaj
秡	cgbi
詙	cgbi
畟	cgbq
秧	cgcd
詇	cgcd
䜔	cgce
豦	cgdh
遽	cgep
誷	cgex
䄽	cgft
秱	cghf
詷	cghf
爯	cgif
畘	cgif
諑	cgii
稠	cgin
奝	cgin
調	cgin
誟	cgjv
詴	cgkm
䛁	cglg
詼	cgmi
訟	cgmx
詗	cgnm
穚	cgnn
譑	cgnn
䅲	cgnr
稅	cgnw
說	cgnw
䚷	cgsa
諡	cgss
秗	cgtt
䅜	cgtt
訞	cgty
諈	cgty
勮	cguc
觅	cgwq
䛦	cgyn
訥	cgyw
䄲	cgyw
虥	chaa
讖	chaf
䆎	chaf
㓨	chaj
䖌	chaj
䛹	chaq
䄰	chat
訝	chay
䅕	chbt
設	chbx
䛯	chby
虤	chch
稫	chcm
諨	chcm
贙	chcm
䖜	chcr
覡	chdw
覤	chdw
䛋	chdy
戲	chea
甝	chef
䖒	chei
䛠	chei
㱆	chel
逅	chep
覻	chew
后	chfe
諯	chfk
譚	chfm
頰	chfm
頽	chfm
颓	chfy
甗	chgj
獻	chgl
鬳	chgr
䛿	chgr
觋	chgw
齾	chgw
謵	chhd
䅱	chhe
諴	chhf
䖗	chhf
疁	chhk
穋	chhk
謬	chhk
䜗	chhu
詡	chhx
蛩	chib
䅃	chic
聓	chid
垕	chif
諲	chif
㧬	chih
巩	chii
訉	chii
㼦	chij
秽	chiq
鞏	chiq
跫	chis
銎	chit
㠫	chit
恐	chiu
䂬	chiv
䊄	chiw
䡗	chix
㼪	chja
尕	chkc
夵	chkd
彪	chke
䚱	chky
㰰	chlq
㞭	chmd
䖕	chmm
䜖	chmm
秈	chmt
㟀	chmt
訕	chmy
䛇	chnm
鹀	choq
虝	chor
謤	chpg
䅺	chpg
䖘	chpi
穨	chpm
讗	chpn
㽯	chpn
䜅	chpr
虎	chqh
䬌	chqq
秃	chqt
虪	chrf
䖑	chrm
鵊	chrr
鵐	chrr
鵚	chrr
䆇	chrr
䖚	chrx
巬	chtg
秳	chtt
話	chty
㪎	chub
劶	chuc
㤲	chup
䖖	chvm
誠	chvv
夾	chwd
巫	chwf
郈	chwv
郟	chwv
䖛	chxh
稤	chyt
䖋	chyw
䄼	chyw
諒	chyy
讅	cibc
稂	cicb
誏	cicb
奚	cicd
㰿	cicl
䫣	cicm
谿	cicn
雞	cicp
鷄	cicr
䜢	cicu
秺	ciej
詫	ciej
垦	cifb
圶	cifd
穦	cifm
諚	cifs
諠	cifu
稜	cigb
稼	cigd
稑	cigi
畊	cigm
證	cihe
累	cihk
乿	cihv
䜁	ciic
穖	ciid
譏	ciid
畦	ciif
奎	ciif
詿	ciif
䅅	ciif
畹	ciio
䛷	ciio
奓	ciiq
移	ciiq
誃	ciiq
㚉	ciiq
㥣	ciiu
䜝	ciiv
穘	ciiw
譊	ciiw
畤	cikf
秲	cikf
詩	cikf
誼	cimm
詺	cinm
㚚	cinm
詑	cinq
䛄	cion
謋	cioo
誴	cipg
詝	cirf
䛭	ciri
詏	ciuc
詠	civi
穯	cixn
戱	cjaa
瓨	cjaf
毗	cjam
毘	cjam
識	cjar
秕	cjat
䚹	cjay
諍	cjbb
嗠	cjbn
稭	cjdr
諧	cjdr
㚞	cjfd
秠	cjff
証	cjfy
諃	cjfy
讂	cjgb
讁	cjge
謪	cjgn
謫	cjgx
称	cjhk
畂	cjii
虛	cjjh
虨	cjke
艳	cjkv
科	cjlf
䚵	cjlf
䆋	cjmm
諦	cjmp
謗	cjmv
䅭	cjmv
冭	cjod
㲗	cjot
稳	cjou
䳕	cjrr
穐	cjrv
訛	cjry
㔜	cjuc
孕	cjvc
季	cjvt
秄	cjvt
乳	cjvv
㐠	cjvv
孚	cjvw
畽	cjwm
種	cjwm
諥	cjwm
㘒	cjwn
郛	cjwv
譫	cjxc
諺	cjxk
詭	cjxo
諂	cjyr
戯	ckaa
秹	ckat
䛘	ckat
蟚	ckbm
鶢	ckbr
爰	ckbx
虢	ckch
覷	ckdw
彭	ckef
㣉	ckef
䚲	ckey
讟	ckfc
夺	ckfd
尌	ckff
讀	ckfm
頱	ckfm
寽	ckfw
討	ckfy
觑	ckgw
虡	ckgw
㚝	ckii
甏	ckja
虚	ckjh
詂	ckkf
歔	cklq
胃	ckmm
読	ckmw
穙	ckni
秸	cknm
詰	cknm
䛙	ckof
㲕	ckot
詽	ckqg
誌	ckup
夿	ckvd
疇	ckvk
譸	ckvk
譵	ckyk
䜟	claf
鼜	clbb
瞽	clbd
戶	clbe
鼟	clbe
鼚	clbf
䵽	clbf
䅩	clbg
鼞	clbi
鼕	clbj
鼙	clbl
䵿	clbl
鼛	clbn
䶀	clbp
鼘	clbr
䶁	clbr
䥢	clbt
鼓	clbx
秓	clbx
䚳	clbx
秵	clcd
䅝	clcf
稛	clct
䅰	clcu
㚏	cldd
遁	clde
瞂	cldi
畎	cldm
盾	cldm
鶞	cldr
譎	clen
㽥	cleo
夲	clfd
穥	clfg
謿	clfu
計	clfy
夳	clgd
諵	clgr
䛝	clhm
秥	clht
詀	clhy
㙒	clif
詶	clij
畮	cljn
誨	cljn
奔	clld
逩	clle
許	cllf
㷏	cllm
汞	clmf
貭	clmm
誝	clnm
䛛	clnm
稇	clof
䛎	cloy
逓	clpe
乕	clpm
䛪	clqb
㰻	clqf
䚿	clqy
稪	clrb
誻	clrm
盢	clsm
所	clte
乺	cltv
稔	clup
諗	clup
㚎	clvd
訖	clvv
譕	clvx
䚼	clvy
訡	clwy
稒	clxf
质	clym
穃	clyn
魊	cmaf
魌	cmaf
秷	cmat
皻	cmav
誈	cmay
蝵	cmbm
誒	cmbt
䰧	cmch
䅟	cmck
魖	cmck
	cmck
䰦	cmdl
覰	cmdw
魐	cmeg
䰡	cmet
讕	cmfh
穤	cmfk
譳	cmfk
㽭	cmfk
魑	cmfm
魎	cmfm
䫥	cmfm
謣	cmfs
䅉	cmft
畯	cmgb
稄	cmgb
誜	cmgb
魃	cmgi
䰣	cmgo
魍	cmgx
魒	cmhp
揫	cmht
魕	cmid
秋	cmit
䰫	cmiw
甃	cmja
魁	cmjl
讇	cmjy
鬽	cmke
魅	cmkg
鬾	cmlb
湬	cmlm
䰬	cmln
魆	cmma
燮	cmmb
㚗	cmmd
貢	cmmf
虘	cmmh
談	cmmi
㽊	cmmj
穇	cmmk
謲	cmmk
㽩	cmmk
爕	cmmm
畳	cmmm
穳	cmmm
讚	cmmm
䵸	cmmm
租	cmmt
䜎	cmmu
㚒	cmmw
詛	cmmy
譝	cmmy
秮	cmnm
詒	cmnm
諣	cmnm
䰯	cmns
鹙	cmoq
㡑	cmpm
魋	cmpr
䨂	cmpr
䰢	cmps
譗	cmpw
魈	cmqk
魓	cmrf
䰠	cmrj
鶖	cmrr
䰨	cmtd
鬿	cmte
鍫	cmtw
詵	cmty
㪥	cmub
愁	cmup
慐	cmup
譋	cmuq
牵	cmut
訦	cmwq
㽙	cmwq
䣜	cmwv
媝	cmxc
謱	cmxc
䅹	cmxc
厺	cmxd
諢	cmxf
魉	cmxh
秾	cmxq
鬼	cmxr
私	cmxt
魀	cmyd
醔	cmyf
䰮	cmyw
謒	cnbn
䅮	cnbn
譺	cnbs
㽨	cncf
囍	cncn
諿	cndf
积	cngw
䛊	cngw
噽	cnjf
嚭	cnjn
䅌	cnkm
歖	cnlq
夻	cnmd
喜	cnmf
和	cnmt
㕿	cnmt
蠻	cnnb
奱	cnnc
矕	cnnd
巒	cnnh
攣	cnnh
孿	cnnj
㽋	cnnj
㝈	cnnj
卛	cnnl
灓	cnnl
㪻	cnnl
㱍	cnnl
稆	cnnm
誥	cnnm
	cnnn
䜌	cnnn
㘘	cnnn
欒	cnno
謹	cnno
㡩	cnnp
彎	cnnq
曫	cnnr
鸞	cnnr
變	cnns
鑾	cnnt
戀	cnnu
孌	cnnx
讌	cnnx
臠	cnny
䖈	cnqh
秢	cnqx
詅	cnqx
䚰	cnqy
詣	cnrm
㚛	cnrm
程	cnsg
䛤	cnsh
㠬	cntg
敼	cnub
虞	cnug
誤	cnug
憙	cnup
惒	cnup
鸆	cnur
諜	cnvo
詍	cnvv
詋	cnwq
秎	cnwt
訜	cnwy
熹	cnxo
譟	cnxo
䆆	cnxo
刴	coaj
奅	coav
謅	cobb
䅳	cobb
䛌	codb
䖿	coeb
䴻	coeb
睝	coed
邌	coee
黧	coef
黎	coel
畖	coem
棃	coeo
剓	coep
鯬	coep
鵹	coer
錅	coet
犂	coeu
㥎	coeu
䊍	coew
朶	cofc
㚓	cofd
采	cofw
誵	cogk
稿	cogn
謞	cogn
稀	cogp
䛥	cogp
䢤	coie
䛾	coih
秫	coii
訋	coii
訹	coii
䄪	coii
譈	cojs
稕	cojv
諄	cojv
彩	coke
請	cokm
稯	colb
訩	colv
誛	comb
譹	comg
積	comm
謮	comm
諪	comr
䅓	conb
訽	conm
㽛	conm
㼽	cooj
詾	cool
䫪	coom
爽	cooo
鷞	coor
訤	coow
穄	copg
䖏	cori
詢	corm
秤	cost
評	cosy
秏	cott
畇	coty
䚽	coty
殷	covb
䛬	covt
慇	covu
㐆	covv
諊	cowi
㽤	cowi
䣋	cowv
諘	coxq
䜉	coyl
蛪	cpbm
㗉	cpbn
謢	cpbx
㓶	cpca
契	cpcd
㓛	cpcf
㓞	cpcg
奮	cpcm
䫔	cpcm
䅦	cpcm
䚉	cpcw
䛚	cpcy
穁	cpdf
齧	cpew
虧	cpfs
奈	cpgd
譁	cpgg
䅿	cpgg
諾	cpgn
挈	cpht
譅	cpie
讛	cpie
䜀	cpie
䜃	cpif
絜	cpih
訒	cpii
認	cpiu
㼤	cpja
讒	cpji
觢	cpjl
誮	cpjr
奪	cpkf
洯	cplm
讉	cpme
䜋	cpmm
訵	cpmy
詔	cpnm
䜓	cpno
栔	cpof
穕	cpof
䜘	cpos
穫	cppb
護	cppb
譴	cppe
㘜	cppn
犫	cppu
奞	cprd
雐	cprh
穭	cprm
䜕	cprn
稚	cprt
譪	cprv
誰	cpry
	cpst
䱷	cpst
秊	cptt
䄭	cptt
恝	cpup
㸷	cput
䂮	cpvd
䅷	cpwo
䅋	cpwq
秴	cpwt
䜛	cpww
詥	cpwy
䅸	cpwy
㛃	cpxc
穛	cpxo
謶	cpxo
譙	cpxo
謊	cpxp
讙	cpxp
䅒	cpxy
䅪	cpym
䅤	cpyr
䛽	cpyr
眘	cqdm
㚕	cqdr
䄶	cqdr
䛍	cqdr
䙽	cqdw
誸	cqfi
稙	cqft
諽	cqfy
穟	cqge
譢	cqge
秆	cqgt
亂	cqgv
稹	cqgw
覶	cqgw
謓	cqgw
辭	cqgw
訐	cqgy
譄	cqir
㽪	cqir
訠	cqjj
畔	cqkg
秚	cqkg
詊	cqkg
稍	cqkm
誚	cqkm
誦	cqlm
㶫	cqmi
税	cqnw
説	cqnw
稊	cqqr
諷	cqqy
遼	cqre
尞	cqrh
昚	cqrm
鹩	cqro
䨅	cqrp
鷯	cqrr
秨	cqtt
詐	cqty
誁	cqxg
噕	cqxn
爲	cqxo
爳	cqxu
鄬	cqxw
譐	cqyk
馢	craa
䭯	crbl
馟	crcj
䅔	crcm
䭲	crcn
馫	crcr
馣	crcv
穝	crdb
馜	crdn
馡	cref
馦	creg
謾	crfb
䅼	crfb
町	crfm
甼	crfm
䫝	crfm
䄵	crft
訂	crfy
馛	crgi
誄	crgy
㚔	crid
馪	crim
䜙	crix
䅙	crja
䛰	crja
訷	crjj
䭱	crki
馥	crlb
馩	crlm
馠	crln
謃	crlt
香	crmt
㸓	crmw
剞	crna
㿲	crna
攲	crnb
敧	crnb
欹	crnl
奇	crnm
訶	crnm
䫑	crnm
謌	crnn
㚡	crnn
鵸	crnr
馚	crnw
稞	crof
課	crof
謁	crov
䅥	crov
䊬	crow
䛕	crow
稈	crqg
䛞	crqg
䲪	crrd
䲨	crrf
誯	crrm
鴫	crrm
䅛	crrm
䜈	crro
譖	crrr
䅾	crrr
馧	crrs
穒	crrt
馤	crrv
馝	crue
奛	cruq
剦	crva
㪑	crvb
䄿	crve
䛖	crve
鹌	crvo
鵪	crvr
奄	crvv
䣍	crvw
馞	crxj
䭰	cryk
註	cryy
巧	csaf
䛒	cscy
誎	csfy
秇	csii
訙	csii
盁	csmc
盉	csmt
䅠	csmt
諟	csmy
訅	csqy
䲾	csrr
㻎	cssg
攻	cstf
䖍	csth
畋	cstm
䚺	csty
㤍	csup
㚽	csxc
讍	csxx
䅯	ctdn
譧	cteg
䆂	cteg
䅊	ctej
訢	ctey
畉	ctgm
䄮	ctgt
訴	ctii
䛉	ctja
畴	ctkf
秒	ctkt
訬	ctky
䛸	ctlh
䆅	ctlm
諮	ctln
䅆	ctlq
鶏	ctrr
誑	ctsg
穅	cttl
讃	cttm
䜠	cttm
譛	cttr
穬	ctxg
詨	ctyy
㓺	cuaj
䄫	cubt
鼔	cubx
記	cuby
夯	cucd
功	cucf
虏	cuch
男	cucm
㽖	cucm
畀	cudm
秘	cuee
虙	cuee
䛑	cuee
謐	cues
顋	cufm
秿	cuft
誧	cufy
秼	cugw
誅	cugw
䚶	cugy
䅞	cukf
㽒	cult
䜜	cumd
詚	cumy
嘉	cunm
畼	cuor
諹	cuor
恳	cupb
虑	cuph
思	cupm
悥	cupy
訫	cupy
䄴	cuqt
訯	cuqy
䚴	cuqy
詯	cury
巭	cutg
㽚	cutm
誋	cuup
奟	cuuq
稝	cuuq
䅄	cuuu
䄦	cuvt
嬲	cuxu
虔	cuyh
訣	cuyw
剩	cvaj
剨	cvaj
䆊	cvcw
砉	cvdg
譀	cvds
䄷	cvdt
繇	cveh
遥	cvep
奢	cvfd
諸	cvfy
詞	cvhf
飖	cvho
乘	cvht
奃	cvii
秪	cvii
詆	cvii
虖	cvlf
訊	cvlf
歑	cvll
䛅	cvmy
䛡	cvnm
鹞	cvoq
颻	cvqq
秖	cvqt
虗	cvrh
諙	cvrm
鷂	cvrr
稰	cvsk
諝	cvsk
䍃	cvtw
稦	cvvt
㐍	cvvw
諱	cvvy
奲	cvxl
䄱	cvyt
訪	cvyy
䄩	cwat
試	cwcf
讔	cwcu
䆏	cwcw
謎	cwep
異	cwfm
頹	cwfm
䜏	cwgk
稐	cwgp
論	cwgp
䛃	cwgy
諔	cwhb
㧭	cwht
塁	cwif
疄	cwio
譮	cwir
詸	cwiy
諭	cwka
疂	cwmm
稶	cwnk
稌	cwof
畭	cwof
禿	cwqt
誐	cwty
譩	cwup
邛	cwvf
謠	cwvt
䛧	cwvv
誂	cwwy
䄻	cwwy
譣	cwxh
穮	cwxo
讑	cwxp
䅧	cwyt
諳	cwyy
䛨	cwyy
㓫	cxaj
詉	cxbx
讈	cxce
魏	cxcm
㚻	cxcm
䭳	cxcr
委	cxct
犩	cxcu
妥	cxcw
覣	cxdw
逶	cxep
謰	cxep
呄	cxfc
套	cxfd
虐	cxff
䫋	cxfm
諤	cxfs
秙	cxft
詁	cxfy
講	cxgi
䄯	cxgt
訮	cxgy
䅴	cxih
穗	cxiu
譓	cxiu
穲	cxiw
瓾	cxja
誖	cxjv
䅢	cxkm
秬	cxlb
壾	cxlb
奆	cxlb
詎	cxlb
䅶	cxlk
誫	cxlo
秞	cxmt
䛆	cxmy
奩	cxnx
謳	cxnx
㼏	cxoe
奁	cxow
譂	cxrl
稓	cxrm
稥	cxrm
諎	cxrm
鵎	cxrr
䛣	cxsa
誆	cxsg
穔	cxxg
讝	cxxs
甿	cxym
訰	cyay
䛵	cybx
譭	cycb
䛼	cycf
界	cydr
畍	cydr
䚸	cydr
稨	cygp
諞	cygp
謆	cyhh
謏	cyjb
畛	cyke
診	cyke
謝	cykf
㓿	cyla
䵗	cylc
䵔	cylh
䵕	cylh
䵛	cyli
䵙	cyli
䵑	cyli
黍	cyll
黏	cyll
黐	cylm
穑	cyln
䵜	cylo
䵘	cylr
䵒	cylr
䵓	cylu
䵚	cyly
贡	cymf
謴	cymm
䄹	cypt
穧	cyrr
䜞	cyrr
舀	cyrw
詮	cysg
詤	cyvp
㽗	cywm
誽	cywq
秂	cywt
議	cywt
㚠	cyxo
䅵	cyxo
諛	cyyw
聀	daaf
䇅	daay
蠫	dabb
䖙	dach
遅	daep
顡	dafm
毅	dahb
眻	daim
刵	dajf
卧	dalf
赴	dalf
羼	dana
䭆	danc
聝	danf
䎸	danm
豙	daqy
赳	davf
䝛	davw
䝣	daxo
䴰	dbaa
䴼	dbaa
麬	dbav
䞵	dbbb
䴶	dbbc
蜸	dbbm
聂	dbbx
颞	dbby
䀱	dbcg
䴸	dbcj
䵖	dbcl
皤	dbcm
麳	dbdd
䴽	dbdl
䁂	dbdm
䴺	dbdn
麲	dbdw
䝠	dbdw
竪	dbdy
䵄	dbee
麯	dbem
麮	dbff
矘	dbfm
麶	dbfm
㿩	dbfm
䴲	dbfo
麵	dbfu
麪	dbfv
麫	dbfv
豎	dbhe
麷	dbhe
䴮	dbhm
掔	dbht
㔌	dbia
䁊	dbid
瞠	dbif
埾	dbif
堅	dbif
䇈	dbif
緊	dbih
㻨	dbii
䀑	dbii
䴱	dbin
聚	dbir
鄹	dbiw
䴷	dbiw
孯	dbjv
䵂	dbjx
腎	dbkm
䴭	dble
䴴	dblh
䴳	dblo
鶌	dblr
屈	dblv
聉	dblv
貀	dblv
趉	dblv
麧	dblv
䴿	dbmg
㷂	dbmi
㷅	dbmi
賢	dbmm
麰	dbmu
䴾	dbnc
貉	dbnm
䞦	dbnm
䀩	dbnm
麭	dbod
棸	dbof
䴯	dbor
麥	dbqd
䵀	dbqm
䴵	dbqx
䴹	dbro
聅	dbtf
麩	dbtg
䵆	dbtg
麨	dbtk
䀢	dbtm
鋻	dbtw
麱	dbuf
贒	dbum
㹂	dbut
硻	dbvd
䴬	dbwa
郰	dbwv
㞋	dbxb
娶	dbxc
婜	dbxc
取	dbxf
臤	dbxf
䵃	dbxg
䵁	dbxk
焣	dbxo
眽	dcaq
睜	dcbb
眼	dcbm
瞓	dcbr
貇	dcbw
皈	dcbx
眅	dcbx
䞬	dccc
䞾	dcch
矑	dccs
㞡	dccx
㚖	dcdr
皭	dcfk
䂃	dcfk
䁰	dcfm
䟊	dcgd
盽	dcgm
䞧	dchf
䝞	dchq
聗	dchw
䀹	dchw
貕	dcic
墾	dcif
睳	dcii
䞯	dcjv
䁔	dckb
奨	dckc
䁌	dckm
醤	dcky
瞃	dcld
䞺	dcld
皋	dclf
翱	dclh
䫧	dclm
鷎	dclr
䣗	dclw
䚌	dclw
屇	dcmb
瞅	dcmi
䎿	dcmi
䁦	dcmm
畠	dcmr
矁	dcmu
魄	dcmx
聭	dcmx
䁛	dcmx
䂅	dcnb
瞦	dcnm
睬	dcof
䝟	dcpc
㡍	dcpm
瞭	dcqh
㞠	dcqh
䝤	dcqh
䝝	dcrn
䁆	dcrv
睤	dcud
懇	dcup
䁘	dcvt
趩	dcwf
䛗	dcyf
䞷	ddbl
趣	ddbx
䇃	ddby
臩	ddcd
皞	ddcl
貜	dddb
䂄	dddb
㯤	dddd
聶	dddf
皨	dddi
㱌	dddl
睞	dddm
瞐	dddm
顳	dddm
䂂	dddp
皛	dddr
睥	ddel
聛	ddel
貏	ddel
䇑	ddel
瞩	dden
聑	ddff
臦	ddff
巺	ddfg
眲	ddfm
瞕	ddfm
鹔	ddgo
肃	ddgw
屡	ddib
䁖	ddim
	ddim
皪	ddio
䟏	ddio
䁻	ddio
矓	ddka
䏊	ddka
矚	ddlb
瞾	ddlc
瞁	ddld
矈	ddlv
煛	ddmi
燛	ddmi
䀠	ddmm
鷪	ddmr
䞳	ddnm
眤	ddnq
䝚	ddnq
趘	ddot
戵	ddpa
矍	ddpb
䢲	ddpe
氍	ddpo
瞿	ddpr
鸜	ddpr
䣤	ddpw
竮	ddqx
䞟	ddrf
暜	ddrm
㿟	ddrr
貃	ddrw
䞹	ddsg
愳	ddup
皦	ddvs
䁶	ddvs
邈	ddwe
選	ddwe
巽	ddwf
皡	ddwl
瞳	ddwm
貌	ddwq
睍	ddwq
親	ddwq
䚅	ddwq
㦝	ddwu
廹	ddxr
㞐	ddyb
趇	ddyf
竝	ddyy
䀽	deed
屝	defh
瞙	defm
貘	defw
层	degb
耺	degf
眃	degm
貖	degs
耻	dehf
䁠	dejg
屛	dekq
㪏	delb
竔	deld
卑	delf
貔	delj
㼰	delj
䫌	delm
鹎	delo
鵯	delr
聰	delu
郫	delw
㔉	dena
属	denn
竬	denn
聥	denn
眦	denq
皉	denq
迉	depb
逨	depd
迫	depr
迆	depv
䝦	desi
眣	detg
趃	detg
趀	devr
䁸	dexo
眨	dexp
㞏	dexp
䀭	deyw
趔	dfaj
竷	dfbb
贛	dfbm
䀍	dfbs
戆	dfbu
戇	dfbu
赣	dfby
䤗	dfby
贑	dfcm
戅	dfcu
遧	dfep
䏆	dfer
貈	dfew
趰	dfgm
睟	dfhl
䁵	dfhx
䁼	dfif
眩	dfin
䁺	dfir
眄	dfjv
䞛	dfjv
彰	dfke
聏	dfkm
盱	dflf
䁴	dflu
頣	dfmm
顂	dfmm
䁲	dfmm
䁫	dfmm
䫉	dfmm
章	dfmy
屍	dfnq
竵	dfnr
䟉	dfob
皌	dfof
眜	dfof
瞝	dfom
睠	dfon
䞙	dfpm
眱	dfqy
䀴	dfrc
貊	dfrm
竡	dfrm
瞌	dfsm
睫	dfts
䀷	dfuc
貆	dfum
鄣	dfwv
䁹	dfwy
眏	dgcd
眮	dghf
聃	dgif
联	dgif
㞘	dgii
眹	dgim
皗	dgin
睭	dgin
䞴	dgin
䎻	dgin
䞥	dgkm
㞕	dgkm
耼	dglg
瞈	dgmh
聬	dgmh
聡	dgmu
竑	dgmx
耾	dgmx
趫	dgnn
盻	dgsa
睡	dgtm
䏋	dgud
㒵	dgwr
䞱	dgyn
䀰	dgyn
豽	dgyw
䞼	dhaq
䝂	dhbe
竐	dhbx
䝘	dhbx
展	dhfb
㞗	dhfb
端	dhfk
貒	dhfk
瞫	dhfm
睓	dhgw
皚	dhhe
䁗	dhhe
䁍	dhhf
趯	dhhp
矅	dhhp
翊	dhhx
趐	dhhx
䎅	dhhx
睉	dhif
趖	dhif
㣎	dhke
赸	dhmf
趓	dhof
飒	dhow
瞟	dhpg
䏇	dhpg
皠	dhpr
凥	dhqb
竌	dhqy
聒	dhtf
趏	dhtf
䀨	dhtm
皑	dhub
䁏	dhxc
䁁	dhym
䀶	dicb
奖	dicd
屪	dich
瞎	dicn
䞰	didg
瞚	difg
矉	difm
聢	difs
睻	difu
睖	digb
䎴	digf
睦	digi
竤	digm
瞪	dihe
竳	dihe
聫	diic
聯	diic
䟇	diid
眭	diif
䞨	diif
聨	diil
睕	diio
眵	diiq
趍	diiq
㞔	diiq
䇋	diiq
皢	diiw
趬	diiw
䁱	diiw
聮	diix
螀	dikb
将	dikf
浆	dilm
㿠	dilr
屆	dilv
竩	dimm
眳	dinm
桨	diof
聺	diop
聍	dirf
眝	dirf
竚	dirf
䁄	diri
睐	dism
眑	diuc
聈	diuc
睽	diug
聧	diug
矃	diur
聹	diur
趤	divd
眿	divi
皖	diwg
睆	diwg
䏁	diwy
酱	diyf
屁	djab
䀝	djam
皂	djar
職	djar
㼟	djar
豼	djaw
竫	djbb
睁	djbb
䞜	djdf
聇	djff
豾	djff
眐	djfm
矄	djfm
矎	djgb
䁤	djgx
趂	djhk
孱	djjj
䇂	djjy
瞮	djks
﨣	djlf
䀞	djlf
䇆	djlf
乸	djnv
趋	djob
䀙	djpc
䁅	djsm
㞌	djvb
瞻	djxc
聸	djxc
䟋	djxc
龍	dkaa
龖	dkaa
龘	dkaa
蠪	dkab
讋	dkac
聾	dkad
驡	dkaf
壟	dkai
龏	dkal
㰍	dkao
龒	dkap
鸗	dkar
龑	dkau
礱	dkav
龔	dkaw
襲	dkax
䀐	dkem
䝖	dkew
导	dkfb
装	dkfx
壮	dkfy
眛	dkgw
瞨	dkni
䑑	dkni
聐	dknm
趌	dknm
貅	dkof
睺	dkub
㞎	dkvb
㿧	dkvk
皅	dkvr
睵	dlan
䟌	dlap
䟈	dlas
睱	dlbb
貑	dlbb
攱	dlbx
䞚	dlbx
聜	dlcf
异	dldb
猌	dldd
灥	dldl
狊	dldm
状	dldy
竎	dldy
豺	dlee
䞗	dlee
瞲	dlen
劚	dlfa
屬	dlfb
皁	dlfr
斸	dlft
聴	dlfu
竍	dlfy
趈	dlhf
䑐	dlhk
䀡	dlhm
站	dlhy
㙬	dlif
䀲	dljn
㣐	dlke
䁭	dlll
䏄	dlma
尿	dlmb
㷉	dlmk
泉	dlmr
臨	dlnx
屄	dlob
睏	dlof
䴗	dloq
	dloq
貁	dlow
赼	dlqf
鶪	dlrr
㓾	dlua
遲	dlue
憖	dlup
趝	dlup
鹽	dlus
犀	dlut
盵	dlvv
䞘	dlvv
䇄	dlvv
瞴	dlvx
耹	dlwf
赺	dlwf
郹	dlwv
盬	dlxs
屋	dmab
越	dmaf
剭	dmaj
眓	dmam
眰	dmam
竢	dmbt
䀵	dmbt
屚	dmfb
䇕	dmfk
褧	dmfx
睃	dmgb
竣	dmgb
䞭	dmgb
䝜	dmgb
耿	dmif
屓	dmmb
賚	dmmd
趄	dmmf
睒	dmmi
䟃	dmmk
屭	dmmm
趲	dmmm
趱	dmmy
眙	dmnm
遰	dmpe
帶	dmpm
皬	dmpr
矐	dmpr
㿥	dmpr
䠠	dmps
慸	dmpu
瞑	dmrb
䏃	dmrb
瞷	dmrm
瞤	dmsg
瞯	dmuq
眸	dmut
矙	dmvs
眈	dmwq
耽	dmwq
屢	dmxc
瞜	dmxc
貗	dmxc
睴	dmxf
㷦	dmxo
㿝	dmxr
䁡	dmyw
剖	dnaj
卽	dnav
瞣	dnbu
䬤	dncb
䟀	dncf
䁟	dncf
䁒	dndf
矊	dndp
迡	dnep
䫓	dnfm
职	dngw
䏈	dnih
瓿	dnja
竒	dnjj
睊	dnkm
㰴	dnlq
瞞	dnmm
䁚	dnmm
䝡	dnmm
咅	dnmy
郶	dnnk
皓	dnnm
聕	dnnm
䁧	dnnt
屌	dnpm
尼	dnqb
皀	dnqr
聆	dnqx
皊	dnqx
竛	dnqx
㞓	dnrm
䳝	dnrr
睈	dnsg
聖	dnsg
趗	dnsh
䇍	dnsh
敨	dnst
㪗	dnub
勏	dnuc
屟	dnvo
䁋	dnvo
䁢	dnvs
屉	dnvv
聁	dnwf
盼	dnwm
竞	dnwq
眖	dnwq
部	dnwv
競	dnww
竕	dnwy
矂	dnxo
趮	dnxo
聊	doav
趨	dobb
鼎	dobm
䵻	doco
杘	dofb
䝗	dofw
皜	dogn
睎	dogp
豹	doii
的	doii
屘	dojv
䇏	dojv
䁨	dojw
屗	dokf
靖	dokm
睛	dokm
皘	dokm
聙	dokm
䁓	dolb
㞙	dolm
皟	domm
瞔	domm
䟄	domm
聤	domr
䁎	domr
竘	donm
眗	donm
豿	donm
䞤	donm
䏅	dopg
鸤	doqb
䀛	dore
眴	dorm
聦	doru
尾	dotb
毦	dotf
眊	dotm
㿞	dotr
盷	doty
竓	doty
赹	doty
赵	dowf
趜	dowi
䁃	doxq
刷	dpaj
䀚	dpav
叞	dpbx
㕞	dpbx
瞄	dpcm
貓	dpcm
㞜	dpcx
屦	dpdi
眬	dpdm
矀	dpds
緜	dpeh
屣	dpes
矒	dpfd
䁾	dpfi
䁐	dpgc
皣	dpgg
瞱	dpgg
眎	dpgm
屩	dpgn
睰	dpgn
䁯	dphh
瞛	dphs
㞞	dphs
䀔	dpii
䂁	dpji
螱	dpkb
尉	dpkf
熨	dpkm
慰	dpku
犚	dpku
褽	dpkx
屐	dplb
履	dplb
䁳	dpll
兜	dplw
瞶	dpmm
聵	dpmm
帛	dpmr
屨	dpmx
貂	dpnm
超	dpnm
眧	dpnm
䞸	dpnm
屧	dpno
瞸	dpno
㞛	dpnr
屜	dpnv
矆	dppb
䁩	dpqm
趡	dprf
睢	dprm
䀪	dpsg
䀒	dptm
竏	dpty
䞩	dpwf
䀫	dpwm
睌	dpwq
瞒	dpxh
瞧	dpxo
趭	dpxo
矔	dpxp
貛	dpxp
䟒	dpxp
聩	dpym
瞆	dpym
㞚	dpyr
䞞	dqdr
䀟	dqdr
赶	dqgf
盰	dqgm
趟	dqgn
瞋	dqgw
豻	dqgw
䀥	dqhk
層	dqir
竲	dqir
䁬	dqir
䀕	dqjj
眫	dqkg
睄	dqkm
屑	dqkm
趙	dqkm
䇌	dqkm
䞻	dqlu
聪	dqnu
睇	dqqr
颯	dqqy
䞢	dqtf
屏	dqxg
皏	dqxg
聠	dqxg
㞟	dqyc
趥	dqyf
竴	dqyk
㔅	draj
䟂	drfb
䝢	drfb
耵	drff
䟆	drff
盯	drfm
䎘	drhh
䁜	dril
䏉	drix
䁙	drix
眒	drjj
䎶	drjj
䁽	drlf
歗	drlq
睲	drlt
睗	dror
䞶	dror
竭	drov
㿣	drov
皔	drqg
睅	drqg
貋	drqg
趕	drqg
肅	drrb
鳲	drrb
䲩	drrb
鶆	drrd
鵈	drrf
瞗	drrm
䟁	drro
鷫	drrr
䁮	drrr
䳆	drrr
鴗	drry
㪩	drub
竜	drvv
䏀	dsaj
䀎	dsam
遑	dsep
趚	dsff
䀳	dsfm
竦	dsfy
皇	dsgr
䞝	dsii
䀓	dsii
㞍	dsii
皝	dsil
聽	dslu
趧	dsmf
睼	dsmm
尻	dsqb
皩	dsri
䳨	dsrr
䀿	dste
䁀	dste
数	dsti
敀	dstr
憗	dsup
皍	dtav
睸	dtdm
瞊	dtdn
瞡	dtdw
覧	dtdw
赾	dtef
盺	dtem
新	dtey
譼	dtfc
矇	dtfg
擥	dtfh
㽉	dtfj
㯺	dtfo
鑒	dtft
覽	dtfw
䜿	dthe
䞣	dtii
眠	dtja
䇇	dtja
䁕	dtjr
赻	dtkf
眇	dtkm
竗	dtky
䇐	dtll
趦	dtln
趑	dtlq
䇊	dtmx
旣	dtra
墍	dtri
䲿	dtrr
曁	dtru
㔋	dtsa
監	dtsm
㲯	dtso
䟎	dttm
鍳	dttw
趛	dtwf
㜪	dtxc
矌	dtxg
皎	dtyr
起	dubf
䞫	dubf
貄	dubw
勑	ducd
赲	ducf
劰	ducr
睷	dudx
䎵	duee
䀣	duee
竨	dufm
趠	dufm
䀯	dufm
䀖	dugm
趎	dugw
䎷	dugw
矏	dulv
䟍	dulv
䞡	dumf
䁑	duor
恥	dupf
䎳	duqf
眀	duqm
㞒	durb
䳵	durr
朢	dusg
愸	duup
皥	duwl
䝥	duwl
盿	duym
赽	duyw
䀗	duyw
䞠	dvdf
瞰	dvds
䇉	dvdy
屠	dvfb
睹	dvfm
県	dvhk
眡	dvii
趆	dvii
㰾	dvlq
局	dvnm
赿	dvqf
眂	dvqm
睧	dvrm
䎽	dvrm
鷵	dvrr
郻	dvrw
譥	dvsc
邀	dvse
䚫	dvsl
鸄	dvsr
敫	dvst
㦘	dvsu
耴	dvvf
䎲	dvvf
癿	dvvr
兠	dvwq
䣝	dvwv
眆	dvym
䞖	dwaf
覞	dwdw
䚒	dwdw
瞇	dwep
遟	dwep
䀧	dwfm
盶	dwgm
睔	dwgp
䎾	dwgp
殿	dwhb
壂	dwhi
臀	dwhk
臋	dwhy
屎	dwib
眯	dwim
瞵	dwio
瞺	dwir
㼿	dwja
覎	dwjv
睮	dwka
貐	dwka
䙷	dwkf
䙸	dwkf
皐	dwlf
翶	dwlh
睑	dwmo
貍	dwmw
童	dwmy
楽	dwof
䞮	dwof
覐	dwoo
氃	dwot
䎺	dwpa
覹	dwps
見	dwqm
皃	dwqr
屙	dwrn
䴀	dwrr
䞲	dwtf
睋	dwtm
皒	dwtr
勭	dwuc
㦟	dwup
郲	dwvd
耶	dwvf
䢻	dwvf
㞑	dwvv
眺	dwwy
聎	dwwy
趒	dwwy
㿡	dwwy
瞼	dwxh
皫	dwxo
䟑	dwxp
屖	dwyb
䟐	dxce
㿨	dxce
妆	dxcy
䀦	dxfm
䀘	dxgm
屫	dxgn
㞖	dxhk
䞽	dxih
睚	dxii
竱	dxik
䁣	dxik
矖	dxiw
睩	dxll
趢	dxll
䎼	dxll
㷡	dxlm
屒	dxlo
䀼	dxlo
届	dxmb
瞘	dxnx
貙	dxnx
䝙	dxow
眍	dxow
矋	dxpn
䁥	dxpn
䀮	dxpr
貚	dxrl
趞	dxrm
䇎	dxrm
聘	dxsa
䀻	dxsa
眶	dxsg
䞪	dxte
䁪	dxte
竰	dxwm
趪	dxxg
盳	dxym
眪	dxyw
盹	dyam
䂀	dyci
瞬	dyio
瞍	dyjb
䏂	dyjb
趁	dyke
眕	dyke
聄	dyke
睙	dyld
屃	dymb
睶	dyrm
㿤	dyrm
竧	dyry
䀬	dysg
皧	dyub
瞹	dyub
臥	dywf
睨	dywq
聣	dywq
貎	dywq
䔐	eaaa
菠	eacf
诐	eacp
堲	eaif
详	eaip
刬	eajg
诫	eald
讣	ealp
语	eanm
䳭	earr
即	eavb
谌	eavv
蔢	eaxc
䗣	ebbm
藩	ebcm
逆	ebep
讳	ebgp
译	ebkg
欮	eblq
诎	eblv
䖝	ebme
蟇	ebmf
落	ebnm
训	ebrp
遡	ebue
塑	ebui
槊	ebuo
朔	ebuq
愬	ebuu
屰	ebvi
谠	ebwq
蒎	ecaq
诱	eccc
茳	ecff
讧	ecfp
谡	ecgb
诟	echf
诬	echw
谖	eckb
谓	eckm
甶	ecme
魂	ecmx
䰟	ecmx
谣	ecvt
诿	ecxc
谑	ecxf
謩	ecyf
诹	edbx
熈	eddx
萡	edrf
蘫	edts
㷩	edum
爺	edwv
㢟	edxh
蜑	eedb
䗺	eedb
郔	eedw
延	eedx
诞	eeed
歮	eeeh
诽	eefh
谟	eefp
谥	eegs
讬	eeja
谦	eejg
㽐	eejg
谫	eekp
谱	eekr
谋	eeof
运	eepg
䢗	eepm
辪	eepw
该	eeyw
谏	efah
剕	efaj
蜚	efbm
奜	efcd
㱳	efdf
歬	efeh
䪤	effc
丢	effe
韭	efff
驀	efff
䫍	effm
裴	effx
翡	efhh
非	efhh
谇	efhl
㱖	efhl
睾	efir
䕪	efir
猆	efld
頉	efmm
䩀	efmm
䫀	efmm
餥	efnc
棐	efof
䩁	efoo
靟	efot
辈	efra
㸘	efrf
㻗	efsi
䨽	efub
悲	efup
㹃	efut
斐	efuy
㐟	efvv
婓	efxc
輩	efxf
刋	egaj
奧	egbc
叐	egbx
兿	egeg
谸	eggn
㸗	eghf
圱	egif
诼	egii
调	egin
诙	egmi
讼	egmx
逈	egne
诇	egnm
向	egnm
䚁	egnw
蠲	egsb
益	egsm
鹢	egso
鷁	egsr
䚊	egsw
奥	egwc
嶴	egwh
䴈	egwr
䢴	egwv
讷	egyw
谶	ehaf
虃	ehaf
讶	ehap
设	ehbx
莈	ehbx
豊	ehei
艶	ehek
豑	eher
鄷	ehew
劌	ehfa
谰	ehfh
歳	ehfh
翽	ehfh
谭	ehfm
藫	ehfm
顪	ehfm
㽑	ehfm
歲	ehfo
谬	ehhk
诩	ehhx
屲	ehme
讪	ehmp
讽	ehow
薸	ehpg
凢	ehqe
讥	ehqp
摹	ehtf
甛	ehtf
萿	ehtf
话	ehtp
诚	ehvv
谅	ehyp
蒗	eicb
诧	eiej
墓	eiff
蔆	eigb
讲	eigp
系	eihk
诖	eiif
孳	eiij
甆	eiij
兹	eiin
鹚	eiio
爹	eiiq
鶿	eiir
鷀	eiir
慈	eiiu
诗	eikf
歭	eikf
胤	eikv
谊	eimm
议	eiow
㱑	eiqh
谉	eirj
乇	ejae
㽍	ejaf
诤	ejbb
谐	ejdr
证	ejfp
㪠	ejgb
甉	ejgj
歉	ejgl
䫡	ejgm
鹣	ejgo
鶼	ejgr
㝺	ejgt
兼	ejgw
谪	ejgx
谛	ejmp
谤	ejmv
诌	ejob
讹	ejrp
歱	ejwm
论	ejwp
谵	ejxc
谚	ejxk
诡	ejxo
谄	ejyr
翦	ekah
前	ekaj
㮍	ekao
剪	ekap
煎	ekax
蒞	ekdy
逬	ekee
甁	ekej
幷	ekeq
讨	ekfp
並	ekji
肯	ekmh
诘	eknm
㠮	ekrc
普	ekrm
爸	ekvw
蓅	ekyf
囱	elbq
粵	elbs
悤	elbu
歧	elbx
升	elde
谲	elen
计	elfp
谳	elgl
诲	eljn
慕	elkf
许	ellf
顖	elom
䪿	elom
恖	elou
㔡	elou
囟	elow
甪	elqe
囪	elri
谂	elup
讫	elvv
粤	elws
薀	elys
诶	embt
读	emjc
龜	emme
菹	emmf
谈	emmi
诅	emmp
㸖	emmw
诒	emnm
菭	emnm
䶰	emot
诨	emra
诜	emtp
莐	emwq
么	emxe
䖪	enbm
䜨	enbu
訾	ency
眥	endm
㙑	engi
禹	engn
鄅	engw
识	engw
胔	engy
㧘	enht
㘹	enif
紫	enih
㱔	eniq
觜	enjl
些	enlg
貲	enmm
飺	ennc
诰	ennm
呰	ennm
谨	enno
	ennx
䜩	ennx
柴	enof
祡	enpg
㠿	enpm
鮆	enpq
此	enqh
㱓	enqx
诣	enrm
㫮	enrm
歶	enrn
鴜	enrr
鈭	entw
误	enug
砦	envd
谍	envo
兎	enwi
姕	enxc
㭰	enxh
啙	enxm
藻	enxo
赀	enym
萢	eodb
某	eoff
莯	eoff
颦	eofl
顰	eofl
頻	eofm
频	eofy
薃	eogn
谆	eojv
步	eokh
请	eokm
蔳	eokm
讻	eolv
蓡	eomb
薓	eomb
歵	eomm
㱕	eomp
范	eonf
询	eorm
萍	eosf
评	eosp
蛗	epbm
㷗	epdm
追	epep
歸	epep
頧	epfm
師	epfp
诺	epgn
峊	ephm
䜧	epie
讱	epii
䘀	eplb
阜	eplf
顊	eplm
币	epme
幕	epmf
䦾	epmw
诏	epnm
菬	epnm
䜦	epor
谴	eppe
帥	eppm
䧳	eprh
谁	eprp
鴭	eprr
䓷	epsg
谗	epwj
谯	epxo
谎	epxp
釜	eqei
讦	eqgp
诮	eqkm
诵	eqlm
说	eqnw
诈	eqtp
爷	eqvw
蓱	eqxg
既	erab
䇒	erdy
谩	erfb
䕕	erfb
订	erfp
蕅	ergn
诔	ergp
塈	erif
䐴	erkm
暮	ermf
菏	ernm
诃	ernm
㱒	ernm
课	erof
槩	erof
㮣	erof
谒	erov
䔽	erov
鱀	erpq
鵖	errb
䲺	errf
䲰	errg
薻	erro
谮	errr
蕰	ersm
䀈	ersm
暨	erum
䊠	erwi
卹	esav
衉	esbn
衇	esca
衈	esdf
歨	eshh
㻃	esii
䘑	esii
䘔	esin
衆	esir
衃	esjd
䘓	esjy
欰	eslq
衄	eslv
䘒	esmb
血	esme
盏	esmg
蒅	esof
䘐	espg
衂	espi
衊	espi
衅	esqk
䘏	eswv
䓅	etef
迭	etep
䜣	etep
	etep
斧	etew
失	etge
诉	etii
莎	etkf
诪	etkf
歩	etkh
叇	etle
谘	etln
㰣	etlq
鴩	etrr
䳄	etrr
诳	etsg
劮	etuc
怣	etup
䓾	etxc
葏	eubf
记	eubp
募	eucf
动	eucg
䜥	eudx
谧	eues
蒲	euff
诛	eugw
薄	eukf
㱗	euld
蕩	euor
蘯	euos
㤟	eupm
诀	euyw
诸	evfp
㸙	evfw
词	evhf
诋	evii
䓜	evii
讯	evlf
蓦	evnf
䓋	evqf
荡	evre
䪠	evrf
䪡	evrf
䪢	evrf
䙻	evrw
谞	evsk
访	evyp
䶞	ewaf
齬	ewan
䶚	ewbm
齦	ewcb
试	ewcf
䶝	ewch
䶥	ewcm
齮	ewcn
齭	ewct
齱	ewdb
齷	ewdm
䶔	ewdv
䶘	ewdy
齜	ewen
齲	ewen
谜	ewep
齸	ewes
葓	ewff
䜤	ewfp
齖	ewha
蔋	ewhb
䶣	ewhe
䶢	ewhh
让	ewhp
䶧	ewiw
齴	ewjk
齽	ewjp
齼	ewjs
䶟	ewjy
谕	ewka
蕍	ewka
䶕	ewkv
齫	ewlo
䶪	ewlp
齢	ewlq
歯	ewlv
齕	ewlv
䶖	ewlw
䶡	ewma
齟	ewmm
齝	ewmn
齳	ewmx
齞	ewng
䶜	ewnn
齔	ewnq
齡	ewnq
齪	ewns
齛	ewnv
齺	ewob
齙	ewod
蒤	ewof
䶦	ewom
齣	ewon
齠	ewpn
齻	ewqg
齚	ewqt
齥	ewre
齵	ewrn
䶗	ewrn
齗	ewte
䶤	ewtm
齩	ewty
鄚	ewvf
邯	ewvf
䢵	ewvg
齓	ewvv
齒	ewwh
䶨	ewwh
䶙	ewxl
齰	ewxr
齶	ewxs
䶫	ewxs
齘	ewyd
谙	ewyp
齨	ewyr
䶩	ewyr
齯	ewyw
诂	exfp
谔	exfs
䓑	exgf
讵	exlb
歫	exlb
菃	exlb
蕖	exlo
農	exlo
讴	exow
乏	expe
鴔	exrr
诓	exsg
茫	exyf
刻	eyaj
頦	eyfm
颏	eyfy
叆	eygb
谝	eygp
㱾	eyhb
诊	eyke
谢	eykf
欬	eylq
賌	eymm
雌	eypr
诠	eysg
劾	eyuc
认	eywp
郂	eywv
亥	eywy
谀	eyyw
殘	faaa
叝	fabx
䑭	facf
㽝	facm
鲏	facq
艇	fadx
鳝	faen
迾	faep
遝	faep
䶛	faew
䑴	fafe
騏	faff
䵦	fafl
鲯	fafq
裂	fafx
駥	fagd
㪝	fahb
柬	fahk
㼑	faho
鶫	fahr
㦱	faif
鲜	faiq
列	fajd
刦	fajf
䵞	fajm
眔	fakm
駴	fald
烮	fami
罭	fanf
䮙	fanf
䮏	fanm
䴕	faoq
	faoq
㱎	fapl
㡂	fapm
鮤	fapq
鴷	farr
䳴	farr
䮯	fast
銐	fatw
劽	fauc
㤠	faup
㱟	favd
却	favf
駊	favf
㔿	favf
黮	favv
姴	faxc
烈	faxo
䲤	fayf
罬	fbbb
䮕	fbbb
駅	fbbf
騒	fbbm
䮣	fbbo
艂	fbcg
艡	fbcm
䮳	fbcm
无	fbdf
騵	fbdf
鳋	fbib
騷	fbib
鱿	fbii
駀	fbii
䑡	fbii
㐪	fbii
駹	fbki
䵨	fbki
黜	fblv
舯	fbme
蝁	fbmf
馽	fbmf
䖭	fbmi
䬸	fbnc
駱	fbnm
舽	fboa
鲦	fbof
卅	fbrf
馴	fbrf
馭	fbxf
衷	fbxq
罰	fcaj
舨	fcbx
艫	fccs
驢	fccs
黸	fccs
㱺	fccs
艣	fccu
馱	fcdf
䮭	fcdw
舡	fcfe
畺	fcff
鳂	fcfo
㱬	fcfo
舿	fcfs
鲘	fchf
䖔	fchq
殎	fchw
騱	fcic
騾	fcih
畝	fcji
殍	fcjv
罦	fcjv
艀	fcjv
㱶	fcke
罸	fckf
䮑	fckf
驉	fckj
画	fclv
畱	fcmf
鳅	fcmi
畆	fcmx
褢	fcmx
騩	fcmx
㱱	fcmx
亩	fcmy
羉	fcnh
䵱	fcnm
騻	fcoo
騎	fcrn
㱦	fcrn
罨	fcrv
殗	fcrv
黤	fcrv
䅈	fcti
稣	fctq
鳃	fcup
罳	fcup
騦	fcup
騞	fcvd
騬	fcvh
鳐	fcvt
㱣	fcxc
誊	fcyi
詈	fcym
畒	fcyw
戛	fdaa
戸	fdbf
驟	fdbi
夏	fdbq
䮮	fdbq
鲰	fdbx
奡	fdcd
䯀	fddd
駵	fddf
騋	fddf
夒	fdeb
駬	fdff
騿	fdfm
奕	fdgc
迹	fdge
弈	fdgl
帟	fdgp
亪	fdgv
亦	fdgw
鳉	fdik
驏	fdjj
䮾	fdka
鳈	fdlm
騡	fdlm
眷	fdmi
殢	fdmp
艜	fdmp
殕	fdnm
艉	fdot
鳚	fdpk
罻	fdpk
艊	fdpm
舶	fdre
奍	fdri
鲌	fdrq
驌	fdrr
亣	fdry
艎	fdsg
鳇	fdsg
騜	fdsg
艦	fdts
馳	fdvf
駶	fdvn
艟	fdwm
罿	fdwm
䮵	fdwm
䚀	fdwq
妻	fdxc
㼮	fdxj
鶈	fdxr
郪	fdxw
㱞	fdyd
䲞	fdyq
罚	feaj
鲫	feav
駳	feed
䮬	feff
鲱	fefh
罪	fefh
騑	fefh
黚	fefm
䥆	feft
裵	fefx
残	fegd
艗	fegs
㱲	fegs
鳢	fehe
舧	fehi
䮹	feho
鲧	feih
馲	feja
鳒	fejg
騚	feka
騈	fekq
驄	felu
䑰	feok
辷	fepf
迲	fepf
遤	fepf
䢝	fepf
羃	fepm
遭	fere
曹	ferm
殈	fesm
䭿	fetg
袠	fetx
䭸	fewf
齤	feww
駭	feyw
㱫	ffah
䮋	ffaj
鳏	ffak
殩	ffbw
殭	ffcf
驑	ffcm
㱛	ffdd
䒅	ffdm
艚	ffer
奰	fffc
騳	ffff
驣	ffff
驫	ffff
䮃	ffff
駦	fffi
罢	fffm
罵	fffm
䯂	fffo
鲡	ffgi
航	ffhq
䭺	ffhq
舷	ffin
䮄	ffin
䍗	ffin
殬	ffir
驛	ffir
鲕	ffkm
艢	ffln
鳣	fflu
驙	fflu
褱	fflx
䪺	ffmm
䮷	ffob
䍠	ffom
䍦	ffop
馷	ffpm
䲍	ffpq
鲞	ffqi
䮊	ffqy
殌	ffrc
鲠	ffro
䭼	ffud
夀	ffvk
䑢	ffwq
㱸	ffwy
罴	ffxo
褭	ffxq
䮍	ffxq
驤	ffxx
鲅	fgbi
䮂	fgbi
殃	fgcd
駚	fgcd
豢	fgdi
艒	fgdm
䗸	fgeb
饔	fgec
㽫	fgec
壅	fgei
㻾	fgei
甕	fgej
雍	fgep
䮱	fgep
罋	fgev
舾	fgfe
䮐	fggn
鲖	fghf
駧	fghf
亹	fghm
逦	fgie
丽	fgii
彨	fgik
鲷	fgin
騆	fgin
鹂	fgio
郦	fgiw
鲔	fgkm
䑵	fgkm
蠒	fgmb
邇	fgme
壐	fgmi
璽	fgmi
爾	fgmm
鸍	fgmr
覼	fgmw
舩	fgmx
䍔	fgmx
駉	fgnm
驕	fgnn
鳍	fgnr
罹	fgpr
鲓	fgsa
殀	fgtd
䮔	fgtf
舰	fgwq
亵	fgxq
殲	fhaf
䍓	fham
螌	fhbb
艍	fhbe
搫	fhbh
縏	fhbh
殧	fhbi
槃	fhbo
幋	fhbp
鞶	fhbq
盤	fhbs
鎜	fhbt
磐	fhbv
殁	fhbx
般	fhbx
媻	fhbx
褩	fhbx
鲾	fhcm
䮠	fhcm
迒	fhep
殏	fhfd
頏	fhfm
驔	fhfm
颃	fhfy
䮥	fhgr
鳛	fhhd
騽	fhhd
䒁	fhhd
㱯	fhhe
黬	fhhf
鳡	fhhu
䎇	fhhx
艏	fhie
黫	fhif
舤	fhii
䭵	fhii
㼚	fhja
卒	fhlf
㰵	fhll
顇	fhlm
㲞	fhlo
㰠	fhlq
舢	fhme
互	fhnf
船	fhnm
䑮	fhof
雜	fhop
鳔	fhpg
驃	fhpg
驨	fhpn
亢	fhqy
䲳	fhrr
拳	fhti
劥	fhuc
邟	fhwv
騕	fhxc
還	fhxe
翾	fhxh
鹮	fhxo
睘	fhxq
衺	fhxq
䮗	fhxq
䴉	fhxr
黥	fhym
鲸	fhyq
艆	ficb
飬	ficb
駺	ficb
㱢	ficb
䍚	ficb
畜	ficm
鄐	ficw
逻	fiep
堊	fiff
殥	fifg
玆	fifi
墨	fifm
殯	fifm
驞	fifm
㱨	fifs
鲮	figb
䮚	figb
㱥	figb
褻	figx
䒇	fihc
艠	fihe
䮴	fihe
絭	fihk
勬	fihu
罫	fiia
鲑	fiif
罣	fiif
黦	fiio
䑱	fiio
㱧	fiio
黟	fiiq
䮈	fiiq
驍	fiiw
袲	fiix
䑿	fikr
玈	fila
駫	filf
䑹	fimb
䮟	fimb
牽	fimu
䂖	finm
舵	finq
駝	finq
瞏	finx
玄	finy
椉	fioo
䮪	fioo
㤪	fiou
舣	fiow
罶	fipc
騮	fipc
騌	fipg
䑸	fipg
驋	fiqb
罗	fiqm
睪	firi
歝	firl
鸅	firr
䲻	firr
斁	firs
䙝	firx
玅	fitk
黝	fiuc
騤	fiug
殡	fivg
䢦	fiwe
鲩	fiwg
率	fiwl
䮨	fiwy
㱰	fiwy
舭	fjae
㓻	fjaj
罘	fjdm
駓	fjff
㱏	fjff
罡	fjfm
罧	fjfm
髙	fjgn
䮰	fjgx
丅	fjjf
䒆	fjks
䵥	fjkv
䮆	fjlf
觠	fjlq
䑓	fjmm
鳑	fjmv
艕	fjmv
騯	fjmv
艋	fjsm
丏	fjvv
䵯	fjwm
黵	fjxc
驜	fkag
夜	fkbi
㖱	fkbn
鵺	fkbr
㓴	fkca
耎	fkcd
㼲	fkcj
䑣	fkee
殰	fkfm
黷	fkfm
䰭	fkfm
䫱	fkfm
䵢	fkgw
眾	fkhw
耏	fkke
鲋	fkkf
耐	fkkf
駙	fkkf
䑧	fkkf
戞	fkma
憂	fkmb
殒	fkmd
而	fkmd
䎡	fkmi
㱊	fkml
驝	fkmo
㥑	fkmu
鄾	fkmw
黠	fknm
鲒	fknm
褒	fknx
䮌	fkof
鸸	fkoq
鴯	fkrr
䯁	fkui
㱻	fkui
亱	fkum
恧	fkup
舥	fkve
䮻	fkvk
鲃	fkvq
耍	fkxc
艈	fkye
殱	flaf
䮉	flaq
驖	flas
騢	flbb
馶	flbx
駰	flcd
弆	fldf
馵	fldf
䭾	fldf
默	fldm
䁿	fldm
駞	fldv
䑨	fldv
罞	flee
驈	flen
騥	fleo
迂	flep
袤	flex
于	flff
䭴	flff
罱	flgr
點	flhm
鲇	flhq
駲	flij
黣	fljn
䍙	fljn
皽	flna
㔊	flna
稟	flnc
邅	flne
㱇	flnl
嗇	flnm
靣	flnm
顫	flnm
㐭	flnm
鹯	flno
氈	flno
禀	flnp
鸇	flnr
亶	flnu
勯	flnu
颤	flny
䒈	flpm
㱵	flpm
鲼	flpy
㰦	flqf
㰳	flqf
㱄	flqm
鳆	flrb
䮡	flrb
䍝	flrm
䵬	flrm
盂	flsm
㪀	flst
殅	fltd
鲶	flup
艌	flup
騐	flup
殤	flur
䵰	flur
䒉	flvo
殇	flvr
䍢	flvx
䑤	flwe
黔	flwm
邘	flwv
鲴	flxf
䍛	flxf
殟	flys
駤	fmaf
䮅	fmaf
騃	fmbt
黪	fmck
鲹	fmck
䍣	fmcm
䚑	fmdw
鲿	fmeg
顨	fmfu
黢	fmgb
駿	fmgb
䒄	fmhc
灭	fmif
鳤	fmip
黩	fmjc
㱩	fmjc
䒀	fmkk
罷	fmkn
㔥	fmku
羆	fmkx
䮁	fmld
戩	fmma
殂	fmmd
頁	fmmd
兩	fmmf
駔	fmmf
鼁	fmmf
驂	fmmk
黲	fmmk
罝	fmmm
買	fmmm
䵴	fmmm
䮼	fmmo
晉	fmmr
鲐	fmnm
殆	fmnm
駘	fmnm
騧	fmnm
鳕	fmob
艝	fmob
䮤	fmpr
鷶	fmrr
㱡	fmtd
駪	fmtf
驦	fmtf
㔝	fmuc
䫰	fmwo
馻	fmwq
馾	fmwq
黕	fmwq
艞	fmww
艛	fmxc
䮫	fmxc
䮝	fmxf
䪾	fmyk
艙	fnbn
飱	fncb
餋	fncb
艖	fncf
艥	fndi
㘸	fnif
䑻	fnjv
罥	fnkm
駽	fnkm
䣖	fnkv
殞	fnmm
䒃	fnne
羂	fnnk
艁	fnnm
殣	fnno
騹	fnno
唟	fnnq
驠	fnnx
駛	fnow
邏	fnpe
羅	fnpr
死	fnqd
舲	fnqx
駖	fnqx
羄	fnuf
鲽	fnvo
殜	fnvo
艓	fnvo
䮜	fnvo
䭻	fnwf
罖	fnwm
䵲	fnxo
駠	foav
劅	foba
斀	fobb
騶	fobb
䑼	fobb
斣	fobl
歜	fobl
蜀	fobm
䫳	fobm
鸀	fobr
歿	fobx
䘮	focf
鲍	fodb
䮀	fodb
䍖	fodb
袌	fodx
罛	foem
㭧	fofe
末	foff
桊	fofi
䍒	fofm
䮦	fogn
䮎	fogp
膥	fohy
馰	foii
䵠	foii
驐	fojs
鲟	fokf
鲭	fokm
䑶	fokm
艐	folb
騣	folb
䍟	folb
离	folm
離	folp
㐫	folv
駸	fomb
㱴	fomm
殪	fone
卷	foni
駒	fonm
䑦	fonm
唜	fonn
駁	foow
鸼	foqe
歾	fore
騨	forl
殉	form
駨	form
騘	foru
駍	fosf
鲆	fosq
㱤	fote
䭷	fotf
勌	fouc
騊	fovt
彥	foxk
產	foxl
顏	foxm
㓬	fpaj
䭹	fpav
䪟	fpbf
艔	fpbx
䑾	fpbx
舠	fpce
刧	fpcf
券	fpci
鱽	fpcq
迊	fpep
䢌	fpep
䲟	fpfa
	fpfa
騲	fpfm
驊	fpgg
䄅	fpgi
刼	fpii
艬	fpji
黭	fpld
巿	fpmf
帀	fpmf
駟	fpmf
帣	fpmi
殨	fpmm
市	fpmy
駋	fpnm
䮶	fpof
㱷	fpof
䴓	fpoq
	fpoq
鳠	fppb
艧	fppb
艭	fppb
鮝	fpqi
騅	fprf
艪	fprm
䍜	fprm
鳾	fprr
歼	fptd
䑪	fpwe
驩	fpxp
	fpym
㱮	fpym
䮢	fpyr
弮	fqbi
羇	fqcn
亊	fqdb
殖	fqfd
羈	fqff
置	fqfm
馯	fqgf
䍐	fqgm
䵟	fqgm
黰	fqgw
罾	fqir
驓	fqir
艄	fqkm
鲬	fqlm
駾	fqnw
驧	fqow
䑺	fqqe
颿	fqqf
罤	fqqr
䑯	fqqr
殚	fqrl
舴	fqte
鲊	fqtq
鳓	fquc
羁	fqvn
駢	fqxg
䑫	fqxg
	fqyf
䲡	fqyf
鳟	fqyk
鴺	fqyr
夷	fqyw
㓦	fraj
黖	fram
㚆	frbq
剄	frca
逕	frce
巠	frcf
巰	frck
鲻	frcm
頸	frcm
鵛	frcr
勁	frcu
䣆	frcw
褎	frcx
鲢	frep
鳗	frfb
罼	frff
驆	frff
皕	frfr
鳎	frhh
䑽	frhh
㯥	frhh
㼯	frhj
亰	frhk
東	frhk
䰤	frhm
鶇	frhr
坙	frif
騴	frix
鲲	frja
騉	frja
㼣	frja
䵪	frja
㪶	frjl
鲥	frkf
裦	frlx
百	frmd
馹	frmf
鲁	frmq
舸	frnm
鲄	frnm
䮿	frns
襃	frnx
䢚	froe
騍	frof
甦	frol
㬲	fros
朅	frov
騔	frov
更	frow
郠	frow
裹	frox
駻	frqg
殦	frrd
鵃	frre
鵶	frrf
鲳	frrm
䮖	frrm
罺	frro
鳁	frsm
㪽	frte
恴	frup
褏	frxx
駐	fryf
罜	frym
㱙	fsad
亏	fsaf
迃	fsep
殐	fsfd
駷	fsff
䫦	fsfm
㱜	fshd
琧	fsii
盘	fsme
盍	fsmf
騠	fsmf
鳀	fsmq
駇	fstf
歽	fted
馸	ftef
艨	ftfg
鲣	ftif
罠	ftja
㱪	ftjr
殔	ftll
㰷	ftlq
䮩	ftmf
疌	ftsh
鳙	fttj
㱝	ftuc
駮	ftyf
鲛	ftyq
刯	fuaj
䩅	fuav
蠠	fubb
肂	fubd
䮇	fubf
巻	fubi
鱾	fubq
鲪	fubq
劫	fucf
䩍	fuch
劵	fuci
舻	fudb
鲈	fudb
亓	fudf
䭶	fudf
鲚	fudr
靦	fudw
騝	fudx
駜	fuee
䮒	fuff
罩	fufm
䑲	fufm
䮓	fufm
殊	fugw
駯	fugw
䩄	fugw
䩊	fuio
䩃	fuja
殠	fuld
䩇	fulh
䩈	fulj
䩂	fulw
面	fumd
亘	fumf
䵣	fumm
殛	funf
靤	fuod
䵮	fuor
悪	fupf
惡	fupf
䩏	fupi
靧	fupm
䩌	fupx
㱚	fuqd
䑥	fuqe
馺	fuqf
䩆	fuqt
䭽	futf
牶	futi
䩋	futj
勔	fuuc
䩉	fuuf
䂲	fuvd
䑠	fuve
丐	fuvv
䩎	fuwh
馼	fuyf
駃	fuyw
驥	fvcw
鲺	fveb
与	fvff
欤	fvfl
署	fvfm
䵭	fvfm
㱭	fvhb
䍕	fvii
舺	fvme
騛	fvpd
駈	fvrf
殙	fvrm
韏	fvvi
䵝	fvvm
舫	fvye
鲂	fvyq
黓	fwam
虺	fwbm
譬	fwcy
尶	fwds
武	fweh
虣	fweh
䝾	fwem
鹉	fweo
避	fwep
鵡	fwer
舼	fwfe
䪲	fwfm
襞	fwfx
豗	fwgd
䑳	fwgp
㠪	fwhf
擘	fwht
壁	fwif
繴	fwih
䍘	fwim
鳞	fwio
驎	fwio
䵳	fwir
甓	fwja
卼	fwjo
孹	fwjv
騟	fwka
㝶	fwkf
䮛	fwkk
臂	fwkm
弐	fwlg
㵨	fwlm
艃	fwme
貮	fwmm
鼊	fwmm
殓	fwmo
鲤	fwmq
躄	fwns
験	fwny
艅	fwof
檗	fwof
駼	fwof
䴙	fwoq
	fwoq
䢃	fwow
劈	fwpc
幦	fwpm
兀	fwqf
㒫	fwqf
鷿	fwrr
鸊	fwrr
䲫	fwrr
尫	fwsg
璧	fwsi
騀	fwtf
鐾	fwtw
憵	fwup
礕	fwvd
郍	fwve
䣕	fwvf
糪	fwwi
駣	fwwy
䑬	fwwy
嬖	fwxc
殮	fwxh
驗	fwxh
䮽	fwxo
裏	fwxq
辟	fwyb
騂	fwyf
騼	fwyf
黯	fwym
罯	fwym
䍡	fwym
㱹	fxce
䍥	fxce
鳜	fxel
㱠	fxfd
䑩	fxfe
罟	fxfm
鳄	fxfs
裔	fxgn
驪	fxiw
専	fxkf
㓰	fxla
駏	fxlb
䘚	fxlf
騄	fxll
罽	fxma
舳	fxme
駎	fxmf
鲉	fxmq
叀	fxmx
驅	fxnx
駆	fxow
衣	fxqy
殫	fxrl
驒	fxrl
曺	fxrm
騁	fxsa
恵	fxup
䒂	fxwk
殑	fxwq
䮲	fxxg
瓤	fxxo
勷	fxxu
襄	fxxx
鲗	fyaj
黗	fyam
鲀	fyaq
殝	fyct
舦	fyde
駄	fydf
鲙	fyeg
鳊	fygp
艑	fygp
騙	fygp
騇	fyhg
騸	fyhh
艘	fyjb
騪	fyjb
餮	fykc
殄	fyke
駗	fyke
䑷	fykm
页	fymd
舱	fyon
䲝	fyon
舮	fype
馿	fypf
䲠	fyrm
	fyrm
䮞	fyrm
艩	fyrr
䮺	fyrr
䍤	fyrr
駩	fysg
鲵	fywq
䮘	fywq
艤	fywt
裒	fyxq
㥇	gaaa
㥍	gafo
刾	gajs
悈	gald
惐	ganf
悟	ganm
慠	gast
怶	gavo
愖	gavv
惙	gbbb
䝌	gbbb
蟸	gbbm
㦀	gbce
㦎	gbcf
憣	gbcm
豲	gbdd
㥳	gbdo
戃	gbfm
慅	gbib
怪	gbif
憆	gbif
忧	gbii
犮	gbii
㣾	gbii
䳊	gbir
盋	gbis
㤏	gbjo
怿	gbkg
㤶	gbki
㤕	gblv
蛰	gbmf
忡	gbmo
恪	gbnm
㥙	gbup
友	gbxd
悧	gcaj
㿮	gcav
豤	gcbd
恨	gcbo
㤆	gcbx
㥴	gcch
懚	gccu
懳	gccu
央	gcdm
忕	gcdo
左	gcfd
愄	gcfo
䝈	gcfo
恗	gcfs
懅	gcgd
㤧	gchf
悏	gchw
慀	gcic
豯	gcic
㼜	gcja
䒋	gcjk
悸	gcjv
愋	gckb
憉	gcke
遀	gcke
憈	gckj
㥜	gckm
毻	gcko
㤒	gclf
㦪	gcmb
愀	gcmi
愩	gcmm
愧	gcmx
憘	gcnm
㥒	gcof
慡	gcoo
鸯	gcoq
憭	gcqh
㥓	gcrn
鴦	gcrr
㤿	gcrv
盎	gcsm
愢	gcup
㦋	gcvf
㦆	gcvl
愮	gcvt
慆	gcyr
慑	gdbb
慳	gdbi
䝒	gdbi
囘	gdbm
戄	gddb
懾	gddd
䝕	gddd
懼	gddp
㦏	gddw
慞	gdfm
㥪	gdio
㦡	gdio
冒	gdmm
㦅	gdmp
㥉	gdnm
㥡	gdno
怩	gdnq
毷	gdot
怕	gdro
乔	gdrt
㒶	gdrw
惶	gdsg
懢	gdts
㪞	gdub
勖	gduc
忚	gdvo
憿	gdvs
㤴	gdvv
憧	gdwm
䝑	gdwm
悓	gdwq
㒻	gdwq
廼	gdxf
蚃	gebm
鄊	gedw
鄕	gedw
乡	geen
悱	gefh
慔	gefo
㤌	gefo
懊	gegc
恦	gegn
忶	gego
剛	geha
岡	gehm
蠁	geib
饗	geic
嚮	gein
㗽	gein
鄉	geiw
響	geiw
慊	gejg
憁	gelu
鬮	gemm
飨	genc
逐	gepd
迺	gepf
送	gepi
慨	gera
恤	gesm
怢	getg
恸	geuc
耉	gevn
郷	gewv
憹	gexo
罔	gexy
㒺	geyv
豥	geyw
㤥	geyw
刐	gfaj
㤡	gfaj
怃	gfbd
㦒	gfcy
慻	gfdm
悽	gfdx
慒	gfer
怯	gffo
恆	gffo
悵	gffo
懐	gffx
懷	gffx
㥖	gfgu
悴	gfhl
忼	gfhq
懁	gfhx
慉	gfic
怰	gfin
懌	gfir
懮	gfkb
愞	gfkc
彤	gfke
懍	gflc
懎	gfln
懔	gflp
憻	gflu
頬	gfmm
㥧	gfmm
㦬	gfnp
恼	gfol
惓	gfon
㒽	gfon
㒿	gfop
雘	gfpb
㥘	gfpi
鬧	gfpm
㤄	gfpm
恞	gfqy
鴅	gfrr
㥺	gfsm
䝊	gfts
㤼	gfuc
愐	gfum
恒	gfum
愣	gfvy
䢷	gfwv
䵊	gfxg
懹	gfxx
颊	gfym
丹	gfyq
怏	ggcd
墯	ggci
惰	ggck
豩	ggdd
㤭	ggdr
惘	ggex
删	ggfa
册	ggff
丝	ggff
鸶	ggfo
恓	ggfo
㤯	gggn
恫	gghf
惆	ggin
㤢	ggkm
冇	ggmd
慃	ggmh
燹	ggmi
恢	ggmi
恱	ggmw
忪	ggmx
䢛	ggne
冏	ggnm
㤑	ggnm
憍	ggnn
恅	ggnq
愭	ggnr
悅	ggnw
怖	ggpm
㤇	ggto
戙	ghaa
懺	ghaf
㤉	ghao
㥟	ghaq
憱	ghbi
豛	ghbx
愊	ghcm
㤱	ghei
鬪	ghek
迵	ghep
惴	ghfk
䝎	ghfk
同	ghfm
憛	ghfm
㤹	ghfo
㥏	ghgw
慴	ghhd
愷	ghhe
憀	ghhk
䰘	ghhk
憾	ghhu
忛	ghii
㤜	ghii
岙	ghmt
㖯	ghnn
慄	ghof
㤦	ghow
慓	ghpg
慛	ghpr
挚	ghtf
恬	ghto
恺	ghub
悯	ghuy
㢥	ghwa
慽	ghwh
憟	ghwi
惊	ghyo
剢	giaj
愘	gibn
悢	gicb
㦥	gicu
懗	gidg
㤸	gidg
㤞	giej
䶲	giem
䝅	gifd
垫	giff
冉	gifm
愃	gifu
㥄	gigb
憕	gihe
䎃	gihh
絷	gihk
丈	giid
豖	giid
㤬	giif
惋	giio
㣺	giio
恀	giiq
憢	giiw
恃	gikf
恍	gilo
㓮	gina
週	gine
忭	ginf
翢	ginh
彫	gink
周	ginm
雕	ginp
鵰	ginr
郮	ginw
懰	gipa
悰	gipg
䝋	gipg
悺	gipm
㤖	girf
悻	giri
怅	gito
怮	giuc
懧	giur
怺	givi
甀	gjat
怀	gjdo
円	gjff
怌	gjff
䍏	gjff
怔	gjfo
惏	gjfo
㥼	gjfx
愌	gjgc
豴	gjgx
悂	gjif
㥔	gjkm
鬦	gjlf
懈	gjlu
㒳	gjmm
㥬	gjmv
㤳	gjnm
㤘	gjob
	gjob
㦗	gjpg
教	gjst
孝	gjvf
憷	gjvs
㤝	gjwq
慟	gjwu
憺	gjxc
㦃	gjxl
恑	gjxo
惂	gjyr
戫	gkaf
㦽	gkar
㤛	gkat
龓	gkda
迶	gkep
忖	gkfo
惧	gkgw
怽	gkgw
恠	gkif
㤔	gkkf
㬼	gklb
有	gkmd
冐	gkmm
䏌	gkmw
恄	gknm
懛	gknm
恘	gkof
豣	gkqg
䳑	gkrr
䀁	gksm
㤫	gkup
豝	gkvd
懤	gkvk
郁	gkwv
㦠	gkyk
慖	glaf
懴	glaf
豭	glbb
忮	glbx
㩾	glbx
悾	glcf
憰	glen
懙	glfg
㥵	glgd
冃	glgm
冄	glgm
怗	glho
悔	gljn
忤	gllf
恛	glnm
㤷	glnm
悃	glof
憤	glpm
豶	glpm
愤	glpy
豮	glpy
忺	glqo
愎	glrb
甤	gltd
性	glto
惗	glup
慯	glur
忸	glvo
忔	glvv
憮	glvx
忴	glwo
忬	glxo
愹	glyn
慍	glys
耊	gmaf
惻	gmaj
怴	gmao
恎	gmao
惨	gmck
㦢	gmea
㦨	gmfh
懦	gmfk
頌	gmfm
颂	gmfy
悛	gmgb
翁	gmhh
翃	gmhh
鹟	gmho
鶲	gmhr
勜	gmhu
灰	gmid
瓮	gmja
豠	gmmd
惔	gmmi
慘	gmmk
㦫	gmmm
怚	gmmo
憴	gmmo
㥃	gmmo
㦧	gmmr
憦	gmmu
怡	gmnm
枀	gmof
雄	gmpr
䫺	gmqq
恽	gmra
慏	gmrb
䲲	gmrr
盔	gmsm
忩	gmup
㦖	gmup
憪	gmuq
恈	gmut
憫	gmuy
內	gmwm
毤	gmwo
忱	gmwq
兊	gmwq
慺	gmxc
䝏	gmxc
厷	gmxd
惲	gmxf
䝍	gmxf
憡	gmxh
㦭	gmxh
禸	gmxm
䙶	gmxq
公	gmxw
㦦	gmyw
愴	gnbn
懝	gnbs
愼	gndg
㒾	gndv
㢠	gndx
迥	gnep
冔	gnfl
敽	gngb
䢪	gnge
䎗	gngh
喬	gngn
鷮	gngr
敿	gngs
䀉	gngs
勪	gngu
怾	gngw
䎝	gnhh
懩	gnic
悁	gnkm
悒	gnkv
耋	gnma
右	gnmd
冋	gnmm
愪	gnmm
慲	gnmm
呑	gnmt
㕣	gnmw
慥	gnne
悎	gnnm
㖈	gnnm
䎛	gnnm
慬	gnno
懄	gnnu
耈	gnon
耄	gnot
䧺	gnpr
㔫	gnqd
老	gnqf
怜	gnqx
耆	gnrm
恉	gnrm
悜	gnsg
鬬	gnte
鬭	gnte
悮	gnug
悞	gnvc
惵	gnvo
怈	gnvv
㐗	gnvv
㤋	gnwo
兌	gnwq
怳	gnwq
敓	gnws
懆	gnxo
刚	goaj
	gobb
㥮	gobb
憳	gock
怉	godb
㤓	goff
恡	gogm
豨	gogp
悕	gogp
愫	goih
怵	goii
㣿	goii
憞	gojs
惇	gojv
情	gokm
惾	golb
忷	golv
㥽	gomm
豷	gone
㦉	gone
耇	gonm
怐	gonm
豞	gonm
羀	gooc
䍞	goof
恟	gool
悩	gool
䍑	gooq
网	goow
㤊	goow
憏	gopg
鸷	goqf
惸	gorj
恂	gorm
㥫	gorm
惚	goru
愡	goru
怦	goso
悙	gouv
㥌	gowi
冈	gowm
罓	gowm
刪	gpaj
愯	gpbx
忉	gpco
懵	gpfd
懜	gpfi
懱	gpfi
愺	gpfm
愥	gpgc
㦊	gpgg
豵	gphs
㣼	gpii
懏	gpjv
懂	gpjw
布	gpmd
㠻	gpmf
憒	gpmm
怬	gpmo
怊	gpnm
憽	gpou
㦜	gppb
惟	gpro
䰗	gprv
㤚	gpsg
忏	gpto
恰	gpwo
冕	gpwq
悗	gpwq
憔	gpxo
慌	gpxp
懽	gpxp
䝔	gpxp
恾	gpxy
愦	gpym
㥝	gqdf
怫	gqdr
惤	gqfi
愅	gqfo
㥀	gqfo
㥞	gqgd
惝	gqgn
忓	gqgo
慎	gqgw
憎	gqir
怑	gqkg
悄	gqkm
悀	gqlm
愑	gqlu
悦	gqnw
悌	gqqr
惮	gqrl
怍	gqto
愵	gqtt
恲	gqxg
㥢	gqyf
愱	grbt
惱	greo
慢	grfb
忊	grfo
㥥	grgn
㦙	grgu
憬	grhy
愰	gril
惃	grja
䝓	grlf
惺	grlt
惈	grof
惕	gror
愒	grov
㤤	grow
悍	grqg
憯	grrr
鴁	grrt
䳠	grrt
愠	grsm
豱	grsm
惭	grte
㥗	gruy
懪	grwl
考	gsaf
兮	gsaw
悚	gsfo
忹	gsgo
㼥	gsja
䒊	gsjk
懶	gsjm
懒	gsjy
忰	gslf
䀃	gsmd
惿	gsmo
㿽	gssm
忻	gteo
懞	gtfg
䎜	gtgn
悭	gtif
怋	gtja
戂	gtjf
懡	gtjm
惽	gtjr
㤽	gtkf
惦	gtlh
㥆	gtll
惞	gtlq
愲	gtmo
䳓	gtrr
慵	gttj
慷	gttl
懫	gttm
惍	gtwo
釡	gtww
懭	gtxg
恔	gtyo
忋	gubo
势	gucf
忇	guco
怭	guee
豧	gufd
悼	gufm
悑	gufo
愽	gukf
㥂	gukf
悿	gulk
怛	gumo
㥛	gunf
悋	gunm
愓	guor
㤈	gupo
忣	guqo
愶	guuk
㥊	guuq
恊	guuu
忟	guyo
快	guyw
懻	gvcw
鬫	gvds
㦑	gvds
豬	gvfd
㥩	gvfo
怟	gvii
櫫	gvof
㤾	gvof
忯	gvqo
惛	gvrm
㥠	gvsk
忆	gvvo
愇	gvvo
㤃	gvyo
㦕	gwbl
恜	gwcf
㦩	gwcu
鬨	gwfg
㤨	gwfo
䝇	gwgd
憜	gwgk
䝐	gwgk
忨	gwgo
惀	gwgp
憐	gwio
懀	gwir
觃	gwjv
愉	gwka
㦐	gwlm
㦓	gwlx
悝	gwmo
悇	gwof
尦	gwoi
见	gwqm
尣	gwqw
尩	gwsg
憶	gwup
郑	gwvi
郏	gwvs
郵	gwvt
恌	gwwy
憸	gwxh
愔	gwyo
㦇	gwyo
怓	gxbx
愜	gxch
懥	gxcs
㦍	gxeb
㥱	gxef
慩	gxep
怙	gxfo
愕	gxfs
豜	gxgd
惬	gxgs
慱	gxik
憓	gxiu
悖	gxjv
怇	gxlb
恹	gxld
怞	gxmo
慪	gxnx
热	gxof
怄	gxow
㥾	gxpn
㤺	gxpr
憚	gxrl
懨	gxrl
惜	gxrm
愝	gxrx
恇	gxsg
慚	gxte
忙	gxyo
怲	gxyw
豘	gyad
恻	gyaj
忳	gyao
㥅	gybx
忲	gydo
忦	gydr
㒷	gyfg
惼	gygp
㥰	gyjb
悷	gyld
㥭	gyll
贽	gymf
慣	gymm
卻	gyna
豅	gyna
螸	gynb
䜱	gynb
谾	gync
豀	gync
䜫	gync
逧	gyne
䜲	gynf
谺	gynh
谻	gynh
㞃	gyni
豂	gynk
欲	gynl
䜰	gynl
谷	gynm
谹	gynm
豄	gynm
㕯	gynm
谽	gynn
鹆	gyno
鵒	gynr
豃	gyns
䜪	gyns
慾	gynu
䜮	gynu
郤	gynw
谼	gynw
䜯	gynw
䜬	gynx
怆	gyon
懠	gyrr
恮	gysg
㦈	gysm
忾	gyto
懓	gyub
豟	gyvv
愾	gywi
内	gywm
鬩	gywq
惯	gyym
肉	gyyw
㥚	gyyw
㟞	haaa
剶	haaj
㦰	haaw
劙	haba
蠡	habb
䗍	habm
韱	haef
阔	haht
㟄	haim
剧	hajb
刮	hajt
剠	hajy
㠌	halq
馘	hanf
阈	hanf
峿	hanm
彖	haqn
鶨	harr
盠	hasm
㟼	hast
㠂	hast
饪	hatq
皳	havf
岥	havm
舏	havt
嵁	havv
峰	hbcg
峯	hbcg
嶓	hbcm
㟲	hbdm
㟶	hbdm
闱	hbgu
就	hbii
鹫	hbio
鷲	hbir
蹵	hbis
彘	hbja
峂	hbjo
峄	hbkg
㟌	hbki
饳	hblv
㞲	hbmm
蚀	hbmq
闽	hbmu
饹	hbnm
阁	hbnm
峈	hbnm
峉	hbnm
㞺	hbtm
殳	hbxq
凤	hbxq
副	hcaj
峲	hcaj
㸧	hcba
崢	hcbb
峎	hcbm
饭	hcbx
岅	hcbx
豐	hcce
㠥	hcci
艷	hcck
屷	hccm
㞧	hccm
豒	hccr
豓	hccs
豔	hccs
㠠	hccs
嶾	hccu
酆	hccw
䙴	hcdb
遷	hcde
䙲	hcdf
尖	hcdk
闼	hcep
逼	hcep
屸	hcfm
㞬	hcfm
嵔	hcfo
㟪	hcfo
巇	hcha
㽬	hchc
尜	hchk
巘	hchl
巚	hchl
峽	hchw
嵠	hcic
峚	hcif
嵙	hcjl
㟊	hcjv
嵈	hckb
㠊	hckj
疈	hclc
畐	hcmf
嵬	hcmx
㟴	hcmx
㠢	hcmx
㠟	hcol
嶚	hcqh
嶛	hcqh
崎	hcrn
㟢	hcrn
鶝	hcrr
阉	hcrv
崦	hcrv
䅇	hctf
崽	hcup
㥻	hcup
嵊	hcvh
馁	hcxc
崣	hcxc
㟎	hcxc
輋	hcxf
巍	hcxm
訔	hcym
訚	hcyu
剚	hdaj
事	hdbf
崛	hdbl
崫	hdbl
㟸	hdcl
崍	hddm
䥚	hddt
馔	hddw
崥	hdel
嶂	hdfm
饵	hdfq
闻	hdfu
耸	hdfw
嵝	hdim
巃	hdka
巄	hdka
阒	hdld
㟫	hdlm
嵽	hdmp
嵜	hdnj
㟝	hdnm
㞾	hdnq
㟹	hdoa
嶎	hdpk
岶	hdrm
凰	hdsg
崲	hdsg
覈	hdvs
㠉	hdwm
峴	hdwq
覍	hdwq
㝸	hdwq
岦	hdym
剅	heaj
䜵	heav
阙	hebl
䜶	hebo
豇	hecf
䆃	hect
夔	hedb
豍	hedl
䜸	hedo
豏	heeg
巕	heej
逗	heep
頭	hefm
馍	hefq
甜	heft
㠗	hegc
饷	hegn
饯	hegq
凨	hegq
凪	hehq
䝀	heic
豆	heif
嵫	heii
豌	heio
饦	heja
凲	hejg
嵰	hejg
㪷	hejl
導	hekf
豉	helb
嵌	helq
㰯	helq
噵	henm
㘏	henn
䜷	heob
毭	heot
迓	hepa
䝄	hepb
逑	hepf
道	hepi
辿	hepm
巋	hepp
适	hept
嶭	hepw
䝃	herx
䜹	hesf
䜻	hesm
䜴	heub
憇	heup
㐙	hevv
䜳	hevv
䜽	hewa
郖	hewv
䜾	hewy
嶩	hexo
覂	hexp
䜺	hexr
阂	heyw
峐	heyw
阑	hfah
峛	hfaj
峢	hfaj
巎	hfdb
夙	hfdq
䚓	hfdw
嶵	hfef
㠑	hfef
䢕	hfep
嶆	hfer
戌	hffd
㐀	hffh
闩	hffu
丛	hffw
㠡	hffx
崒	hfhl
崪	hfhl
闶	hfhq
阛	hfhx
嶧	hfir
㟵	hfjf
剬	hfka
㪜	hfkb
遄	hfke
㼷	hfkj
歂	hfkl
耑	hfkm
峏	hfkm
顓	hfkm
䳪	hfkr
颛	hfky
覃	hfmf
烕	hfmi
㶾	hfmi
崸	hfmm
頢	hfmm
䪵	hfmm
䭭	hfmm
㟡	hfon
闹	hfpm
峓	hfqy
崠	hfrh
崬	hfrh
凬	hfrm
凮	hfrm
峕	hfrm
峺	hfro
鳳	hfrr
鷣	hfrr
㓘	hfsi
馌	hfsm
阖	hfsm
崨	hfts
峘	hfum
屿	hfvf
翘	hfwh
屼	hfwq
尧	hfwq
㠔	hfwy
威	hfxc
裘	hfxq
饻	hfxq
㠤	hfxx
岟	hgcd
峤	hgdr
覥	hgdw
崗	hgeh
㟠	hgeh
豳	hggd
崋	hggm
觍	hggw
峒	hghf
峝	hghf
舑	hgif
嶳	hgii
㟘	hgin
峟	hgkm
䐌	hgkm
䑙	hglg
嵡	hgmh
炭	hgmi
闳	hgmx
尙	hgnm
嶠	hgnn
㠐	hgnn
峔	hgnq
岗	hgow
融	hgrb
鬷	hgrb
䰙	hgrb
鬸	hgrc
翮	hgrh
鬲	hgri
䰛	hgrj
鹝	hgro
鞷	hgrq
鬺	hgrr
鷊	hgrr
䰝	hgrr
鬴	hgru
䰚	hgru
䣓	hgrw
峡	hgsm
敟	hgst
岆	hgtm
崜	hgtm
饫	hgtq
典	hgwm
岘	hgwq
峪	hgyn
䎒	hhaa
岈	hham
翍	hhav
㠇	hhbi
翀	hhbm
崌	hhbm
㠦	hhce
羾	hhcf
翜	hhch
䎚	hhcu
翼	hhcw
㦻	hhda
飁	hhdq
習	hhdr
䎎	hhdv
翫	hhdw
翌	hhdy
翋	hhdy
剴	hhea
巙	hheb
敱	hheb
凱	hheh
豈	hhei
饾	hhei
獃	hhel
顗	hhem
颽	hheq
敳	hhes
翐	hhet
覬	hhew
䶠	hhew
咸	hhfd
䁞	hhfd
㟨	hhfk
翠	hhfl
頨	hhfm
顑	hhfm
㟈	hhfm
嵗	hhfo
饶	hhfw
峣	hhfw
崴	hhfx
翇	hhgi
嶍	hhhd
㠄	hhhd
嵦	hhhe
嵅	hhhf
䎉	hhhi
尛	hhhk
嵺	hhhk
掱	hhht
舙	hhht
翞	hhhy
翣	hhhy
	hhif
㟇	hhif
䦷	hhif
㞩	hhii
觱	hhjl
翭	hhkb
翄	hhlb
羿	hhld
䌠	hhlh
㰹	hhlq
䎓	hhlr
䎀	hhma
屾	hhmm
岀	hhmm
翚	hhmr
翬	hhmx
䎆	hhnq
䎌	hhns
翂	hhnw
翪	hhob
䎂	hhod
㟳	hhof
翯	hhon
翑	hhon
毣	hhot
岚	hhow
戳	hhpa
巀	hhpa
㠒	hhpa
㪬	hhpb
䢰	hhpe
㟽	hhpg
翟	hhpr
鸐	hhpr
㞦	hhqm
饥	hhqq
䎈	hhre
㫺	hhrm
翵	hhrr
䍿	hhsg
翆	hhsl
翨	hhsm
䥭	hhtw
闿	hhub
䎍	hhuf
䎔	hhuk
䫲	hhum
感	hhup
峸	hhvv
峫	hhwv
䣁	hhwv
崾	hhxc
翴	hhxe
䎑	hhxl
羽	hhxx
戮	hhya
剹	hhya
䢧	hhye
翏	hhyk
顟	hhym
鹨	hhyo
雡	hhyp
鷚	hhyr
勠	hhyu
鄝	hhyw
刿	hiaj
剉	hiaj
㟯	hibn
夎	hibq
崀	hicb
阆	hicb
㟍	hicb
䚈	hidw
垔	hiff
尘	hifk
坐	hifw
崚	higb
峵	higm
嶝	hihe
翙	hihh
戍	hiid
闺	hiif
䙵	hiif
崶	hiik
尐	hiik
	hiik
䫜	hiim
幽	hiin
凡	hiiq
嶢	hiiw
嶤	hiiw
甄	hija
羐	hiji
峙	hikf
崁	hilq
歅	hilq
岮	hinq
嵥	hioo
㞿	hiow
㓽	hipa
馏	hipc
嵧	hipc
崇	hipg
馆	hipm
岁	hiqm
崃	hism
岰	hiuc
阕	hiug
㟉	hiut
鄄	hiwv
峖	hixc
㼘	hjam
峥	hjbb
	hjbb
䦶	hjbb
叓	hjbx
㞸	hjdm
岯	hjff
崊	hjfm
㠃	hjgx
㞮	hjii
㞳	hjlf
㟆	hjlf
嵚	hjlq
崅	hjlq
嶰	hjlu
崹	hjmp
嵭	hjmv
㟂	hjnm
阄	hjrv
㞨	hjvm
嶦	hjxc
舚	hjxc
嵃	hjxk
嵼	hjxl
峗	hjxo
峞	hjxo
阎	hjyr
馅	hjyr
阀	hkaa
嶪	hkag
嶫	hkag
芈	hkgh
羋	hkgh
覄	hkld
嶹	hkvk
岜	hkvm
㠚	hkyk
剝	hlaj
嶻	hlap
岐	hlbx
崆	hlcf
闭	hlee
嶼	hlfg
㠘	hlfg
䫈	hlfm
亗	hlgm
岾	hlhm
埊	hlif
㟮	hlld
㞰	hllf
彔	hlln
汖	hlmm
㟏	hlnm
㟔	hlnm
阃	hlof
岤	hlom
饰	hlpm
㰞	hlqm
饮	hlqq
崉	hlrm
饬	hluc
屹	hlvv
岑	hlwm
岒	hlwm
崮	hlxf
崓	hlxf
嵱	hlyn
崱	hmaj
峌	hmam
㞽	hmam
㟥	hmck
嶿	hmfk
嶀	hmfs
峻	hmgb
馂	hmgb
闫	hmgu
䙳	hmif
㶡	hmiq
峅	hmld
賈	hmmf
舕	hmmi
嵾	hmmk
㠁	hmmk
岨	hmmm
巑	hmmm
巆	hmmn
嶸	hmmo
嶗	hmmu
巊	hmmx
饴	hmnm
㟰	hmrb
彙	hmro
㠈	hmsg
㞥	hmwm
嶁	hmxc
㟺	hmxc
㟦	hmxf
嵢	hnbn
嶷	hnbs
㠜	hnbs
嵯	hncf
嵳	hncf
嶯	hndi
巓	hndm
崺	hndv
㟕	hnjl
馐	hnlv
问	hnmu
闾	hnnm
峼	hnnm
馑	hnno
㕾	hnnq
㟗	hnnw
嶉	hnpr
嶺	hnqm
䳥	hnqr
岭	hnqx
岺	hnqx
㞻	hnsa
䑜	hnvo
岎	hnwm
岲	hnwq
嵓	hnxm
㠋	hnxs
嶘	hoaa
剁	hoaj
峁	hoav
飔	hocu
饱	hodb
栗	hoff
朵	hofq
凩	hofq
闲	hofu
崤	hogk
巐	hogl
崧	hogm
㟣	hogm
嵩	hogn
嵪	hogn
㟓	hogp
飗	hoic
崞	hojv
飓	hokg
崝	hokm
嵏	holb
嵕	holb
飐	holh
㟅	holw
㠙	homg
飚	homm
嵉	homr
岣	honm
茍	honm
飑	hood
㠨	hook
鹇	hooq
鸦	hoqa
鸹	hoqt
岉	hore
峋	horm
鷅	horr
嵀	hory
岼	hosm
嵖	houm
馇	houm
飏	hovr
吏	howf
风	howq
巌	hoxs
飕	hoyb
蠽	hpab
剽	hpaj
嶑	hpaq
岇	hpav
屶	hpcm
嶶	hpds
顠	hpfm
㔒	hpga
票	hpgf
㠏	hpgg
巂	hpgn
酅	hpgw
嶖	hphh
翲	hphh
飘	hpho
嵷	hphs
嵸	hphs
屻	hpii
岃	hpii
崻	hpik
㼼	hpja
巉	hpji
嶲	hpjv
彯	hpke
覆	hplb
㠅	hplb
㟿	hpll
凧	hpmq
岧	hpnm
岹	hpnm
㠍	hpof
㠎	hpof
瓢	hpoi
㠛	hppb
㟷	hppw
飄	hpqq
雅	hpra
雈	hprh
雀	hprk
崔	hprm
䳽	hprr
嶱	hprv
嵂	hpub
勡	hpuc
馋	hpwj
峆	hpwm
峇	hpwm
饸	hpwq
嶕	hpxo
嶣	hpxo
巏	hpxp
馕	hpxx
㟐	hpxy
馈	hpym
阓	hpym
覉	hqcn
岪	hqdr
覊	hqff
屽	hqgm
巔	hqgm
闬	hqgu
阗	hqgw
嵮	hqgw
巅	hqgy
嶒	hqir
㟜	hqjh
峭	hqkm
嵹	hqnb
阅	hqnw
㟋	hqnw
巈	hqow
阐	hqrl
岞	hqtm
岝	hqtm
嵶	hqtt
覇	hquq
饼	hqxg
崷	hqyf
嶟	hqyk
崰	hrcm
馒	hrfb
嵿	hrfm
饤	hrfq
嵎	hrgn
䦸	hrgn
阘	hrhh
嵵	hrik
馄	hrja
崐	hrja
崑	hrja
㞱	hrmm
间	hrmu
岢	hrnm
㞹	hrnm
馃	hrof
舓	hror
嵑	hrov
㣇	hrpm
㣈	hrpp
鴉	hrra
鶋	hrrb
阊	hrrm
嶋	hrrm
嶌	hrrm
鳯	hrrq
嶜	hrrr
鴰	hrrt
鶁	hrry
峳	hrst
崭	hrte
嵨	hrxo
㟛	hsef
闰	hsgu
㟖	hsld
盚	hsmf
崼	hsmm
嶊	hspr
㐜	hsqf
救	hstf
敌	hstt
慦	hsup
嶽	htcl
嵋	htdm
嵣	htdn
岓	htem
㠓	htfg
岽	hthk
岷	htja
㠧	htjf
㟭	htjr
嶔	htlq
馉	htmq
岿	htob
嵘	htof
㟾	httj
嵻	httl
㠝	httm
崂	htuc
崟	htwm
崯	htwm
峧	htym
饺	htyq
剀	huaj
屺	hubm
岂	hubm
峍	hubm
峮	hubm
㟒	hubm
屴	hucm
劧	huct
㔚	huct
勍	hucy
峬	hufm
觊	hugw
凯	huhq
馎	hukf
舔	hulk
嵲	huof
崵	huor
闷	hupu
怂	hupw
岌	huqm
岄	huqm
岋	huqm
䑚	huqt
剻	huua
憩	huup
崩	huuq
䣙	huuw
崡	huwl
䭪	huwm
㞵	huym
㞶	huym
闵	huyu
岩	hvdm
阚	hvds
䫆	hvfm
阇	hvfu
㟃	hvhf
饲	hvhf
岻	hvii
䑛	hvii
㼩	hvja
岬	hvmm
闸	hvmu
闯	hvnu
㞴	hvqm
舐	hvqt
饧	hvre
阍	hvrm
岴	hvrm
崏	hvrm
盛	hvsm
成	hvvd
乢	hvvm
乱	hvvt
郕	hvwv
阏	hvyj
㔄	hwaj
嶐	hwbl
㠕	hwcm
㟟	hwdb
岏	hwgm
崘	hwgp
崙	hwgp
㞝	hwhd
戚	hwhk
顣	hwhm
㗤	hwhn
蹙	hwhs
慼	hwhu
粟	hwif
彝	hwil
嶙	hwio
䊲	hwjl
嵛	hwka
崳	hwka
崄	hwmo
峠	hwnf
彜	hwnl
馀	hwof
峨	hwtm
峩	hwtm
饿	hwtq
邪	hwva
䣇	hwvf
邖	hwvm
䢳	hwvq
嶮	hwxh
嵴	hwyk
峷	hwym
辞	hwyt
㠣	hxce
要	hxcf
屵	hxdm
嶡	hxel
嶥	hxel
岵	hxfm
崿	hxfs
㟧	hxfs
岍	hxgm
崖	hxii
崕	hxii
饽	hxjv
㟑	hxjv
馓	hxks
岠	hxlb
㟤	hxll
岫	hxmm
峀	hxmm
嶇	hxnx
覅	hxor
岖	hxow
㞫	hxpm
巁	hxpn
嵟	hxpr
岸	hxqg
㟁	hxqg
㠆	hxrl
㟙	hxrm
䳩	hxrr
嶃	hxte
嶄	hxte
嶈	hxwk
巖	hxxs
巗	hxxs
嶏	hxyu
饨	hyaq
阌	hybx
嵄	hycd
岕	hydr
峜	hyeh
馊	hyjb
㟬	hyjb
贾	hymf
峑	hysg
饩	hytq
㐁	hywf
㞤	hywm
阋	hywq
嶬	hywt
㠖	hywt
闪	hywu
㟱	hyxo
坡	iacf
䀤	iadm
墡	iaen
迯	iaep
達	iaep
㙋	iaff
垟	iaif
㓝	iajg
圤	ialf
外	ialq
域	ianf
夞	iann
寖	iaob
墚	iapo
盐	iasm
夘	iavq
墈	iavu
堪	iavv
㙍	ibbb
㘮	ibbf
塳	ibce
埄	ibcg
墦	ibcm
壋	ibcm
審	ibcm
㔤	ibcu
覾	ibcw
塬	ibdf
㕚	ibii
㝮	iblb
㙥	ibmx
垎	ibnm
客	ibnm
額	ibnm
愙	ibnu
额	ibny
鿍	iboa
宻	ibqh
圳	ibrf
垁	ibtf
宷	ibwo
㝊	ibxo
壗	ibxs
壌	ibxx
宍	ibyo
垠	icbf
良	icbi
坂	icbx
㙼	iccc
壚	iccs
垯	icep
䢣	icep
㙗	icfo
㙽	icfr
垮	icfs
憲	icfu
壉	icgd
㚀	icha
垢	ichf
㙈	ichq
埉	ichw
垺	icjv
埒	ickf
埓	ickf
墟	ickj
㙕	ickm
塊	icmx
割	icna
㪡	icnb
㲅	icnb
害	icnm
豁	icnn
壪	icnq
鶷	icnr
㝬	icnt
垜	icof
埰	icof
寀	icof
塽	icoo
㝣	icpc
㓪	icpc
寮	icqh
㙩	icqh
寪	icqx
寄	icrn
埼	icrn
埯	icrv
塖	icvh
㙤	icvl
郞	icwv
郎	icwv
堺	icyd
㝘	icyo
塪	icyr
圯	idbf
堀	idbl
㝡	idbx
㙌	iddg
寴	iddw
埤	idel
逇	idep
墇	idfm
宦	idfo
螫	idgb
赧	idgb
赨	idgb
赮	idgb
䞑	idgc
䞓	idgc
赫	idgg
䞒	idgh
赩	idgk
䞕	idgk
赥	idgl
赬	idgm
頳	idgm
赯	idgn
䞔	idgo
赦	idgs
赭	idgv
郝	idgw
赤	idgw
䚂	idgw
赪	idgy
壣	idic
樂	idio
壠	idka
寵	idka
墀	idlu
墆	idmp
培	idnm
坭	idnq
寝	idob
䵺	idob
墛	idpk
塀	idqx
堭	idsg
㘲	idsq
壏	idts
地	idvf
墽	idvs
墥	idwm
垷	idwq
垃	idyf
剆	ieaj
埏	ieed
㝚	ieed
坩	ieff
塻	ieff
寞	iefo
墺	iegc
坛	iegf
垧	iegn
塧	iegs
址	iehf
圫	ieja
宅	ieja
欴	ielq
郒	ienk
㙖	ienn
㝢	ienn
埗	ieok
塠	iepe
进	iepg
埠	iepl
垖	iepm
勆	ieuc
塱	ieui
㮾	ieuo
朗	ieuq
垓	ieyw
堜	ifah
壃	ifcf
㙧	ifcm
㝟	ifdw
埡	ifff
㙊	ifff
㝉	iffo
㝞	iffo
寕	iffr
壞	iffx
㙲	ifgp
埣	ifhl
坘	ifhn
坑	ifhq
寰	ifhx
堘	ifif
墿	ifir
堽	ifjf
堧	ifkc
壈	iflc
䢓	ifle
圩	iflf
宇	iflf
墻	ifln
壇	iflu
寡	ifmn
䎙	ifoh
垴	ifol
賓	ifom
顮	ifom
埢	ifon
䨈	ifop
䚔	ifow
埬	ifrh
埂	ifro
圬	ifsa
定	ifsh
顁	ifsm
寁	ifts
翧	ifuh
垣	ifum
宣	ifum
䳦	ifur
㝍	ifvf
塄	ifvy
壀	ifwy
戭	ifxa
寅	ifxg
㪦	ifxs
壤	ifxx
坺	igbi
夌	igbq
坱	igcd
堶	igck
家	igdo
堈	igeh
堩	igfu
坍	igfy
埛	iggn
垌	ighf
逵	igie
㙯	igie
坴	igif
驇	igif
㘱	igif
摰	igih
埶	igii
㙇	igii
燅	igim
䞇	igim
槷	igio
暬	igir
鵱	igir
勎	igiu
勢	igiu
熱	igix
宯	igjv
宥	igkm
塕	igmh
翝	igmh
鼀	igmm
宏	igmx
㝐	igmx
坰	ignm
墧	ignn
㝯	ignn
㘵	igpm
㝭	igrl
㘼	igsa
埵	igtf
宎	igto
㘨	igyw
堟	ihaq
坄	ihbx
癹	ihbx
寷	ihce
富	ihcm
堛	ihcm
㔁	ihea
邆	ihee
凳	iheh
登	ihei
㽅	ihej
㲪	iheo
䳾	iher
覴	ihew
鄧	ihew
㙐	ihfk
墰	ihfm
㙎	ihfx
塥	ihgr
㙉	ihgw
塏	ihhe
堿	ihhf
寥	ihhk
耀	ihhp
㙳	ihhu
堙	ihif
糸	ihkn
埁	ihlw
圸	ihmf
垛	ihof
塛	ihof
墂	ihpg
墔	ihpr
宂	ihqo
鴧	ihrr
垲	ihub
塴	ihuu
墭	ihvs
宬	ihvv
城	ihvv
墄	ihwh
㙘	ihxc
䢇	ihxk
堓	ihxq
畿	iiac
墶	iiae
刲	iiaj
卦	iial
卶	iiav
䖯	iibm
埌	iicb
㝗	iicb
幾	iidd
㡮	iidy
垞	iiej
迻	iiep
㙟	iieu
㚊	iiey
蠿	iifb
圭	iiff
夤	iifg
坓	iifg
㘾	iifl
䫂	iifm
埞	iifs
斷	iift
㫁	iift
塇	iifu
㡭	iifv
堎	iigb
㘫	iigf
㐩	iigg
㙆	iigm
㷇	iigm
㚋	iign
宑	iigo
墱	iihe
翗	iihh
㡬	iihv
㙨	iiid
遶	iiie
垚	iiif
圡	iiif
丼	iiig
翹	iiih
㙓	iiii
顤	iiim
埦	iiio
垑	iiiq
㝖	iiiq
䴃	iiir
堯	iiiw
墝	iiiw
㚁	iiiw
㣋	iike
封	iikf
垨	iikf
㨍	iikh
堼	iiki
夡	iikn
幇	iikp
幫	iikp
鞤	iikq
犎	iiku
㜂	iikx
㩼	iilb
垙	iilf
㰪	iilq
鼃	iimm
䵷	iimm
郌	iink
坨	iinq
㝨	iinx
剜	iioa
䗕	iiob
䵫	iiof
宛	iion
夠	iion
鹓	iioo
鵷	iior
惌	iiou
塯	iipc
㚍	iipm
墢	iiqb
多	iiqq
坾	iirf
㝪	iiri
郺	iirk
㚌	iiro
䳏	iirr
盭	iirs
㪈	iiub
坳	iiuc
劸	iiuc
恚	iiup
奊	iivc
㘭	iivv
垸	iiwg
邽	iiwv
垵	iixc
㘩	ijaf
埩	ijbb
实	ijcd
坏	ijdf
堦	ijdr
坯	ijff
壎	ijfm
㝝	ijfo
墕	ijfx
寏	ijgc
墒	ijgn
墑	ijgx
㙄	ijif
㝌	ijii
堉	ijkm
斘	ijlf
㘰	ijlf
埆	ijlq
塝	ijmv
坶	ijnf
㕻	ijnm
垇	ijvf
宐	ijvf
字	ijvo
堹	ijwm
㙴	ijxc
垝	ijxo
埳	ijyr
㘺	ikaa
䢘	ikep
寺	ikff
守	ikfo
宿	ikfr
埧	ikgw
㝛	ikhy
坿	ikkf
㙸	ikki
垘	ikld
埙	ikmf
墣	ikni
堢	ikno
寑	ikob
宱	ikqt
堠	ikub
壔	ikvk
邿	ikwv
㘻	ilcd
埪	ilcf
䆪	ilcf
宊	ildo
㚈	ilfq
墘	ilfv
壊	ilfx
坫	ilhf
㼭	ilja
㙁	iljn
堗	illd
汬	ilmg
氷	ilmi
㲾	ilmo
塩	ilns
坹	ilof
㙾	iloj
墳	ilpm
坎	ilqf
㙏	ilrb
㙀	ilsq
夝	iltq
䤰	iltw
㘯	iluc
慭	ilup
埝	ilup
塲	ilur
䀋	ilus
凷	ilvf
圪	ilvv
墲	ilvx
坅	ilwf
発	ilwq
堌	ilxf
㘧	ilxf
塎	ilyn
垤	imaf
室	imao
埃	imbt
叜	imbx
墵	imeg
垭	imff
塜	imfg
壖	imfk
埈	imgb
塚	imgi
坈	imhq
灻	imif
灾	imio
壛	imjy
坥	immf
垻	immf
埮	immi
墋	immk
宜	immo
坮	imnm
堝	imnm
㙮	impw
壩	imqu
辉	imra
塓	imrb
墹	imrm
宪	imto
圦	imwf
塿	imxc
寠	imxc
堚	imxf
輝	imxf
寲	inbs
飧	incb
塡	indg
宮	inen
迱	inep
圷	inff
卞	infi
宺	infp
埚	ingy
埍	inkm
塤	inmm
㙢	inmm
名	inmq
宫	innm
墐	inno
宲	inof
㙅	inof
它	inqo
坽	inqx
埕	insg
㗮	inty
堞	invo
坋	inwf
遠	inxe
袁	inxq
舛	ioaq
䖤	iobm
㽜	iocm
垉	iodb
眢	iodm
坬	ioef
駌	ioff
䫅	iofm
宋	iofo
㙵	iogi
塙	iogn
㘶	ioif
塐	ioih
圴	ioii
㼝	ioja
墩	iojs
埻	iojv
墎	iojw
埥	iokm
寈	iokm
堫	iolb
埐	iomb
壕	iomg
埽	iomp
㘬	iomx
㙪	ione
坸	ionm
夗	ionq
寙	iooe
桀	ioof
鸳	iooq
察	iopg
㠾	iopm
圽	iore
鴛	iorr
坪	iosf
盌	iosm
㘪	iotf
宒	ioto
鋆	iott
均	ioty
怨	ioup
坞	iovf
义	iowi
妴	ioxc
㝦	ipcc
遛	ipce
留	ipcm
墖	ipcm
㓜	ipcn
鹠	ipco
鶹	ipcr
垅	ipdf
寬	ipdi
宠	ipdo
寛	ipdw
逭	ipep
㙹	ipfi
壒	ipfs
斵	ipft
墷	ipgg
㒯	ipgg
宗	ipgo
刱	ipgo
宽	ipgw
崈	iphm
㙡	iphs
埖	ipjr
寯	ipjv
壝	ipme
墤	ipmm
貿	ipmm
賨	ipmm
官	ipmo
鄮	ipmw
㙫	ipof
㘷	ipow
塔	ippw
堆	iprf
寉	ipro
鶎	iprr
垳	ipsg
劉	ipta
圲	iptf
悹	ipup
墸	ipvf
垥	ipwf
堍	ipwi
寃	ipwi
㝓	ipwo
墌	ipxo
塃	ipxp
壦	ipxp
㚂	ipxx
贸	ipym
宆	iqbo
増	iqcr
坲	iqdr
埴	iqff
㙣	iqff
埫	iqgn
填	iqgw
寘	iqgw
癷	iqgx
㔇	iqha
發	iqhb
赱	iqii
增	iqir
坢	iqkg
宵	iqkm
埇	iqlm
宖	iqmx
㙂	iqnw
垱	iqob
堸	iqqf
垪	iqxg
為	iqxo
墫	iqyk
報	irab
㝠	irby
堖	ireo
逹	irep
墁	irfb
圢	irff
宁	irfo
寓	irgn
堣	irgn
䴁	irgr
塌	irhh
幸	irif
㘿	irif
塒	irik
㙷	irix
堒	irja
尡	irja
㼬	irja
坤	irjj
审	irjj
埘	irkf
壜	irme
坷	irnm
瓡	iroe
堁	irof
埸	iror
堨	irov
㡫	irov
垾	irqg
䲧	irrf
䥌	irrt
蟄	irsb
謺	irsc
騺	irsf
摯	irsh
縶	irsh
執	irsi
墊	irsi
漐	irsl
塭	irsm
贄	irsm
㿾	irsm
䲀	irsp
鷙	irsr
盩	irss
䠟	irss
䥍	irst
慹	irsu
褺	irsx
宴	irxc
塢	irxo
宔	iryo
㝙	isfg
宝	isii
寳	isjm
堤	ismf
寔	ismo
宄	isqo
坆	istf
寶	isvm
䴐	isvr
寚	isvt
堳	itdm
塘	itdn
䙾	itdw
圻	itef
坼	itii
垊	itja
㼠	itja
埭	itll
垿	itlx
賔	itmm
墉	ittj
㝩	ittl
㙻	itwi
垹	itwv
兤	itxg
壙	itxg
圹	ityf
㝔	ityo
戣	iuaa
垏	iubf
圮	iubf
宭	iubo
㝕	iubx
㘦	iucf
幼	iucn
垆	iudb
蜜	iueb
䁇	iued
宓	iuee
密	iueh
寗	iuei
䀄	iues
埔	iuff
宧	iufo
癸	iugx
为	iuii
孧	iujv
㙛	iukf
甯	iulm
塷	iulu
㝰	iulv
坦	iumf
寊	iumm
㙞	iuof
場	iuor
塆	iuqb
圾	iuqf
垍	iurf
鴢	iurr
䳫	iurr
寜	iusj
寍	iusm
㲰	iuso
寧	iusr
鸋	iusr
牢	iuto
㙝	iuuk
堋	iuuq
㝋	iuvo
鄈	iuwv
坟	iuyf
块	iuyw
坧	ivdf
宕	ivdo
堵	ivff
宾	ivgw
㙃	ivgw
塅	ivhb
永	ivic
坻	ivii
昶	ivir
垀	ivlf
堔	ivof
坁	ivqf
场	ivre
坵	ivrf
㐧	ivrk
壻	ivsk
圠	ivvf
㙔	ivvf
㐋	ivvf
韑	ivvl
幻	ivvn
乣	ivvn
逺	ivxe
坊	ivyf
㝑	ivyo
㝫	iwbl
塂	iwdb
垬	iwff
坃	iwgf
完	iwgo
埨	iwgp
寂	iwhb
埱	iwhb
圵	iwhf
宩	iwio
堬	iwka
塨	iwlk
埋	iwmf
垰	iwnf
圥	iwqf
鵍	iwrr
寇	iwub
邜	iwvq
境	iwwq
垗	iwwy
宨	iwwy
宼	iwxc
垶	iwyf
堷	iwyf
塶	iwyf
塉	iwyk
宰	iwyo
寤	ixan
壢	ixce
安	ixco
䅁	ixct
寣	ixcy
㙭	ixel
壥	ixfi
頞	ixfm
㝒	ixfo
堮	ixfs
㝤	ixgi
㝧	ixhi
堐	ixii
塼	ixik
寭	ixiu
寐	ixkg
宸	ixlo
宙	ixmo
塸	ixnx
寢	ixob
喪	ixoc
案	ixof
㝱	ixpi
㙺	ixpm
㝎	ixpo
㝲	ixpp
鞌	ixqf
墠	ixrl
㝜	ixrm
鴳	ixrr
堰	ixrx
䀂	ixsm
坜	ixuc
寱	ixuo
㝥	ixwi
䢿	ixwv
墴	ixxg
黋	ixxg
壧	ixxs
寎	ixxy
坉	iyaf
㙿	iyci
圿	iydr
㝏	iydr
実	iygo
塮	iykf
埲	iykg
墙	iyln
坝	iymf
實	iymm
赉	iyms
寫	iyox
堾	iyrm
㙚	iyut
堄	iywq
铍	jact
铤	jadx
	jaen
䦅	jaen
钊	jajt
钋	jalt
铻	janm
戠	jarm
㿫	java
铴	javr
争	jbbq
锋	jbcg
镗	jbif
钗	jbii
铎	jbkg
钟	jbmt
铬	jbnm
钏	jbrt
镋	jbwq
孻	jbxs
银	jcbt
钣	jcbx
瓪	jcbx
锈	jccc
奀	jcdd
头	jcdo
㯄	jcfk
镙	jcih
锾	jckb
锊	jckf
锛	jcll
锧	jcly
榃	jcmf
锹	jcmi
钿	jcmt
㝆	jcnm
锲	jcpc
镣	jcqh
锜	jcrn
䥿	jcta
锶	jcup
镊	jdbb
樷	jdbx
	jddb
䦆	jddb
䢥	jdep
頥	jdfm
铒	jdft
嫑	jdhx
锵	jdik
镂	jdit
钼	jdmt
锫	jdnm
铌	jdnq
锦	jdpm
皆	jdra
鶛	jdrr
铂	jdrt
锽	jdsg
勓	jduc
锔	jdvn
毑	jdvn
覔	jdwq
铥	jeff
镆	jeft
钳	jeft
镒	jegs
钱	jegt
遜	jeie
孫	jeih
镃	jeii
愻	jeiu
镨	jekr
还	jepd
䢞	jepf
䢊	jepv
铁	jetg
孩	jeyw
䥻	jfbd
丕	jffd
丄	jffj
䪹	jffm
孲	jffv
钪	jfhq
镮	jfhx
铉	jfin
锣	jfiq
凸	jfjf
卍	jfjv
夣	jfmi
頙	jfmm
䫐	jfmm
熏	jfmt
毙	jfnq
镯	jfob
锩	jfon
铈	jfpm
镥	jfrm
瓸	jfrm
䲹	jfrr
勳	jfuc
钙	jfuv
鄢	jfvw
焉	jfvx
邳	jfwv
铱	jfxq
袰	jfxq
䘡	jfxq
镶	jfxx
钹	jgbi
奂	jgcd
毋	jgdn
奐	jggc
烉	jggm
商	jggn
铜	jghf
铕	jgkm
铑	jgnq
钢	jgow
钸	jgpm
铐	jgsa
铗	jgst
锤	jgtt
適	jgxe
啇	jgxf
甋	jgxj
歒	jgxl
敵	jgxs
夐	jgyb
敻	jgys
钠	jgyw
	jhat
䥺	jhat
锯	jhbt
覙	jhdw
迩	jhep
逊	jhep
镧	jhfh
镡	jhfm
铙	jhfw
镉	jhgr
镠	jhhk
䦀	jhhx
锉	jhif
钒	jhii
梵	jhii
尔	jhkq
孙	jhkv
铅	jhnm
镖	jhpg
凣	jhqj
锏	jhrm
玺	jhsi
铦	jhtt
铠	jhub
钔	jhut
镚	jhuu
铖	jhvv
铘	jhwv
锎	jhxg
锒	jicb
坒	jifa
埜	jiff
锭	jifs
钍	jift
镓	jigd
镫	jihe
久	jiiq
灸	jimi
铭	jinm
铊	jinq
镲	jiop
镏	jipc
孮	jipg
梦	jiqf
铼	jist
镔	jivg
粂	jiwi
铵	jixc
铮	jjbb
锴	jjdr
钚	jjdt
歪	jjfd
钲	jjft
镝	jjgx
㐂	jjja
亇	jjjq
孴	jjjr
孨	jjjv
铯	jjkv
钭	jjlf
铧	jjlf
镑	jjmv
锰	jjsm
㝀	jjvn
孖	jjvv
锺	jjwm
铳	jjwq
铲	jjxd
彬	jkef
逳	jkep
钐	jket
育	jkmy
镤	jkni
色	jkvq
钯	jkvt
锍	jkyt
觧	jlai
㓩	jlaj
觓	jlav
触	jlbm
觡	jlbn
铟	jlcd
䚦	jlch
觨	jlcl
觭	jlcn
䚡	jlcu
䚞	jldd
䚜	jldl
觻	jldo
弃	jldy
䢏	jlep
毕	jlfa
瓧	jlfa
觸	jlfb
㔻	jlfd
䚝	jlfl
斗	jlfo
华	jlfr
针	jlft
䚙	jlfu
䚪	jlfx
䚗	jlgm
䚩	jlgn
觩	jlhf
䚧	jlhk
觿	jlhn
钻	jlht
觽	jlhv
䚨	jlib
觟	jlii
觥	jlil
觼	jljb
斛	jljl
觤	jljo
觞	jllr
觴	jllr
䚚	jlmt
镩	jlnb
㖍	jlnn
䚛	jlnn
䚢	jlno
觾	jlnx
觚	jloe
㪳	jlov
蟹	jlpb
邂	jlpe
㙰	jlpi
䚭	jlpp
解	jlpu
觹	jlpv
甭	jlqd
觯	jlql
角	jlqq
钦	jlqt
䚥	jlqt
䚠	jlrj
䚤	jlrn
鵤	jlrr
觫	jlsf
䚣	jlsm
觘	jltk
觔	jluc
䚟	jluk
觛	jlum
觙	jluq
觖	jluy
觰	jlvf
觝	jlvi
觗	jlvq
钮	jlvt
乧	jlvv
㪲	jlvv
棽	jlwf
䚬	jlwo
钤	jlwt
觪	jlwy
锢	jlxf
觵	jlxg
觮	jlxl
觶	jlxl
㜿	jlxv
镕	jlyn
觲	jlyu
觬	jlyw
铚	jmat
钺	jmat
䥽	jmbi
	jmbi
镭	jmcm
䥾	jmff
孺	jmfk
铔	jmft
棾	jmhq
㶪	jmid
焚	jmif
钬	jmit
锬	jmmi
負	jmmq
貨	jmmr
孭	jmmv
孾	jmmx
孡	jmnm
㡣	jmpa
遆	jmpe
帝	jmpm
䫕	jmpm
啻	jmpn
鶙	jmpr
㛳	jmpx
铣	jmtt
锄	jmuc
㿶	jmva
䒍	jmvk
覫	jmvw
旁	jmvy
镞	jnbt
䬩	jncb
梺	jnff
䫊	jnfm
锅	jngy
否	jnmd
锆	jnnm
铝	jnnm
棄	jnof
铞	jnpm
铃	jnqx
锃	jnsg
䠂	jnsh
镟	jnvs
瓰	jnwa
棼	jnwf
袬	jnxq
皱	joac
铆	joav
刍	jobq
孢	jodb
铇	jodb
孤	joev
枈	jofa
钵	joff
镐	jogn
钓	joii
镦	jojs
锖	jokm
靕	jokm
锓	jomb
钩	jomx
铩	joof
雏	jopr
䥼	jore
锪	joru
煞	josx
毞	jota
瓱	jota
钧	joty
急	joup
钨	jovf
邹	jowv
锿	joxq
镀	jpbx
切	jpca
镌	jpcc
锚	jpcm
䫴	jpfm
袃	jpfx
锳	jpgc
禁	jpgf
锘	jpgn
镎	jpht
镵	jpji
㱈	jplq
剰	jpoa
乗	jpof
镬	jppb
锥	jprt
瓩	jpta
钎	jptt
䦃	jpvf
	jpvf
㝃	jpwq
铪	jpwt
铓	jpxy
锸	jpyr
镄	jqdy
镇	jqgw
铄	jqhk
销	jqkm
䝉	jqmg
镪	jqnb
锐	jqnw
铛	jqob
檒	jqqf
锑	jqqr
锁	jqym
锱	jrcm
链	jrep
镘	jrfb
钉	jrft
锟	jrja
㰱	jrjl
镴	jrlf
㫘	jrmd
旧	jrmj
钶	jrnm
锞	jrof
锡	jror
鴀	jrrd
鴊	jrrf
锠	jrrm
䳇	jrrn
亀	jrrv
龟	jrvv
児	jrwq
钰	jsii
盃	jsmd
孟	jsmv
㭝	jsqf
㝂	jste
政	jstf
孜	jstv
勐	jsuc
㤵	jsup
镅	jtdm
镰	jteg
秉	jthk
铿	jtif
铸	jtkf
钞	jtkt
锨	jtlq
镛	jttj
铹	jtuc
䦁	jtwv
铰	jtyt
㪔	jubx
键	judx
㯬	judx
铋	juee
毖	juee
铺	juft
铢	jugw
镈	jukf
锝	jukf
钽	jumt
镍	juof
孞	jupv
钥	juqt
钑	juqt
钌	juvt
锗	jvft
锻	jvhb
凹	jvjf
兕	jvjw
钾	jvmt
钖	jvre
楚	jvsh
钇	jvvt
钆	jvvt
孔	jvvv
钫	jvyt
粊	jwia
濌	jwlr
瓼	jwma
锂	jwmt
重	jwmt
充	jwqy
锕	jwrn
䳯	jwrr
锇	jwtt
動	jwuc
铽	jwup
镱	jwup
憅	jwuu
勲	jwux
邷	jwva
郴	jwvf
镜	jwwq
铫	jwwy
镳	jwxo
麓	jwyf
麁	jwyq
锌	jwyt
铏	jxaj
矦	jxbt
婪	jxcf
钕	jxct
厃	jxdq
产	jxdy
镢	jxel
㰈	jxep
锷	jxfs
钴	jxft
詹	jxgc
甔	jxgj
钘	jxgt
䦄	jxix
亷	jxjg
孬	jxjv
彦	jxke
遃	jxke
顔	jxkm
颜	jxky
剷	jxla
钜	jxlb
㯟	jxll
辳	jxlo
産	jxlt
铀	jxmt
钷	jxnm
铷	jxnm
㩻	jxob
㶨	jxod
㷊	jxof
頠	jxom
危	jxon
䣀	jxow
椘	jxpf
错	jxrm
甅	jxwm
瓲	jyaa
铡	jyaj
钝	jyat
镁	jycd
㜾	jydr
钛	jydt
	jyhh
䦂	jyhh
锼	jyjb
欿	jylq
燄	jymm
负	jymq
货	jymr
钡	jymt
鹐	jyoq
臽	jyrq
鵮	jyrr
铨	jysg
㷺	jysm
俴	kaaa
伐	kaar
侹	kadx
僐	kaen
伍	kafr
倛	kafr
㱉	kagl
鸈	kagr
業	kagw
鄴	kagw
凭	kahq
垡	kaif
䋕	kaih
佯	kair
刌	kajf
㑘	kald
僛	kalq
仆	kalr
㽔	kalt
賃	kamm
俉	kanm
栠	kaof
鵀	karr
傲	kast
㒋	kate
任	katr
恁	kaup
佊	kavr
偡	kavv
㶵	kaxo
䣸	kayf
赁	kaym
倃	kban
偺	kbar
伬	kbbr
俻	kbcm
僠	kbcm
儅	kbcm
傆	kbdr
儻	kbfm
伟	kbgr
㑽	kbif
优	kbii
佟	kbjo
侭	kbjo
俢	kbke
㑁	kblv
償	kbmm
仲	kbmr
佫	kbnm
倁	kbnm
佭	kboa
㒉	kbof
傩	kbpr
僁	kbup
傥	kbwq
仅	kbxr
儘	kbxs
刭	kcaj
俐	kcaj
㑼	kcbn
佷	kcbr
仮	kcbx
儡	kccc
傂	kcch
儽	kcch
㒦	kcci
仍	kccr
儢	kccu
㒚	kccu
㐲	kcdr
迳	kcep
偎	kcfo
仜	kcfr
侉	kcfs
颈	kcfy
偁	kcgi
仹	kcgr
俿	kchq
俠	kchw
傒	kcic
傫	kcih
偧	kcii
俘	kcjv
㑧	kcjv
傠	kckf
巯	kcky
偱	kcld
倴	kcll
偢	kcmi
佃	kcmr
僽	kcmu
傀	kcmx
俬	kcmx
僖	kcnm
俰	kcnm
倸	kcof
傸	kcoo
偰	kcpc
倷	kcpg
傄	kcqd
僚	kcqh
僞	kcqx
倚	kcrn
俺	kcrv
㺱	kcsi
劲	kcuc
侽	kcuc
㑭	kcud
偲	kcup
儲	kcvf
㒡	kcvh
傜	kcvt
倭	kcxc
俀	kcxc
信	kcyr
㒘	kdbd
倔	kdbl
㐶	kdbr
㒤	kddd
倈	kddr
僎	kddw
儭	kddw
傡	kddy
俾	kdel
倶	kdfg
傽	kdfm
佴	kdfr
偻	kdir
僝	kdjj
儱	kdka
偓	kdma
僀	kdmp
倍	kdnm
伲	kdnq
偋	kdqx
伯	kdrr
偟	kdsg
儖	kdts
怹	kdup
侷	kdvn
他	kdvr
儌	kdvs
㑙	kdvv
僮	kdwm
俔	kdwq
倻	kdwv
位	kdyr
㑡	keav
俳	kefh
佄	kefr
伝	kegr
僼	kehe
係	keih
仛	keja
傔	kejg
偂	keka
倂	kekq
傻	kelb
㐼	keld
傯	kelu
㑋	kemr
仫	kemx
頿	kenm
偊	kenn
偨	keno
佌	kenq
过	kepf
侐	kesm
佚	ketg
储	kevf
儂	kexo
侅	keyw
例	kfaj
㑢	kfav
僵	kfcf
㑊	kfdg
侜	kfer
傮	kfer
儯	kfff
冊	kffm
佉	kffr
俹	kffr
倀	kffr
傌	kffr
㒟	kffx
俪	kfgi
儞	kfgm
㒕	kfgp
倅	kfhl
仾	kfhn
伉	kfhq
儇	kfhx
傗	kfic
伭	kfin
㑩	kfiq
㒅	kfix
㒗	kfjm
優	kfkb
偄	kfkc
侕	kfkm
㐵	kflf
儃	kflu
夁	kflx
皾	kfma
䇓	kfmd
䢱	kfme
澃	kfml
倆	kfmm
賣	kfmm
須	kfmm
㑯	kfmm
頾	kfmn
盨	kfms
覿	kfmw
嬃	kfmx
儸	kfnp
㒔	kfob
倦	kfon
㒧	kfop
伂	kfpm
侇	kfqy
俓	kfrc
倲	kfrh
佰	kfrm
便	kfro
倢	kfts
偭	kfum
僫	kfup
倵	kfwe
㐳	kfwq
僻	kfwy
依	kfxq
㥋	kfxu
儴	kfxx
须	kfym
㑔	kfym
媭	kfyx
伖	kgbx
佒	kgcd
佐	kgcf
侨	kgdr
䙿	kgdw
㱿	kgfb
侗	kghf
䋰	kgih
仗	kgii
倜	kgin
侾	kgjv
侑	kgkm
佾	kgkm
䫇	kglm
傟	kgmh
倊	kgmu
伀	kgmx
佑	kgnm
僑	kgnn
㖝	kgnn
佬	kgnq
㐛	kgnv
㮂	kgof
佈	kgpm
侤	kgsa
斄	kgsd
孷	kgsj
漦	kgsl
氂	kgso
㲠	kgso
剺	kgsp
侠	kgsr
犛	kgsu
㹈	kgsu
釐	kgsw
嫠	kgsx
倕	kgtr
仸	kgtr
未	kgwg
具	kgwm
伣	kgwq
仈	kgwr
䡞	kgxf
俗	kgyn
㐻	kgyw
㒩	khab
㑰	khaq
伢	khar
僦	khbi
倨	khbr
伇	khbx
僊	khcd
㒥	khce
偪	khcm
倳	khdb
縣	kheh
侸	khei
懸	kheu
㑉	khfd
偳	khfk
佩	khfp
俅	khfr
価	khfr
侥	khfw
倎	khgw
僇	khhk
㒛	khhp
侳	khif
僲	khio
㑕	khiq
㺸	khis
仦	khkr
侺	khlw
價	khmm
仙	khmr
岊	khmv
傈	khof
使	khow
㐽	khow
僄	khpg
儶	khpn
催	khpr
㒞	khpv
仉	khqr
佸	khtr
㐿	khtr
们	khur
傰	khuu
傶	khwh
僳	khwi
偠	khxc
倞	khyr
倿	khyr
㒓	kiae
俍	kicb
侘	kiej
在	kifd
坕	kife
伫	kiff
儐	kifm
倰	kigb
傢	kigd
僜	kihe
僟	kiid
佳	kiif
倇	kiio
侈	kiiq
僥	kiiw
侍	kikf
㑏	kikf
侊	kilr
佲	kinm
佗	kinq
俕	kiof
傑	kioo
仪	kiow
倧	kipg
倌	kipm
㐴	kiqr
偽	kiqx
佇	kirf
倖	kiri
俫	kisr
伥	kitr
㑃	kiuc
㑻	kiuh
伪	kiui
儜	kiur
傧	kivg
俒	kiwg
侒	kixc
仳	kjar
佤	kjar
偕	kjdr
伓	kjdr
伾	kjff
佂	kjfr
㑣	kjfr
傿	kjfx
毐	kjgd
㒀	kjgx
丯	kjje
俼	kjkm
偩	kjmm
偙	kjmp
傍	kjmv
俖	kjnm
䫠	kjnm
㑄	kjnr
㑇	kjob
	kjob
僸	kjpg
存	kjvd
仔	kjvr
儊	kjvs
偅	kjwm
伦	kjwr
働	kjwu
儋	kjxc
偐	kjxk
佹	kjxo
㒒	kkag
㑖	kkbm
䵾	kkcb
儥	kkfm
仕	kkfr
付	kkfr
黻	kkgi
俱	kkgw
佅	kkgw
黹	kkij
侟	kkjv
壵	kkkf
僕	kkni
佶	kknm
儓	kknm
㖚	kknn
黺	kknw
黼	kkuf
俧	kkup
怤	kkup
爬	kkve
儔	kkvk
姇	kkxc
㐺	kkyw
傤	klar
儎	klax
假	klbb
伎	klbx
倥	klcf
伏	kldr
値	kldv
㒨	kled
僪	klen
㑱	kleo
㒜	klfg
什	klfr
仁	klgr
㑲	klgr
佔	klhr
㒁	klir
侮	kljn
仵	kllf
僋	klmm
㲻	klmr
佪	klnm
僨	klpm
偾	klpy
佣	klqr
㐸	klqr
僒	klub
伤	kluc
㑫	klup
傷	klur
击	klvg
传	klvi
儛	klvo
仡	klvv
㒇	klvx
㑅	klwh
仱	klwr
佞	klxc
個	klxf
伃	klxr
傛	klyn
倒	kmaj
側	kmaj
侄	kmar
俟	kmbt
㚄	kmcs
俨	kmee
偿	kmeg
偸	kmff
儒	kmfk
俊	kmgb
㑓	kmgb
仨	kmgr
殻	kmhb
㨌	kmhb
壺	kmhh
壳	kmhq
伔	kmhq
悫	kmhu
慤	kmhu
伙	kmir
壶	kmkj
㑷	kmkn
㑞	kmld
㒍	kmmh
㒌	kmmh
倓	kmmi
傪	kmmk
儹	kmmm
儝	kmmo
伹	kmmr
們	kmmr
僶	kmmr
僗	kmmu
壷	kmnf
佁	kmnm
壱	kmnq
㚃	kmoe
㒐	kmor
傕	kmpr
毂	kmrb
僴	kmrm
儩	kmrr
㲄	kmsb
侁	kmtr
僩	kmuq
侔	kmut
蠧	kmvb
槖	kmvo
売	kmwq
僂	kmxc
㑮	kmxf
侬	kmxq
仏	kmxr
㓤	knaj
傖	knbn
儗	knbs
㑨	knbt
傞	kncf
偮	kndf
㒙	kndp
侶	knen
迼	knep
頡	knfm
颉	knfy
伿	kngw
翓	knhh
菐	knii
㲫	knio
䴆	knir
喆	knkn
嚞	knkn
俋	knkv
欯	knlq
吉	knmf
傊	knmm
臺	knmm
㐰	knmr
侣	knnm
俈	knnm
僅	knno
儺	knnp
巼	knnq
傼	knnt
保	knof
堡	knoi
煲	knom
賲	knom
䳰	knor
㷛	knox
諐	knpc
侃	knpr
伶	knqx
鴶	knrr
侱	knsg
促	knsh
劼	knuc
㔛	knuc
俣	knug
俁	knvc
偞	knvo
伳	knvv
㐖	knvv
㑆	knwq
份	knwr
郆	knwv
偘	knxm
僺	knxo
	kobb
㑳	kobb
佨	kodb
爮	kodb
体	koff
休	kofr
倄	kogk
倯	kogm
傐	kogn
俙	kogp
傃	koih
仢	koii
倩	kokm
儬	kokw
侵	komb
㑴	komb
儫	komg
債	komm
停	komr
佝	konm
鸺	kooq
傺	kopg
伆	kore
侚	korm
鵂	korr
偬	koru
伻	kosr
伨	koty
恷	koup
㑚	kowv
烋	koxo
俵	koxq
偯	koxq
债	koym
像	kpaq
仰	kpav
伊	kpbr
㸕	kpbx
㑺	kpcc
㑤	kpcm
儰	kpcx
傇	kpdf
儚	kpfi
㒝	kpfi
偀	kpgc
偌	kpgn
㒆	kphh
傱	kphs
㒊	kpie
仞	kpii
仭	kpii
偫	kpik
儳	kpji
儁	kpjv
款	kplq
僓	kpmm
伵	kpmr
佀	kpmr
佋	kpnm
僷	kpno
僃	kpol
儆	kpos
儙	kppe
㒖	kprn
倠	kprr
隷	kptl
仟	kptr
㒂	kpvf
俛	kpwq
佮	kpwr
僬	kpxo
儾	kpxx
偛	kpyr
彂	kqbt
佛	kqdr
值	kqfr
幵	kqgg
倘	kqgn
仠	kqgr
僘	kqgs
傎	kqgw
僧	kqir
伄	kqjj
伴	kqkg
俏	kqkm
俑	kqlm
侻	kqnw
栞	kqof
俤	kqqr
偑	kqqr
作	kqtr
㤰	kqup
壭	kqvf
郉	kqwv
併	kqxg
偤	kqyf
僔	kqyk
壿	kqyk
伡	krar
㑵	krbt
叢	krdb
僈	krfb
仃	krfr
偶	krgn
㑍	krgr
傝	krhh
㑎	krhm
僿	krif
丵	krij
儑	krix
倱	krja
伸	krjj
㒏	krjo
敒	krjs
儠	krlf
凿	krlv
何	krnm
倮	krof
㑥	kror
偈	krov
䳤	krri
倡	krrm
㑿	krro
僭	krrr
儤	krwl
住	kryr
鑿	kryt
糳	kryw
蟞	ksbm
瞥	ksdm
龞	ksem
斃	ksfn
鳖	ksfq
㑛	ksfr
仼	ksgr
辵	kshe
撆	ksht
䌘	ksih
弊	ksld
獘	ksld
㑝	ksld
伜	kslf
鼈	ksmm
偍	ksmr
鄨	ksnk
㖌	ksnn
蹩	ksns
幣	kspm
鱉	kspq
䨆	kspr
彆	ksqb
仇	ksqr
暼	ksrm
鷩	ksrr
㑜	kste
敝	ksti
鐅	kstw
憋	ksup
嫳	ksxc
偗	ktdm
傏	ktdn
侂	ktej
伒	kter
傾	ktfm
伕	ktgr
殸	kthb
謦	kthc
䅽	kthc
聲	kthd
㿦	kthd
撀	kthh
㲇	kthj
㑈	kthk
漀	kthl
㷫	kthm
毊	kthn
㲈	kthn
㯏	ktho
㲆	kthq
馨	kthr
鏧	ktht
罄	kthv
磬	kthv
韾	kthw
䡰	kthx
㑠	ktif
俦	ktkf
俯	ktkk
仯	ktkr
㒣	ktku
佽	ktlq
俽	ktlq
傦	ktmr
俇	ktsg
傚	ktst
傭	kttj
儧	kttm
儨	kttm
僣	kttr
俲	ktuc
声	ktvf
儣	ktxg
佼	ktyr
羸	kuai
蠃	kubi
䫛	kubm
侓	kubr
侰	kubr
侯	kubt
鄇	kubw
勋	kucm
仂	kucr
䇔	kudi
侪	kudr
覟	kudw
健	kudx
佖	kuee
㒎	kuef
驘	kufi
倬	kufm
俌	kufr
侏	kugw
㒠	kuif
儏	kuiw
傅	kukf
俷	kukv
儍	kulb
贏	kumi
偵	kumm
但	kumr
伽	kunm
偒	kuor
偼	kuos
志	kupf
伈	kupr
伋	kuqr
仴	kuqr
臝	kuri
鸁	kuri
㑑	kurr
㑪	kurr
件	kutr
倗	kuuq
䊨	kuwh
嬴	kuxi
赢	kuyi
侦	kuym
伩	kuyr
翿	kvch
壽	kvck
魗	kvcm
㦞	kvcu
燾	kvcx
佦	kvdr
㒈	kvds
偖	kvfr
㑟	kvgw
伺	kvhf
低	kvii
似	kviy
偝	kvkm
㐷	kvnr
偦	kvsk
倣	kvst
㐊	kvvf
亿	kvvr
偉	kvvr
仿	kvyr
佧	kwal
代	kwar
侙	kwcf
㑾	kwcy
黛	kwfm
供	kwfr
袋	kwfx
倫	kwgp
㐾	kwgr
俶	kwhb
㑐	kwhk
岱	kwhm
仩	kwhr
垈	kwif
僯	kwio
侎	kwir
儈	kwir
偷	kwka
㒃	kwlm
㒄	kwlx
貸	kwmm
俭	kwmo
俚	kwmr
倹	kwny
俆	kwof
柋	kwof
帒	kwpm
俄	kwtr
億	kwup
牮	kwut
邺	kwvj
郧	kwvm
傹	kwwq
䣏	kwwv
佻	kwwy
儉	kwxh
儦	kwxo
㒢	kwxp
贷	kwym
偣	kwyr
侀	kxaj
㒑	kxap
伮	kxbx
儮	kxce
㚢	kxcr
備	kxel
僆	kxep
憊	kxeu
㷶	kxex
估	kxfr
俥	kxfr
偔	kxfs
傋	kxgi
俩	kxhw
侢	kxif
傳	kxik
僡	kxiu
儷	kxiw
侼	kxjv
佢	kxlb
傉	kxlk
侲	kxlo
伷	kxmr
侞	kxnm
傴	kxnx
伌	kxon
伛	kxow
僤	kxrl
借	kxrm
㑸	kxrn
偃	kxrx
俜	kxsa
㑌	kxsg
做	kxst
僌	kxst
侫	kxxc
㑬	kxxf
僙	kxxg
儼	kxxs
㑂	kxyw
侧	kyaj
伅	kyar
价	kydr
㑀	kydr
侩	kyeg
倾	kyfy
偏	kygp
倽	kyhg
傓	kyhh
伱	kyhk
佡	kyhm
僢	kyio
傁	kyjb
對	kykf
俸	kykg
懟	kyku
㑦	kyld
傣	kyll
伧	kyon
僱	kypr
偆	kyrm
儕	kyrr
㑗	kyrr
佺	kysg
㐹	kytr
僾	kyub
㑶	kywi
倪	kywq
儀	kywt
	laaf
战	laah
蛓	labm
戴	lacw
韯	laef
窏	lafl
䵧	lafm
裁	lafx
胾	lagy
㘽	laif
㦳	laif
窪	laii
㓠	lajh
臷	lama
烖	lami
䆱	lamm
國	lanf
窢	lanf
爴	lank
圄	lanm
哉	lanm
濷	lanm
䆮	laob
栽	laof
㦲	laoq
䳣	laor
䘁	lapb
截	lapr
载	lara
䳒	larr
㘤	larr
載	laxf
酨	layf
窡	lbbb
䆯	lbbx
䆺	lbcm
頍	lbfm
围	lbgm
翅	lbhh
图	lbjo
叚	lblb
遐	lble
㰺	lbll
䫗	lblm
窋	lblv
䆔	lbmo
梷	lbof
攳	lbok
㲍	lbot
䧴	lbpr
圕	lbrm
鳷	lbrr
攰	lbuc
竊	lbum
窸	lbup
支	lbxf
㘝	lbxm
奌	lcdh
因	lcdm
空	lcfo
䆽	lcgd
㲁	lchb
畞	lcji
欭	lclq
畓	lcmm
圝	lcnn
圞	lcno
窫	lcpc
竂	lcqh
鵼	lcrr
窍	lcsa
囷	lctm
甥	lcuc
恩	lcup
㘥	lcvh
窰	lcvt
䆧	lcxc
圁	lcym
窟	ldbl
䆩	ldcd
迤	ldep
䆠	ldfo
窭	ldio
竉	ldka
窅	ldmo
眚	ldmt
看	ldmt
窷	ldoa
䆾	ldts
竅	ldvs
㐌	ldvt
悳	ldvu
䆹	ldwm
覘	ldwq
蟊	lebb
奦	lebc
熃	lebm
䂈	lebm
䖥	lebm
䳱	lebr
䥐	lebt
務	lebu
㜈	lebx
矡	ledb
鼒	ledo
䂌	ledw
才	leef
矛	leex
劀	lega
遹	lege
囩	legm
矞	legn
鹬	lego
氄	lego
鷸	legr
侌	legw
㱐	leii
䂉	lekb
窗	lelb
㮗	lelo
䢉	lelo
窻	lelu
㥤	lelu
䂇	lelv
矜	lelw
䂎	lemm
矝	lenq
柔	leof
䂆	leoi
鶔	leor
䂊	lepa
迖	lepd
辻	lepf
迠	leph
矟	leqk
䂍	lerl
蝥	lesb
瞀	lesd
䜼	lese
騖	lesf
嵍	lesh
䋷	lesh
堥	lesi
䆝	lesm
鹜	leso
楘	leso
㡔	lesp
䱯	lesp
䨁	lesp
鞪	lesq
暓	lesr
鶩	lesr
鍪	lest
敄	lest
愗	lesu
骛	lesv
婺	lesx
窆	lexp
矠	lexr
戟	lfaa
韩	lfbg
夓	lfdb
曰	lffm
䎐	lfhh
窣	lfhl
囥	lfhq
圜	lfhx
圛	lfir
穻	lflf
雗	lflp
鶾	lflr
乾	lflv
	lfmf
預	lfmm
頕	lfmm
圈	lfon
圔	lfsm
圏	lfub
朝	lfuq
譽	lfvc
與	lfvg
擧	lfvh
舉	lfvk
歟	lfvl
鸒	lfvr
㥁	lfvu
㦛	lfvu
乹	lfvv
礜	lfvv
韓	lfvv
㐦	lfvv
轝	lfvx
圐	lfvy
衾	lfxq
螒	lfyb
䮧	lfyf
翰	lfyh
斡	lfyl
预	lfym
榦	lfyo
㲦	lfyo
幹	lfyq
倝	lfyw
圂	lgdm
䆥	lgdo
䆳	lgep
圙	lgfu
囧	lggm
朙	lggu
䆚	lghf
興	lghg
璺	lghi
臖	lghk
爨	lghm
爂	lghm
舋	lghm
㸑	lghm
釁	lghn
囶	lgif
窙	lgjv
囿	lgkm
䆜	lgkm
䆖	lgmx
遖	lgre
南	lgri
献	lgrl
穾	lgto
慁	lgup
圀	lgvy
觇	lgwq
穿	lhao
圌	lhfk
尓	lhkt
賫	lhmm
赍	lhmy
窚	lhvv
䆡	licb
坔	lifm
玍	lift
囲	ligm
穽	ligo
䆸	lihe
窐	liif
州	lijj
㘢	lilm
竈	limm
園	linx
穸	liqo
圉	liri
竃	lirv
窈	liuc
囨	ljdm
竀	ljdw
緐	ljeh
囸	ljfm
䆙	ljfo
䌓	ljhh
䋣	ljih
㶗	ljil
㔺	ljjj
毓	ljky
竹	ljlj
每	ljnt
図	ljow
窃	ljpc
囮	ljrm
䆴	ljrv
鳘	ljsf
繁	ljsh
瀪	ljsl
鰵	ljsp
敏	ljst
慜	ljsu
勄	ljuc
囝	ljvm
囵	ljwm
窞	ljyr
㣌	lkeh
団	lkfm
竇	lkfm
圆	lkmm
窾	lkpl
啎	llan
囙	llbm
㹜	lldd
卉	lldf
㘟	lldm
突	lldo
团	llee
䆷	llen
迕	llep
頮	llfm
午	llft
颒	llfy
亖	llgg
㴅	llgn
甧	llkm
猋	llld
㵘	llll
淼	lllm
㴇	lllm
飙	lllo
飆	lllq
㽓	lllt
囦	llmm
沝	llmm
欦	llqw
鶟	llrr
盥	llsm
甡	lltt
㤙	llup
凼	llvm
沀	llxm
㐨	llxx
窒	lmao
㼂	lmei
窦	lmjc
圗	lmlu
䆦	lmmi
圎	lmmm
貪	lmmw
䆼	lmne
囼	lmnm
窩	lmnm
梥	lmof
窓	lmup
䆓	lmwq
窶	lmxc
囜	lmxm
㓧	lnaj
䆗	lnav
窽	lnbl
窜	lnbm
廻	lndx
䆛	lnej
迴	lnep
卋	lnff
頷	lnfm
颔	lnfy
窝	lngy
䎏	lnhh
掰	lnht
㼨	lnja
㘣	lnkm
圖	lnln
呇	lnmm
回	lnmm
圓	lnmm
䆬	lnmm
含	lnmw
窖	lnnm
枽	lnof
囹	lnqx
窌	loav
窇	lodb
窊	loeo
困	lofm
穼	lofo
圊	lokm
斅	loob
䁷	lood
窳	looe
䮸	loof
黌	loog
嶨	looh
壆	looi
學	looj
㽇	looj
䑁	look
澩	lool
觷	lool
燢	loom
嚳	loon
竁	looo
雤	loop
鱟	loop
鷽	loor
斆	loos
礐	loov
覺	loow
窎	loqo
囫	lore
䆫	loru
㫄	lovy
䇁	lpai
豫	lpaq
鼖	lpcb
搿	lpht
翸	lpmh
歕	lpml
圚	lpmm
賁	lpmm
帘	lpmo
䴅	lpmr
桒	lpof
䫙	lpom
㫩	lprm
雂	lprw
䆟	lpwo
䆶	lpxo
贲	lpym
穹	lqbo
䇀	lqdf
邃	lqge
窴	lqgw
䆵	lqir
窄	lqto
窱	lrbo
复	lrbq
舆	lrfg
䆑	lrfo
年	lrft
窤	lrja
沓	lrmm
䆞	lrnq
窠	lrof
亁	lrqv
窵	lrro
窼	lrro
鴪	lrro
鵇	lrrr
䲼	lrrt
鳹	lrrw
䆨	lrug
囯	lsgm
拜	lsgt
国	lsii
䆒	lsii
㔟	lsiu
泴	lsmm
究	lsqo
䥅	lsst
䆢	lsuy
窺	ltdw
窥	ltgw
囻	ltja
䆲	lttl
窔	ltyo
窘	lubo
敁	lubx
㪁	lubx
㔹	lucf
㘞	lucm
穷	luco
㘠	luee
圃	lufm
窧	lufm
协	lugo
博	lukf
圑	lukf
忈	lupg
㤐	luph
念	lupw
敜	lust
窂	luto
協	luuu
䆕	luyw
刉	lvaj
沯	lvdm
䆻	lvds
迄	lvep
专	lvii
舞	lvio
橆	lvjf
㘡	lvmm
䆘	lvmo
㩿	lvst
窑	lvto
亐	lvvg
乩	lvvh
圍	lvvm
穵	lvvo
乞	lvvt
甒	lvxj
無	lvxo
鷡	lvxr
鄦	lvxw
窿	lwbl
园	lwgm
圇	lwgp
窲	lwjl
窬	lwka
㢤	lwoq
窕	lwwy
窛	lwxc
窨	lwyo
窹	lxan
囡	lxcm
輿	lxfg
固	lxfm
團	lxik
䆣	lxlo
賷	lxmm
䆰	lxnx
点	lxoh
䆭	lxqg
䆿	lxuo
尭	lxwq
窉	lxyw
囤	lyam
窀	lyao
酓	lyfw
竄	lyfx
㱃	lylq
贪	lymw
㼸	lynj
彮	lynk
容	lynm
竆	lynn
㮤	lyno
毎	lynt
䨄	lypr
窮	lyqb
㳫	lyrm
䆤	lyro
䳺	lyrr
盦	lysm
囚	lywm
氼	lywm
韽	lywy
窯	lyxo
箋	maaa
賤	maaa
簸	maac
戝	maam
䨙	maat
䇝	maat
箥	maav
霮	maav
籓	mabc
霪	maca
箔	madr
筂	madv
烶	madx
霆	madx
筳	madx
閮	madx
㷽	maen
䦢	maff
䨕	mafl
霈	mafp
箕	maft
蠈	magb
賊	magd
霘	magh
䨵	mahf
闊	maht
簊	maif
烊	maii
䨟	maii
到	maja
䨬	majf
灲	maji
刞	majm
則	majm
霶	majv
霑	malh
㓀	malp
䈌	mamm
箈	mamn
箲	mamt
霃	mamw
閾	manf
䈅	manf
焐	manm
䦜	manm
霗	manq
霂	maof
笵	maon
䈃	mapn
簗	mapo
䨰	maqf
霐	maqm
篞	mari
霔	mary
䦞	masg
燍	mate
簛	mate
䇵	mate
閯	matk
䈬	mauf
簿	mauk
簜	maur
䉇	mava
貱	mavm
煁	mavv
䨢	mavv
篊	mawf
霟	mawf
靋	maxe
爞	mbbb
䦤	mbbb
篷	mbce
熢	mbce
烽	mbcg
燔	mbcm
簹	mbcm
闣	mbcm
䉒	mbcm
㷧	mbdi
逘	mbep
爣	mbfm
炜	mbgi
闛	mbif
发	mbii
烬	mbjo
炵	mbjo
笗	mbjo
䝲	mbjo
欸	mblq
炪	mblv
笜	mblv
㒴	mblv
烛	mbmi
贘	mbmm
閩	mbmm
烙	mbnm
笿	mbnm
臵	mbnm
賂	mbnm
閣	mbnm
䇨	mboa
筿	mbof
䉎	mbof
䉜	mbpr
笶	mbtt
矣	mbtx
雾	mbuc
燼	mbxs
贐	mbxs
筣	mcaj
笻	mcav
箏	mcbb
䦘	mcbm
炍	mcbx
販	mcbx
靁	mccc
䉪	mccc
篪	mcch
畚	mccm
篲	mcco
䨮	mcco
爐	mccs
籚	mccs
爈	mccu
㓃	mcej
煺	mcep
䢮	mcep
灴	mcfi
爝	mcfk
煨	mcfo
笁	mcft
㒰	mcfw
㷾	mcgd
䞊	mcgd
籧	mcge
炐	mcgi
㸍	mcha
遾	mche
篫	mchh
筑	mchi
簭	mchn
築	mcho
箎	mchq
筮	mchw
筴	mchw
䉂	mcih
煃	mcii
簃	mcii
熪	mcii
䈖	mcjl
㷔	mcjr
烰	mcjv
筟	mcjv
䨗	mcjv
煖	mckb
䈠	mckb
参	mcke
簴	mckg
煟	mckm
毵	mcko
㶹	mclm
夑	mcmb
靐	mcmc
䨻	mcmc
叁	mcmg
煍	mcmi
畑	mcmi
篍	mcmi
熕	mcmm
篢	mcmm
貵	mcmm
雷	mcms
䈭	mcmx
熺	mcnm
䉫	mcol
䦬	mcpc
燎	mcqh
簝	mcqh
䞈	mcqx
䦱	mcqx
䈧	mcqx
䦭	mcrm
奙	mcrv
閹	mcrv
靄	mcrv
㷈	mcrv
簋	mcsm
秌	mcti
箅	mcud
熎	mcvt
熼	mcwf
霬	mcwf
筇	mcwv
䉸	mcww
軬	mcxf
誾	mcym
熖	mcyr
䈱	mcyr
霅	mcys
䇾	mcyt
䉨	mdab
熞	mdbi
煀	mdbl
䉯	mdbm
䦩	mdbq
䨫	mdbq
冣	mdbx
箃	mdbx
籑	mdcc
䉵	mdcc
䵵	mdcf
纂	mdch
篡	mdcm
簒	mdcm
篹	mdco
籰	mddb
㸎	mddd
箫	mddg
爠	mddp
箂	mddt
簨	mddw
㷷	mddw
䞋	mddw
焷	mdel
箄	mdel
簈	mdeq
烥	mdfi
聞	mdfm
䇯	mdft
爍	mdio
篓	mdit
爖	mdka
籠	mdka
贚	mdka
靇	mdka
㔍	mdla
爥	mdlb
算	mdld
闃	mdld
闎	mdlm
霠	mdlw
箼	mdma
焙	mdnm
箁	mdnm
賠	mdnm
䦣	mdnm
冟	mdnq
䨧	mdnq
䉁	mdnq
篰	mdnw
鼏	mdob
䈮	mdon
䇻	mdot
霨	mdpk
篼	mdpw
箳	mdqx
熽	mdrr
簫	mdrr
鷑	mdrr
篭	mdrv
篁	mdsg
煌	mdsg
䉤	mdst
篎	mdtk
爁	mdts
籃	mdts
爦	mdtw
闅	mdub
灺	mdvi
貤	mdvm
焗	mdvn
燩	mdvs
竾	mdvt
霾	mdwm
燑	mdwm
筧	mdwq
䙺	mdwq
䨘	mdwq
䨳	mdww
閚	mdym
雴	mdys
笠	mdyt
蠞	meab
節	meav
闕	mebl
筵	meed
烻	meed
严	meef
閁	meem
霏	mefh
㷬	mefi
㶰	mefi
雸	mefs
䇞	meft
燠	megc
䉛	megc
炿	megi
尝	megl
賹	megs
雲	megs
笺	megt
闦	mehe
霻	mehe
䇛	meht
䈘	meii
灹	meja
䨋	meja
熑	mejg
賺	mejg
䈴	mejg
箭	meka
㷙	meka
篦	melj
䴡	melj
篏	melq
熜	melu
霒	melw
䨺	meme
筁	memt
䨞	menn
煤	meof
㷟	mepe
䨨	mepe
㷆	mepl
冪	mepm
䢐	mepm
䢙	mepm
篩	mepp
选	mept
込	mepw
䨭	meqk
靅	meqm
霭	merv
烅	mesm
賉	mesm
䦗	mesm
靆	mete
霴	metl
笫	mevr
燶	mexo
貶	mexp
霕	meya
靉	meyb
烗	meyw
賅	meyw
閡	meyw
霼	meyw
䉔	mfaa
煉	mfah
闌	mfah
簚	mfap
㷜	mfdc
霋	mfdx
㔐	mfea
烐	mfei
㷮	mfer
㷃	mffi
賬	mffm
閂	mffm
閸	mffm
闖	mffm
篤	mfft
冡	mfgd
籋	mfgm
䦵	mfgm
䈲	mfhb
篾	mfhi
焠	mfhl
箤	mfhl
賥	mfhl
䇘	mfhn
炕	mfhq
笐	mfhq
貥	mfhq
閌	mfhq
闤	mfhx
爅	mfif
炫	mfin
䝮	mfin
箩	mfiq
燡	mfir
䦴	mfir
煗	mfkc
䞂	mfkc
兪	mfkf
焲	mfki
䨲	mfki
需	mfkm
顬	mfkm
䰰	mfkm
颥	mfky
燣	mflc
竽	mflf
䉢	mfln
燷	mflp
䉡	mflu
霊	mfmf
㷵	mfmi
䉚	mfmj
煩	mfmm
簤	mfmm
䪶	mfmm
䞉	mfmm
籮	mfnp
燭	mfob
㶬	mfof
篱	mfom
㷰	mfom
箞	mfon
闂	mfon
籬	mfop
閙	mfpm
䨑	mfqy
烴	mfrc
䦨	mfrh
筻	mfro
雩	mfsa
熆	mfsm
篕	mfsm
闔	mfsm
鄠	mfsw
箑	mfts
烜	mfum
写	mfvf
賦	mfwe
霹	mfwy
闢	mfwy
爙	mfxx
䉴	mfxx
烦	mfym
皴	mgba
逡	mgbe
炦	mgbi
㕙	mgbi
夋	mgbq
鵕	mgbr
炴	mgcd
雵	mgcd
䇦	mgcd
烼	mgdi
賵	mgdm
焵	mgeh
篴	mgep
䦳	mgew
焹	mgex
烿	mgfk
閪	mgfm
䇴	mgft
笧	mggf
賎	mggm
䈐	mggm
烱	mggn
䇳	mggt
烔	mghf
筒	mghf
冢	mgii
烪	mgii
䦠	mgii
簓	mgik
関	mgim
賙	mgin
霌	mgin
烠	mgkm
焨	mgkm
賄	mgkm
䨖	mgkm
䈵	mgmh
烣	mgmi
焧	mgmu
炂	mgmx
閎	mgmx
䇗	mgmx
炯	mgnm
燆	mgnn
簥	mgnn
䇭	mgnq
閱	mgnw
䈀	mgpa
烤	mgsa
䇲	mgst
笑	mgtt
箠	mgtt
筷	mguy
笕	mgwq
箆	mgyj
焀	mgyn
笍	mgyw
㶧	mgyw
肏	mgyy
籤	mhaf
閕	mham
篆	mhaq
笌	mhat
㷨	mhbc
䝻	mhbm
炈	mhbx
靊	mhce
䉦	mhce
冨	mhcm
煏	mhcm
䈏	mhcm
䇺	mhei
闘	mhek
煓	mhfk
篅	mhfk
簟	mhfm
燂	mhfm
賕	mhfm
贉	mhfm
烧	mhfw
䈪	mhgr
賟	mhgw
熠	mhhd
熤	mhhd
霫	mhhd
闓	mhhe
箴	mhhf
煘	mhhf
熮	mhhk
賿	mhhk
燿	mhhp
籊	mhhp
䉞	mhhu
䨒	mhhx
煙	mhif
闉	mhif
	mhif
㷑	mhif
䦟	mhif
竼	mhii
籈	mhij
厼	mhkx
灿	mhmi
閊	mhmm
冚	mhmp
屳	mhmw
篥	mhof
熛	mhpg
篻	mhpg
熣	mhpr
熦	mhpr
冗	mhqp
熴	mhrj
简	mhrm
䦐	mhtm
䦚	mhtm
筈	mhtt
焖	mhup
筬	mhvv
臹	mhvv
闄	mhxc
䢆	mhxk
䝶	mhym
霎	mhys
䈉	mhyt
䇧	mhyw
燵	miae
闥	miae
烺	micb
筤	micb
閬	micb
爎	mich
焃	midg
爀	midg
䦝	midg
烢	miej
垩	miff
灶	mifi
坣	mifl
䦌	mifm
煊	mifu
箮	mifu
䈊	migb
䨍	migs
簦	mihe
燈	mihe
霯	mihe
關	miic
筀	miif
烓	miif
閨	miif
篈	miik
箢	miio
焥	miio
䝹	miio
㶴	miiq
籪	miit
燒	miiw
闗	miix
等	mikf
䝰	mikf
䦙	mikf
䈹	mikr
䨔	mils
闧	mine
炞	minf
笇	minf
熍	minn
炨	minq
筞	miof
筠	miot
䉧	mipa
熘	mipc
霤	mipc
賩	mipg
㽌	mipj
管	mipm
䦡	mipm
㶤	miqi
㒱	miqw
貯	mirf
䇡	mirf
䉅	miri
靌	mism
㶭	miuc
䇟	miuc
闋	miug
䈼	miuh
簆	miwb
筦	miwg
烷	miwg
䨪	miwm
㷯	miyk
熾	mjar
笓	mjat
筝	mjbb
	mjbb
䦛	mjbb
卖	mjcd
觌	mjcw
炋	mjdi
煯	mjdr
篯	mjeg
炡	mjfi
燻	mjfm
䦥	mjfm
冧	mjfp
霖	mjfs
箖	mjft
䇥	mjft
爋	mjfu
篶	mjfx
焕	mjgc
煥	mjgc
熵	mjgn
焔	mjjr
䨷	mjkb
霦	mjke
焴	mjkm
筚	mjlf
烨	mjlf
炓	mjlf
閗	mjlf
䈸	mjll
䉉	mjlo
䇶	mjlq
䉏	mjlu
䈥	mjlu
篣	mjmv
䨦	mjmv
箛	mjoe
炛	mjri
䦰	mjrv
䈣	mjst
煄	mjwm
箽	mjwm
㷲	mjwu
簷	mjxc
贍	mjxc
䦲	mjxc
簅	mjxl
焰	mjyr
閻	mjyr
筏	mkaa
閥	mkaa
㸁	mkag
䇚	mkal
䇮	mkat
筗	mkbm
烃	mkcf
笊	mket
䏻	mkff
贖	mkfm
箯	mkfo
㷱	mkfx
臶	mkjv
符	mkkf
䈗	mkmb
肎	mkmp
筼	mkmt
䏍	mkmx
螚	mknb
䘅	mknb
贌	mkni
熋	mknm
籉	mknm
䦖	mknm
能	mknn
態	mknu
熊	mknx
䈜	mkob
烌	mkof
篟	mkok
筓	mkqg
筰	mkqt
爜	mkrb
䳌	mkrr
篌	mkub
䞀	mkub
籝	mkui
籯	mkui
燽	mkvk
籌	mkvk
笆	mkvt
笩	mkwa
䨴	mkyk
簂	mlaf
籖	mlaf
賳	mlan
霞	mlbb
煆	mlbb
䈔	mlbb
䇱	mlbq
笝	mlbx
烟	mlcd
筃	mlcd
箜	mlcf
焢	mlcf
箘	mlct
煾	mlcu
灷	mldi
炧	mldv
䝯	mldv
弁	mldx
霿	mled
財	mlee
閉	mlee
雺	mlee
燏	mlen
霱	mlen
煣	mleo
䢠	mlep
霚	mles
霧	mleu
籅	mlfg
䪻	mlfm
簳	mlfq
煵	mlgr
䈒	mlgr
竺	mlgt
炶	mlhi
貼	mlhm
䦓	mlhm
笘	mlht
霉	mljn
烸	mljn
㷝	mlld
贆	mlll
閖	mlmm
汆	mlmw
焓	mlnm
筨	mlnm
䨓	mlnm
焑	mlof
閫	mlof
燌	mlpm
焪	mlqb
㶲	mlqi
炊	mlqi
㰫	mlqt
䇜	mlqt
䈋	mlrm
鴘	mlrr
貹	mltm
笙	mltt
簙	mluk
焾	mlup
炄	mlvi
䦍	mlvv
㷻	mlvx
䉑	mlvx
䶴	mlwp
笒	mlwt
箇	mlxf
㶦	mlxi
焼	mlxw
熔	mlyn
䈶	mlyn
熅	mlys
臸	mmaa
剡	mmaj
箌	mmaj
䈟	mmaj
䇪	mmat
㶼	mmbt
䉊	mmcx
譻	mmcy
䨶	mmdo
覢	mmdw
㸅	mmea
䉙	mmeg
霥	mmfg
爛	mmfh
籣	mmfh
燸	mmfk
顃	mmfm
顲	mmfm
焌	mmgb
賐	mmgb
閆	mmgm
䢯	mmie
烾	mmif
炎	mmii
炏	mmii
焛	mmim
㷠	mmio
甖	mmja
爓	mmjy
笲	mmld
閞	mmld
煔	mmlh
欻	mmlq
剼	mmma
劗	mmma
螢	mmmb
謍	mmmc
㽦	mmmc
䁝	mmmd
遪	mmme
䝁	mmme
嵤	mmmh
焭	mmmh
絫	mmmh
縈	mmmh
㕘	mmmh
䎕	mmmh
焱	mmmi
垒	mmmi
塋	mmmi
瑩	mmmi
賧	mmmi
㷋	mmmi
檾	mmmj
甇	mmmj
參	mmmk
篸	mmmk
膋	mmmk
贂	mmmk
亝	mmml
叅	mmml
斚	mmml
歘	mmml
滎	mmml
煢	mmml
燚	mmmm
叄	mmmm
熒	mmmm
籫	mmmm
賏	mmmm
贊	mmmm
贔	mmmm
閴	mmmm
闁	mmmm
䫩	mmmm
營	mmmn
燊	mmmo
榮	mmmo
毿	mmmo
爃	mmmo
㕖	mmmo
㲭	mmmo
冝	mmmp
禜	mmmp
	mmmp
飊	mmmq
鶯	mmmr
笡	mmmt
筫	mmmt
鎣	mmmt
勞	mmmu
憥	mmmu
犖	mmmu
簩	mmmu
罃	mmmv
䃕	mmmv
覮	mmmw
酇	mmmw
㓄	mmmw
䪯	mmmw
厽	mmmx
嫈	mmmx
褮	mmmx
貟	mmmx
醟	mmmy
簻	mmne
笞	mmnm
炲	mmnm
煱	mmnm
貽	mmnm
䈑	mmnm
㷘	mmno
䈢	mmno
燯	mmnq
䈚	mmnu
㲜	mmot
籱	mmpp
㸌	mmpr
篧	mmpr
籗	mmpr
靏	mmpr
䉮	mmpr
熐	mmrb
䈿	mmrb
簡	mmrm
㬜	mmrm
㬱	mmrm
鶑	mmrr
鸎	mmrr
䴍	mmrr
贁	mmst
闝	mmst
䞃	mmst
䦯	mmst
烍	mmti
筅	mmtt
兟	mmtt
鑍	mmtw
敥	mmub
筯	mmuc
㷥	mmuf
悬	mmup
燜	mmup
㥕	mmup
䉍	mmup
燗	mmuq
燘	mmuy
簢	mmuy
㷀	mmvl
罌	mmvt
㶩	mmwq
郯	mmwv
嬰	mmxc
熡	mmxc
簍	mmxc
煇	mmxf
賱	mmxf
爧	mmxh
䉹	mmxh
县	mmxm
䨉	mmxp
㶶	mmxq
鸚	mmxr
籔	mmxs
厸	mmxx
㕕	mmxx
赞	mmym
酂	mmyw
熌	mmyw
籏	mnaf
刣	mnaj
剮	mnaj
䈺	mnbj
賗	mnbm
熗	mnbn
篬	mnbn
賶	mnbn
籎	mnbs
簇	mnbt
贃	mnbu
篒	mncb
箿	mndf
霵	mndi
箷	mndv
迨	mnep
過	mnep
閇	mnfm
䫚	mnfm
雫	mnfs
炽	mngw
㶽	mngy
䈫	mngy
瓵	mnja
㣍	mnke
䈙	mnkf
焆	mnkm
䇼	mnkv
歄	mnlq
㰧	mnlq
炱	mnmi
咼	mnmm
問	mnmm
熉	mnmm
篔	mnmm
霣	mnmm
台	mnmx
簉	mnne
㸆	mnnf
筥	mnnm
筶	mnnm
焅	mnnm
焒	mnnm
閭	mnnm
䈽	mnno
熯	mnnt
枲	mnof
箹	mnoi
䴇	mnqr
零	mnqx
炩	mnqx
笭	mnqx
閝	mnqx
旤	mnra
䇸	mnsg
筽	mnug
怠	mnup
煠	mnvo
䈎	mnvo
乨	mnvv
笹	mnvv
䢄	mnwj
炾	mnwq
貺	mnwq
雰	mnws
邰	mnwv
辝	mnwy
煰	mnxm
闆	mnxm
燥	mnxo
簯	moaf
烞	moal
笷	moav
㶯	moav
煼	mobb
篘	mobb
䈷	mobn
雪	mobs
燖	mock
雹	modb
炮	modb
笣	modb
䇖	moee
䈤	moef
笟	moet
笨	moff
㶱	moff
炑	mofi
閑	mofm
雬	mofs
簑	mofx
簔	mofx
㸀	mogi
篙	mogn
熇	mogn
燺	mogo
烯	mogp
籕	moic
灼	moii
炢	moii
䉘	moip
燉	mojs
焞	mojv
霩	mojw
箐	mokm
	mokm
䝼	mokm
䨝	mokm
䈦	molb
籇	momg
煷	momh
簀	momm
箒	momp
㷌	momp
㷚	momr
笱	monm
䝭	monm
笅	moow
䈾	moqk
笏	more
箰	morj
賯	morj
筍	morm
㶷	morm
䈞	morm
䉓	moro
鷴	morr
㷓	moru
䨚	moru
䈡	moru
閛	mosm
䨛	mote
閐	motm
㲘	motm
雮	mots
笔	mott
笉	moty
䝧	moty
爩	movk
篐	moxp
䉩	moxx
箦	moym
䉳	mpai
劄	mpaj
箚	mpaj
䇷	mpaj
笋	mpbt
篗	mpbx
䨥	mpbx
㷪	mpcc
灱	mpci
簰	mpdl
霺	mpds
䉠	mpds
笼	mpdt
簁	mpes
䓥	mpfm
煐	mpgc
霙	mpgc
䦫	mpgc
燁	mpgg
箬	mpgn
焫	mpgy
熻	mphh
闟	mphh
篵	mphs
䑒	mpii
䝸	mplb
䨱	mplb
㱋	mplq
爤	mpmh
簣	mpmm
闠	mpmm
㠳	mpmw
笤	mpnm
炤	mpnm
烵	mpoi
鹤	mpoq
燪	mpou
籆	mppb
䉶	mppb
靃	mppr
爑	mppx
爡	mprb
焳	mpri
雎	mprm
閵	mprm
燤	mprn
贎	mprn
隺	mprp
靍	mprr
鶴	mprr
鸖	mprr
霍	mprs
烆	mpsg
筕	mpsg
箻	mpub
㷹	mpuf
篽	mpwa
冤	mpwi
烚	mpwi
閤	mpwm
籞	mpwp
䨐	mpws
答	mpwt
贜	mpxd
燋	mpxo
熫	mpxo
䉀	mpxo
爟	mpxp
篑	mpym
炥	mqdr
笰	mqdr
煂	mqfi
䉲	mqfm
䨣	mqfs
煫	mqgd
燧	mqge
㶥	mqgi
閈	mqgm
竿	mqgt
闐	mqgw
䈯	mqgw
烁	mqhk
熷	mqir
贈	mqir
䉕	mqir
䇙	mqjj
箾	mqka
筲	mqkm
霄	mqkm
焇	mqkm
熥	mqle
筩	mqlm
㷁	mqlm
烂	mqmg
䞆	mqmm
䨎	mqmx
閲	mqnw
筜	mqob
煈	mqqi
闏	mqqm
霛	mqqq
焍	mqqr
第	mqrk
箪	mqrl
炸	mqti
䝫	mqtm
笮	mqtt
篛	mqtt
簕	mquc
霸	mquq
賆	mqxg
䦕	mqxg
䈂	mqxg
煪	mqyf
燇	mqyk
戬	mraa
皲	mrac
军	mrap
䨹	mrbf
䒌	mrbk
鼆	mrbm
䫤	mrbm
篠	mrbo
覭	mrbw
鄍	mrbw
冥	mrby
幂	mrcp
熶	mrdb
覸	mrdw
煜	mrdy
焺	mrel
熳	mrfb
熚	mrff
篳	mrff
灯	mrfi
閅	mrfm
㷸	mrgg
㷒	mrgn
筙	mrgt
闒	mrhh
䈳	mrhh
燝	mrhy
簺	mrif
熀	mril
焜	mrja
箟	mrja
爉	mrlf
䉭	mrlf
煋	mrlt
篂	mrlt
晋	mrmf
間	mrmm
㒲	mrmw
炣	mrnm
笴	mrnm
閜	mrnm
㷄	mrof
焬	mror
賜	mror
㷎	mrov
䦪	mrov
䨠	mrov
䈓	mrov
爗	mrpg
燳	mrpx
焊	mrqg
筸	mrqg
鵄	mrra
䲴	mrri
焻	mrrm
閶	mrrm
鴡	mrrm
鵙	mrrm
簪	mrrr
熸	mrrr
鷼	mrrr
䉆	mrrt
鳰	mrrw
煴	mrsm
筱	mrst
霷	mrur
閺	mruy
䇩	mrve
電	mrvv
爆	mrwl
郓	mrwv
鄑	mrwv
熓	mrxo
籍	mrxr
炷	mryi
䝬	mrym
䇠	mryt
箨	msbk
篺	msdl
箝	msef
䉥	mseu
籒	msfc
籜	msfr
䇿	msft
閏	msgm
籀	msic
笂	msii
閠	msii
籟	msjm
㸊	msjm
籁	msjy
筢	mskv
筭	msld
簌	mslq
煶	msmi
笽	msmt
䈕	msmt
䉗	msnd
筘	msnm
䉟	mspb
箉	mspm
㶢	msqi
䈰	msqk
致	msta
䇽	mste
炇	msti
敗	mstm
㪇	mstt
籡	mswh
簼	msxi
箍	msxp
簎	msxr
籛	mtaa
煝	mtdm
箵	mtdm
篃	mtdm
煻	mtdn
篖	mtdn
闚	mtdw
燫	mteg
簾	mteg
炘	mtei
靀	mtfg
筛	mtfp
霜	mtfs
箱	mtft
䉬	mtib
賍	mtif
賘	mtii
笢	mtja
籦	mtjw
筹	mtkf
炒	mtki
焮	mtlq
䨏	mtlq
鹴	mtoq
靎	mtrr
鸘	mtrr
篮	mtsm
㸇	mttm
簮	mttr
焿	mtty
䉰	mtty
炼	mtvg
簘	mtwd
䦦	mtwm
爌	mtxg
籙	mtxl
烄	mtyi
賋	mtym
筊	mtyt
箙	muab
筆	mubt
䇹	mubt
霢	muca
助	mucm
竻	muct
䶍	mucu
簲	mudl
霁	mudr
覵	mudw
煡	mudx
閟	muee
笾	muep
籘	mufh
烳	mufi
籐	mufl
焯	mufm
䝵	mufm
䈇	mufm
䇫	muft
䈛	mugb
䇬	mugw
爘	muic
䇰	muif
霡	muii
燦	muiw
篜	muix
煿	mukf
賻	mukf
䈈	mukv
籩	mule
炟	mumi
䦔	mumm
笪	mumt
笳	munm
㶺	munm
闑	muof
煬	muor
恶	mupf
悶	mupm
閒	muqm
雭	muqs
笈	muqt
鴾	murr
鷳	murr
簠	musm
牟	mutx
筋	muuc
劺	muuc
䈻	muuf
熁	muuk
燲	muum
熄	muup
焩	muuq
䨜	muuq
㶸	muuu
䨡	muwl
䈄	muwl
炆	muyi
閔	muym
雯	muys
炔	muyw
䦑	muyw
簱	mvaf
露	mvbn
簬	mvbn
炻	mvdi
䦒	mvdm
闞	mvds
雼	mvds
賭	mvfm
闍	mvfm
箸	mvft
煅	mvhb
笥	mvhf
貾	mvii
笖	mviy
烀	mvlf
雽	mvlf
炠	mvmi
閘	mvmm
笚	mvmt
笃	mvnt
賝	mvof
䬠	mvpd
炀	mvre
焝	mvrm
閽	mvrm
䝪	mvsh
䈝	mvsk
㤀	mvup
煒	mvvi
闈	mvvm
兦	mvvw
㐈	mvvw
箊	mvyj
閼	mvyj
閍	mvym
雱	mvys
霳	mwbl
䈨	mwcb
烒	mwcf
䨸	mwcu
闀	mwdb
䨯	mwfh
烘	mwfi
烡	mwfi
閧	mwfm
䪴	mwfm
貦	mwgm
䦎	mwgm
㷍	mwgp
䈁	mwgp
䨌	mwgs
笎	mwgt
㱽	mwhb
糴	mwhp
䉄	mwib
燐	mwio
冞	mwip
燴	mwir
籴	mwiw
瓭	mwja
冠	mwkf
沊	mwlm
籂	mwlp
燃	mwlx
䈩	mwma
签	mwmo
筡	mwof
賖	mwof
鸩	mwoq
䧵	mwpr
䨀	mwpr
䉌	mwqg
灮	mwqi
冘	mwqp
允	mwqx
䨩	mwrj
鴆	mwrr
冦	mwub
燱	mwup
郅	mwva
邩	mwvi
郥	mwvm
鄳	mwvm
䢸	mwvm
簖	mwvt
䢾	mwvt
篨	mwwo
邥	mwwv
烑	mwwy
筄	mwwy
雿	mwwy
㓂	mwxc
簽	mwxh
㷿	mwxh
簶	mwxl
籨	mwxl
籲	mwxm
爊	mwxo
籥	mwxp
爚	mwxp
籢	mwxs
熝	mwyi
闇	mwym
簏	mwyt
皸	mxav
簵	mxbn
笯	mxbx
爏	mxce
靂	mxce
篋	mxch
婁	mxcm
贓	mxdf
䈍	mxdm
篚	mxef
運	mxep
遱	mxep
䨤	mxep
閳	mxfm
顐	mxfm
䫫	mxfm
軍	mxfp
䇢	mxft
篝	mxgi
煹	mxgi
購	mxgi
開	mxgm
箧	mxgs
笄	mxgt
箣	mxha
策	mxhk
䝽	mxii
篿	mxik
籭	mxiw
甊	mxja
㪹	mxjl
㶿	mxjv
霰	mxks
䉈	mxks
炬	mxlb
箓	mxll
䞅	mxln
震	mxlo
賑	mxlo
㮡	mxlo
簐	mxlq
笛	mxmt
龗	mxna
㪮	mxnb
靈	mxnh
笸	mxnm
筎	mxnm
霝	mxnm
䰱	mxnm
䉖	mxnq
䴒	mxnr
酃	mxnw
䚖	mxnw
孁	mxnx
熰	mxnx
範	mxon
氀	mxot
籄	mxpm
爄	mxpn
农	mxqp
㷞	mxrj
燀	mxrl
簞	mxrl
闡	mxrl
焟	mxrm
鶤	mxrr
鷜	mxrr
䞁	mxrx
筐	mxsg
筺	mxsi
數	mxst
䉋	mxtd
雳	mxuc
煳	mxuq
箶	mxuq
筪	mxvm
䉃	mxwk
鄆	mxwv
䣚	mxwv
䉐	mxxf
簧	mxxg
熿	mxxg
䉷	mxxs
笀	mxyt
炳	mxyw
䇤	mxyw
炖	myai
閿	mybx
燬	mycb
爔	myci
臻	myct
炌	mydr
䦏	mydr
烩	myeg
煸	mygp
篇	mygp
煽	myhh
䇣	myhk
閦	myhw
㷐	myif
䝩	myke
䈆	myld
贠	mymx
熩	mynk
簄	mynk
炝	myon
冩	myox
䉣	myox
賒	mypg
炉	mypi
箺	myrm
賰	myrm
閰	myrm
䦮	myrm
霽	myrr
㸄	myrr
筌	mysg
烇	mysg
闙	mysn
燰	myub
㷣	myut
熂	mywi
閃	mywm
閄	mywm
霓	mywq
䦧	mywq
燨	mywt
䉝	mywt
䉱	myxx
綫	naaa
啵	naac
嘙	naax
綎	nadx
繕	naen
唭	nafm
㕶	nafm
綨	nafn
旗	nafy
絨	nagd
羢	nagd
膐	nagy
咩	naim
絴	nain
㓸	najn
膂	nakm
㖑	nald
嗨	nalj
卟	nalm
緎	nanf
㖪	nanf
唔	nanm
旅	naqy
嚽	nasm
嗷	nast
嘶	nate
唦	natk
紝	natn
叩	navm
叫	navm
糾	navn
紴	navn
啿	navv
旇	navy
綹	nban
喒	nbar
啜	nbbb
綴	nbbb
䍳	nbbb
呎	nbbm
䋇	nbbn
嗓	nbbo
縔	nbbo
縫	nbce
繣	nbcf
㗲	nbcf
綘	nbcg
㖓	nbcg
噃	nbcm
噹	nbcm
旛	nbcm
繙	nbcm
羳	nbcm
羱	nbdi
縓	nbdn
嗤	nbfb
嘡	nbif
経	nbif
紁	nbii
紌	nbii
㕱	nbii
咚	nbjo
終	nbjo
哤	nbki
欵	nblq
咄	nblv
絀	nblv
串	nbmm
虽	nbmm
蚠	nbmw
創	nbna
戧	nbna
䢢	nbne
咯	nbnm
倉	nbnm
絡	nbnm
嚐	nbnr
鶬	nbnr
絳	nboa
雖	nbpr
㽈	nbqj
觺	nbql
疑	nbqs
紃	nbrn
鷟	nbrr
族	nbty
肄	nbub
患	nbup
㗭	nbup
叹	nbxm
嚍	nbxs
唎	ncaj
哌	ncaq
㿷	ncav
哏	ncbm
䋼	ncbs
食	ncbw
唀	nccc
綉	nccc
嗁	ncch
纝	ncch
嘒	ncco
嚧	nccs
纑	nccs
嚖	nccu
䌥	nccu
㕦	ncdm
䌐	ncdw
哒	ncep
齹	ncew
差	ncfi
嚼	ncfk
叿	ncfm
穎	ncfm
紅	ncfn
喂	ncfo
䋿	ncfo
咵	ncfs
絝	ncfs
颖	ncfy
㘌	ncga
噱	ncgd
㕩	ncgm
嚱	ncha
㖃	nchf
囐	nchl
唬	nchq
唊	nchw
綊	nchw
嗘	ncic
縘	ncic
縲	ncih
喹	ncii
䋾	ncii
噓	ncjj
䌀	ncjl
哹	ncjv
啂	ncjv
綒	ncjv
喛	nckb
緩	nckb
嘭	ncke
哷	nckf
嘘	nckj
喟	nckm
緭	nckm
䋸	ncld
喯	ncll
啾	ncmi
㷢	ncmi
䋺	ncmi
嗊	ncmm
細	ncmn
䌆	ncmx
嘻	ncnm
啝	ncnm
繥	ncnm
噳	ncnu
纞	ncnu
啋	ncof
綵	ncof
嚟	ncol
喫	ncpc
㖠	ncpg
噄	ncph
囓	ncpw
嘹	ncqh
繚	ncqh
噅	ncqx
㗍	ncrm
旖	ncrn
綺	ncrn
唵	ncrv
咊	nctm
綥	ncud
緦	ncup
㗔	ncuy
嘑	ncvl
嗂	ncvt
䌊	ncvt
哸	ncxc
唩	ncxc
綏	ncxc
緌	ncxc
䍴	ncxc
䡨	ncxf
㖸	ncxf
唝	ncym
唁	ncym
縚	ncyr
㗖	ncyr
嗫	ndbb
䌑	ndbi
啒	ndbl
㘋	ndbm
㕧	ndbm
䗐	ndbm
嘜	ndbq
緅	ndbx
㖩	ndbx
嗥	ndcl
囁	nddd
䌰	nddd
啸	nddg
唻	nddm
䋱	nddn
㘗	nddp
噀	nddw
嚫	nddw
繏	nddw
䍻	nddw
啤	ndel
綼	ndel
嘱	nden
咡	ndfm
咠	ndfm
唗	ndfm
䋙	ndfn
䋗	ndfn
喽	ndim
嚛	ndio
纅	ndio
唣	ndja
嚨	ndka
䌬	ndka
囑	ndlb
䌵	ndlb
唕	ndlf
線	ndlm
喔	ndma
䌂	ndma
着	ndmi
䞄	ndmm
㗣	ndmp
喞	ndna
㖣	ndnm
䋨	ndnm
旎	ndnq
呢	ndnq
㗦	ndoa
啲	ndoi
唰	ndpa
綿	ndpm
㕷	ndrm
絈	ndrn
嘯	ndrr
繡	ndrr
喤	ndsg
噺	ndte
緲	ndtk
嚂	ndts
繿	ndts
囕	ndtw
纜	ndtw
䌫	ndtw
眞	ndvg
戢	ndvi
吔	ndvm
顚	ndvm
䊶	ndvn
鷆	ndvr
噭	ndvs
繳	ndvs
施	ndvy
噑	ndwl
噇	ndwm
絼	ndwn
哯	ndwq
絸	ndwq
㖿	ndwv
繉	ndww
㕸	ndym
唧	neav
縌	nebe
嗍	nebu
唌	need
綖	need
啡	nefh
緋	nefh
咁	nefm
嗼	nefm
紺	nefn
縸	nefn
噢	negc
呍	negm
响	negn
紜	negn
嗌	negs
縊	negs
䌡	nehe
䊼	nehn
噦	neho
嗲	neii
嗞	neii
㘂	neiu
吒	neja
嗛	nejg
縑	nejg
啃	nekm
繌	nelb
呏	neld
總	nelu
㖆	nemm
㗪	nenh
嘴	nenl
呂	nenm
喍	neno
呲	nenq
紪	nenq
㖼	neof
嚬	neom
縋	nepe
㗓	nepe
嘅	nera
呹	netg
紩	netg
噛	newl
㕮	newm
嚙	neww
噥	nexo
繷	nexo
咳	neyw
絯	neyw
嚃	nfae
練	nfah
咧	nfaj
呒	nfbd
繮	nfcf
嘎	nfda
嗄	nfdb
啛	nfdx
緀	nfdx
嘈	nfer
呿	nffm
唖	nffm
啞	nffm
嗎	nffm
紶	nffn
絚	nffn
䌳	nfgi
䌤	nfgm
噰	nfgp
啐	nfhl
綷	nfhl
䊺	nfhn
囃	nfhp
吭	nfhq
䋁	nfhq
噮	nfhx
繯	nfhx
㗜	nfic
嚜	nfif
纆	nfif
繂	nfil
呟	nfin
絃	nfin
啰	nfiq
繹	nfir
㘁	nfir
縴	nfiu
䌉	nfjf
嘠	nfka
嚘	nfkb
纋	nfkb
緛	nfkc
㖡	nfki
㖇	nfkm
吁	nflf
紆	nflf
嚸	nflh
繬	nfln
旜	nflu
繵	nflu
羶	nflu
嘿	nfmm
啢	nfmm
嘪	nfmm
緉	nfmm
頒	nfmm
㖽	nfmm
䋶	nfmm
㔬	nfmq
囉	nfnp
纙	nfnp
噣	nfob
䍪	nfof
縭	nfom
啳	nfon
綣	nfon
囄	nfop
旆	nfpm
䍨	nfpm
嚺	nfqe
鲝	nfqi
咦	nfqy
羠	nfqy
經	nfrc
羥	nfrc
䍶	nfrh
㖦	nfrh
噜	nfrm
咟	nfrm
絔	nfrm
哽	nfro
綆	nfro
䊸	nfsa
嗑	nfsm
啑	nfts
緁	nfts
㘐	nfty
咺	nfum
喕	nfum
絙	nfum
緬	nfum
噁	nfup
㗄	nfvy
噼	nfwy
䌟	nfwy
䌁	nfxc
黃	nfxg
嚷	nfxx
纕	nfxx
颁	nfym
紱	ngbi
㕹	ngbi
咉	ngcd
紻	ngcd
咗	ngcf
綱	ngeh
網	ngex
緪	ngff
哂	ngfm
絤	ngfn
縆	ngfu
旃	ngfy
咝	nggf
綗	nggn
哃	nghf
絧	nghf
嘦	nghx
呥	ngif
㫋	ngif
啄	ngii
咲	ngim
啁	ngin
綢	ngin
嘋	ngjs
哮	ngjv
哊	ngkm
絠	ngkm
喐	ngkw
㰨	nglq
嗡	ngmh
咴	ngmi
総	ngmu
吶	ngmw
吰	ngmx
紘	ngmx
㕬	ngmx
絅	ngnm
嘺	ngnn
繑	ngnn
咾	ngnq
嗜	ngnr
䋞	ngoo
䋄	ngow
嗣	ngph
翤	ngph
咘	ngpm
唾	ngtm
㕭	ngtm
綞	ngtn
叭	ngwm
只	ngwm
剐	ngya
唂	ngyn
綌	ngyn
呙	ngyw
呐	ngyw
納	ngyw
纖	nhaf
呀	nham
喙	nhaq
緣	nhaq
噈	nhbi
啹	nhbm
䋧	nhbn
羖	nhbx
吺	nhbx
䋹	nhcm
哣	nhei
㖅	nhff
喘	nhfk
嘾	nhfm
絿	nhfn
哓	nhfw
喴	nhfx
縅	nhfx
羰	nhgm
嗝	nhgr
唺	nhgw
㗩	nhhd
䌌	nhhd
喊	nhhf
緘	nhhf
羬	nhhf
嘐	nhhk
繆	nhhk
噿	nhhl
嚁	nhhp
䌦	nhhp
翔	nhhx
䋚	nhhx
唑	nhif
緸	nhif
㖶	nhif
㗀	nhii
㕨	nhii
哕	nhiq
綠	nhll
㖗	nhlw
岔	nhmw
哚	nhof
㗚	nhof
㘍	nhpa
嘌	nhpg
旚	nhpg
縹	nhpg
纗	nhpn
嗺	nhpr
繀	nhpr
哶	nhqg
叽	nhqm
斻	nhqy
緃	nhsh
咶	nhtm
絬	nhtn
嘣	nhuu
繃	nhuu
啱	nhvd
㘎	nhvs
絾	nhvv
嘁	nhwh
縬	nhwh
䌚	nhwi
喓	nhxc
㫏	nhxc
嘊	nhxi
唼	nhym
綡	nhyn
噠	niae
繨	niae
喀	nibn
哴	nicb
羪	nicb
嗐	nicn
縖	nicn
哧	nidg
嚇	nidg
养	nidr
哋	nidv
咤	niej
啷	niew
縯	nifg
吐	nifm
繽	nifm
啶	nifs
綻	nifs
喧	nifu
縇	nifu
坌	nifw
綾	nigb
㖫	nigb
綋	nigm
噔	nihe
絲	nihk
顈	nihm
鷥	nihr
啩	niia
養	niic
嘰	niid
哇	niif
絓	niif
䋽	niik
啘	niio
綩	niio
哆	niiq
㔦	niiu
繼	niiv
嘵	niiw
繞	niiw
縮	nikr
咣	nilm
絖	niln
㗌	nima
吆	ninm
咜	ninq
紽	ninq
䍫	ninq
嚓	niop
嚠	nipa
綜	nipg
綰	nipm
鯗	nipq
㗶	niqb
咛	nirf
紵	nirf
羜	nirf
啈	niri
緈	niri
呦	niuc
嘧	niuh
䌏	niuh
嚀	niur
哰	niut
咏	nivi
唍	niwg
綄	niwg
羦	niwg
縡	niwy
咹	nixc
㗷	nixy
吡	njam
咓	njam
紕	njan
織	njar
瓫	njaw
旊	njay
䍵	njbb
䋫	njbb
吥	njdm
紑	njdn
喈	njdr
遊	njep
呸	njff
䋔	njff
啉	njfm
嚑	njfm
纁	njfm
綝	njfn
䋊	njfn
嘕	njfx
㫌	njfy
唤	njgc
喚	njgc
嘀	njgx
㗏	njjf
唷	njkm
䋭	njkm
㔃	njkp
㔢	njku
絶	njkv
哔	njlf
哗	njlf
呌	njlf
紏	njlf
嘝	njll
唃	njlq
繲	njlu
啼	njmp
締	njmp
嗙	njmv
縍	njmv
䍭	njni
呣	njnm
䋓	njob
喼	njou
繺	njox
噤	njpg
䌝	njpg
吪	njrm
吇	njvm
吼	njvv
斿	njvy
喠	njwm
緟	njwm
統	njwq
㗢	njwu
㗋	njxb
噡	njxc
喭	njxk
㘖	njxm
䍯	njxo
啗	njyr
㗼	nkag
䌜	nkag
剈	nkaj
絍	nkat
羟	nkcf
咃	nkdv
喺	nkeh
羏	nkei
吋	nkfm
續	nkfm
紂	nkfn
緶	nkfo
味	nkgw
㖵	nkgw
瓹	nkja
咐	nkkf
紨	nkkf
纀	nkki
絥	nkld
嗰	nklx
肙	nkmm
続	nkmw
噗	nkni
䣈	nknk
咭	nknm
結	nknm
纈	nknm
㘆	nknm
緥	nkno
咻	nkof
鹃	nkoq
咿	nkpb
㘑	nkpl
哬	nkrn
鵑	nkrr
喉	nkub
緱	nkub
䌱	nkui
䌴	nkui
綕	nkup
羓	nkvi
嚋	nkvk
䌧	nkvk
吧	nkvm
邑	nkvm
紦	nkvn
嚉	nkyk
旒	nkyy
嘓	nlaf
纎	nlaf
繊	nlak
縀	nlbb
㗇	nlbb
吱	nlbx
咽	nlcd
絪	nlcd
䍰	nlcd
啌	nlcf
羫	nlcf
㖥	nlct
嗯	nlcu
吠	nldm
紎	nldn
絁	nldv
弅	nldw
䋒	nlee
䊷	nlee
噊	nlen
繘	nlen
㖻	nleo
䋴	nleo
駂	nlff
旟	nlfg
叶	nlfm
潁	nlfm
嘲	nlfu
颍	nlfy
喃	nlgr
䋻	nlgr
呫	nlhm
絒	nlij
㖄	nlij
䋦	nljn
吘	nllf
啚	nlln
鄙	nllw
㗧	nlma
焁	nlmi
嗿	nlmm
唅	nlnm
絗	nlnm
綑	nlof
䋉	nlon
鸨	nloq
噴	nlpm
羵	nlpm
喷	nlpy
吹	nlqm
䊻	nlqn
緮	nlrb
哖	nlrf
鴇	nlrr
㗑	nlsg
啯	nlsi
旌	nlty
唸	nlup
羞	nlvi
吜	nlvm
紐	nlvn
吃	nlvv
紇	nlvv
嘸	nlvx
䌗	nlvx
吟	nlwm
紟	nlwn
噾	nlwy
紓	nlxn
縕	nlys
咥	nmam
絰	nman
䋐	nman
唉	nmbt
噬	nmch
㘊	nmcy
䚋	nmdw
㘉	nmea
繧	nmeg
喩	nmff
㘓	nmfh
嚅	nmfk
繻	nmfk
羺	nmfk
哑	nmfm
熲	nmfm
顢	nmfm
䫟	nmfm
囖	nmfp
颎	nmfy
羧	nmgb
唆	nmgb
㗛	nmgt
㕴	nmhq
炗	nmif
吙	nmim
䌣	nmip
炃	nmiw
嚪	nmjy
䌪	nmjy
㒼	nmmf
啖	nmmi
緂	nmmi
嘇	nmmk
縿	nmmk
㗵	nmml
咀	nmmm
員	nmmm
唄	nmmm
囋	nmmm
纘	nmmm
組	nmmn
繩	nmmn
㘇	nmmo
嘮	nmmu
貧	nmmw
嚶	nmmx
纓	nmmx
㗻	nmne
咍	nmnm
喎	nmnm
紿	nmnm
緺	nmnm
䌢	nmnq
緿	nmnu
嚯	nmpr
㗳	nmpw
囎	nmqr
縉	nmrm
㗿	nmrn
鶰	nmrr
緻	nmst
䌮	nmtf
勛	nmuc
繝	nmuq
㗴	nmuq
哞	nmut
	nmvs
	nmvs
㘚	nmvs
叺	nmwm
吮	nmwq
紞	nmwq
㕪	nmwq
鄖	nmwv
嘍	nmxc
縷	nmxc
喗	nmxf
緷	nmxf
㫎	nmxf
哝	nmxq
嘂	nnan
嗆	nnbn
㘈	nnbs
嗾	nnbt
䍺	nnbu
喰	nncb
嗟	nncf
縒	nncf
緝	nndf
丳	nndr
靠	nnef
造	nnep
吓	nnfm
頶	nnfm
嚻	nnfn
㖰	nngh
呮	nngw
	nngy
㖞	nngy
䎋	nnhh
噝	nnih
絹	nnkm
唈	nnkv
吕	nnmm
縜	nnmm
告	nnmt
哠	nnnm
絽	nnnm
䌍	nnno
兺	nnnq
嘆	nnnt
哛	nnnw
嚥	nnnx
堇	nnog
喲	nnoi
歏	nnol
鹄	nnoq
斳	nnot
㝻	nnot
勤	nnou
懃	nnou
觐	nnow
鄞	nnow
覲	nnow
䧼	nnpr
叱	nnqm
呤	nnqx
羚	nnqx
旍	nnqx
紷	nnqx
鵠	nnrr
䋲	nnrv
呺	nnsa
哫	nnsh
㖹	nnsm
艱	nntc
歎	nntl
囏	nntn
㔮	nntn
難	nntp
戁	nntu
㸐	nntx
臡	nnty
勂	nnuc
嚩	nnuk
嗴	nnvm
㷼	nnvm
喋	nnvo
緤	nnvo
鷰	nnvr
㬫	nnvr
䴏	nnvr
縼	nnvs
呭	nnvv
唴	nnvv
紲	nnvv
酀	nnvw
燕	nnvx
嬊	nnvx
羒	nnwi
吩	nnwm
紛	nnwn
呪	nnwq
郜	nnwv
郘	nnwv
噪	nnxo
繰	nnxo
㖎	nnyd
縐	nobb
㗙	nobb
唛	nobq
噚	nock
咆	nodb
呱	noem
呠	noff
絊	noff
呆	nofm
㕲	nofm
㯋	nofm
䊾	nofn
㘄	nofv
縗	nofx
㖁	nogm
嗃	nogn
縞	nogn
唏	nogp
絺	nogp
嗉	noih
縤	noih
約	noii
絉	noii
噋	nojs
啍	nojv
綧	nojv
㗥	nojw
㖊	nokf
啨	nokm
綪	nokm
緵	nolb
㕳	nolv
唚	nomb
綅	nomb
嚎	nomg
喨	nomh
嘖	nomm
績	nomm
噎	none
呴	nonm
絇	nonm
槑	nono
喣	nonx
哅	nool
䋂	noow
縩	nopg
㗫	nopg
鸣	noqm
吻	nore
咰	norm
絢	norm
唿	noru
緫	noru
䍬	nosi
呯	nosm
唽	note
㕰	notm
䋃	notn
旄	noty
呁	noty
喳	noum
哼	nouv
呜	novf
㕼	novo
啕	novt
綯	novt
史	nowm
綂	nowq
哪	nowv
䋝	noxc
喖	noxf
㗒	noxq
啧	noym
哵	npaj
纄	npbe
吚	npbm
䗽	npbm
喥	npbx
喵	npcm
叨	npcm
叧	npcm
緢	npcm
糿	npcn
㘛	npda
縙	npdf
咙	npdm
㘕	npds
嘥	npes
縦	npes
縰	npes
䌩	npfi
颕	npfy
緓	npgc
嘩	npgg
呩	npgm
喏	npgn
㘃	npgu
噏	nphh
縱	nphs
㗰	nphs
嗱	npht
囈	npie
紉	npii
綛	npiu
䌲	npjf
嚵	npji
纔	npji
嗬	npkn
絕	npkv
啽	npld
囒	npmh
吊	npmm
呬	npmm
嘳	npmm
繢	npmm
斾	npmy
䬭	npnc
紹	npnm
㗱	npof
䌖	npof
嚆	npon
䌨	npop
㖴	npor
繱	npou
哎	npow
嚄	nppb
囌	nppc
繾	nppe
嗒	nppw
䌋	nppw
䌭	nppx
嚿	nppy
鮺	npqi
囆	nprb
唯	nprm
嚕	nprm
噧	nprn
維	nprn
鷕	nprr
噶	nprv
哘	npsg
絎	npsg
吀	nptm
䊹	nptn
㘅	npts
嘚	npuk
㗹	npup
㗸	npvs
呓	npvv
哈	npwm
給	npwn
絻	npwq
噍	npxo
嗻	npxo
嚾	npxp
䌯	npxp
囔	npxx
嗏	npyo
喢	npyr
刢	nqaj
咈	nqdr
紼	nqdr
領	nqfm
㗆	nqfm
緙	nqfn
领	nqfy
旞	nqge
繸	nqge
緔	nqgn
嗔	nqgw
縝	nqgw
翎	nqhh
嚡	nqii
噌	nqir
繒	nqir
瓴	nqja
吲	nqjj
吖	nqjj
紖	nqjj
㗾	nqjr
䌃	nqka
絆	nqkg
哨	nqkm
旓	nqkm
綃	nqkm
嗵	nqle
㗈	nqlu
繈	nqmb
嗩	nqmm
紭	nqmx
繦	nqnb
縂	nqnu
哾	nqnw
綐	nqnw
哟	nqoi
鸰	nqoq
颪	nqqf
綈	nqqr
㖒	nqqr
啴	nqrl
鴒	nqrr
咋	nqtm
䋏	nqtn
嘞	nquc
邻	nqwv
絣	nqxg
令	nqxw
緧	nqyf
噂	nqyk
繜	nqyk
唢	nqym
縧	nrbo
緇	nrcm
嘬	nrdb
繓	nrdb
喅	nrdy
匘	nreo
縵	nrfb
嗶	nrff
縪	nrff
叮	nrfm
糽	nrfn
嗮	nrgf
喁	nrgn
䋘	nrgn
䌈	nrhh
䭫	nrhi
噻	nrif
㖏	nrif
縨	nril
緄	nrja
呻	nrjj
紳	nrjj
啭	nrli
㘔	nrmm
旨	nrmq
嗈	nrnk
呵	nrnm
䋍	nrnm
㫊	nrnm
嘄	nrof
綶	nrof
緆	nror
羯	nrov
喝	nrov
䋵	nrov
哻	nrqg
䭬	nrrd
鴹	nrri
唱	nrrm
鳴	nrrm
繅	nrro
噆	nrrr
鴲	nrrr
䍼	nrrr
縄	nrrv
鳻	nrrw
嗢	nrsm
緼	nrsm
㫍	nrst
絏	nrve
㖂	nrve
黾	nrvv
嚗	nrwl
嗚	nrxo
紸	nryn
喇	nsaj
号	nsam
饕	nscc
號	nsch
㙱	nsci
啪	nsdr
啦	nsdy
逞	nsep
䪽	nsfm
綀	nsfn
呈	nsgm
㕵	nsgm
䟳	nshh
足	nshm
紈	nsii
唞	nsjl
哢	nsld
紣	nslf
嗽	nslq
㖷	nsmm
緹	nsmn
盆	nsmw
飸	nsnc
鸮	nsoq
㕤	nsqm
䊵	nsqn
咑	nsrf
鴞	nsrr
噖	nssl
哳	nste
䍩	nsti
呚	nstm
攽	nstw
郢	nswv
㗂	ntdm
䌅	ntdn
听	ntem
斲	nten
紤	nten
㖢	nten
旂	ntey
纐	ntfm
緗	ntfn
呋	ntgm
䊿	ntgn
呡	ntja
䋋	ntja
嘛	ntjf
䌕	ntjf
嚤	ntjh
嚒	ntji
緡	ntjr
㗃	ntjr
嚰	ntjv
吵	ntkm
紗	ntkn
絘	ntlq
唙	ntmi
嗗	ntmm
縎	ntmn
絋	ntmx
唥	ntnq
嘃	nttj
纉	nttm
唠	ntuc
嘨	ntwd
繍	ntwd
纏	ntwi
唫	ntwm
䋮	ntwn
綁	ntwv
嚝	ntxg
纊	ntxg
咬	ntym
絞	ntyn
㖀	nubm
紀	nubn
䋖	nubn
劷	nuci
叻	nucm
糼	nucn
嚊	nucu
哜	nudr
咇	nuee
㗺	nuef
哺	nufm
啅	nufm
綽	nufm
䋠	nufn
吴	nugm
咮	nugw
絑	nugw
縛	nukf
䍸	nukf
㗘	nukf
嗅	nuld
䍹	nuld
㖭	nulk
䋬	nulk
呾	numm
緽	numm
䋎	numn
咖	nunm
㖔	nunm
㗎	nuno
啺	nuor
忑	nupf
吣	nupm
您	nupr
忿	nupw
吸	nuqm
級	nuqn
咱	nurm
緕	nurr
吽	nutm
䋅	nutn
嗋	nuuk
䋟	nuup
綳	nuuq
嘷	nuwl
㖤	nuwl
呅	nuym
紋	nuyn
吷	nuyw
䊽	nuyw
㗞	nvav
吳	nvcd
嚹	nvcl
噉	nvds
迣	nvep
叼	nvff
呉	nvfg
啫	nvfm
緒	nvfn
緞	nvhb
呞	nvhf
羝	nvii
呧	nvii
緖	nvii
㕽	nviy
䋳	nvkm
呼	nvlf
㰥	nvlq
呷	nvmm
貰	nvmm
勩	nvmu
羗	nvmx
吗	nvnm
䢡	nvoe
枼	nvof
紙	nvqn
緍	nvrm
㖧	nvrm
鶭	nvrr
䗠	nvsb
旋	nvsh
縃	nvsk
世	nvvf
乤	nvvf
羌	nvvi
䍷	nvvi
喡	nvvm
糺	nvvn
緯	nvvn
嘟	nvwv
唹	nvyj
贳	nvym
㕫	nvym
紡	nvyn
勚	nvyu
咔	nwal
啣	nwea
哄	nwfm
綸	nwgp
㖮	nwgp
咪	nwim
䋛	nwin
噒	nwio
繗	nwio
噲	nwir
旝	nwir
繪	nwir
喻	nwka
緰	nwka
羭	nwka
噷	nwlq
嘢	nwlx
嘫	nwlx
繎	nwlx
哩	nwmm
唨	nwmm
䋥	nwmn
㒭	nwnw
唋	nwof
䍱	nwof
䋡	nwof
兄	nwqm
啊	nwrn
䋪	nwrn
哦	nwtm
噫	nwup
繶	nwup
継	nwvv
邠	nwvw
旐	nwwy
咷	nwwy
絩	nwwy
䍮	nwwy
噞	nwxh
羷	nwxh
䌞	nwxh
喑	nwym
㖕	nwym
䌒	nwyn
麄	nwyw
縁	nxaq
呶	nxbx
嚦	nxce
䍽	nxce
嚏	nxcs
嚔	nxcs
噘	nxel
嗹	nxep
縺	nxep
纒	nxfi
咕	nxfm
唓	nxfm
㗁	nxfs
㗕	nxgi
咞	nxgm
啮	nxhm
喦	nxhm
嵒	nxhm
唡	nxhw
嗦	nxih
䌇	nxih
啀	nxii
縳	nxik
繐	nxiu
囇	nxiw
纚	nxiw
哱	nxjv
綍	nxjv
繖	nxks
䋌	nxlb
嗕	nxlk
縟	nxlk
緑	nxll
㖨	nxll
㖘	nxlo
品	nxmm
紬	nxmn
轡	nxnn
嘔	nxnx
䌔	nxnx
劋	nxoa
喿	nxof
呃	nxon
氉	nxoo
呕	nxow
鄵	nxow
咂	nxpm
嘽	nxrl
嚈	nxrl
繟	nxrl
唶	nxrm
哐	nxsg
呖	nxuc
㗅	nxuq
碞	nxvd
喱	nxwm
緾	nxwm
䌙	nxxg
囀	nxxk
㘙	nxxs
䌄	nxyb
䋑	nxyw
吨	nyam
純	nyan
綬	nybx
㖬	nybx
㖟	nybx
嗪	nyct
縥	nyct
呔	nydm
吤	nydr
紒	nydr
哙	nyeg
絵	nyeg
㖉	nyeh
噙	nyfm
唒	nyfm
噸	nyfm
綇	nyfn
嗳	nygb
編	nygp
啥	nyhg
㘴	nyif
嗖	nyjb
紾	nyke
唪	nykg
唳	nyld
綟	nyld
呗	nymm
贫	nymw
呛	nyon
䋆	nypn
㖺	nyrm
嚌	nyrr
纃	nyrr
絟	nysg
㗐	nysm
噯	nyub
羻	nyvb
呝	nyvv
㘀	nywi
㕥	nywm
唲	nywq
䍲	nywq
䋩	nywq
㗝	nyxo
嘤	nyyx
棧	oaaa
梃	oadx
橏	oaen
棋	oaff
櫇	oafm
毧	oagd
㭜	oagd
样	oaif
樭	oaif
櫀	oaih
刈	oajw
械	oald
朴	oalf
棫	oanf
梧	oanm
㯦	oaof
樑	oapo
㯕	oate
桫	oatk
朻	oavf
柀	oavf
卯	oavq
椹	oavv
乮	oavv
棳	obbb
螙	obbm
槡	obbo
槰	obce
桻	obcg
橎	obcm
檔	obcm
榞	obdf
欓	obfm
麺	obfu
㭏	obgf
橕	obha
㮻	obib
㲧	obib
樘	obif
柽	obif
㙶	obif
杈	obii
㮷	obir
柊	objo
树	obkf
柮	oblv
格	obnm
椥	obnm
栙	oboa
皺	oboa
芻	obob
橖	obof
㱀	obol
㯯	obom
雛	obop
鶵	obor
麹	obow
鄒	obow
麦	obqg
杊	obrf
麸	obtg
权	obxf
㯸	obxs
梸	ocaj
㭛	ocaq
根	ocbf
楹	ocbs
板	ocbx
櫑	occc
㭁	occf
榹	occh
欙	occh
槥	occo
櫨	occs
㲌	occt
檼	occu
櫖	occu
櫘	occu
㯭	occu
㚑	ocdb
杕	ocdf
㯒	ocdw
杠	ocff
杢	ocff
梔	ocfk
栀	ocfo
椳	ocfo
槬	ocfo
桍	ocfs
㮨	ocgb
㯫	ocgd
㭋	ocgf
穀	ochb
獣	ochl
㮪	ocho
椃	ochq
䖊	ochq
梜	ochw
榽	ocic
樏	ocih
楏	ocii
桴	ocjv
楥	ockb
樹	ockf
㭩	ockf
楯	ocld
㰔	ocmb
楸	ocmi
櫆	ocml
槓	ocmm
樝	ocmm
畄	ocmo
甸	ocmq
槐	ocmx
畗	ocmy
彠	ocnb
尋	ocnk
橲	ocnm
䫮	ocnm
鄩	ocnw
桗	ocof
棌	ocof
㯎	ocof
㰀	ocol
樉	ocoo
楔	ocpc
㮈	ocpg
㮮	ocph
橑	ocqh
楿	ocrm
椅	ocrn
匎	ocrv
㭺	ocrv
㝷	ocsk
栃	octa
柇	octf
㭷	ocuc
楒	ocup
毸	ocup
榩	ocuy
櫧	ocvf
櫾	ocvh
㯉	ocvl
榣	ocvt
桏	ocwv
桵	ocxc
㮃	ocxc
檶	ocxx
楐	ocyd
訇	ocyq
詧	ocyq
槄	ocyr
刨	odaj
樫	odbi
㭾	odbl
包	odbq
棷	odbx
槔	odcl
欔	oddb
欇	oddd
枾	oddf
桺	oddf
棶	oddf
欋	oddp
櫬	oddw
㯢	oddw
椑	odel
栕	odff
栮	odff
樟	odfm
瞉	odhb
榐	odhf
楼	odif
櫟	odio
梍	odja
樼	odjj
櫳	odka
欘	odlb
楾	odlm
樨	odlu
樾	odma
楃	odma
㯂	odmp
䀏	odmq
棓	odnm
毰	odnm
柅	odnq
梎	odnq
槪	odnr
檉	odns
檙	odob
梶	odot
㰃	odph
棉	odpm
㯧	odpn
榍	odqk
柏	odrf
橚	odrr
槞	odrv
楻	odsg
㰓	odtm
檻	odts
欖	odtw
㰖	odtw
杝	odvf
梮	odvn
檄	odvs
㭯	odvv
橷	odvw
槹	odwl
橦	odwm
檪	odwo
梘	odwq
覒	odwq
椰	odwv
炰	odxo
榇	odyf
柆	odyf
卿	oeav
楖	oeav
㮶	oebu
梴	oeed
柑	oeff
模	oeff
棑	oefh
毴	oefh
㯇	oefi
氁	oeft
栈	oegf
枟	oegf
榏	oegs
匓	oehb
杫	oehf
檅	oeho
杔	oeja
槏	oejg
㼓	oejg
椾	oeka
椪	oekj
氆	oekr
枡	oeld
㮰	oelj
㭡	oelo
樬	oelu
櫷	oemm
橴	oenh
楀	oenn
楳	oeof
㰋	oeom
槌	oepe
桘	oepm
概	oera
櫭	oeru
桖	oesm
瓞	oetg
柣	oetg
欂	oeuk
槠	oevf
柹	oevr
檂	oexo
欁	oexo
柉	oexp
核	oeyw
楝	ofah
栵	ofaj
橿	ofcf
橊	ofcm
榎	ofdb
棲	ofdx
㯾	ofee
檌	ofef
槽	ofer
㭕	offf
本	offf
棖	offf
椏	offf
榪	offf
櫰	offx
檷	ofgm
㮽	ofhb
翉	ofhh
椊	ofhl
枑	ofhn
杭	ofhq
檈	ofhx
槒	ofic
椤	ofiq
檡	ofir
㯠	ofiu
橠	ofix
櫌	ofkb
㮕	ofkc
棭	ofki
栭	ofkm
檁	oflc
杅	oflf
檣	ofln
檩	oflp
檀	oflu
氊	oflu
欏	ofnp
㯮	ofob
枺	ofof
樆	ofom
棬	ofon
㰚	ofop
㮄	ofov
柿	ofpm
杮	ofpm
㯰	ofqf
桋	ofqy
桱	ofrc
棟	ofrh
橹	ofrm
氇	ofrm
栢	ofrm
梗	ofro
杇	ofsa
榼	ofsm
㔩	ofsm
椦	ofuc
桓	ofum
㮌	ofum
楞	ofvy
杌	ofwq
檘	ofwy
㮺	ofxn
㲤	ofxo
衰	ofxq
欀	ofxx
瓥	ogbb
柭	ogbi
柍	ogcd
楕	ogck
㭬	ogdf
桥	ogdr
棡	ogeh
㯌	ogep
㮸	ogep
棢	ogex
栖	ogff
㮓	ogff
毢	ogft
枬	ogfy
栅	oggf
桟	oggf
豰	oghb
桐	oghf
柟	ogif
栚	ogif
椓	ogii
杖	ogii
椆	ogin
靑	ogjf
敎	ogjs
㭳	ogjv
殽	ogkb
肴	ogkm
栯	ogkm
郩	ogkw
㮋	ogkw
枏	oglg
㕁	ogma
㮬	ogmh
棇	ogmu
郄	ogmw
松	ogmx
枩	ogmx
敲	ognb
毃	ognb
稾	ognc
䯨	ognc
髚	ognh
㙜	ogni
䯩	ognk
歊	ognl
髜	ognl
高	ognm
柗	ognm
䯪	ognm
槗	ognn
橋	ognn
槀	ogno
髞	ogno
栳	ognq
榰	ognr
鶮	ognr
髛	ogns
㪣	ogns
髝	ognu
鄗	ognw
梲	ognw
㭎	ogow
	ogow
柵	ogpf
瓻	ogpj
欷	ogpl
㹷	ogpl
希	ogpm
柨	ogpm
鵗	ogpr
郗	ogpw
枍	ogsa
栲	ogsa
棰	ogtf
枖	ogtf
朳	ogwf
枧	ogwq
㮝	ogya
㭲	ogyn
枘	ogyw
欚	ohab
㼖	ohab
枒	ohaf
櫼	ohaf
椽	ohaq
螜	ohbb
椐	ohbf
愨	ohbu
麴	ohbw
杸	ohbx
櫏	ohce
匐	ohcm
楅	ohcm
梪	ohei
豋	ohei
檤	ohep
梂	ohff
椯	ohfk
橝	ohfm
毬	ohft
桡	ohfw
楲	ohfx
槅	ohgr
椣	ohgw
殼	ohhb
槢	ohhd
榿	ohhe
壼	ohhf
椷	ohhf
樛	ohhk
櫂	ohhp
栩	ohhx
桽	ohif
㮒	ohif
㭫	ohif
杋	ohii
㲓	ohii
㭂	ohkf
鼡	ohkg
毜	ohkt
梣	ohlw
杣	ohmf
樮	ohmi
檟	ohmm
㭣	ohnm
榈	ohnn
梤	ohnw
枫	ohow
檦	ohpa
標	ohpg
㯹	ohpk
欈	ohpn
槯	ohpr
㰎	ohpv
机	ohqf
栝	ohtf
杽	ohtf
桤	ohub
枞	ohwf
槭	ohwh
㯨	ohwi
㰘	ohwl
㰗	ohws
㭨	ohwv
楆	ohxc
椋	ohyf
椄	ohyf
槚	ohym
橽	oiae
栁	oiav
㰂	oibc
楁	oibn
桹	oicb
槣	oicn
㮫	oicn
櫶	oicu
㭦	oiej
述	oiep
鶐	oier
樃	oieu
榔	oiew
杜	oiff
檳	oifm
椗	oifs
楦	oifu
棱	oigb
榢	oigd
槸	oigi
㰊	oigm
縠	oihb
橙	oihe
繛	oihf
櫈	oihh
䋤	oihi
素	oihk
機	oiid
桂	oiif
术	oiif
朮	oiif
㝳	oiif
椀	oiio
勺	oiiq
栘	oiiq
檵	oiiv
橈	oiiw
㭙	oikf
樎	oikr
桄	oilf
榁	oima
椬	oimm
㭃	oinf
柁	oinq
鸵	oinq
榬	oinx
桝	oioa
榤	oioo
檫	oiop
榴	oipc
棕	oipg
棺	oipm
橮	oipm
橃	oiqb
匇	oiqq
柠	oirf
梾	oisf
枨	oitf
㯽	oitm
櫁	oiub
柪	oiuc
楑	oiug
樒	oiuh
橣	oiul
怷	oiup
怸	oiup
檸	oiur
槟	oivg
栐	oivi
梡	oiwg
榸	oiwm
桞	oiwv
榟	oiwy
桉	oixc
枇	ojaf
樴	ojar
㼞	ojas
棦	ojbb
杯	ojdf
楷	ojdr
槂	ojeh
森	ojff
柸	ojff
柾	ojff
櫄	ojfm
㯊	ojfx
㰅	ojge
樀	ojgx
㝅	ojhb
梐	ojif
杦	ojii
纛	ojkh
棛	ojkm
㯙	ojks
栬	ojkv
觳	ojlb
桦	ojlf
枓	ojlf
槲	ojll
桷	ojlq
檞	ojlu
楴	ojmp
榜	ojmv
栂	ojnf
毒	ojng
桮	ojnm
㝇	ojoj
鹑	ojoq
㯲	ojpg
亸	ojql
杹	ojrf
鶉	ojrr
撉	ojsh
孰	ojsi
塾	ojsi
墪	ojsi
㮎	ojsm
敦	ojst
鐜	ojst
憝	ojsu
䃞	ojsv
䃦	ojsv
熟	ojsx
棅	ojth
李	ojvf
杍	ojvf
檚	ojvs
享	ojvy
㮔	ojwm
郭	ojwv
檐	ojxc
楌	ojxk
嚲	ojxl
㯆	ojxl
桅	ojxo
㝄	ojya
㭥	ojym
栰	okaa
檏	okag
栣	okat
靜	okcb
靚	okdw
杉	okef
枛	okef
毝	oket
寻	okfb
村	okff
櫝	okfm
楩	okfo
㮉	okgs
靓	okgw
椇	okgw
㭑	okgw
䐨	okhb
靗	okil
靛	okis
静	okjb
壸	okjf
靘	okjk
栫	okjv
柎	okkf
㯷	okki
栿	okld
青	okmg
㯛	okmh
樸	okni
桔	oknm
檯	oknm
椺	okno
䴖	okoq
	okoq
彟	okpb
䨼	okpb
㯘	okpl
梻	okqd
欉	okrb
鶄	okrr
橀	oksm
㮢	okub
梽	okup
杷	okvf
檮	okvk
㭖	okwa
郬	okwv
裛	okxq
梳	okyf
靔	okyt
㲙	okyt
靝	okyw
槶	olaf
㰇	olaf
㭚	olaq
椵	olbb
㟚	olbh
枝	olbx
栶	olcd
椌	olcf
棞	olct
枤	oldf
柂	oldv
材	olee
柕	olee
壄	olei
橘	olen
楙	oleo
楺	oleo
㮘	oles
懋	oleu
橶	olfa
欅	olfh
櫸	olfk
檊	olfq
㯖	olfu
㚇	olgb
㮯	olgd
栴	olgf
勻	olgq
楠	olgr
㺉	olhb
枮	olhf
毡	olht
栦	olij
梅	oljn
枿	olld
杵	ollf
橻	olll
柡	ollm
㲑	olmt
䯬	olnl
梒	olnm
柼	olof
梱	olof
㮊	olof
㰒	oloj
櫲	olpa
橨	olpm
杴	olqf
榨	olqt
椱	olrb
㭼	olrm
椢	olsi
栍	oltf
棯	olup
杻	olvf
杚	olvv
凶	olvw
橅	olvx
枔	olwf
兇	olwq
㲐	olwt
杼	olxf
棝	olxf
檲	olxk
榕	olyn
榲	olys
㰄	omaa
桎	omaf
檱	omaf
椡	omaj
櫊	ombn
㮥	omcc
椮	omck
毶	omck
桳	omcl
檑	omcm
稁	omct
䚍	omdw
櫛	omea
櫤	omea
橒	omeg
亳	omej
桠	omff
楡	omff
欄	omfh
檽	omfk
樗	omfs
梭	omgb
豪	omgd
㭅	omgf
䯧	omgn
㷤	omhb
亮	omhq
灵	omib
灳	omiq
亴	omis
椟	omjc
櫩	omjy
㭓	omld
柤	ommf
査	ommf
梖	ommf
椚	ommf
責	ommg
橩	ommh
棪	ommi
毯	ommi
槮	ommk
檆	omml
欑	ommm
櫿	ommn
橯	ommu
櫻	ommx
檛	omne
膏	omnk
枱	omnm
楇	omnm
櫚	omnn
㯪	omnq
樰	omob
㯗	omof
㰏	omon
橁	omor
毫	omot
䢜	ompe
帚	ompm
榷	ompr
㰌	ompr
㯚	ompw
㲮	ompw
欛	omqu
榠	omrb
亭	omrf
榗	omrm
橺	omrm
樦	omry
橍	omsg
㮹	omst
㭠	omtf
毨	omtt
勣	omuc
橌	omuq
毪	omut
桙	omut
櫡	omvf
杁	omwf
枕	omwq
㼉	omwq
㭇	omwq
樓	omxc
楎	omxf
欞	omxh
櫺	omxn
勾	omxq
櫢	omxs
㰉	omyc
梙	onbm
槍	onbn
槵	onbu
槎	oncf
檹	oncn
㐯	oncr
楫	ondf
槇	ondg
檝	ondi
檰	ondp
椸	ondv
皼	onea
壹	onei
㱅	onel
鷧	oner
懿	oneu
㦤	oneu
亄	onev
橫	onfg
䪷	onfm
㮵	ongf
枳	ongw
櫞	onha
嗀	onhb
够	onii
梋	onkm
欨	onlq
杏	onmf
樠	onmm
䵶	onmm
句	onmq
㯞	onnk
梠	onnm
梏	onnm
槿	onno
㰙	onnp
㖜	onnq
椕	onof
鸲	onoq
㲒	onot
枴	onpc
雊	onpr
朼	onqf
匂	onqq
柃	onqx
栺	onrm
鴝	onrr
枵	onsa
桯	onsg
敂	onst
斪	onte
劬	onuc
楪	onvo
㯀	onvs
枻	onvv
枌	onwf
柷	onwq
邭	onwv
榀	onxm
橾	onxo
刹	ooaj
柳	ooav
㮲	oobb
樳	oock
㭵	oocm
枹	oodb
瓟	oodb
㼌	ooee
柧	ooef
杀	oofw
榱	oofx
㮁	oogk
槁	oogn
桸	oogp
榖	oohb
殺	oohb
剎	ooia
弒	ooic
榡	ooih
杓	ooii
瓝	ooii
橔	oojs
椁	oojv
槨	oojw
桪	ookf
棈	ookm
椶	oolb
胷	oolk
匈	oolv
梫	oomb
檺	oomg
棂	oomi
樍	oomm
爼	oomm
楟	oomr
构	oomx
閷	oomy
枸	oonm
榝	ooob
樧	ooob
蠜	ooob
樊	oooc
攀	oooh
欎	oook
欝	oook
鬰	oook
燓	ooom
䫶	ooom
橇	oooo
棥	oooo
榋	oooo
㯔	oooo
㸚	oooo
䄟	ooop
毳	ooot
鐢	ooot
㦌	ooou
礬	ooov
䙪	ooox
㮏	oopg
㭤	ooqf
栒	oorm
毥	oorm
楤	ooru
枰	oosf
匉	oosq
枆	ootf
㲎	oott
枃	ooty
楂	ooum
梈	oouv
弑	oowc
椈	oowi
毱	oowi
匁	oowq
梛	oowv
爻	ooww
桜	ooxc
㯃	ooyl
㭭	opaj
橡	opaq
椼	opas
枊	opav
樥	opbc
槜	opcc
朷	opcf
櫯	opct
栊	opdf
榵	opdf
㰛	opdo
櫹	opdr
櫗	opfi
㯜	opfl
㯼	opfs
楧	opgc
柰	opgf
标	opgf
樺	opgg
楉	opgn
祭	opgq
㯓	ophh
樅	ophs
杒	opii
梕	opiu
欃	opji
椛	opjr
檇	opjv
㯵	opjw
㲉	oplb
榫	oplf
㯴	opln
歀	oplq
柶	opmf
柺	opmf
㭒	opmf
欗	opmh
樻	opmm
㮱	opmt
柖	opnm
㯣	opno
櫒	opop
槆	opor
㯳	opos
㲡	opot
檧	opou
鹱	oppb
檴	oppb
欆	oppb
匒	oppw
榙	oppw
櫵	oppx
欍	oppy
栉	opqv
椎	oprf
㭊	oprf
㮅	oprf
櫓	oprm
氌	oprm
㲝	oprt
橗	opru
桁	opsg
杄	optf
隸	optl
㭶	opvy
㭘	opwf
㭸	opwi
匌	opwq
梚	opwq
欌	opxd
櫣	opxe
楛	opxf
樵	opxo
樜	opxo
權	opxp
欟	opxw
櫙	opxx
欜	opxx
㮑	opyr
杛	oqbf
柫	oqdr
植	oqff
㮖	oqff
㯑	oqff
㭹	oqfi
檖	oqge
杆	oqgf
㰜	oqgm
㭻	oqgn
槙	oqgw
橼	oqha
彀	oqhb
栎	oqhk
橧	oqir
柈	oqkg
梢	oqkm
樋	oqle
桶	oqlm
㮭	oqlr
栏	oqmg
棁	oqnw
档	oqob
楓	oqqf
梯	oqqr
椫	oqrl
柞	oqtf
榒	oqtt
栟	oqxg
橂	oqyc
楢	oqyf
樽	oqyk
刎	oraj
樇	orbk
樤	orbo
槉	orbt
椔	orcm
樶	ordb
䀜	ordm
梿	orep
迿	orep
勿	oreq
槾	orfb
㭮	orfd
朾	orff
㮿	orff
䝆	orgd
鷇	orhb
榻	orhh
㲩	orhh
槝	orhm
匆	orii
榯	orik
榥	oril
桚	oriq
怱	oriu
棍	orja
柛	orjj
㝁	orjv
戦	orla
単	orlf
曶	orlf
㫚	orlf
㯿	orlf
㲱	orlf
甮	orlq
㰬	orlq
杳	ormf
旬	ormq
亯	ormy
柯	ornm
棵	orof
巣	orof
楬	orov
㭿	orpa
桿	orqg
㬟	orqr
棩	orrf
樢	orrf
椙	orrm
樔	orro
橬	orrr
橸	orrr
榅	orsm
㪟	orst
銞	ortw
忽	orup
栧	orve
郇	orwv
㮧	orxo
柱	oryf
朽	osaf
楋	osaj
㯈	osep
梀	osff
枉	osgf
瑴	oshb
櫴	osjm
梇	osld
枠	oslf
樕	oslq
㮛	osmf
㭗	osmf
朹	osqf
勼	osqq
枚	ostf
櫮	osxx
榳	otad
杤	otaf
蜤	otbm
檭	otcb
櫥	otck
㯅	otdl
楣	otdm
㮐	otdm
榶	otdn
皙	otdr
槻	otdw
析	otef
檬	otfg
枎	otgf
榄	otgw
栋	othk
櫠	otib
桩	otif
㭴	otif
柝	otii
梼	otkf
杪	otkf
椨	otkk
棣	otll
栤	otlm
㮞	otln
栨	otlq
榾	otmf
梑	otmi
椞	otof
㮠	otof
晳	otrm
槛	otsm
槦	ottj
槺	ottl
櫍	ottm
櫕	ottm
椩	otty
㭞	otuc
惁	otup
㭽	otvi
梆	otwv
櫎	otxg
㼎	otye
校	otyf
匀	otyq
棴	ouab
皶	ouav
杞	oubf
桾	oubf
朸	oucf
栌	oudb
楗	oudx
毽	oudx
柲	ouee
榓	oues
㭪	ouff
棹	oufm
匍	oufq
橳	oufu
㮳	ougi
株	ougw
榑	oukf
棏	oukf
㯶	oulb
㮇	oulk
樐	oulu
㔪	oulu
櫋	oulv
查	oumf
柦	oumf
楨	oumm
極	ounf
枷	ounm
楊	ouor
鸉	ouor
㼒	ouor
杺	oupf
㣻	oupw
极	ouqf
枂	ouqf
槕	ouro
㭌	outf
㰑	ouuo
梞	ouup
㮩	ouup
棚	ouuq
栛	ouuu
亨	ouvy
橰	ouwl
㮀	ouwl
烹	ouxo
桢	ouym
㭈	ouyw
蚻	ovbm
㯝	ovbn
柘	ovdf
橄	ovds
楮	ovff
乌	ovff
邬	ovfw
梹	ovgw
椴	ovhb
䍍	ovhb
柌	ovhf
堏	ovif
紮	ovih
柢	ovii
榉	ovkg
㔨	ovkm
㭄	ovlf
㭔	ovlf
柙	ovmf
杩	ovnf
桰	ovnm
棎	ovof
㮟	ovof
鬱	ovok
榌	ovpd
杨	ovre
棔	ovrm
楈	ovsk
匋	ovtq
札	ovvf
朰	ovvf
椲	ovvf
㰁	ovvv
㐔	ovvy
枋	ovyf
棜	ovyj
杙	owaf
栻	owcf
㯁	owdn
栱	owff
樄	owfh
㰐	owge
杬	owgf
椭	owgk
橢	owgk
棆	owgp
椒	owhb
糓	owhb
橉	owio
匊	owiq
檜	owir
毩	owit
榆	owka
毺	owka
樲	owlm
橪	owlx
梩	owmf
检	owmo
椧	owna
桛	ownf
検	owny
梌	owof
権	owpr
榊	owrj
鵴	owrr
檍	owup
那	owvb
䢶	owvf
樈	owwq
桃	owwy
檋	owxf
檢	owxh
梓	owyf
樚	owyf
㭢	oxaj
櫪	oxce
櫉	oxck
榧	oxef
橛	oxel
槤	oxep
枯	oxff
厳	oxfs
㮙	oxfs
枅	oxgf
構	oxgi
轂	oxhb
㜌	oxhb
橱	oxhk
栜	oxhk
㮦	oxih
槫	oxik
橞	oxiu
欐	oxiw
柩	oxji
桲	oxjv
梉	oxkf
橵	oxks
柜	oxlb
槈	oxlk
椂	oxll
桭	oxlo
柚	oxmf
楍	oxnm
樞	oxnx
杰	oxof
枙	oxon
枢	oxow
櫃	oxpm
櫔	oxpn
表	oxqg
哀	oxqy
樿	oxrl
棤	oxrm
椻	oxrx
梬	oxsa
框	oxsg
枥	oxuc
楜	oxuq
㭱	oxvm
㯍	oxwk
橭	oxwy
横	oxxg
㮜	oxxk
欕	oxxs
杧	oxyf
匄	oxyq
柄	oxyw
杶	oyaf
㮆	oyai
檓	oycb
㰕	oyci
榛	oyct
桧	oyeg
梄	oyff
檎	oyfm
楄	oygp
㮼	oyhh
樣	oyii
橓	oyio
㮴	oyjb
榭	oykf
棒	oykg
厀	oyla
㓼	oyla
棙	oyld
㯡	oyld
桼	oyll
様	oyll
樯	oyln
䣛	oylw
责	oymg
樌	oymm
槴	oynk
匔	oynn
枪	oyon
枦	oypf
匑	oyqb
桕	oyrf
椿	oyrm
櫅	oyrr
栓	oysg
檨	oytl
楱	oyug
櫦	oyvb
匃	oyvv
椖	oyvy
朲	oywf
勽	oywq
棿	oywq
檥	oywt
槱	oyxo
榚	oyxo
樁	oyyr
楰	oyyw
樱	oyyx
帴	paaa
牋	paaa
菚	paaa
㣤	paaa
䱠	paaa
䰹	paaq
彼	pace
帔	pacm
莛	padx
䱓	padx
鱔	paen
迎	paep
萁	paff
帺	pafm
鯕	pafq
茙	pagd
㣝	pagd
徉	paie
藄	paih
鮮	paiq
别	pajm
別	pajm
魝	pajq
㓣	pajw
䱛	panf
鯃	panm
䓊	panm
衙	pans
象	paqq
䴂	parr
衍	pasg
荍	past
蔜	past
愆	pasu
䔮	pate
䲉	pate
鯋	patk
勨	pauc
蘛	pavk
卬	pavq
鮍	pavq
葚	pavv
㿯	pavw
剫	pbaj
鯦	pban
䓘	pban
櫜	pbao
虄	pbbl
庹	pbby
蓬	pbce
㡝	pbce
莑	pbcg
幡	pbcm
蕃	pbcm
鱕	pbcm
蒝	pbdf
苇	pbgf
帏	pbgm
幥	pbht
鰠	pbib
芆	pbii
魷	pbii
荩	pbjo
苳	pbjo
鮗	pbjo
㠽	pbjo
蟗	pblb
䔴	pblb
茁	pblv
茧	pbmf
萒	pbmw
蓘	pbmx
茖	pbnm
鮥	pbnm
䓡	pbnm
鱨	pbnr
蔉	pbnx
薙	pbpr
䒘	pbqf
䒨	pbtf
㣰	pbup
隻	pbxr
藎	pbxs
度	pbxy
䧶	pbyr
莉	pcaj
鯏	pcaj
䔧	pcao
䔣	pcau
很	pcbe
茛	pcbf
萾	pcbs
版	pcbx
魬	pcbx
蘐	pccb
莠	pccc
藟	pccc
艿	pccf
虆	pcch
䕛	pcch
㡗	pcch
蘲	pcci
䕝	pcci
蔧	pcco
蘽	pcco
隽	pccr
蘆	pccs
鱸	pccs
䔉	pcct
藘	pccu
㡥	pccu
䲐	pccu
㡪	pcdb
㣕	pcde
芖	pcdf
薭	pcdl
蘒	pcem
荙	pcep
葨	pcfo
鰃	pcfo
魟	pcfq
荂	pcfs
鮬	pcfs
㡁	pcfs
蘧	pcge
䒠	pcgf
䰷	pcgq
蔎	pchb
茩	pchf
鮜	pchf
茿	pchi
蘈	pchm
萀	pchq
鯱	pchq
莁	pchw
莢	pchw
㣣	pchw
蒆	pchx
薐	pcib
徯	pcic
蒵	pcic
蔂	pcih
䔟	pcii
萪	pcjl
莩	pcjv
鯚	pcjv
䱆	pcjv
䱐	pcjv
萲	pckb
鰀	pckb
㣪	pckb
鱋	pckj
薣	pclb
循	pcld
㡒	pcld
莾	pcll
䔓	pcll
苗	pcmf
萩	pcmi
鰍	pcmi
幊	pcmm
蒩	pcmm
蔖	pcmm
䔈	pcmm
畣	pcmw
蒐	pcmx
䖂	pcnh
萂	pcnm
鱚	pcnm
莻	pcnn
虊	pcno
蒑	pcob
菞	pcoe
菜	pcof
藜	pcol
蔾	pcoo
䔪	pcoo
鹋	pcoq
䕶	pcpb
葜	pcpc
䱮	pcpc
萘	pcpg
䱞	pcpg
蘓	pcpq
讎	pcpr
䕌	pcpr
䕴	pcpx
蕱	pcqk
蕛	pcqr
薍	pcqv
蔿	pcqx
萫	pcrm
徛	pcrn
䓫	pcrn
鶓	pcrr
菴	pcrv
藒	pcrv
藹	pcrv
㡋	pcrv
萟	pcsi
䒩	pctf
穌	pctq
䓽	pcub
莮	pcuc
䕒	pcun
葸	pcup
鰓	pcup
㢜	pcup
鰬	pcuy
藷	pcvf
蘨	pcvh
徭	pcvt
鰩	pcvt
䔄	pcvt
䔬	pcwf
荽	pcxc
萎	pcxc
鮾	pcxc
鯘	pcxc
㣦	pcxc
蘶	pcxm
䓐	pcya
詟	pcyd
䓂	pcyf
藊	pcyp
幍	pcyr
蓞	pcyr
藙	pdab
藂	pdbi
鰹	pdbi
䓛	pdbl
藖	pdbm
菆	pdbx
菣	pdbx
鯫	pdbx
繤	pdch
䔌	pdcl
蘤	pdcx
藠	pddd
徠	pdde
萊	pddf
萧	pddg
忂	pddp
鯠	pddq
䱖	pddq
衢	pdds
藐	pddw
藽	pddw
䕫	pdeb
萆	pdel
牌	pdel
㗗	pdel
䱝	pdel
聋	pdfd
徒	pdfe
茸	pdff
茞	pdff
幛	pdfm
蔁	pdfm
鱆	pdfm
鯐	pdfq
䔤	pdfr
黴	pdfs
䔜	pdgi
䕎	pdhc
䱼	pdhf
微	pdhs
蒌	pdif
蒋	pdik
藥	pdio
鱳	pdio
徽	pdis
䘗	pdis
藈	pdiu
蘵	pdjr
徿	pdka
蘢	pdka
龕	pdka
荘	pdkf
葩	pdkv
萛	pdld
葲	pdlm
鰁	pdlm
徲	pdlu
幄	pdma
苜	pdmf
蔕	pdmp
菩	pdnm
苨	pdnq
㣲	pdns
蔀	pdnw
薡	pdob
菂	pdoi
蒟	pdon
荱	pdot
㲨	pdot
蔚	pdpk
䲁	pdpk
幑	pdps
鰴	pdps
藯	pdpu
蔸	pdpw
㣯	pdqk
幈	pdqx
苩	pdrf
帕	pdrm
鮊	pdrq
蕭	pdrr
鱐	pdrr
徨	pdsg
葟	pdsg
鰉	pdsg
㠞	pdsh
徵	pdss
薮	pdst
懲	pdsu
薪	pdte
彵	pdve
徼	pdvs
薂	pdvs
鮿	pdvv
㡇	pdvv
萈	pdwi
蔝	pdwi
幢	pdwm
徸	pdwm
蕫	pdwm
薶	pdwm
薬	pdwo
莧	pdwq
覑	pdwq
苙	pdyf
莭	peav
鯽	peav
蒴	pebu
莚	peed
鯅	peed
蕋	peee
蘃	peeo
㔈	pefa
苷	peff
韮	peff
徘	pefh
菲	pefh
鯡	pefh
幙	pefm
䕁	pefo
㰆	pefo
魽	pefq
蕜	pefu
薁	pegc
芸	pegf
鱧	pehe
芷	pehf
薉	peho
鱥	peho
㠶	pehq
鯀	peih
鰦	peii
魠	peja
蒹	pejg
鰜	pejg
㡘	pejg
葥	peka
㡐	peka
帲	pekq
䲕	pekr
蓖	pelj
㡙	pelj
幒	pelu
牕	pelu
蔥	pelu
䒼	pemf
䔝	penh
莵	peni
萭	penn
䓱	peno
茈	penq
徏	peok
荹	peok
蘋	peom
辺	pepc
孽	pepj
蘖	pepo
蒒	pepp
蘬	pepp
鰤	pepp
㔑	pepp
雠	pepr
進	pepr
躠	peps
迁	pept
薛	pepw
糵	pepw
䢔	pepw
㜸	pepx
蔇	pera
蔼	perv
徙	pesh
従	pesh
䒸	pesm
帙	petg
苵	petg
䱃	petg
蕽	pexo
䒦	pexp
荄	peyw
徚	pfah
萰	pfah
鰊	pfah
藓	pfai
蓟	pfaj
茢	pfaj
鰥	pfak
印	pfav
芜	pfbd
藅	pfca
薑	pfcf
䲔	pfcf
虁	pfdb
萋	pfdx
薤	pfef
蓸	pfer
鰽	pfer
㡟	pfer
萇	pfff
䔍	pfff
䒧	pfff
帳	pffm
魼	pffq
鰢	pffq
䱍	pffq
薾	pfgm
蕹	pfgp
蒰	pfhb
蔑	pfhi
蕐	pfhk
萃	pfhl
䱣	pfhl
魱	pfhn
䕹	pfhp
苀	pfhq
魧	pfhq
䘕	pfhs
鱞	pfhx
蓄	pfic
䔞	pfil
鮌	pfin
萝	pfiq
䕉	pfir
衒	pfis
䓴	pfkc
荋	pfkm
鮞	pfkm
䕸	pfkn
芋	pflf
薔	pfln
鱣	pflu
䕊	pflu
㣶	pflu
薎	pfma
蘉	pfmb
瞢	pfmd
草	pfmf
夢	pfmi
甍	pfmj
䒐	pfmk
幁	pfmm
蕒	pfmm
頜	pfmm
顀	pfmm
顭	pfmm
䓣	pfmm
䪳	pfmm
薨	pfmn
藣	pfmn
虈	pfmn
䠢	pfms
鄸	pfmw
薞	pfnc
塟	pfni
葬	pfnl
蘿	pfnp
薥	pfob
茉	pfof
帓	pfof
䱅	pfof
蓠	pfom
菤	pfon
䱧	pfon
蘺	pfop
芾	pfpm
魳	pfpm
䒥	pfpm
䰽	pfpm
荑	pfqy
鮧	pfqy
蘷	pfrb
徑	pfrc
莖	pfrc
菄	pfrh
鯟	pfrh
帞	pfrm
莄	pfro
鯁	pfro
葝	pfru
芌	pfsa
蓋	pfsm
鰪	pfsm
徢	pfts
萐	pfts
荁	pfum
䱎	pfum
薚	pfur
薯	pfvf
鱰	pfvf
蘗	pfwo
薜	pfwy
蘮	pfxa
䕍	pfxn
袭	pfxq
䒾	pfxq
蘘	pfxx
忀	pfxx
颌	pfym
衡	pfys
茇	pgbi
帗	pgbi
鮁	pgbi
苃	pgbx
英	pgcd
䱀	pgcd
鰖	pgck
㲟	pgco
鶧	pgcr
䣐	pgcw
䚆	pgcw
帽	pgdm
萺	pgdm
荞	pgdr
芗	pgee
蓫	pgep
鱁	pgep
䔨	pgep
薌	pgew
鱜	pgew
菵	pgex
䱩	pgex
徆	pgfe
茜	pgff
䱭	pgff
䱴	pgfu
蘹	pgfx
䒟	pgfy
華	pggf
䕥	pggm
茼	pghf
鮦	pghf
㣚	pghf
衕	pghs
苒	pgif
徟	pgin
鯛	pgin
䓟	pgin
繭	pgjb
䓔	pgjv
鮪	pgkm
䒴	pgkm
㡌	pgkm
䒣	pglg
蕤	pglt
蓊	pgmh
䱵	pgmh
䓗	pgmu
㣞	pgmw
彸	pgmx
䰸	pgmx
蠚	pgnb
逽	pgne
苘	pgnm
若	pgnm
蕎	pgnn
鱎	pgnn
䖃	pgnn
荖	pgnq
鮱	pgnq
蓍	pgnr
鰭	pgnr
惹	pgnu
鄀	pgnw
刅	pgoc
㯻	pgof
䒽	pgoo
鷨	pgrr
鮳	pgsa
荚	pgsf
芺	pgtf
菙	pgtf
藸	pgvf
䒔	pgwf
苋	pgwq
嚢	pgxx
萞	pgyj
芮	pgyw
魶	pgyw
芽	phaf
㡨	phaf
蒃	phaq
䱲	phaq
垼	phbi
䱟	phbq
芟	phbx
役	phbx
蘴	phce
幅	phcm
葍	phcm
鰏	phcm
徾	phcs
茂	phdf
蔵	phdf
荳	phei
䱏	phei
䕱	phem
莍	phff
蕈	phfm
鱏	phfm
鯄	phfq
荛	phfw
葳	phfx
鰄	phfx
蒚	phgr
虉	phgr
䓦	phgw
㪧	phhb
鰼	phhd
䔇	phhe
䱺	phhe
葴	phhf
鰔	phhf
㽂	phhj
蓼	phhk
歙	phhl
䕜	phhl
藋	phhp
䔢	phhs
搻	phht
鱤	phhu
翕	phhx
翖	phhx
鮙	phhx
蓌	phib
遳	phie
莝	phif
䓰	phif
芃	phii
帆	phii
荗	phii
薽	phij
䒕	phkf
蒧	phlh
蕆	phmm
䔁	phof
䒳	phof
菫	phog
幖	phpg
蔈	phpg
徱	phpg
鰾	phpg
䕯	phpo
蔺	phpr
蕥	phpr
芁	phqf
聳	phsd
䢨	phse
衜	phsg
從	phsh
㼻	phsj
熧	phsm
䳷	phsr
徴	phss
慫	phsu
㹐	phsu
䒷	phtf
拿	phtw
㧱	phtw
䒻	phub
荿	phvv
鯎	phvv
苁	phwf
䓉	phwv
庻	phwy
葽	phxc
菨	phyf
蒇	phym
帹	phym
鯜	phyq
鯨	phyq
薘	piae
㣵	piae
䵈	pibj
後	pibq
莨	picb
藔	pich
幰	picu
藼	picu
䓇	pidg
蓢	pieu
蓈	piew
䱶	piew
垄	pifd
苎	piff
芏	piff
丒	piff
蔩	pifg
荢	pifl
薲	pifm
㡦	pifm
萣	pifs
萱	pifu
鰚	pifu
蘾	pifx
菱	pigb
鯪	pigb
幏	pigd
藝	pige
蓺	pigi
鯥	pigi
䕭	pigm
爇	pigx
䔰	pihc
䔲	pihe
㡠	pihe
䒺	pihk
刃	piic
刄	piic
徍	piif
茥	piif
鮭	piif
孶	piij
葑	piik
茲	piin
菀	piio
帵	piio
茤	piiq
㡅	piiq
街	piis
徺	piiw
蕘	piiw
鱙	piiw
茡	pijv
待	pikf
䓁	pikf
蓿	pikr
㣧	pikv
茪	pilf
莰	pilq
鰘	pima
萓	pimm
蕵	pinc
薳	pine
苄	pinf
茗	pinm
鮀	pinq
荈	pioa
苑	pion
䕓	piop
荺	piot
葾	piou
藰	pipa
蒥	pipc
鰡	pipc
歰	pipe
徖	pipg
萗	pipg
鯮	pipg
菅	pipm
蕟	piqb
鱍	piqb
芕	piqf
蒍	piqx
蕔	pirb
苧	pirf
蓻	piri
䕮	pirw
徕	pise
莱	pisf
苌	pitf
帐	pitm
䕋	pitn
藌	piub
苭	piuc
䱂	piuc
葵	piug
蔤	piuh
䔭	piul
忍	piup
薴	piur
㣷	piur
菪	pivd
䒛	pivv
蔻	piwb
莞	piwg
鯇	piwg
蔲	piws
茒	piwv
䔂	piwy
荌	pixc
鮟	pixc
藛	piyx
芘	pjaf
㼙	pjam
魮	pjaq
㲋	pjaq
幟	pjar
䱢	pjbb
㣠	pjbj
㚟	pjcd
芣	pjdf
蒈	pjdr
䕖	pjee
蓀	pjeh
征	pjfe
㣩	pjfe
苤	pjff
菻	pjff
魾	pjff
薰	pjfm
蘍	pjfu
蔫	pjfx
藑	pjgb
藡	pjge
蔏	pjgn
蔐	pjgx
荪	pjhk
徰	pjjf
徹	pjks
勶	pjku
葪	pjla
荜	pjlf
蔛	pjll
䚘	pjls
薢	pjlu
䲒	pjlu
萯	pjmm
蒂	pjmp
䱱	pjmp
蒡	pjmv
徬	pjmv
牓	pjmv
鰟	pjmv
苺	pjnf
䓏	pjnm
蒊	pjnn
菰	pjoe
劖	pjpa
彻	pjpc
苆	pjpc
毚	pjpi
酁	pjpw
花	pjrf
魤	pjrq
衔	pjsg
鯭	pjsm
䓝	pjsm
惩	pjup
芓	pjvf
䰵	pjvq
芤	pjvv
雋	pjvv
董	pjwm
㣫	pjwm
㡖	pjwm
䱰	pjwm
茺	pjwq
衝	pjws
薫	pjwx
幨	pjxc
薝	pjxc
鮠	pjxo
萏	pjyr
㡊	pjyr
䱤	pjyr
茷	pkaa
㡤	pkag
㸣	pkag
㣸	pkal
荏	pkat
茽	pkbm
㣡	pkbm
芿	pkcc
茎	pkcf
径	pkcf
㗡	pkcn
䔀	pkcx
蓓	pkdn
莅	pkdy
牘	pkfm
蕦	pkfm
藚	pkfm
䄣	pkfm
鯾	pkfo
苿	pkgw
鮇	pkgw
苮	pkhm
茬	pkif
㣥	pkik
荐	pkjv
茌	pkkf
苻	pkkf
鮒	pkkf
茯	pkld
鮲	pkld
芢	pklg
葰	pkmb
幞	pkni
薹	pknm
鮚	pknm
䓀	pknm
㣟	pknm
葆	pkno
䕵	pknr
藵	pknx
葠	pkob
茠	pkof
鮴	pkof
蒨	pkok
䕀	pkpl
䲌	pkpl
莋	pkqt
䓲	pkqw
䕺	pkrb
荷	pkrn
虌	pksm
蔽	pkst
徶	pkst
帿	pkub
葔	pkub
鯸	pkub
䕦	pkui
䓌	pkup
芭	pkvf
幬	pkvk
薵	pkvk
䲖	pkvk
帊	pkvm
䰾	pkvq
鮘	pkwa
䒫	pkwa
薱	pkyk
鯍	pkyq
毈	plab
幗	plaf
蔮	plaf
卵	plai
孵	plaj
贕	plam
䕙	plap
㤻	plau
葭	plbb
徦	plbb
鰕	plbb
蕸	plbe
芰	plbx
茵	plcd
菌	plct
蒽	plcu
䰿	pldv
弇	pldw
茅	plee
鱊	plen
葇	pleo
鰇	pleo
鶜	pler
䓮	ples
蓩	pleu
藇	plfg
鱮	plfg
蕷	plfm
蔨	plfo
隼	plfr
德	plfu
徳	plfu
蓣	plfy
莔	plgg
䕟	plgg
虋	plgn
萳	plgr
㣮	plgr
苫	plhf
帖	plhm
鮎	plhq
㡧	plie
薗	plix
蘩	pljh
莓	pljn
䱕	pljn
䲄	pljs
葖	plld
莽	plld
䒎	pllk
䔸	plll
茴	plnm
徊	plnm
莟	plnm
鮰	plnm
茓	plof
幩	plpm
蕡	plpm
鱝	plpm
芡	plqf
苚	plqf
㸝	plqr
欱	plqw
復	plrb
鰒	plrb
䓠	plrm
鶽	plrr
帼	plsi
徃	plte
苼	pltf
鮏	pltq
䓖	pluc
	pluc
菍	plup
鯰	plup
㥈	plup
䒗	plvv
䰴	plvv
幠	plvx
蕪	plvx
㣳	plvx
芩	plwf
䰼	plwq
芧	plxf
鯝	plxf
䓢	plxf
燞	plxo
魣	plxq
蓉	plyn
鰫	plyn
藭	plyq
蒕	plys
鰮	plys
苬	plyw
鮂	plyw
荎	pmaf
鱡	pmag
菿	pmaj
萴	pmaj
鰂	pmaj
䕰	pmbc
蕿	pmcb
鯵	pmck
㡎	pmck
蕾	pmcm
鱩	pmcm
幯	pmea
䲙	pmea
蕓	pmeg
遺	pmep
幱	pmfh
蘭	pmfh
薷	pmfk
鱬	pmfk
薠	pmfm
䫭	pmfm
荾	pmgb
鮻	pmgb
鱵	pmhh
䕞	pmic
苂	pmif
䲘	pmip
牍	pmjc
䒪	pmld
徂	pmme
苴	pmmf
菛	pmmf
䝴	pmmf
菼	pmmi
幓	pmmk
蔘	pmmk
鰺	pmmk
藀	pmmm
貴	pmmm
鱦	pmmq
䱉	pmmq
䲏	pmmu
蘡	pmmx
薖	pmne
䕂	pmne
苔	pmnm
萵	pmnm
蔄	pmnm
鮐	pmnm
䕡	pmnn
葈	pmno
蕶	pmnq
鱈	pmob
䔵	pmof
䓎	pmoi
藿	pmpr
蒮	pmpr
藺	pmpr
幎	pmrb
蕳	pmrm
蔊	pmrq
莇	pmuc
蘎	pmuk
蕄	pmup
蕑	pmuq
虂	pmvn
帎	pmwq
魞	pmwq
魫	pmwq
蔅	pmxc
蔞	pmxc
㡞	pmxc
䱾	pmxc
鯶	pmxf
㡓	pmxf
䖅	pmxh
蘦	pmxn
藪	pmxs
刟	pnaj
卲	pnav
蘕	pnbe
蔠	pnbj
蒼	pnbn
䱽	pnbn
薿	pnbs
蔟	pnbt
藧	pncb
䓹	pncb
葒	pncf
蒫	pncf
䱹	pncf
蘔	pncm
䕑	pncx
巶	pndb
葺	pndf
㣬	pndf
蕺	pndi
葹	pndv
䙼	pndw
迢	pnep
芐	pnff
帜	pngw
莴	pngy
蒳	pngy
䎄	pnhh
鱶	pnic
蕬	pnih
蕝	pnjk
葤	pnkf
菋	pnkg
䓃	pnkv
䱒	pnkv
欩	pnlq
蘊	pnls
鱃	pnlv
荶	pnlw
召	pnmc
蒷	pnmm
售	pnmr
䔏	pnne
莒	pnnm
鯌	pnnm
蓳	pnno
䕼	pnnp
䕿	pnnr
蒶	pnnw
䖄	pnnx
棻	pnof
廑	pnog
葯	pnoi
蘏	pnpm
蓶	pnpr
䕘	pnqm
㠲	pnqm
衑	pnqs
苓	pnqx
彾	pnqx
魿	pnqx
蘰	pnrb
鮨	pnrm
㸟	pnrm
䳂	pnrr
藴	pnrs
徎	pnsg
莡	pnsh
葐	pnsm
䔋	pntk
劭	pnuc
茣	pnug
牒	pnvo
幉	pnvo
葉	pnvo
鰈	pnvo
蔙	pnvs
䲂	pnvs
㐒	pnvv
芬	pnwf
綤	pnwh
帉	pnwm
魵	pnwq
邵	pnwv
䓵	pnxm
幧	pnxo
鱢	pnxo
蕚	pnxs
蒓	pnya
苅	poaj
茆	poav
蒭	pobb
䕩	poch
蕁	pock
鱘	pock
䓒	pocm
苞	podb
鮑	podb
苽	poef
䱄	poeq
苯	poff
㭉	poff
䱁	poff
集	pofr
蓑	pofx
藳	pogc
藃	pogl
菘	pogm
蒿	pogn
鰝	pogn
藁	pogo
莃	pogp
鯑	pogp
蔔	pohc
蒁	poie
荰	poif
芍	poii
彴	poii
蓕	poii
魡	poii
術	pois
䘘	pois
䓯	pojn
䔻	pojs
鯙	pojv
荨	pokf
菁	pokm
鯖	pokm
葼	polb
鯼	polb
䓩	polb
㣭	polb
䔦	polj
鮼	pomb
幘	pomm
蔶	pomm
鰿	pomm
㣱	pomm
薧	pomn
菷	pomp
鯞	pomp
葶	pomr
萙	pomw
芶	pomx
蟼	ponb
警	ponc
驚	ponf
擎	ponh
㢣	ponl
苟	ponm
莕	ponm
鮈	ponm
㣘	ponm
檠	pono
敬	pons
憼	ponu
䓭	pooa
蔱	poob
蓏	pooe
䒝	poow
蔡	popg
鰶	popg
㡜	popg
藮	popx
茑	poqf
䔠	poqk
鸽	poqw
芴	pore
魩	pore
茐	pori
徇	porm
荀	porm
㡄	porm
樖	porn
鴱	porr
葱	poru
牎	poru
䓤	poru
苹	posf
鮃	posq
菥	pote
芼	potf
魹	potq
㲏	potr
葡	pouf
䖇	povk
萄	povt
䕆	powa
艾	powf
菊	powi
䱡	powi
䱪	poxq
藲	poxx
帻	poym
蘚	ppai
剳	ppaj
莂	ppaj
薊	ppaj
鱌	ppaq
葕	ppas
䒢	ppav
劐	ppba
䨇	ppbb
芛	ppbf
蒦	ppbx
雙	ppbx
䓳	ppcb
芀	ppcf
魛	ppcq
蘇	ppct
讐	ppcy
茏	ppdf
蓗	ppdf
薇	ppds
藢	ppds
龛	ppdw
遣	ppep
蓰	ppes
茚	ppfa
鮣	ppfa
䲛	ppfd
幭	ppfi
鱴	ppfi
蘅	ppfs
㡕	ppgc
䒬	ppgf
祘	ppgg
鰙	ppgn
䱈	ppgq
䓈	pphb
蓯	pphs
䔼	ppie
㠴	ppii
荵	ppiu
㸥	ppji
蕧	pplb
葊	ppld
萜	pplh
芇	ppmf
苢	ppmf
㸈	ppmi
蕢	ppmm
䓚	ppmm
席	ppmy
苕	ppnm
牊	ppnm
鮉	ppnm
鱯	pppb
刕	pppc
蒜	pppg
脋	pppk
蓆	pppm
雧	pppo
茘	pppp
䲜	pppp
鱻	pppq
雥	pppr
雦	pppr
䨊	pppr
䔡	ppqf
䲆	ppqq
萑	pprf
帷	pprm
魸	pprq
䱦	pprq
雔	pprr
㸞	pprr
䧻	pprw
荇	ppsg
芊	pptf
䕔	ppts
䲗	ppts
葎	ppub
犨	pput
䓙	ppvh
蓹	ppwa
㣛	ppwe
荅	ppwf
菟	ppwi
帢	ppwm
蒣	ppwo
蘌	ppwp
莬	ppwq
鮯	ppwq
鮸	ppwq
㡈	ppwq
葂	ppwu
蔗	ppxo
蕉	ppxo
徔	ppxp
鱹	ppxp
㡛	ppxp
蒉	ppym
牐	ppyr
舊	ppyr
芎	pqbf
荭	pqcf
葞	pqdf
茀	pqdr
彿	pqdr
鮄	pqdr
徝	pqfe
䕬	pqff
㡉	pqfi
䕳	pqfm
芉	pqgf
徜	pqgn
衠	pqgs
蒖	pqgw
鱛	pqir
䒡	pqjj
萷	pqka
荮	pqkf
牉	pqkg
帩	pqkm
莦	pqkm
鮹	pqkm
蓪	pqle
鯒	pqlm
䓿	pqlr
苰	pqmx
蔃	pqnb
帨	pqnw
莌	pqnw
鮵	pqnw
药	pqoi
蘜	pqow
虇	pqpp
葻	pqqf
鮷	pqqr
㣢	pqqr
苐	pqrk
蕴	pqrs
蕲	pqrt
衎	pqsg
苲	pqtf
鮓	pqtq
蒻	pqtt
鰯	pqtt
鰳	pquc
憄	pqup
节	pqvf
荓	pqxg
帡	pqxg
鮩	pqxg
莼	pqya
鰌	pqyf
鱒	pqyk
䔿	pqyk
蓚	prbk
蓨	prbk
忁	prbl
蓧	prbo
鰷	prbo
蒺	prbt
菑	prcm
藱	prcm
鯔	prcm
蕞	prdb
莲	prep
蔓	prfb
幔	prfb
鰻	prfb
葘	prfc
㣔	prfe
艼	prff
蓽	prff
帄	prfm
䰳	prfq
衟	prfs
㡢	prft
蠆	prgb
䘍	prgb
邁	prge
䒹	prgf
萬	prgn
鰅	prgn
躉	prgs
勱	prgu
䖁	prgu
鰨	prhh
藆	prht
幜	prhy
蒔	prik
鰣	prik
幌	pril
菎	prja
鯤	prja
莳	prkf
鱲	prlf
鯹	prlt
䒤	prmf
魯	prmq
苛	prnm
魺	prnm
䔅	prnn
菒	prof
菓	prof
鯣	pror
䓪	pror
葛	prov
幆	prov
茰	prow
䓍	prqg
葃	prqt
鳭	prrc
蔦	prrf
菖	prrm
鯧	prrm
藕	prrn
䲃	prro
鷠	prrq
蕌	prrr
䳡	prrr
鴿	prrw
鵆	prsg
蒀	prsm
鰛	prsm
莜	prst
䱔	prst
萌	pruq
䒶	prve
鱪	prvf
鰞	prxo
藉	prxr
往	prye
䒓	psaf
鯻	psaj
䓶	psaj
萚	psbk
菈	psdy
䔎	psep
䲇	psep
蘀	psfr
蓵	psfs
䶭	psgd
行	psge
彺	psge
菝	psgi
葀	psht
芄	psii
藾	psjm
䲚	psjm
藗	psle
蔌	pslq
徥	psme
鯷	psmq
盒	psmw
䔱	psnd
菢	psod
鸻	psoq
萔	pspn
蓷	pspr
艽	psqf
䔊	psqx
鴴	psrr
䔾	psrv
䔷	pssl
䔶	pssm
䔩	psst
䓆	pste
䱑	pste
荴	pstg
莏	pstk
䰻	pstq
㪉	pstw
蒱	psuf
菗	psxm
蘁	psxx
鱷	psxx
莸	ptbi
幮	ptck
䕇	ptcm
蓭	ptcv
葿	ptdm
蓎	ptdn
䲅	ptdw
芹	ptef
薕	pteg
㠼	ptem
菦	ptep
䰺	pteq
葙	ptff
幪	ptfg
䔛	ptfm
䕲	ptfp
芙	ptgf
㠸	ptgm
蓙	pthi
蓤	ptib
䕠	ptib
苠	ptja
蘼	ptjf
蔴	ptjf
䲈	ptjf
藦	ptjh
䕷	ptjh
蘑	ptjv
帱	ptkf
䓓	ptkf
䒚	ptkf
㠺	ptkm
魦	ptkq
㣹	ptku
获	ptld
薋	ptlm
茨	ptlq
莥	ptlv
蓇	ptmf
荻	ptmi
䱻	ptmq
䔙	ptoi
蕕	ptqy
銜	ptsg
蓝	ptsm
䓄	ptte
牗	pttj
鱅	pttj
鱇	pttl
䲋	pttr
菮	ptty
䕧	ptty
蕏	ptvf
菧	ptvi
鯳	ptvi
䔥	ptwd
菳	ptwf
䔆	ptwm
茭	ptyf
鮫	ptyq
菔	puab
律	pube
莙	pubf
芑	pubf
茟	pubf
魢	pubq
鮶	pubq
敆	pubx
艻	pucf
㔓	puct
䕗	pucu
荠	pudr
徤	pudx
鰎	pudx
苾	puee
鮅	puee
莆	puff
茝	puff
虅	puff
䕨	pufh
藤	pufl
䓬	pufm
鯆	pufq
䱌	pufq
蕂	pufu
䶮	pugd
	pugd
苏	pugo
茱	pugw
鮢	pugw
㸡	pugw
䒱	puif
䕄	puis
薒	puiw
蒸	puix
得	pukf
牔	pukf
蒪	pukf
䒭	pukf
萉	pukv
菾	pulk
蓾	pulu
幀	pumm
䱇	pumq
䓧	punf
茄	punm
葋	puon
鰑	puor
芯	pupf
忎	pupt
彶	puqe
芨	puqf
㠷	puqm
魥	puqq
葄	puqt
萕	purr
䒜	putf
蒯	puua
荕	puuc
䔕	puuf
蘂	puuo
蒠	puup
萠	puuq
荔	puuu
蕊	puuu
菡	puwl
蔒	puxo
芠	puyf
帧	puym
魰	puyq
芵	puyw
蠹	pvbb
蕗	pvbn
砻	pvdd
鮖	pvdq
䲎	pvds
鯴	pveb
䔫	pveh
蔬	pvek
䕽	pvfb
著	pvff
䒒	pvff
帾	pvfm
鯺	pvfq
葮	pvhb
苝	pvhf
乖	pvht
茋	pvii
彽	pvii
苡	pviy
荬	pvjc
苸	pvlf
䒖	pvlf
埀	pvlg
䔘	pvmm
魻	pvmq
讏	pvnc
䕢	pvnc
衞	pvns
躛	pvns
䘙	pvns
橐	pvof
㯱	pvof
芪	pvqf
茊	pvrf
讆	pvsc
衛	pvsg
䘖	pvsg
䱬	pvsk
躗	pvss
㦣	pvsu
㪓	pvub
㔞	pvuc
蒛	pvuy
徫	pvve
艺	pvvf
葦	pvvf
礼	pvvg
幃	pvvm
䰲	pvvq
藞	pvvv
彷	pvye
芳	pvyf
菸	pvyj
鯲	pvyj
魴	pvyq
芅	pwaf
䔗	pwai
蕯	pwbl
蘟	pwcu
䔒	pwdn
御	pwea
禦	pwep
蒾	pwep
䓕	pwep
衘	pwes
龚	pwfd
蔯	pwfh
䱋	pwfq
芫	pwgf
䔺	pwgk
䲊	pwgk
菕	pwgp
鯩	pwgp
魭	pwgq
菽	pwhb
䱙	pwhb
䕐	pwhc
䒙	pwhf
茮	pwhk
鮛	pwhk
䔖	pwib
逸	pwie
薼	pwif
兔	pwii
鱗	pwio
䱊	pwiq
徻	pwir
薈	pwir
鱠	pwir
鵵	pwir
薩	pwjl
萨	pwjx
牏	pwka
萮	pwka
㡏	pwka
蔭	pwle
蘱	pwlm
䔳	pwlx
荲	pwmf
䔃	pwmm
莶	pwmo
鯉	pwmq
蔹	pwms
荼	pwof
徐	pwof
鮽	pwof
䔑	pwol
鷋	pwor
鯯	pwpa
藬	pwpm
䔹	pwqg
免	pwqq
鰰	pwrj
衏	pwsg
衖	pwsg
莪	pwtf
勉	pwuc
薏	pwup
荫	pwuq
郃	pwvw
蘪	pwwi
蒢	pwwo
䔔	pwwq
鮡	pwwy
㸠	pwwy
薟	pwxh
䲓	pwxh
蘝	pwxl
藨	pwxo
蘥	pwxp
蘞	pwxs
莘	pwyf
萻	pwyf
蔍	pwyf
䕃	pwyx
劁	pxaj
荆	pxaj
荊	pxaj
㣜	pxaj
蘙	pxbh
䓼	pxbi
䗪	pxbm
藶	pxce
藏	pxdf
䒲	pxej
蕨	pxel
鱖	pxel
㸢	pxel
遮	pxep
蓮	pxep
鰱	pxep
苦	pxff
莗	pxff
顦	pxfm
蘠	pxfn
鮕	pxfq
萼	pxfs
鰐	pxfs
䖀	pxfx
茾	pxgf
㡚	pxgi
莿	pxha
䱨	pxha
蕀	pxhh
茦	pxhk
㡡	pxhk
蓛	pxhs
颟	pxhy
蓴	pxik
鱄	pxik
蕙	pxiu
鱺	pxiw
䕻	pxiw
葧	pxju
荸	pxjv
䒵	pxjv
莊	pxkf
苣	pxlb
鮔	pxlb
蘻	pxlh
蓐	pxlk
䔚	pxlk
菉	pxll
䱚	pxll
帪	pxlo
莀	pxlo
衐	pxls
㣙	pxme
苖	pxmf
鮋	pxmq
蒘	pxnh
蕠	pxnh
茹	pxnm
䕈	pxno
蓲	pxnx
鰸	pxnx
苊	pxon
鹧	pxoq
鹪	pxoq
焦	pxor
㲬	pxot
庶	pxoy
芝	pxpf
㼹	pxpj
歡	pxpl
顴	pxpm
䕚	pxpm
鱱	pxpn
鹳	pxpo
飌	pxpq
荒	pxpr
雚	pxpr
鸛	pxpr
㡆	pxpr
勸	pxpu
觀	pxpw
酄	pxpw
颧	pxpy
蓒	pxqg
幝	pxrl
蕇	pxrl
鱓	pxrl
徣	pxrm
䱜	pxrm
鷓	pxrr
鷦	pxrr
蘄	pxrt
鄿	pxrw
䕤	pxrw
鰋	pxrx
䒰	pxsg
䡓	pxsg
蔪	pxte
䱿	pxte
㫂	pxte
蕼	pxub
苈	pxuc
莣	pxup
葫	pxuq
鰗	pxuq
衚	pxus
蕻	pxwf
蔣	pxwk
鱂	pxwk
䱳	pxwm
苉	pxwq
菇	pxxf
㣨	pxxf
鱑	pxxg
㣴	pxxg
蘳	pxxi
薅	pxxk
䓸	pxxq
蘣	pxxr
䕾	pxxs
囊	pxxx
葌	pxxx
䕅	pxyb
芒	pxyf
䰶	pxyq
苪	pxyw
芚	pyaf
荝	pyaj
魨	pyaq
䓺	pycd
蓁	pyct
㣖	pyde
芥	pydr
魪	pydr
㠹	pydr
虀	pyef
荟	pyeg
遗	pyep
莤	pyff
鯂	pyfq
薦	pyfx
䖆	pyfx
萹	pygp
徧	pygp
牑	pygp
鯿	pygp
苶	pyhk
蕣	pyio
蓃	pyjb
䱸	pyjb
菶	pykg
菺	pykm
䓞	pyld
蔷	pyln
歃	pylq
贵	pymm
蔰	pynk
芲	pynq
茶	pyof
苍	pyon
蕮	pyox
㣗	pype
芦	pypf
魲	pypq
蘸	pypx
萅	pyrm
萶	pyrm
鰆	pyrm
鯓	pyrq
薺	pyrr
鱭	pyrr
䶓	pyrr
臿	pyrt
䕣	pyrv
荃	pysg
盫	pysm
葢	pysm
芞	pytf
敮	pyub
蓜	pyub
薆	pyub
鱫	pyub
牖	pyuf
㡃	pyvp
萖	pywq
魜	pywq
鯢	pywq
䕏	pywt
䲑	pywt
䣒	pywv
葁	pyxc
䔯	pyxf
蓔	pyxo
葅	pyym
萸	pyyw
鞁	qacf
䩠	qadx
缮	qaen
绒	qagd
刊	qajg
䬎	qanf
纴	qatn
㢰	qavb
纠	qavn
㣄	qaxo
绺	qban
缀	qbbb
弢	qbbx
缝	qbce
䩼	qbce
䩶	qbfb
纬	qbgn
颾	qbib
鞺	qbif
靫	qbii
终	qbjo
绎	qbkg
绌	qblv
络	qbnm
绛	qboa
绦	qbof
矤	qbtb
䬆	qcaj
鞎	qcbf
绣	qccc
鞑	qcep
红	qcfn
䫹	qcfq
绔	qcfs
兽	qchf
䩡	qchw
䬊	qchw
鞵	qcic
缧	qcih
缓	qckb
䬑	qckm
鞦	qcmi
细	qcmn
䌽	qcof
缭	qcqh
飉	qcqh
曽	qcrm
绮	qcrn
䩭	qcrn
鞂	qctf
缌	qcup
颸	qcup
䬙	qcvt
兾	qcwf
绥	qcxc
鞖	qcxc
㢻	qcxc
䬐	qcxc
䩧	qcyf
鞱	qcyr
刜	qdaj
彏	qddb
鞞	qdel
弭	qdfb
弫	qdfb
䌺	qdfn
缕	qdin
艴	qdjk
䪊	qdka
缐	qdlm
費	qdmm
鄪	qdmw
鞛	qdnm
䬏	qdnm
绵	qdpm
㢽	qdqb
弗	qdrb
彇	qdrr
䬖	qdsg
㪄	qdst
缈	qdtk
㔗	qduc
弛	qdvb
缴	qdvs
䩤	qdwq
费	qdym
䬃	qdyq
䩥	qeed
绯	qefh
绀	qefn
线	qegn
纭	qegn
缢	qegs
䪆	qehe
缣	qejg
彅	qekp
缒	qepe
迀	qepg
迮	qept
颲	qfaj
缰	qfcf
彊	qfcf
韁	qfcf
飅	qfcm
弖	qffb
張	qffb
㢧	qffb
䩻	qfff
䩨	qfff
䬚	qffq
卫	qffv
瓕	qfgi
彌	qfgm
㣆	qfgs
䥸	qfgt
㜷	qfgx
缳	qfhx
彋	qfhx
弦	qfin
䩘	qfin
䩙	qfin
婱	qfix
纡	qflf
弙	qflf
䩒	qflf
頇	qfmm
䩫	qfmm
䪅	qfob
靺	qfof
缡	qfom
䬜	qfom
绻	qfon
䩟	qfqy
弳	qfrc
㢶	qfrm
绠	qfro
鞕	qfro
弼	qfrq
㢪	qfsa
缅	qfum
靰	qfwq
顸	qfym
绂	qgbi
颰	qgbi
鞅	qgcd
㒸	qgdi
鞒	qgdr
㸂	qgem
遂	qgep
顛	qgfm
颠	qgfy
绸	qgin
䩺	qgmh
纮	qgmx
㢬	qgmx
㲂	qgnb
㢢	qgnl
䌹	qgnm
尚	qgnm
鞽	qgnn
氅	qgno
幤	qgnp
敞	qgns
䣊	qgnw
纲	qgow
㒹	qgqg
鷏	qgrr
缍	qgtn
㥲	qgup
真	qgwf
绤	qgyn
纳	qgyw
靹	qgyw
判	qhaj
缘	qhaq
颬	qhaq
䩔	qhbx
叛	qhcb
韆	qhce
䌿	qhcm
䬄	qhff
頖	qhfm
绕	qhfw
䰜	qhgq
䩹	qhgr
㣂	qhgr
缄	qhhf
缪	qhhk
飂	qhhk
䌻	qhhx
㢾	qhif
㢷	qhiq
乐	qhkq
㢫	qhmb
缥	qhpg
飃	qhpg
䪎	qhpn
颳	qhtq
纵	qhwn
弶	qhyb
㢺	qhyb
弻	qhyq
韃	qiae
䬉	qidg
疆	qiff
纻	qiff
靯	qiff
绽	qifs
绫	qigb
䬋	qigb
鞿	qiid
鞋	qiif
䩩	qiio
缩	qikr
䩳	qimb
䬒	qimb
䬁	qinq
䬟	qipa
飀	qipc
综	qipg
绾	qipm
䩪	qipm
䪀	qipu
䎖	qirh
甑	qirj
䒏	qirk
㣒	qirk
曾	qirm
朆	qirr
鄫	qirw
张	qitb
靿	qiuc
䬀	qiuc
缤	qivg
鞍	qixc
纰	qjan
弥	qjhk
引	qjjb
弔	qjjb
丫	qjji
㣃	qjkq
绝	qjkv
缔	qjmp
䩷	qjmv
绉	qjob
靴	qjrf
盄	qjsm
纶	qjwn
统	qjwq
韂	qjxc
揱	qkah
削	qkaj
鵥	qkar
弪	qkcf
经	qkcf
逍	qkep
颩	qkeq
韇	qkfm
纣	qkfn
缏	qkfo
鞭	qkfo
半	qkgi
颶	qkgw
㢼	qkib
㪵	qkjl
弣	qkkf
肖	qkml
䪁	qkni
结	qknm
鞊	qknm
缬	qkny
㲖	qkot
缑	qkub
㢿	qkub
弝	qkvb
靶	qkvf
䬞	qkvk
㦷	qlaa
㢳	qlaq
鞇	qlcd
鞚	qlcf
㢮	qldv
䌶	qlee
鞣	qleo
通	qlep
䌾	qlgr
䩞	qlhf
颭	qlhq
㼧	qlja
飇	qlll
甬	qlmx
䩿	qlpm
弞	qlqb
圅	qlri
㢴	qlri
鞜	qlrm
㪌	qlub
勇	qluc
勈	qluc
恿	qlup
靵	qlvf
䌸	qlvi
纽	qlvn
颴	qlvs
纥	qlvv
䩐	qlvv
靲	qlwf
纾	qlxn
绖	qman
䬂	qmaq
強	qmbm
覝	qmdw
䪍	qmfh
兰	qmgi
㢱	qmhk
㶣	qmig
续	qmjc
靻	qmmf
颷	qmmi
飈	qmmm
组	qmmn
缵	qmmy
绐	qmnm
颱	qmnm
缙	qmrm
䣔	qmwv
弘	qmxb
鞻	qmxc
䩵	qmxf
謽	qnbc
强	qnbm
䥒	qnbt
犟	qnbu
勥	qnbu
缉	qndf
䩰	qndf
织	qngw
绢	qnkm
弲	qnkm
鞙	qnkm
嗭	qnnq
绳	qnrv
鞓	qnsg
总	qnup
弽	qnvo
鞢	qnvo
绁	qnvv
靾	qnvv
䫄	qnwm
纷	qnwn
兑	qnwq
䬇	qnwq
敚	qnws
缲	qnxo
㓥	qoaj
当	qobl
鞫	qocy
鞄	qodb
颮	qodb
弧	qoeb
䩝	qoef
缞	qofx
缟	qogn
䬘	qogn
约	qoii
靮	qoii
㢩	qoii
䪃	qojs
弴	qojv
鞟	qojv
鞹	qojw
䩓	qomx
弾	qorl
绚	qorm
䬍	qoru
䫽	qotq
绹	qovt
鞠	qowi
绩	qoym
䩕	qpav
䩲	qpbx
䫸	qpcq
䩸	qpdf
韈	qpfi
绬	qpgc
鞾	qpgg
纫	qpii
靭	qpii
靱	qpii
䪌	qpji
鞯	qpkj
鞥	qpld
䪋	qpme
韊	qpmh
鞼	qpmm
弨	qpnm
绍	qpnm
鞀	qpnm
䫿	qpnm
韄	qppb
缱	qppe
䪈	qppe
鞳	qppw
䧲	qprg
维	qprn
绗	qpsg
纤	qptn
䪇	qpuk
㢵	qpwb
鞈	qpwf
给	qpwn
鞔	qpwq
䩾	qpxo
缋	qpym
韉	qpyx
弜	qqbb
䩑	qqbf
䶬	qqda
绋	qqdr
㢲	qqfg
缂	qqfn
㢨	qqgb
䍁	qqge
靬	qqgf
绱	qqgn
鞝	qqgn
缜	qqgw
㣀	qqgw
缯	qqir
弚	qqjj
靷	qqjj
鞩	qqka
绊	qqkg
靽	qqkg
绡	qqkm
鞘	qqkm
弰	qqkm
颵	qqkm
鞃	qqmx
䬈	qqnw
䌼	qqnw
矗	qqqf
飍	qqqq
䬕	qqqq
绨	qqqr
剃	qqra
递	qqre
弟	qqrk
弹	qqrl
鹈	qqro
鵜	qqrr
䶏	qqru
㢸	qqst
兯	qqvi
麉	qqwy
鞧	qqyf
缁	qrcm
缦	qrfb
彃	qrff
靪	qrff
鞸	qrff
䬛	qrff
虩	qrhh
韅	qrix
绲	qrja
绅	qrjj
单	qrlf
䪉	qrlf
冁	qrlh
郸	qrlw
䫻	qrmq
彁	qrnn
鞨	qrov
辔	qrqn
䳬	qrrf
鳱	qrrg
缫	qrro
㣅	qrrr
缊	qrsm
鞰	qrsm
鞡	qsdy
纨	qsii
鞮	qsmf
㿻	qsmg
缇	qsmn
飋	qsse
䩢	qste
攼	qstg
靳	qtef
缃	qtfn
颫	qtgq
缆	qtgw
㢯	qtja
缗	qtjr
䩖	qtkf
纱	qtkn
鶸	qtqr
弱	qtqt
䍀	qtsm
练	qtvg
缠	qtwm
绑	qtwv
彍	qtxg
纩	qtyn
绞	qtyn
弬	quab
纪	qubn
㢭	qubx
勒	qucf
鞬	qudx
䩛	quee
䫾	quee
绰	qufm
缚	qukf
靼	qumf
䩯	qunf
颺	quor
惪	qupf
怎	qupt
靸	quqf
䩗	quqf
级	quqn
弸	quuq
绷	quuq
䬅	quuu
纹	quyn
䫼	quyw
绪	qvfn
缎	qvhb
弤	qvii
䩚	qvii
纸	qvqn
䰞	qvqr
颹	qvvq
纺	qvyn
䩱	qwka
䬔	qwka
鞐	qwnf
䩣	qwof
粥	qwqb
鬻	qwqr
邗	qwvg
继	qwvv
鞉	qwwy
㢹	qwyb
䬓	qwyq
鞴	qxel
㣁	qxel
迸	qxep
頩	qxfm
鞲	qxgi
并	qxgi
䪂	qxhh
瓶	qxja
艵	qxjk
弡	qxlb
缛	qxlk
绿	qxll
䩮	qxll
䩜	qxmf
	qxmn
䌷	qxmn
彄	qxnx
䩽	qxnx
剙	qxpg
剏	qxpi
彈	qxrl
鵧	qxrr
㔙	qxuc
㤣	qxup
䩴	qxuq
郱	qxwv
彉	qxxg
䪄	qxxg
䬝	qxxg
鞆	qxyw
䤋	qyaf
纯	qyan
蠤	qybb
绶	qybx
奠	qycd
㽀	qycj
鄭	qycw
绘	qyeg
遒	qyep
酋	qyfi
韀	qyfx
编	qygp
颼	qyjb
遵	qyke
尊	qykf
䩬	qykg
鷷	qykr
猷	qyld
㷕	qymi
缨	qyyx
疲	racy
鶀	rafr
痒	raiy
痦	ranm
晤	ranm
㬁	rapw
㾲	rast
痧	ratk
耚	ravg
瘎	ravv
㽱	ravy
晷	rban
辍	rbbb
䖺	rbbm
轰	rbbx
㫞	rbbx
偹	rbcm
儵	rbfm
曭	rbfm
翛	rbhh
瘙	rbib
絛	rbih
疣	rbii
疼	rbjo
昸	rbjo
鴤	rbjo
㫡	rbjo
修	rbke
痝	rbki
脩	rbkm
倏	rbld
曓	rblf
㬧	rblh
昢	rblv
㽾	rblv
㬥	rblw
倐	rbmi
䗙	rbmo
痋	rbmy
辂	rbnm
痴	rbnm
鴼	rbnm
條	rbof
鎥	rbot
鯈	rbpq
瘫	rbpr
鞗	rbqf
㫦	rbrm
疾	rbty
昗	rbym
痢	rcaj
㓯	rcaj
昻	rcav
昄	rcbx
㽹	rcbx
痕	rcby
㿔	rccc
癳	rcch
鷈	rcch
㾷	rcch
暳	rcco
曥	rccs
㿖	rccs
㬩	rccu
疓	rccy
轪	rcda
旲	rcdm
昦	rcdr
䲦	rcdr
㾼	rcep
㬭	rcfk
㾯	rcfo
晇	rcfs
疀	rcfs
㿆	rcfx
疘	rcfy
瘞	rchi
㿗	rchm
痜	rchq
㿓	rchs
瘱	rchu
㾜	rchw
䳶	rcic
瘰	rcih
痵	rcjv
㬊	rckb
暖	rckb
㾵	rclf
㫹	rclt
㾭	rcmi
甾	rcmn
瘣	rcmx
癴	rcnh
暿	rcnm
癵	rcny
癪	rcom
瘈	rcpc
瘛	rcpu
暸	rcqh
療	rcqh
㬙	rcqx
㾨	rcrn
鶅	rcrr
晻	rcrv
痷	rcrv
䎨	rcrv
昮	rcuc
痹	rcud
暚	rcvt
䣎	rcwv
痿	rcxc
瘧	rcxf
謇	rcyo
最	rdbx
暤	rdcl
㿁	rdcl
癯	rddp
㬬	rddp
㾢	rddy
痺	rdel
暲	rdfm
瘴	rdfm
䞿	rdfo
辗	rdhf
耧	rdig
㿐	rdii
瘘	rdiy
曨	rdka
曯	rdlb
瘺	rdmf
㿃	rdmp
㾇	rdmy
䎧	rdnm
㾦	rdnm
昵	rdnq
痆	rdnq
㬘	rdrr
㾮	rdsg
朂	rduc
䎤	rdvn
曒	rdvs
辄	rdvv
䳖	rdvv
癜	rdwb
暭	rdwl
曈	rdwm
晛	rdwq
廵	rdxn
䢂	rdya
昱	rdym
瘚	rebl
痱	refh
暃	refh
㫵	refh
暯	refm
瘼	refy
疳	refy
耘	regg
昙	regm
晌	regn
晑	regn
㾾	rejg
昇	reld
㾚	renl
㾹	reno
疵	renq
㾟	reok
连	repa
㾽	repe
巡	repn
鶳	repp
迬	repy
昳	retg
轶	retg
䳀	retg
㾅	revr
癑	rexo
疺	rexp
晐	reyw
痎	reyw
暕	rfah
癣	rfai
㾐	rfaj
瘝	rfak
㾡	rfav
煭	rfax
鄤	rfbw
曼	rfbx
癅	rfcm
辀	rfea
㿙	rffc
䎬	rfff
畢	rffm
㫢	rffm
騫	rffo
鷌	rffr
耲	rffx
痮	rffy
瘂	rffy
㾺	rffy
㾀	rffy
癕	rfgp
瘢	rfhb
瘁	rfhl
晬	rfhl
癏	rfhx
䴋	rfhx
癦	rfif
	rfim
昡	rfin
痃	rfin
曎	rfir
耰	rfkb
㬉	rfkc
㾍	rfkm
癛	rflc
旴	rflf
㽳	rflf
癝	rflp
暊	rfmm
頂	rfmm
頛	rfmm
	rfmn
䎱	rfmn
曪	rfnp
㿚	rfnp
昩	rfof
昁	rfpm
痍	rfqy
痙	rfrc
㬌	rfrh
㾘	rfro
鷝	rfrr
疞	rfsa
㪤	rfst
㬅	rfta
㫸	rfts
晅	rfum
癋	rfup
曙	rfvf
癖	rfwy
褰	rfxq
裊	rfxq
䙚	rfxq
曩	rfxx
顶	rfym
䳁	rgbi
映	rgcd
轿	rgdr
㿈	rgep
曏	rgew
辋	rgex
晒	rgfm
暅	rgfu
晍	rghf
痌	rghf
瘗	rgif
㾆	rgif
瘃	rgii
㽴	rgii
晭	rgin
痚	rgjv
㫴	rgjv
痏	rgkm
暡	rgmh
昖	rgmx
遇	rgne
禺	rgnh
㼴	rgnj
顒	rgnm
愚	rgnu
颙	rgny
䎥	rgyn
㔀	rhaj
疨	rhay
疫	rhbx
殶	rhbx
辐	rhcm
痘	rhei
曋	rhfm
顥	rhfm
晓	rhfw
颢	rhfy
曧	rhgb
㬏	rhgr
晪	rhgw
痶	rhgw
㿇	rhhd
遢	rhhe
暟	rhhe
瘳	rhhk
㬔	rhhk
毾	rhho
曜	rhhp
㿑	rhhp
痤	rhif
影	rhke
旵	rhmm
島	rhmr
㠀	rhmr
疝	rhmy
㫟	rhnm
痫	rhof
䯫	rhon
疯	rhow
瘭	rhpg
㬓	rhpg
鳧	rhqr
鳬	rhqr
㬞	rhrv
㿂	rhss
搴	rhto
晟	rhvv
晠	rhvv
疭	rhwy
辌	rhya
晾	rhym
景	rhym
㫰	ricb
㾗	ricb
曢	rich
辖	ricn
㫱	ridg
㬨	ridg
㾿	riew
圼	rifm
塞	rifo
暄	rifu
㽵	rify
耕	rigg
耭	riid
晆	riif
㾏	riif
歞	riil
顯	riim
晼	riio
痑	riiq
曉	riiw
㬎	riix
痔	rikf
時	rikf
㫭	rikf
晃	rilm
晄	rilm
㾱	rilw
㫥	rinm
鴕	rinq
㾃	rinq
辕	rinx
曻	rioa
䳃	rion
瘤	ripc
痯	ripm
癈	riqb
暌	riug
昹	rivi
㫤	rivi
䳹	riwb
晥	riwg
晏	rixc
㫨	rixc
䨃	rixp
鷃	rixr
㼗	rjaf
昆	rjam
疪	rjay
㾬	rjdr
迧	rjep
朄	rjfh
曛	rjfm
昰	rjfm
晽	rjfm
症	rjfy
痲	rjfy
痳	rjfy
痪	rjgc
瘓	rjgc
㬇	rjgc
䎮	rjgx
疚	rjii
申	rjjm
曱	rjjm
甴	rjjm
辙	rjks
㬚	rjks
晔	rjlf
㿍	rjlu
耪	rjmv
痞	rjnm
畃	rjoi
寒	rjoo
鹍	rjoq
㬠	rjox
晩	rjrw
晸	rjst
暢	rjur
㾎	rjvf
耔	rjvg
㫗	rjvm
㜽	rjvn
畅	rjvr
轮	rjwa
瘇	rjwm
曕	rjxc
癚	rjxc
曗	rkag
痉	rkcf
轻	rkcf
时	rkfm
顕	rkfm
疛	rkfy
昧	rkgw
显	rkjm
㾈	rkkf
猒	rkld
㦔	rklu
㾋	rkof
瘊	rkub
㬋	rkub
䳧	rkub
㬯	rkui
痣	rkup
耙	rkvg
㿒	rkvk
疤	rkvy
鴏	rkwa
㬣	rkyk
戥	rlaa
瘕	rlbb
暇	rlbb
㽻	rlbx
㾤	rlcf
㫒	rldm
旪	rlfm
暔	rlgr
痁	rlhy
晦	rljn
痗	rljn
旿	rllf
㽷	rlmy
晗	rlnm
痐	rlnm
邋	rloe
巤	rlof
鴥	rlor
㿎	rlpm
软	rlqa
欥	rlqm
痈	rlqy
星	rltm
甠	rltm
转	rlvi
疙	rlvv
䢀	rlvv
䎢	rlvv
㫓	rlvv
昑	rlwm
痼	rlxf
暁	rlxw
轾	rmaa
晊	rmam
痓	rmay
瘆	rmck
癗	rmcm
癤	rmea
曇	rmeg
曘	rmfk
㫫	rmfm
痖	rmfy
晙	rmgb
痠	rmgb
鵔	rmgb
炅	rmim
炚	rmim
災	rmin
疢	rmiy
㿕	rmjy
昪	rmld
耝	rmmg
痰	rmmi
晱	rmmi
䎦	rmmi
瘮	rmmk
㿘	rmmn
賽	rmmo
癆	rmmu
耮	rmmu
癭	rmmx
疽	rmmy
瘑	rmnm
耛	rmnm
㬃	rmnm
㾂	rmnm
㬡	rmnq
㷖	rmpn
曤	rmpr
癨	rmpr
晖	rmra
晕	rmra
暝	rmrb
癎	rmrm
㬐	rmrm
㾌	rmty
勗	rmuc
耡	rmuc
癇	rmuq
㽸	rmwq
瘻	rmxc
耬	rmxc
暈	rmxf
暉	rmxf
瘒	rmxf
瘡	rnbn
癡	rnbs
瘯	rnbt
瘥	rncf
暛	rncf
辑	rndf
暆	rndv
疜	rnfy
轵	rngw
疻	rngw
䳅	rngw
癢	rnic
㾓	rnkm
雝	rnkp
邕	rnkv
㰤	rnlq
可	rnmf
暪	rnmm
䎭	rnne
晧	rnnm
㾔	rnnm
瘽	rnno
癱	rnnp
㬮	rnnp
暵	rnnt
䎯	rnnt
曣	rnnx
㫐	rnqm
昤	rnqx
㾉	rnqx
疕	rnqy
戨	rnra
歌	rnrl
哥	rnrn
㢦	rnrw
蹇	rnsh
㪼	rnte
㪃	rnub
暶	rnvs
疶	rnvv
㐓	rnvv
昐	rnwm
㫛	rnwq
癌	rnxh
㿋	rnxo
昴	roav
疱	rodb
䳈	rodb
㼍	roeg
㽿	roey
杲	rofm
果	rofm
顆	rofm
寨	rofo
梟	rofr
䲷	rofr
颗	rofy
暠	rogn
㾸	rogn
晞	rogp
㾙	rogp
夥	roii
旳	roii
㾁	roii
㼫	roja
暾	rojs
鷻	rojs
㬀	rojv
㬑	rojw
晴	rokm
䎫	rolb
㾛	romb
耫	romm
㾴	romm
㫶	romp
曀	rone
昫	ronm
痀	ronm
寋	rono
煦	ronx
瘵	ropg
暩	ropg
剔	rora
敡	rorb
昒	rore
易	rore
逷	rore
㫬	rorm
鶍	rorr
惖	roru
㪙	rost
晰	rote
耗	rotg
昀	roty
敤	roub
鄡	rowv
褁	roxq
㓭	roya
遏	roye
歇	royl
䫘	roym
鹖	royo
毼	royo
鶡	royr
㔠	royu
曷	royv
癬	rpai
昂	rpav
旫	rpcm
昽	rpdm
癓	rpds
癥	rpds
暹	rpep
㿅	rpes
暎	rpgc
曄	rpgg
曅	rpgg
㬛	rphh
暰	rphs
瘲	rphs
轫	rpii
癁	rplb
㬒	rpll
耜	rpmg
㿉	rpmm
轺	rpnm
昭	rpnm
照	rpnx
曔	rpos
耯	rppb
鸌	rppb
㬦	rppb
瘩	rppw
㫿	rprm
癘	rprn
鵻	rprr
暀	rpry
痽	rpry
㾩	rpvh
耠	rpwg
晚	rpwq
㾑	rpwy
瘔	rpxf
癄	rpxo
弿	rqbo
曊	rqdm
昲	rqdr
疿	rqdr
瘬	rqff
轩	rqga
旰	rqgm
旱	rqgm
癲	rqgm
耥	rqgn
㫾	rqgn
瘨	rqgw
癫	rqgy
轹	rqhk
㬝	rqir
㽼	rqjj
㫠	rqkg
痟	rqkm
痛	rqlm
痥	rqnw
晜	rqqr
瘋	rqqy
瘅	rqrl
䳚	rqrr
昨	rqtm
痄	rqty
㪋	rqub
疖	rqvy
兓	rraa
辎	rrcm
䎩	rrcm
鵿	rrel
耓	rrfg
㫯	rrfw
疔	rrfy
耦	rrgn
㬂	rrgn
鬵	rrhr
暻	rrhy
暥	rrix
㬤	rrix
辊	rrja
痩	rrjb
暒	rrlt
焸	rrmi
昌	rrmm
昍	rrmm
疴	rrnm
轲	rrnm
鴚	rrnm
癰	rrnp
剿	rroa
巢	rrof
㾧	rrof
晹	rror
痬	rror
勦	rrou
暍	rrov
鄛	rrow
晘	rrqg
㔆	rrra
蠶	rrrb
㬪	rrrh
曑	rrrk
曐	rrrl
晶	rrrm
晿	rrrm
曡	rrrm
朁	rrrm
䫬	rrrm
曟	rrro
鶱	rrro
㿊	rrrr
䣟	rrrw
辒	rrsm
瘟	rrsm
㬈	rrsm
㫀	rrte
㫣	rrvv
曝	rrwl
鸔	rrwl
疰	rryy
瘌	rsaj
㽲	rsay
䀺	rsdm
旺	rsgm
癩	rsjm
癞	rsjy
疩	rslf
瘶	rslq
㿀	rsls
焂	rsmi
昷	rsmm
跾	rsns
㼔	rsoe
轨	rsqa
䩦	rsqf
旯	rsqm
瘷	rsst
晣	rste
攸	rstr
鋚	rstw
悠	rsup
癍	rsus
㛜	rsxc
疠	rtay
㾪	rtdm
斩	rtea
昕	rtem
曚	rtfg
䴌	rtfg
㫙	rtgm
堑	rtif
㬆	rtjr
耱	rtjv
耖	rtkg
曃	rtle
㾳	rtlx
昿	rtmx
㾶	rtmy
椠	rtof
瘹	rtoi
暂	rtrm
㾠	rtsg
鵾	rttr
錾	rttw
耢	rtuc
痨	rtuc
㾣	rtwy
曠	rtxg
较	rtya
旷	rtym
晈	rtym
㿏	ruai
候	rubt
㽶	ruby
㫑	rucm
鳨	rucr
轳	rudb
㿢	rudr
辅	rufa
晡	rufm
晫	rufm
痡	rufy
昊	rugm
瘪	rujw
䎪	rukf
㬍	rukf
曌	rulc
焽	rumi
㫜	rumm
疸	rumy
痂	runm
耞	runm
瘸	runy
暞	ruof
暘	ruor
瘍	ruor
㤅	rupa
㥶	rupo
䢁	ruqa
明	ruqm
昅	ruqm
㽺	ruqy
䳟	rurr
琞	rusi
盟	rusm
瘜	ruup
痭	ruuq
疗	ruvy
曍	ruwl
癟	ruwp
㿜	ruwp
旻	ruym
旼	ruym
疦	ruyw
鴃	ruyw
曳	rvee
曵	rvei
暑	rvfm
暏	rvfm
瘏	rvfy
疷	rvii
㫝	rvii
䎣	rviy
轷	rvlf
骞	rvno
䲬	rvqr
疧	rvqy
旸	rvre
疡	rvre
痻	rvrm
轧	rvva
㐉	rvvf
电	rvvm
暐	rvvm
鳦	rvvr
瘀	rvyj
昉	rvym
昘	rvym
䲱	rvyr
㬕	rwai
癃	rwbl
轼	rwcf
癮	rwcu
謈	rwcy
晎	rwfm
耣	rwgp
㫻	rwgp
㾥	rwhb
㫔	rwhm
㫧	rwim
辚	rwio
暽	rwio
癐	rwir
瘾	rwju
输	rwka
瘉	rwka
癒	rwku
㿺	rwla
癊	rwle
暴	rwll
㬗	rwlx
㾖	rwmy
鵌	rwof
痸	rwpa
㫼	rwpa
痾	rwrn
䳗	rwtr
䳘	rwtr
癔	rwup
邒	rwvf
䣂	rwvg
鄥	rwvr
㾻	rwwo
晁	rwwy
晀	rwwy
㿌	rwxh
辘	rwya
瘠	rwyk
暗	rwym
瘖	rwyy
㾕	rwyy
㿄	rxbb
癧	rxce
妟	rxcm
轱	rxfa
疟	rxff
㾝	rxfy
㽽	rxfy
耩	rxgi
㾊	rxhk
辆	rxhw
㬄	rxig
暷	rxik
曬	rxiw
㿛	rxiw
㫲	rxjv
昛	rxlb
耟	rxlb
耨	rxlk
鵦	rxll
㫽	rxll
煚	rxlm
晨	rxlo
歍	rxlq
鷐	rxlr
轴	rxma
㾄	rxmy
㾒	rxnm
䳼	rxnx
炁	rxoa
轭	rxon
烏	rxor
暱	rxpn
曞	rxpn
暺	rxrl
癉	rxrl
耤	rxrm
瘄	rxrm
䳛	rxrr
䎰	rxrt
䣢	rxrw
疬	rxuc
㾰	rxuq
鄔	rxwv
癀	rxxg
曂	rxxg
曮	rxxs
昃	rxyw
昺	rxyw
病	rxyw
昞	rxyw
旽	ryam
曦	ryci
疥	rydr
癙	ryfx
㾞	ryfy
暧	rygb
㾫	rygp
瘦	ryjb
轸	ryke
昣	ryke
疹	ryke
赛	rymo
疮	ryon
昈	rypm
暙	ryrm
癠	ryrr
辁	rysg
痊	rysg
㬖	rysn
曖	ryub
辏	ryug
暣	rywi
㬰	rywm
晲	rywq
鶃	rywq
鸃	rywt
㬢	rywt
瘐	ryyw
瘿	ryyx
琖	saaa
找	saaf
报	sabx
披	sacf
玻	sacg
撹	sadw
珽	sadx
挺	sadx
掑	saff
琺	saff
琪	safg
搅	sagw
揧	saht
璂	saif
珜	saig
剌	sajf
㺫	sajg
㓳	sajm
扑	salf
㺪	salg
掝	sanf
琙	sanf
珸	sanm
捂	sanm
䱫	sapq
璈	sast
撕	sate
挱	satk
㧃	savf
㺩	savg
揕	savv
㻣	savv
㧟	saxa
	saxa
璖	saxo
揝	sbar
掇	sbbb
択	sbbf
掻	sbbm
搡	sbbo
㧐	sbbx
	sbbx
摓	sbce
㻱	sbce
㩇	sbcf
捀	sbcg
琒	sbcg
璠	sbcm
播	sbcm
擋	sbcm
璫	sbcm
攩	sbfm
玮	sbgg
韪	sbgm
撐	sbha
拠	sbhq
撑	sbht
搔	sbib
瑵	sbib
摚	sbif
扰	sbii
扠	sbii
择	sbkg
拙	sblv
㨰	sbmx
珞	sbnm
挌	sbnm
瑺	sbpm
摊	sbpr
玔	sbrg
拋	sbuc
璶	sbxs
琍	scaj
挀	scaq
掙	scbb
拫	scbf
珢	scbg
㨿	scbh
撂	scbn
㨕	scbs
鋬	scbt
扳	scbx
琇	sccc
攂	sccc
瓃	sccc
扔	sccf
搋	scch
㩸	scch
擨	sccl
㩹	sccm
㨹	scco
㻰	scco
攎	sccs
瓐	sccs
擄	sccu
攄	sccu
㩨	sccu
㺯	scdg
挞	scep
扛	scff
玒	scfg
㩊	scfk
㩱	scfk
揋	scfo
摦	scfo
挎	scfs
璩	scgd
據	scgd
玤	scgg
㧨	schf
㻈	schf
瓛	schl
㩵	schl
虓	schq
琥	schq
挾	schw
㨙	scic
摞	scih
㨒	scii
琈	scjv
捊	scjv
㻑	scjv
㩬	scka
瑗	sckb
援	sckb
捋	sckf
揗	scld
捹	scll
揪	scmi
摃	scmm
摣	scmm
瑰	scmx
挅	scof
採	scof
㩀	scoi
瓈	scol
摤	scoo
揳	scpc
捺	scpg
撩	scqh
璙	scqh
揺	scql
撝	scqx
琦	scrn
掎	scrn
掩	scrv
掳	scuc
摅	scup
揌	scup
㨜	scuy
撦	scvf
摢	scvl
㻯	scvl
瑶	scvt
摇	scvt
挼	scxc
捼	scxc
琾	scyd
琂	scyg
訄	scyq
搯	scyr
瑫	scyr
摄	sdbb
摼	sdbi
掘	sdbl
㻕	sdbl
掫	sdbx
㻓	sdbx
攫	sddb
攝	sddd
琜	sddg
㩴	sddp
撰	sddw
捭	sdel
琕	sdel
挋	sdff
挕	sdff
珥	sdfg
璋	sdfm
搌	sdhf
搂	sdif
擽	sdio
瓅	sdio
㻵	sdjj
攏	sdka
瓏	sdka
瑔	sdlm
摨	sdlu
握	sdma
㺺	sdmg
摕	sdmp
掊	sdnm
琣	sdnm
抳	sdnq
捤	sdot
㨮	sdpw
㨝	sdqk
摒	sdqx
拍	sdrf
珀	sdrg
璛	sdrr
㩋	sdrr
瑝	sdsg
揘	sdsg
擞	sdst
璼	sdts
㩜	sdts
攬	sdtw
碧	sdvd
扡	sdvf
挶	sdvn
璬	sdvs
撽	sdvs
㩔	sdwb
撞	sdwm
挸	sdwq
現	sdwq
揶	sdwv
瑘	sdwv
搱	sdwy
摂	sdwy
拉	sdyf
揤	seav
搠	sebu
挻	seed
摸	seff
拑	seff
玵	sefg
琲	sefh
排	sefh
㧞	segb
擙	segc
抎	segf
珦	segn
搤	segs
扯	sehf
托	seja
扥	seja
搛	sejg
㻩	sejg
揃	seka
瑐	seka
掽	sekj
掯	sekm
㨵	sekp
抍	seld
璁	selu
摠	selu
瑀	senn
玼	senq
㧗	senq
捗	seok
㻉	seok
搥	sepe
速	sepf
迋	sepg
遈	sepm
瑡	sepp
摡	sera
抶	setg
擃	sexo
抸	sexp
㧡	seyw
瑓	sfah
揀	sfah
挒	sfaj
抚	sfbd
㩖	sfcf
璢	sfcm
㩅	sfcm
捿	sfdx
珘	sfeg
摆	sfff
抾	sfff
掁	sfff
掗	sfff
珐	sffg
瑪	sffg
瓌	sffx
擟	sfgm
擁	sfgp
搬	sfhb
捽	sfhl
琗	sfhl
抗	sfhq
搼	sfht
擐	sfhx
環	sfhx
搐	sfic
摔	sfil
㻭	sfil
玹	sfin
擇	sfir
撁	sfiu
擾	sfkb
瓇	sfkb
瑌	sfkc
㨎	sfkc
㐡	sfkc
掖	sfki
㧫	sfkm
扜	sflf
玗	sflf
擅	sflu
璮	sflu
㩏	sfmf
掚	sfmm
頄	sfmm
頊	sfmm
頼	sfmm
題	sfmm
擺	sfmn
攞	sfnp
㼈	sfnp
擉	sfob
㻿	sfob
抹	sfof
璃	sfom
摛	sfom
捲	sfon
攡	sfop
㧊	sfpm
㺰	sfpm
㺻	sfpm
挗	sfqy
挳	sfrc
㨂	sfrh
撸	sfrm
挭	sfro
扝	sfsa
㺮	sfsa
搕	sfsm
捷	sfts
玙	sfvf
珷	sfwe
扤	sfwq
擗	sfwy
挔	sfxq
攘	sfxx
瓖	sfxx
顼	sfym
题	sfym
拔	sgbi
抜	sgbx
抰	sgcd
㨊	sgck
㻟	sgck
瑁	sgdm
挢	sgdr
掆	sgeh
拪	sgff
揯	sgff
㧇	sgff
搄	sgfu
玬	sgfy
珊	sggf
挏	sghf
抩	sgif
珃	sgif
琢	sgii
扙	sgii
㧻	sgii
琱	sgin
㨄	sgin
珛	sgkm
㨣	sgmh
拻	sgmi
捴	sgmu
玜	sgmx
㺾	sgnm
撟	sgnn
珯	sgnq
㧯	sgnq
搘	sgnr
挩	sgnw
	sgow
㧏	sgow
抪	sgpm
拷	sgsa
挟	sgsf
捶	sgtf
扷	sgtf
㻔	sgtg
扒	sgwf
兲	sgwg
玐	sgwg
现	sgwq
掷	sgwv
抐	sgyw
攭	shab
攕	shaf
㧎	shaf
玡	shag
瑑	shaq
掾	shaq
据	shbf
琚	shbg
㩆	shbi
璏	shbj
搁	shbn
投	shbx
㨽	shca
揊	shcm
㩄	shcu
㧔	shdf
珟	shfd
捄	shff
珬	shff
球	shfg
瑞	shfk
揣	shfk
搣	shfm
撢	shfm
㻼	shfm
珮	shfp
㧩	shfp
挠	shfw
揻	shfx
㨏	shgm
搹	shgr
捵	shgw
琠	shgw
摺	shhd
㨟	shhe
瑊	shhf
㨔	shhf
璆	shhk
摎	shhk
璻	shhl
擢	shhp
撼	shhu
珝	shhx
挧	shhx
㩣	shhx
挫	shif
㺬	shii
馗	shiq
琌	shlw
挆	shof
搮	shof
瑮	shof
㩗	shpc
摽	shpg
攜	shpn
瓗	shpn
璀	shpr
摧	shpr
㼇	shpv
玑	shqg
㧿	shsh
㻜	shsh
括	shtf
抙	shtf
扪	shuf
珹	shvv
摵	shwh
琊	shwv
捓	shwv
掠	shyf
接	shyf
琼	shyg
撻	siae
㼀	siae
揢	sibn
琅	sicb
搳	sicn
㨳	sicn
攇	sicu
捇	sidg
挓	siej
琎	siep
瑯	siew
扗	siff
璌	sifg
䎠	sifk
擯	sifm
璸	sifm
琔	sifs
掟	sifs
揎	sifu
瑄	sifu
掕	sigb
璒	sihe
撜	sihe
抭	sihq
掛	siia
㼄	siic
璣	siid
珪	siif
挂	siif
玉	siig
玊	siig
琬	siio
捥	siio
丸	siiq
拸	siiq
撓	siiw
持	sikf
摍	sikr
挄	silf
珖	silg
抃	sinf
玣	sinf
拕	sinq
㨬	sinx
㧲	siof
搩	sioo
㻧	sioo
擦	siop
瑠	sipc
㨨	sipc
琮	sipg
琯	sipm
捾	sipm
㩁	sipr
撥	siqb
拧	sirf
㻘	sirj
拗	siuc
揆	siug
㨸	siuh
㧑	siui
擰	siur
摈	sivg
瑸	sivg
抝	sivv
捖	siwg
琓	siwg
按	sixc
奿	sixc
批	sjaf
㧚	sjaf
玭	sjag
珁	sjag
㼵	sjam
琤	sjbb
挣	sjbb
抔	sjdf
环	sjdg
揩	sjdr
瑎	sjdr
搎	sjeh
抷	sjff
㨆	sjff
㺽	sjff
琳	sjfg
瓊	sjgb
换	sjgc
換	sjgc
瑍	sjgc
擿	sjge
瓋	sjge
摘	sjgx
珎	sjhk
玖	sjii
㻙	sjkm
撤	sjks
抖	sjlf
㺶	sjlf
㩂	sjll
揿	sjlq
捔	sjlq
賴	sjmm
揥	sjmp
搒	sjmv
拇	sjnf
㧵	sjnm
栆	sjof
㩒	sjpg
挿	sjrj
揷	sjrj
㻄	sjsh
掹	sjsm
㨀	sjth
㺭	sjvg
璴	sjvs
抡	sjwf
揰	sjwm
珫	sjwq
㧤	sjwq
擔	sjxc
摌	sjxl
㧪	sjxo
赖	sjym
掐	sjyr
擈	skag
拰	skat
抓	skef
挝	skep
瓄	skfm
抺	skgw
拵	skjv
珔	skjv
拊	skkf
损	skmf
璞	skni
撲	skni
拮	sknm
擡	sknm
擷	sknm
㨐	skno
撷	skny
撇	skst
攍	skui
把	skvf
擣	skvk
璹	skvk
瓙	skvx
玳	skwa
㧧	skyf
琉	skyg
摑	slaf
㩥	slaf
擮	slap
瑕	slbb
技	slbx
㩽	slbx
珚	slcd
㧢	slcd
控	slcf
㻒	slct
摁	slcu
㧋	sldf
弄	sldg
㺴	sldg
拖	sldv
璚	slen
揉	sleo
瑈	sleo
遬	slep
撠	slfa
抇	slff
璵	slfg
㩮	slfh
攑	slfk
擀	slfq
卆	slfq
㨴	slfv
搇	slfx
攌	slfx
㨡	slgd
擜	slgl
揇	slgr
瑏	slha
拈	slhf
玷	slhg
逰	slje
㩯	sljh
挴	sljn
珻	sljn
揬	slld
㻠	slld
玝	sllf
撺	slnb
琀	slnm
㻁	slnm
搲	sloe
捆	slof
㧒	slof
㩭	sloj
攨	sloo
攪	slow
拥	slqf
扻	slqf
欶	slqf
㺵	slqg
搾	slqt
㧺	slrm
班	slsg
掴	slsi
珄	sltg
㩈	slub
捻	slup
摥	slur
㨓	slut
扭	slvf
㧄	slvf
㺲	slvg
抟	slvi
琁	slvs
挖	slvv
扢	slvv
撫	slvx
璑	slvx
扲	slwf
玪	slwg
抒	slxf
㧽	slxf
㩛	slxk
攛	slyf
摉	slyi
瑢	slyn
搈	slyn
搵	slys
挃	smaf
捯	smaj
拨	smbi
擱	smbn
挨	smbt
㨧	smcc
擌	smch
掺	smck
擂	smcm
撪	smcx
攥	smdh
擳	smea
擶	smea
挜	smff
攔	smfh
瓓	smfh
瓀	smfk
擩	smfk
㩶	smfm
摴	smfs
㻬	smfs
捘	smgb
㻐	smgb
㧠	smhk
㩐	smik
㻆	smkm
㨢	smkn
拚	smld
㺹	smld
抯	smmf
捫	smmf
珇	smmg
珼	smmg
琰	smmi
掞	smmi
㼆	smmi
摻	smmk
撡	smml
攢	smmm
瓚	smmm
攚	smmn
㩞	smmo
撈	smmu
攖	smmx
瓔	smmx
瓒	smmy
攒	smmy
撾	smne
抬	smnm
珆	smnm
㩕	smnq
攉	smpr
搉	smpr
撘	smpw
珲	smra
挥	smra
㨠	smrb
瑨	smrm
搢	smrm
撋	smsg
㨖	smst
㧥	smtf
珗	smtg
㻶	smub
撊	smuq
扖	smwf
抁	smwq
抌	smwq
玧	smwq
摟	smxc
㻲	smxc
璭	smxe
払	smxf
揮	smxf
琿	smxf
丟	smxg
㺨	smxg
㩍	smxh
厹	smxq
擻	smxs
㨛	smyw
搶	snbn
瑲	snbn
擬	snbs
瑳	sncf
搓	sncf
揖	sndf
擑	sndi
撯	sndm
揓	sndv
㻢	sndv
㩪	snfm
抧	sngw
㨥	sngy
㧳	snht
攁	snic
撧	snjk
琄	snkm
捐	snkm
挹	snkv
㩩	snlm
扣	snmf
損	snmm
璊	snmm
㨺	snmm
叴	snmq
擹	snnl
捁	snnm
捛	snnm
瑾	snno
㨷	snno
攤	snnp
匙	snqm
拎	snqx
玲	snqx
指	snrm
珵	snsg
挰	snsg
捉	snsh
珿	snsh
㻍	snug
揲	snvo
㻡	snvo
璇	snvs
抴	snvv
玴	snvv
琷	snvv
扮	snwf
玢	snwg
拀	snwq
操	snxo
璪	snxo
珋	soav
㧕	soav
搊	sobb
扫	sobf
撏	sock
璕	sock
揈	socy
抱	sodb
玸	sodb
㧓	soef
杂	sofq
搞	sogn
琋	sogp
㨞	soih
玓	soii
扚	soii
㺷	soii
瑇	sojn
撴	sojs
㻻	sojs
㨃	sojv
㨯	sojw
挦	sokf
掅	sokm
㨑	solb
㩝	somg
㻏	somi
掃	somp
揨	somr
抅	somx
撎	sone
拘	sonm
玽	sonm
㐝	sonv
摋	soob
撬	sooo
摖	sopg
㻮	sopg
雑	sopr
鸠	soqq
珣	sorm
㧦	sorm
揔	soru
㧾	soru
抨	sosf
玶	sosg
㧌	sotf
抣	soty
揸	soum
㧸	souv
掏	sovt
掬	sowi
挪	sowv
珱	soxc
㧼	soxq
捌	spaj
抑	spav
㨦	spbx
㻳	spca
携	spcc
璓	spcc
㻪	spcc
㧅	spcf
描	spcm
拢	spdf
搑	spdf
珑	spdg
璡	spep
㩢	spfi
瓂	spfs
瑛	spgc
撶	spgg
璍	spgg
掿	spgn
㩦	spgn
㨅	spgy
㩉	sphh
摐	sphs
瑽	sphs
扨	spii
㨲	spio
攙	spji
擕	spjv
㻽	spjv
揜	spld
㔼	splf
拐	spmf
㧆	spmf
撌	spmm
璝	spmm
玿	spnm
招	spnm
擛	spno
㩰	spno
㻤	spon
攃	spop
㨚	spor
璥	spos
擏	spos
擭	sppb
瓁	sppb
	sppb
㩳	sppb
搭	sppw
推	sprf
扸	sprf
琟	sprg
擼	sprm
䧱	sprq
擖	sprv
珩	spsg
扦	sptf
擆	spvf
拾	spwf
珨	spwg
搀	spwj
瑹	spwo
挽	spwq
㻊	spwq
摭	spxo
撨	spxo
瓘	spxp
㩲	spxp
攮	spxx
搽	spyo
插	spyr
㧈	sqbf
㩌	sqdm
拂	sqdr
㨁	sqff
璲	sqge
扞	sqgf
玕	sqgg
攧	sqgm
瑱	sqgw
搷	sqgw
㐤	sqgw
㧰	sqhk
璔	sqir
拌	sqkg
捎	sqkm
琑	sqkm
捅	sqlm
拦	sqmg
瑣	sqmm
摾	sqnb
搃	sqnu
捝	sqnw
珰	sqob
挡	sqob
挮	sqqr
珶	sqqr
掸	sqrl
拃	sqtf
搦	sqtt
拼	sqxg
㻂	sqxg
揂	sqyf
㻥	sqyf
撙	sqyk
琐	sqym
擲	sqyw
撮	srdb
瑙	sreo
琏	srep
摱	srfb
㻴	srfb
打	srff
㩷	srff
㻫	srff
玎	srfg
攐	srfx
㻦	srgn
搨	srhh
搗	srhm
璟	srhy
撔	srhy
捏	srif
㩙	srif
㨪	sril
拶	sriq
琨	srja
掍	srja
捜	srjb
抻	srjj
珅	srjj
㩃	srjo
㩎	srkl
擸	srlf
㼃	srlf
瑆	srlt
旮	srmq
旭	srmq
珂	srnm
抲	srnm
攓	srns
捰	srof
㩟	srof
掲	sron
掦	sror
㻛	sror
揭	srov
㻀	srow
捍	srqg
鵣	srrf
㨶	srrf
鳿	srrg
琩	srrm
鶗	srrm
摷	srro
璅	srro
鳩	srrq
䲥	srrq
撍	srrr
㻸	srrr
揾	srsm
瑥	srsm
擝	srus
琝	sruy
捑	srvc
拽	srve
㩧	srwl
摀	srxo
瑦	srxo
拄	sryf
揦	ssaj
㻝	ssaj
遫	ssep
捒	ssff
㻋	ssfg
抂	ssgf
拝	ssgf
玨	ssgg
珏	ssii
琵	ssja
整	ssjf
攋	ssjm
瓎	ssjm
琶	sskv
挵	ssld
摗	sslq
琴	sslw
提	ssmf
瑅	ssmg
琹	ssof
扏	ssqf
鷘	ssrr
璱	ssse
攷	ssta
敕	sstf
玫	sstg
抛	ssuc
瑟	ssue
慗	ssup
珡	ssyw
㨩	stad
㿱	stav
蜇	stbm
誓	stcy
瑂	stdm
䀸	stdm
㨘	stdm
瑭	stdn
搪	stdn
摫	stdw
折	stef
逝	step
㩚	stfg
裚	stfx
扶	stgf
玞	stgg
揽	stgw
埑	stif
䋢	stih
拆	stii
珉	stja
抿	stja
攠	stjf
擵	stjh
瑉	stjr
㨉	stjr
抄	stkf
捬	stkk
尟	stkm
掂	stlh
捸	stll
㻖	stll
掀	stlq
撳	stlq
搰	stmf
烲	stmi
拡	stmx
䭁	stnc
哲	stnm
踅	stns
梊	stof
毮	stot
晢	strm
㨫	stsm
攅	sttm
瓆	sttm
瓉	sttm
㩫	sttm
撵	sttr
銴	sttw
攆	sttx
掶	stty
捞	stuc
挘	stuc
悊	stup
硩	stvd
拣	stvg
掋	stvi
乴	stvv
捦	stwf
琻	stwg
挷	stwv
娎	stxc
擴	stxg
㼅	stxg
焎	stxo
扩	styf
挍	styf
珓	styg
捃	subf
珺	subg
玘	subg
珒	subg
㺳	subx
勅	sucf
扐	sucf
玏	sucg
擤	sucu
挤	sudr
揵	sudx
珌	suee
㧙	suee
㩑	suef
捕	suff
㺿	sufg
掉	sufm
琸	sufm
璳	sugm
珠	sugw
㧣	sugw
拯	suif
璨	suiw
珳	suke
搏	sukf
㧹	sukf
搝	suld
掭	sulk
璿	sumd
担	sumf
揁	summ
珈	sunm
拁	sunm
㧷	sunm
揚	suor
瑒	suor
㨗	suos
抋	supf
扱	suqf
抈	suqf
玥	suqg
鶒	surr
㨈	surr
斑	susg
搚	suuk
掤	suuq
㻚	suuq
珕	suuu
拹	suuu
璷	suvs
㩤	suvs
抆	suyf
玟	suyg
玦	suyw
抉	suyw
璐	svbn
拓	svdf
撖	svds
㨋	svff
琽	svfg
捠	svgw
瑖	svhb
捳	svhm
紥	svih
抵	svii
拟	sviy
揹	svkm
扟	svlf
揼	svlm
押	svmf
玾	svmg
玛	svng
琛	svof
探	svof
扺	svqf
玚	svre
扬	svre
拞	svrf
捪	svrm
琘	svrm
㺼	svsh
揟	svsk
珤	svtg
扎	svvf
玌	svvg
瑋	svvg
韙	svvm
㐇	svvq
㩡	svvv
㧍	svyf
拤	swal
拭	swcf
攈	swct
㨱	swcy
拱	swff
珙	swfg
瓍	swge
抏	swgf
玩	swgg
撱	swgk
掄	swgp
琡	swhb
掓	swhb
璘	swio
撛	swio
璯	swir
揄	swka
瑜	swka
攟	swlc
撚	swlx
捚	swmf
理	swmg
捡	swmo
掵	swna
挊	swnf
捈	swof
㻌	swof
㧴	swtf
珴	swtg
搖	swvt
瑤	swvt
攗	swwi
摬	swwq
璄	swwq
珧	swwy
挑	swwy
撿	swxh
㩠	swxo
揞	swyf
摝	swyf
辢	swyf
擓	sxap
攊	sxce
瓑	sxce
撅	sxel
摙	sxep
璉	sxep
捙	sxff
搆	sxgi
㻷	sxhh
拺	sxhk
捱	sxii
摶	sxik
瑼	sxik
璤	sxiu
攦	sxiw
挬	sxjv
撒	sxks
拒	sxlb
搙	sxlk
琭	sxll
振	sxlo
䳲	sxlr
抽	sxmf
摳	sxnx
扼	sxon
抠	sxow
㧜	sxpm
㨤	sxpr
搟	sxqg
撣	sxrl
擫	sxrl
措	sxrm
揠	sxrx
摲	sxte
瑚	sxuq
摪	sxwk
璜	sxxg
撗	sxxg
噩	sxxm
䫷	sxxm
抦	sxyw
扽	syaf
授	sybx
揑	sycf
瑧	syct
搸	syct
玠	sydr
扴	sydr
㻅	syeg
擒	syfm
瑷	sygb
揙	sygp
㻞	sygp
捨	syhg
搧	syhh
捣	syhm
㨾	syii
搜	syjb
扵	syjo
珍	syke
抮	syke
捧	sykg
琫	sykg
掮	sykm
捩	syld
摜	symm
瑻	symm
㨭	synk
玱	syon
抢	syon
护	sypf
㧮	syrf
㧶	syrf
瑃	syrm
擠	syrr
璾	syrr
拴	sysg
㻇	sysg
㧉	sytf
璦	syub
揍	syug
㧖	syvv
掜	sywq
㩘	sywt
㼁	sywt
摿	sywy
掼	syym
摏	syyr
璎	syyx
撄	syyx
錢	taaa
㹽	taaa
鈛	taaw
㡲	taay
鎃	taca
庭	tadx
鋌	tadx
䯕	tadx
㹶	tadx
鐥	taen
鍅	taff
猉	tafq
錤	tafw
狨	tagd
䥓	taif
庠	taiy
釗	tajw
釙	talw
鋙	tanm
㹳	tanm
廒	tast
獓	tast
凘	tate
廝	tate
鐁	tate
猀	tatk
䤬	tatk
狅	tatq
鈓	tatw
鐋	taur
骳	tavm
狓	tavq
鍖	tavv
鈹	tavw
䤛	tavw
㿰	tavy
㹾	tban
錣	tbbb
鎟	tbbo
鈬	tbbw
鏠	tbce
鋒	tbcg
鐇	tbcm
鐺	tbcm
㺕	tbcm
㢖	tbcm
獂	tbdq
㺈	tbfb
䥀	tbfb
钂	tbfm
鐣	tbht
鏜	tbif
㹩	tbif
犹	tbii
釵	tbii
䤞	tbii
庝	tbjo
鉖	tbjo
㹣	tbjo
庬	tbki
狵	tbki
鈯	tblv
虿	tbma
萤	tbmf
鑜	tbmm
独	tbmq
狆	tbmq
鈡	tbmw
鉵	tbmw
冲	tbmy
骼	tbnm
狢	tbnm
鉻	tbnm
鏿	tbof
鏛	tbpm
釧	tbrw
鉃	tbtw
鏭	tbup
鎲	tbwq
猁	tcaj
鋓	tcaj
鏫	tcao
䤨	tcaq
凈	tcbb
猙	tcbb
狠	tcbq
鑙	tcbr
銀	tcbw
鈑	tcbx
㡾	tcby
銹	tccc
鑘	tccc
鑸	tcci
鏏	tcco
廬	tccs
獹	tccs
鑪	tccs
髗	tccs
鐪	tccu
鑢	tccu
㢚	tccu
釢	tccw
釱	tcdw
庆	tcdy
㢉	tcej
猥	tcfo
鍡	tcfo
銙	tcfs
骻	tcfs
釭	tcfw
冮	tcfy
鐻	tcgd
㺣	tcha
骺	tchf
銗	tchf
钀	tchl
猇	tchq
虠	tchq
鋵	tchq
錿	tchq
䖐	tchq
鎼	tcht
㥷	tchu
狹	tchw
鋏	tchw
鏍	tcih
鍷	tcii
鋢	tcjv
猨	tckb
鍰	tckb
廚	tckf
鋝	tckf
猬	tckm
獄	tcld
鍎	tcld
錛	tcll
銾	tclm
鸑	tclr
鍬	tcmi
㢒	tcmm
鈿	tcmw
廆	tcmx
鑗	tcol
廭	tcom
鏯	tcoo
猰	tcpc
鍥	tcpc
錼	tcpg
緳	tcph
䥛	tcph
䤿	tcph
㓗	tcph
䥹	tcpw
獠	tcqh
鐐	tcqh
㺔	tcqx
猗	tcrn
錡	tcrn
㢊	tcrn
庵	tcrv
䤶	tcrv
鉌	tctw
鍶	tcup
鏬	tcvl
猺	tcvt
鎐	tcvt
廙	tcwf
鋖	tcxc
錗	tcxc
骽	tcxc
㹻	tcxc
鎅	tcyd
䛓	tcyj
狺	tcyq
䤾	tcyr
㢇	tcyy
鏗	tdbi
鑦	tdbm
䥑	tdbq
釲	tdbw
鋷	tdbx
獆	tdcl
玃	tddb
钁	tddb
鑷	tddd
鑺	tddp
猍	tddq
錸	tddw
鐉	tddw
䚇	tddw
庲	tddy
螷	tdeb
蠯	tdeb
庳	tdel
髀	tdel
猈	tdel
錍	tdel
獐	tdfm
鏱	tdfm
㢓	tdfm
鉺	tdfw
㺦	tdic
髅	tdim
鑠	tdio
㼳	tdja
鑨	tdka
龐	tdka
钃	tdlb
䤼	tdlm
廰	tdlu
省	tdmk
廗	tdmp
眉	tdmv
鉬	tdmw
廏	tdnb
㼺	tdnj
唐	tdnm
錇	tdnm
㲥	tdno
狔	tdnq
鈮	tdnq
鶶	tdnr
鄌	tdnw
廍	tdnw
鐤	tdob
鹛	tdoq
錦	tdpm
狛	tdrq
鏽	tdrr
鶥	tdrr
鉑	tdrw
鍠	tdsg
䯌	tdsq
廳	tdsu
鑑	tdts
㺝	tdts
鑬	tdtw
廜	tdvf
鋦	tdvn
獥	tdvs
䥞	tdvs
銸	tdvv
釶	tdvw
獔	tdwl
獞	tdwm
鐘	tdwm
槼	tdwo
規	tdwq
鋧	tdwq
㹸	tdwq
鬹	tdwr
郿	tdwv
鎁	tdwv
嫢	tdwx
竖	tdyj
鉝	tdyw
㡴	tdyy
鎙	tebu
㡿	tebv
㺆	tecy
凞	tedx
狿	teed
鋋	teed
銩	teff
猅	tefh
䤵	tefh
䨾	tefh
獏	tefq
鉗	tefw
鏌	tefw
鎫	tegb
鐭	tegc
銄	tegn
獈	tegs
鎰	tegs
廄	tehb
體	tehe
獩	teho
鐬	teho
䤠	tehw
鎡	teii
劆	teja
䤜	teja
㡯	teja
廉	tejg
鎌	tejg
䯡	tejg
㺌	tejg
㢘	tejx
鎆	teka
錹	tekm
鐠	tekr
狱	teld
鎞	telj
鏓	telu
庅	temx
庛	tenq
骴	tenq
䤮	teok
迈	tepa
近	tepe
鎚	tepe
㢂	tepm
獅	tepp
䢒	tepy
廐	tera
鉄	tetg
鑮	teuk
鑡	teww
㺜	texo
骸	teyw
䤤	teyw
鍊	tfah
冽	tfaj
䤽	tfak
庑	tfbd
鐂	tfcm
廈	tfdb
獿	tfdb
凄	tfdx
鏪	tfer
獁	tffq
㹤	tffq
鉣	tffw
鋹	tffw
錏	tffw
鎷	tffw
馮	tffy
蒙	tfgd
獮	tfgm
鑈	tfgm
鹲	tfgo
氋	tfgo
鸏	tfgr
猝	tfhl
錊	tfhl
冱	tfhn
凴	tfhq
犺	tfhq
鈧	tfhq
骯	tfhq
獧	tfhx
鐶	tfhx
鉉	tfin
㹡	tfin
猡	tfiq
凙	tfir
鐸	tfir
鏲	tfiu
鎠	tfjf
獶	tfkb
䥳	tfkb
䤳	tfki
凜	tflc
廩	tflc
㺛	tfld
釪	tflf
骬	tflf
㡰	tflf
㵗	tflm
廧	tfln
廪	tflp
凛	tflp
慿	tflu
鋄	tfmb
錽	tfmb
頃	tfmm
頎	tfmm
頝	tfmm
顉	tfmm
顝	tfmm
䥯	tfmn
玀	tfnp
鑼	tfnp
髑	tfob
斶	tfob
獨	tfob
鐲	tfob
錈	tfon
师	tfpm
犻	tfpm
鈰	tfpm
銕	tfqy
㹫	tfqy
鋞	tfrc
㹵	tfrc
凍	tfrh
錬	tfrh
銆	tfrm
㹮	tfrm
骾	tfro
㹴	tfro
釫	tfsa
廅	tfsm
鎑	tfsm
狟	tfum
憑	tfup
鐚	tfup
鈣	tfuv
錻	tfwe
廦	tfwy
鐴	tfwy
庡	tfxq
銥	tfxq
獽	tfxx
鑲	tfxx
颀	tfym
冹	tgbi
鈸	tgbi
䯋	tgbi
鉠	tgcd
㹧	tgcd
髓	tgce
䥦	tgce
䯝	tgck
䤻	tgck
鋼	tgeh
鎹	tgep
㢕	tgep
銏	tggf
㹪	tggf
㓏	tggn
銭	tggw
狪	tghf
銅	tghf
㓊	tghf
䤡	tgif
凋	tgin
錭	tgin
庨	tgjv
㹲	tgjv
髄	tgke
銪	tgkm
狦	tglj
鎓	tgmh
㺋	tgmh
庺	tgmo
鈆	tgmx
鈜	tgmx
獢	tgnn
鐈	tgnn
㢗	tgnn
狫	tgnq
銠	tgnq
銳	tgnw
鈽	tgpm
銬	tgsa
狭	tgsq
錘	tgtw
㓇	tgty
椝	tgwo
览	tgwq
规	tgwq
鬶	tgwr
釟	tgww
鋊	tgyn
鈉	tgyw
䯐	tgyy
鑯	thaf
㺤	thaf
犽	thaq
猭	thaq
䤸	thaq
釾	thaw
冴	thay
庌	thay
鎽	thbc
鋸	thbw
骰	thbx
鈠	thbx
㱼	thbx
鍢	thcm
䥮	thda
鋀	thei
㢄	thei
銊	thff
猯	thfk
鍴	thfk
鐔	thfm
㓕	thfm
銶	thfw
鎘	thgr
猠	thgw
錪	thgw
凒	thhe
鎧	thhe
减	thhf
鍼	thhf
㺂	thhf
廖	thhk
髎	thhk
鏐	thhk
㺒	thhk
鑃	thhp
㺟	thhp
䥘	thhr
㢞	thhw
座	thif
凐	thif
銼	thif
釩	thii
骪	thii
䒮	thii
东	thka
釥	thkw
錄	thll
䤫	thlw
鉛	thnm
凓	thof
䤪	thof
鸫	thoq
㹬	thow
鏢	thpg
銟	thpm
鑴	thpn
凗	thpr
獕	thpr
鏙	thpr
䥴	thpv
釠	thqw
䤱	thte
㧛	thtj
䯏	thtm
狧	thtq
銛	thtw
㓉	thty
懖	thup
鏰	thuu
鋮	thvv
鏚	thwh
䥔	thwi
鋣	thwv
錌	thxq
猄	thyq
鍄	thyw
凉	thyy
鐽	tiae
㺚	tiae
㿭	tiav
髂	tibn
狼	ticb
鋃	ticb
䯖	ticb
㢃	ticb
鎋	ticn
䤲	tidg
䯔	tiej
䤩	tiej
廊	tiew
鎯	tiew
茔	tiff
鏔	tifg
坚	tifj
獱	tifm
鑌	tifm
髕	tifm
錠	tifs
鍹	tifu
釷	tifw
庄	tify
凌	tigb
庱	tigb
錂	tigb
鎵	tigd
錴	tigi
㓐	tigi
鋐	tigm
鐙	tihe
萦	tihk
紧	tihk
銯	tihk
鐖	tiid
斥	tiie
銈	tiif
䯓	tiif
庒	tiii
鋺	tiio
䯛	tiio
鉹	tiiq
㢁	tiiq
獟	tiiw
鐃	tiiw
髐	tiiw
㺙	tijy
庤	tikf
狩	tikf
䯚	tikm
鏥	tikr
䯑	tilm
㹰	tilq
廃	tilw
銧	tilw
廀	timb
䤹	timb
犿	tinf
銘	tinm
鉈	tinq
䟟	tins
猿	tinx
鎱	tinx
鑔	tiop
廇	tipc
鎦	tipc
猔	tipg
錝	tipg
鑧	tipi
髖	tipi
䥉	tipi
錧	tipm
髋	tipw
廢	tiqb
鏺	tiqb
釸	tiqw
狞	tirf
㓑	tiri
狕	tiuc
猤	tiug
鍨	tiug
獰	tiur
鑏	tiur
髌	tivg
㺍	tivg
鋎	tiwg
䯘	tiwg
銨	tixc
䥱	tiyx
民	tjab
刡	tjaj
鈚	tjaw
庇	tjay
狰	tjbb
净	tjbb
蟁	tjbb
錚	tjbb
魔	tjcm
黁	tjcr
穈	tjct
㥸	tjcu
䜆	tjcy
黀	tjdb
鍇	tjdr
鈈	tjdw
劘	tjea
靡	tjef
猻	tjeh
麽	tjem
㸏	tjem
爢	tjex
狉	tjff
鉟	tjff
獯	tjfm
鑂	tjfm
䪸	tjfm
鉦	tjfw
麻	tjfy
鏑	tjgx
狲	tjhk
狝	tjhk
鉨	tjhk
摩	tjht
狴	tjif
塺	tjif
䯗	tjif
縻	tjih
㡱	tjii
麼	tjin
錥	tjkm
銫	tjkv
鈄	tjlf
銔	tjlf
黂	tjlm
廨	tjlu
獬	tjlu
鍗	tjmp
鎊	tjmv
髈	tjmv
麿	tjnn
鉧	tjnw
㭍	tjof
麾	tjot
凚	tjpg
敯	tjrb
昬	tjrm
鴖	tjrr
䳸	tjrr
鈋	tjrw
睯	tjsd
㟩	tjsh
猛	tjsm
錳	tjsm
暋	tjsr
敃	tjst
䵇	tjst
愍	tjsu
䯢	tjtm
㦄	tjup
犘	tjut
磨	tjvd
犼	tjvv
釨	tjvw
䵉	tjwa
糜	tjwi
鍾	tjwm
銃	tjwq
㓍	tjwq
㓆	tjwy
㺅	tjxb
䥥	tjxg
鏟	tjxl
䤥	tjxo
㓒	tjyl
錎	tjyr
䤦	tkaa
銋	tkat
釤	tkew
釽	tkew
寿	tkfg
凟	tkfm
鑟	tkfm
㢋	tkii
銌	tkjv
府	tkkf
鉜	tkkf
焤	tkkm
腐	tkky
䒿	tkmf
肾	tkmj
獛	tkni
鏷	tkni
狤	tknm
銡	tknm
庥	tkof
銝	tkof
㹯	tkof
譍	tkpc
膺	tkpk
䥗	tkpl
噟	tkpn
鹰	tkpo
鷹	tkpr
䧹	tkpr
應	tkpu
銒	tkqg
獙	tkst
䥕	tkst
猴	tkub
鍭	tkub
鋕	tkup
鑄	tkvk
鈀	tkvw
焘	tkxo
鑆	tkyk
鋶	tkyw
鐡	tlae
䥫	tlap
鐵	tlas
猳	tlbb
鍜	tlbb
庋	tlbx
鈘	tlbx
銦	tlcd
秶	tlct
犾	tldq
狏	tldv
鉇	tldv
犲	tlee
釮	tlee
獝	tlen
鐍	tlen
猱	tleo
鍒	tleo
逮	tlep
㺞	tlfg
廟	tlfu
針	tlfw
㓓	tlgr
峱	tlhm
鉆	tlhw
店	tlhy
垐	tlif
銂	tlij
瓷	tlja
鋂	tljn
隶	tllb
銢	tllm
荥	tlmf
資	tlmm
淾	tlmw
冰	tlmy
餈	tlnc
咨	tlnm
鋡	tlnm
䤧	tlnm
楶	tlno
栥	tlof
㺠	tloo
狖	tloq
獖	tlpm
鉓	tlpm
鐼	tlpm
㰝	tlqb
欣	tlqe
䯉	tlqm
欽	tlqw
次	tlqy
鍑	tlrb
錔	tlrm
㹺	tlrm
䳐	tlrr
盗	tlsm
狌	tltq
鉎	tltw
恣	tlup
錜	tlup
狃	tlvq
乲	tlvv
犵	tlvv
釳	tlvv
鈕	tlvw
廡	tlvx
粢	tlwi
鈐	tlww
庈	tlwy
姿	tlxc
凅	tlxf
錮	tlxf
序	tlxy
鑹	tlyf
资	tlym
鎔	tlyn
廁	tmaj
鍘	tmaj
狘	tmaq
鉞	tmaw
銍	tmaw
庢	tmay
废	tmbi
鐳	tmcm
䥷	tmda
逖	tmep
䥂	tmfg
鑭	tmfh
獳	tmfk
鑐	tmfk
狻	tmgb
鋑	tmgb
䤟	tmhq
荧	tmif
狄	tmiq
鈥	tmiw
錟	tmmi
䝨	tmmj
鏒	tmmk
㺑	tmmk
鑽	tmmm
鑅	tmmo
狙	tmmq
狽	tmmq
鐒	tmmu
鉏	tmmw
鋇	tmmw
鍆	tmmw
廮	tmmx
㡹	tmmy
鐹	tmne
冶	tmnm
猧	tmnm
鈶	tmnm
鍋	tmnm
䯞	tmnm
㢐	tmnm
䥨	tmnn
䥤	tmod
䥜	tmof
应	tmoy
髉	tmpr
㺢	tmpr
䥃	tmpr
凕	tmrb
猽	tmrb
鐧	tmrm
銑	tmtw
冼	tmty
鋤	tmuc
悐	tmup
鐗	tmuq
鉾	tmut
㐥	tmuv
狁	tmwq
鈂	tmwq
鈗	tmwq
釞	tmww
廔	tmxc
鏤	tmxc
髏	tmxc
㺏	tmxc
鍕	tmxf
鐦	tmxg
鏼	tmxh
広	tmxy
鋛	tnbm
凔	tnbn
獊	tnbn
鎗	tnbn
凝	tnbs
鏃	tnbt
飡	tncb
鎈	tncf
髊	tncf
鍓	tndf
鎭	tndg
鍦	tndv
鉙	tngw
㡶	tngw
狷	tnkm
鋗	tnkm
鐑	tnkn
邫	tnkv
鏋	tnmm
釦	tnmw
营	tnnm
鋁	tnnm
鋯	tnnm
㢙	tnnu
鉂	tnow
銱	tnpm
冷	tnqx
狑	tnqx
鈴	tnqx
䯍	tnqx
㡵	tnqx
庀	tnqy
鋥	tnsg
趸	tnsh
鋜	tnsh
㹱	tnsh
鋘	tnug
獇	tnvm
鍱	tnvo
鏇	tnvs
猐	tnvv
鉪	tnvv
錓	tnvv
况	tnwq
鈖	tnww
鐰	tnxo
鉚	toav
㡻	toav
归	tobk
鐞	tock
鍧	tocy
狍	todb
庖	todb
鉋	todb
骲	todb
狐	toeq
鈲	toew
荣	toff
鉢	toff
骵	toff
㡷	toff
狇	tofq
鈢	tofw
床	tofy
凇	togm
鎬	togn
髇	togn
狶	togp
䤭	togp
猟	tohk
犳	toii
釣	toii
鉥	toii
獤	tojs
鐓	tojs
錞	tojv
廓	tojw
猜	tokm
凊	tokm
錆	tokm
猣	tolb
鍐	tolb
鋟	tomb
㓎	tomb
㺓	tomm
䥊	tomm
帰	tomp
鈎	tomx
狗	tonm
鉤	tonm
犯	tonq
鎩	toob
鑻	tooh
莺	toqf
鹘	toqm
䴔	toqy
	toqy
狥	torm
銁	torm
鍃	toru
鍯	toru
㺀	toru
毟	totk
憌	totu
鈞	toty
猹	toum
䥋	toux
鋾	tovt
㹼	towi
錰	toxo
錶	toxq
鎄	toxq
廯	tpai
鐌	tpaq
䤝	tpav
鑝	tpbe
鍍	tpbx
㕠	tpbx
鎸	tpcc
猫	tpcm
庿	tpcm
錨	tpcm
㢝	tpct
釖	tpcw
䥩	tpds
庞	tpdy
鑖	tpfi
䯦	tpfi
髒	tpfl
頴	tpfm
鑉	tpfs
鍈	tpgc
㢍	tpgc
鏵	tpgg
鍩	tpgn
狋	tpgq
䥠	tphh
鏦	tphs
㢔	tphs
鎿	tpht
釰	tpii
釼	tpii
鑱	tpji
㺥	tpji
錵	tpjr
鐫	tpjv
凖	tplf
鎨	tplf
㢑	tplf
䥈	tpll
帇	tpmb
钄	tpmh
帅	tpmk
鐀	tpmm
䯣	tpmm
鈻	tpmw
䤢	tpmw
鉊	tpnm
㹦	tpnm
鐷	tpno
䥡	tpno
鏶	tpof
㺃	tpon
銰	tpow
獲	tppb
鑊	tppb
鑓	tppe
鍣	tppn
鎝	tppw
鑥	tprm
猚	tprq
獦	tprv
錐	tprw
准	tpry
㢈	tpry
䯒	tpsg
釺	tptw
䥬	tpuk
鐯	tpvf
錺	tpvy
䥏	tpwa
蒬	tpwi
㝹	tpwi
凂	tpwq
鋔	tpwq
鉿	tpww
冾	tpwy
鑶	tpxd
鏣	tpxo
鐎	tpxo
㺘	tpxo
獾	tpxp
鑵	tpxp
玂	tpxt
鋩	tpxy
鍤	tpyr
㢎	tpyr
鐨	tqdm
狒	tqdr
鉘	tqdr
獼	tqfm
䯟	tqgd
鐩	tqge
骭	tqgm
鋿	tqgn
犴	tqgq
廠	tqgs
釬	tqgw
鎮	tqgw
鏳	tqir
猕	tqjh
鈏	tqjj
鈟	tqjj
冸	tqkg
鉡	tqkg
銷	tqkm
銿	tqlm
䥁	tqlr
鎖	tqmm
鏹	tqnb
鋭	tqnw
猦	tqqq
銻	tqqr
鈼	tqtw
㡸	tqty
庰	tqxg
鉼	tqxg
骿	tqxg
䥖	tqyc
猶	tqyf
鐏	tqyk
荤	traf
库	tray
鎀	trbk
鏅	trbk
蓂	trby
錙	trcm
㺁	treo
獌	trfb
鏝	trfb
鍿	trfc
鏎	trff
㓖	trff
釘	trfw
庁	trfy
㓅	trfy
髃	trgn
庽	trgn
鍝	trgn
銇	trgw
鎉	trhh
鐛	trhy
鎤	tril
䥵	triw
䯥	trix
䥪	trix
猑	trja
錕	trja
鉮	trjj
獵	trlf
鑞	trlf
猩	trlt
鍟	trlt
临	trmj
鎻	trmm
鈤	trmw
鈳	trnm
䯊	trnm
鎶	trnn
廱	trnp
鑳	trns
髁	trof
猓	trof
錁	trof
錫	tror
䯜	tror
猲	trov
鍻	trov
猂	trqg
銲	trqg
鳺	trrg
䲵	trrk
猖	trrm
錩	trrm
鶻	trrm
鏁	trro
㺐	trro
鐕	trrr
鵭	trrw
鵁	trry
鎾	trsm
䯠	trsm
㹭	trve
㡼	trve
鑤	trwl
鎢	trxo
㹥	tryq
鉒	tryw
逛	tsep
鋉	tsfw
凁	tsfy
狂	tsgq
莹	tsii
犱	tsii
釻	tsii
鈺	tsii
骫	tsii
䒯	tsii
獺	tsjm
獭	tsjy
庪	tslb
㢅	tsld
鏉	tslq
㔭	tsma
监	tsmj
鍉	tsmw
骩	tsqm
犰	tsqq
釚	tsqw
鵟	tsrr
䥟	tsrv
錱	tssg
攺	tstb
狾	tste
效	tsty
㤮	tsup
鑩	tsxx
猸	ttdm
鎇	ttdm
鎕	ttdn
斦	ttee
鐮	tteg
㹞	tteq
釿	ttew
庍	ttey
獴	ttfg
廎	ttfm
狮	ttfp
廂	ttfy
㚘	ttgg
鈇	ttgw
冻	tthk
冺	ttja
鈱	ttja
髍	ttjf
鍲	ttjr
鋳	ttkf
庸	ttkj
㣑	ttkk
鷛	ttkr
鄘	ttkw
鈔	ttkw
㩺	ttlb
康	ttll
㱂	ttll
廞	ttlq
鍁	ttlq
劕	ttma
賛	ttmm
質	ttmm
猾	ttmq
鄼	ttmw
鉱	ttmx
啠	ttnm
辇	ttra
替	ttrm
䣠	ttrw
鏞	tttj
㺎	tttj
鏮	tttl
鑕	tttm
鑚	tttm
鐟	tttr
鑫	tttw
㹹	ttty
蓥	ttwf
鉴	ttwj
鍂	ttww
凎	ttwy
輦	ttxf
獷	ttxg
鑛	ttxg
鄻	ttxw
賡	ttym
骹	ttym
鹒	ttyo
犷	ttyq
狡	ttyq
鶊	ttyr
庚	ttyw
鉸	ttyw
赓	ttyy
銉	tubw
鈙	tubx
冿	tuby
㡽	tuby
劢	tuca
劤	tuce
劳	tucf
劣	tuck
䯇	tucm
釛	tucw
効	tucy
鍵	tudx
鉍	tuee
鋽	tufm
䯙	tufm
㹿	tufm
鋪	tufw
庯	tufy
銖	tugw
廫	tuhk
猼	tukf
鍀	tukf
鎛	tukf
髆	tukf
鑁	tulb
㺇	tuld
鏀	tulu
䥧	tumd
鍞	tumm
狚	tumq
鉭	tumw
㡺	tumy
鉫	tunm
㹢	tunm
鎳	tuof
鍚	tuor
想	tupf
鈊	tupw
応	tupy
鈅	tuqw
鈒	tuqw
荦	tutf
鈝	tutw
鎴	tuup
錋	tuuq
釕	tuvw
獋	tuwl
䤴	tuwl
决	tuyw
鈌	tuyw
鈫	tuyw
㹟	tuyw
鏴	tvbn
㺖	tvds
鉐	tvdw
㓈	tvdy
猪	tvfq
鍺	tvfw
鋲	tvgw
鍛	tvhb
鉰	tvhf
鉳	tvhw
骶	tvii
底	tvii
䣌	tviw
鉯	tviy
茕	tvlf
䤣	tvlf
狎	tvmq
鉀	tvmw
庘	tvmy
銽	tvnm
犸	tvnq
冯	tvny
橥	tvof
㹝	tvqq
㡳	tvqy
錉	tvrm
䤺	tvte
䓨	tvtf
䯆	tvvm
釓	tvvw
釔	tvvw
鍏	tvvw
鈁	tvyw
鉲	twal
骮	twam
釴	twaw
鉽	twcf
幚	twdp
粛	twdr
鉷	twfw
㓋	twfy
廛	twgi
䯈	twgm
錀	twgp
鄽	twgw
鈨	twgw
獜	twio
鏻	twio
廥	twir
獪	twir
䯤	twir
銤	twiw
㺄	twka
鍮	twka
㢏	twka
蒄	twkf
廕	twle
鎺	twmm
猃	twmo
狸	twmq
鋰	twmw
㢆	twmy
䥝	twnq
狳	twof
凃	twof
庩	twof
猘	twpa
帮	twpm
䒞	twqf
䥙	twqg
錒	twrn
㢌	twrn
鋨	twtw
鋱	twup
鐿	twup
鐊	twur
邤	twve
邦	twvg
邞	twvg
郊	twvy
邝	twvy
獍	twwq
鏡	twwq
庣	twwy
狣	twwy
銚	twwy
䓻	twxc
獫	twxh
鐱	twxh
㢛	twxh
鑣	twxo
鑰	twxp
鋅	twyw
鏕	twyw
廘	twyy
鉶	txaj
䥰	txbb
㺡	txce
䥶	txce
釹	txcw
獗	txel
鐝	txel
鏈	txep
葷	txff
骷	txfm
狜	txfq
鍔	txfs
鈷	txfw
㺧	txfx
庫	txfy
鈃	txgw
㢀	txhk
鎍	txih
鏄	txik
鏸	txiu
廲	txiw
鋍	txjv
䤯	txke
鏾	txks
鉅	txlb
鎒	txlk
䥎	txlk
録	txll
鋠	txlo
㹨	txmq
鈾	txmw
庙	txmy
䥲	txnl
鉕	txnm
銣	txnm
廤	txnn
鏂	txnx
鈪	txon
鉔	txpm
鑎	txpm
㺗	txrl
猎	txrm
庴	txrm
錯	txrm
䤷	txrx
獑	txte
鏩	txte
猢	txuq
鍸	txuq
錷	txvv
㐣	txvv
鏘	txwk
鋴	txwq
廣	txxg
獚	txxg
鐄	txxg
䥄	txxr
玁	txxs
懬	txxu
鄺	txxw
釯	txyw
鈵	txyw
㹠	tyaq
鈍	tyaw
庉	tyay
鎂	tycd
獉	tyct
骱	tydr
庎	tydr
鈦	tydw
狯	tyeg
蒏	tyff
庼	tyfy
庮	tyfy
猵	tygp
鍽	tygp
猞	tyhg
	tyhh
䥇	tyhh
鉩	tyhk
廋	tyjb
獀	tyjb
鎪	tyjb
鉁	tyke
㓔	tykf
猏	tykm
錑	tyld
贤	tymj
鏆	tymm
狈	tymq
鈩	typw
庐	typy
䯎	tyqg
鑇	tyrr
銵	tyrw
銓	tysg
㓌	tysg
鑀	tyub
凑	tyug
㺊	tyup
獡	tyvx
鎎	tywi
猊	tywq
庂	tywy
庾	tyyw
䏼	uaaa
牫	uaat
鵩	uabr
服	uabx
脡	uadx
膳	uaen
㠱	uafb
群	uaib
羣	uaib
羘	uaiq
䍧	uait
刖	uajq
刘	uajy
牾	uanm
䏸	uanm
䏕	uatq
䏢	uavq
㸨	uavt
腏	ubbb
䘉	ubbb
䘇	ubbb
螡	ubbm
䗞	ubbm
膖	ubce
䐸	ubcf
䏺	ubcg
㸼	ubcg
膰	ubcm
㹉	ubdt
膛	ubif
肬	ubii
牻	ubki
䏵	ubki
朏	ublv
胐	ublv
蚕	ubmg
肿	ubmq
蛮	ubmy
蚉	ubmy
胳	ubnm
胮	uboa
変	ubqy
㸪	ubrt
螤	ubry
攴	ubxh
变	ubxy
斔	ubyy
脷	ucaj
脈	ucaq
臚	uccs
䐛	ucdf
腿	ucep
腲	ucfo
肛	ucfq
䐍	ucfq
胯	ucfs
㹄	ucgb
臄	ucgd
肨	ucgq
㸸	uchf
脥	uchw
膎	ucic
䐯	ucih
㹎	ucih
䐒	ucii
犐	ucjl
脬	ucjv
䐘	uckb
膨	ucke
脟	uckf
㸹	uckf
臌	uclb
腯	ucld
䐐	ucmi
䐆	ucof
䐼	ucph
膫	ucqh
犄	ucrn
䐀	ucrn
腌	ucrv
劓	ucua
鼼	ucua
鼻	ucud
䶌	ucud
齀	ucuj
齆	ucuk
齂	ucul
齅	ucul
䶊	ucul
齇	ucum
齁	ucun
齈	ucuo
腮	ucup
䶎	ucup
鼾	ucuq
䶐	ucur
鼽	ucus
䶑	ucus
齄	ucuu
䶋	ucuu
齃	ucuv
鼿	ucuw
齉	ucux
脮	ucxc
腇	ucxc
剂	udaj
巸	udbf
卢	udbh
臔	udbm
䐅	udbt
臞	uddp
脾	udel
䏪	udfq
颅	udfy
斊	udfy
䑈	udio
朧	udka
犑	udld
脲	udlm
腺	udlm
腛	udma
䐭	udmp
犃	udnm
䏽	udnm
胒	udnq
鼑	udob
鸬	udoq
斎	udpg
胉	udrq
䐹	udrr
齐	udry
䏱	udvn
肔	udvq
牠	udvt
䐖	udwi
朣	udwm
犝	udwm
膧	udwm
斍	udwq
覠	udwq
䏹	udwq
建	udxb
媐	udxc
廽	udxm
熙	udxo
煕	udxo
䏠	udyq
䐚	ueav
覕	uedw
脠	ueed
必	ueep
㪪	uefb
齑	uefd
䪞	ueff
腓	uefh
䨿	uefh
膜	uefq
䐿	uegc
膉	uegs
膁	uejg
腁	uekq
膍	uelj
腜	ueof
䢖	uepb
边	uepc
䢋	uepd
膇	uepe
逋	uepf
迗	uepg
逥	uepm
䏨	uepm
迌	uepq
辽	uepv
这	uepy
鴓	uerr
胅	uetg
牬	uevr
胏	uevr
邲	uewv
膿	uexo
胲	ueyw
㦸	ufaa
脚	ufav
螣	ufbm
㹔	ufcf
謄	ufcy
㹛	ufdb
脜	ufdm
膡	ufdm
逴	ufep
䐬	ufer
騰	ufff
黱	uffm
䲢	uffq
胠	uffq
脹	uffq
	uffq
孒	uffv
㹖	ufgd
臃	ufgp
脺	ufhl
肮	ufhq
牨	ufhq
塍	ufif
縢	ufih
膟	ufil
胘	ufin
䐾	ufir
腝	ufkc
腋	ufki
斋	ufkm
胹	ufkm
䏏	uflf
滕	ufll
膻	uflu
䵡	ufmg
卓	ufmh
脼	ufmm
賸	ufmm
頤	ufmm
頵	ufmm
䪱	ufmm
䐓	ufmm
䫁	ufmm
犤	ufmn
臰	ufnq
臅	ufob
榺	ufof
䏞	ufof
脑	ufol
犈	ufon
腃	ufon
肺	ufpm
幐	ufpm
㬺	ufpm
㸬	ufpm
鰧	ufpq
胰	ufqy
牼	ufrc
脛	ufrc
腖	ufrh
鵫	ufrr
衋	ufrs
肟	ufsa
䐦	ufsm
脻	ufts
㪕	ufub
勝	ufuc
腼	ufum
腾	ufvn
斌	ufwe
贇	ufwm
赟	ufwy
䑀	ufwy
媵	ufxc
裠	ufxq
䑋	ufxx
颐	ufym
㦵	ugaa
胈	ugbi
胦	ugcd
膸	ugce
豚	ugdq
犅	ugeh
遯	ugep
膷	ugew
牺	ugft
胴	ughf
䏥	ugif
䐁	ugii
朕	ugiq
㼡	ugja
肸	uglf
䐥	ugmh
脄	ugmi
鼄	ugmm
䐋	ugmu
肱	ugmx
犞	ugnn
脫	ugnw
办	ugoc
㕟	ugpb
欳	ugpl
鴸	ugrr
肹	ugsa
腄	ugtq
朱	ugwt
邾	ugwv
腳	ugya
肭	ugyw
脔	ugyy
朒	ugyy
䑎	uhaf
腞	uhaq
腒	uhbq
股	uhbx
腷	uhcm
犪	uheb
脰	uhei
斓	uhfh
腨	uhfk
䐺	uhfm
脙	uhfq
膈	uhgr
腆	uhgw
䐲	uhhd
䐩	uhhe
膠	uhhk
臎	uhhl
脞	uhif
䏎	uhii
㞯	uhmb
峦	uhmy
膘	uhpg
膗	uhpr
肌	uhqq
䏦	uhtq
挛	uhty
腰	uhxc
㹁	uhyt
餐	uibc
韰	uibf
㣓	uibk
䝳	uibm
䱗	uibp
粲	uibw
㛑	uibx
斏	uicb
朖	uicb
犗	uicn
氶	uicv
丞	uiff
脀	uifk
臏	uifm
卺	uifo
肚	uifq
腚	uifs
牡	uift
巹	uifu
烝	uifx
肼	uigq
膯	uihe
紊	uihk
㞼	uihm
胿	uiif
腕	uiio
䏧	uiiq
孓	uiiv
膮	uiiw
㹓	uiiw
牸	uijv
特	uikf
胱	uilq
腟	uima
㸰	uinq
肞	uiow
腙	uipg
臗	uipi
歺	uiqh
胀	uitq
膑	uivg
脉	uivi
䳮	uivr
脘	uiwg
胺	uixc
㼢	ujaf
肶	ujaq
膱	ujar
㬹	ujbb
叏	ujbx
肧	ujdq
胚	ujff
臐	ujfm
㪱	ujgc
䐱	ujgx
㹍	ujgx
䏶	ujif
脃	ujkv
㸯	ujlf
觕	ujlq
膪	ujmn
腣	ujmp
膀	ujmv
脴	ujnm
胟	ujnq
牳	ujnt
孪	ujvy
斈	ujvy
腫	ujwm
膽	ujxc
䐮	ujxl
㹌	ujxl
脆	ujxo
䐄	ujyr
蜰	ukbm
胫	ukcf
肜	ukeq
彣	ukey
尃	ukff
犢	ukfm
㝵	ukfm
肘	ukfq
対	ukfy
犋	ukgw
㪯	ukgy
臮	ukhw
胕	ukkf
㸿	ukmh
㹒	ukni
㸵	uknm
䏫	ukof
䑉	ukui
䏯	ukup
㹗	ukvk
肥	ukvq
㸭	ukvt
膕	ulaf
犌	ulbb
腵	ulbb
肢	ulbx
胭	ulcd
㸶	ulcd
腔	ulcf
䐃	ulct
肰	uldq
臭	uldr
胣	uldv
㸱	uldv
腬	uleo
䑂	ulfg
斖	ulgm
腩	ulgr
胋	ulhq
脢	uljn
忝	ulkg
卣	ullb
逌	ulle
㬳	ullf
沗	ullg
䚃	ullw
膣	ulma
邉	ulne
㔽	ulnm
鬯	ulnq
鹾	uloc
㬷	ulof
禼	ulom
卤	ulow
膹	ulpm
肷	ulqq
腹	ulrb
脌	ulrf
卥	ulri
腘	ulsi
胜	ultq
牲	ultt
䴝	ulub
鹺	uluc
鹻	ulug
鹹	uluh
鹼	uluh
䴚	uluh
䴛	uluk
鹶	ulul
䴜	ulum
腍	ulup
䴞	ulup
鹷	uluq
膓	ulur
鹵	uluw
鹸	uluy
邊	ulve
䏝	ulvi
	ulvi
䫵	ulvm
䏔	ulvq
肐	ulvv
膴	ulvx
臱	ulvy
㓙	ulvy
肣	ulwq
鄓	ulwv
㮚	ulyo
膃	ulys
胵	umaq
敹	umbs
㸻	umbt
㭀	umch
遉	umep
叡	umfb
㕡	umfb
㕢	umfb
㪫	umfb
㲊	umfb
睿	umfd
䪥	umff
斕	umfh
䑌	umfh
壑	umfi
壡	umfi
臑	umfk
㹘	umfk
䜭	umfn
朘	umgb
脧	umgb
承	umic
犊	umjc
肻	umkm
㹙	ummd
貞	ummh
腅	ummi
犙	ummk
臢	ummm
鼂	ummm
㹚	ummn
䏣	ummq
㸽	ummt
朥	ummu
䑍	ummx
臜	ummy
膼	umne
胎	umnm
卨	umnm
腡	umnm
膤	umob
臛	umpr
㹊	umpr
膶	umsg
䏬	umut
䏙	umwq
膢	umxc
腪	umxf
㹆	umxf
脓	umxq
亟	unbf
凾	unbl
焏	unbx
㚙	uncd
䐤	uncf
䐕	undf
迦	unep
駕	unff
袈	unfx
胑	ungw
脶	ungy
㧝	unht
䑆	unic
加	unmc
吞	unmg
賀	unmm
䐽	unmm
䐣	unmm
吢	unmp
吿	unmt
叾	unmv
吝	unmy
牿	unnm
㬶	unnm
㖙	unnn
㹏	unno
喸	unnq
臙	unnx
架	unof
毠	unot
㔔	unov
牝	unqt
朎	unqx
㸳	unqx
脂	unrm
哿	unrn
鴐	unrr
鼌	unrv
脭	unsg
㠰	unub
脵	unug
㤎	unup
䂟	unvd
驾	unvn
䐑	unvo
乫	unvv
朑	unvv
㔖	unvv
嗧	unwp
朌	unwq
肦	unwq
㸮	unwt
䪪	unwy
妿	unxc
臊	unxo
㬽	unxs
贺	unym
㓷	uoaj
犓	uobb
䐢	uobb
胞	uodb
褜	uodx
胍	uoeq
臬	uofr
栾	uofy
犒	uogn
䐧	uogn
脪	uogp
膆	uoih
肑	uoii
甈	uoja
臲	uojo
犜	uojs
㬿	uojs
朜	uojv
犉	uojv
腈	uokm
朡	uolb
賾	uomm
朐	uonm
胊	uonm
脎	uoof
胸	uool
脳	uool
膬	uooo
﨤	uooq
鸾	uoqy
㦹	uora
物	uore
昜	uore
肳	uore
逿	uore
脗	uorn
䬗	uorq
鷍	uorr
䐇	uorr
敭	uors
惣	uoru
㹅	uoru
胓	uosq
牦	uott
䏛	uoty
脝	uouv
脿	uoxq
膝	uoyl
赜	uoym
䐪	upcc
胧	updq
䑅	upfi
膵	upfl
朠	upgc
䏡	upgq
臓	uphd
䐫	uphs
牣	upii
肕	upii
䏰	upiu
㸾	upiu
㬸	upjr
臇	upjv
帬	upmb
䑊	upme
膭	upmm
牭	upmt
臒	uppb
䐳	upqq
脽	uprq
䏒	uprq
臈	uprv
胻	upsg
脕	upwq
䏩	upwq
臟	upxd
膲	upxo
䑏	upxp
㬻	upxp
䐠	upxp
弯	uqby
胇	uqdr
䐈	uqfq
䐙	uqfq
犆	uqft
肝	uqgq
㸩	uqgt
䐜	uqgw
䏖	uqjj
胖	uqkg
䏴	uqkm
䐝	uqmm
膙	uqnb
脱	uqnw
䏲	uqqr
胙	uqtq
䐞	uqtt
㸲	uqtt
胼	uqxg
剤	uraj
䐰	urbk
㹋	urbk
䐉	urcm
腦	ureo
腢	urgn
䐊	urja
胂	urjj
犣	urlf
臘	urlf
腥	urlt
昋	urmg
牱	urnm
胢	urnm
桌	urof
腂	urof
㹇	urov
䏷	urqg
鵘	urrb
鵏	urrf
鴌	urrg
鴠	urrm
䲯	urrq
䐶	urrr
斉	urry
鳼	urry
鴍	urry
鵉	urry
腽	ursm
㲃	urtb
奣	uruq
犦	urwl
脨	usfq
肒	usii
盙	usmf
䐎	usmq
肍	usqq
改	ustb
䏳	uste
牧	ustt
膅	utdn
臁	uteg
肵	uteq
㸫	utet
朦	utfg
䑃	utfg
肤	utgq
胨	uthk
脏	utif
腑	utkk
䏚	utkq
䑇	uttm
銮	utwy
胶	utyq
㬵	utyq
蝅	uubm
㪊	uubx
肋	uucq
牞	uuct
䑄	uucu
胪	uudb
脐	uudr
腱	uudx
犍	uudx
䏟	uuee
脯	uufq
胁	uugo
䏭	uugw
膊	uukf
䝺	uumm
胆	uumq
鹏	uuoq
腸	uuor
忌	uupb
㤁	uupg
㤂	uupq
息	uupr
忞	uupy
恋	uupy
朋	uuqq
䏜	uuqq
蠺	uurb
鵋	uurr
鵬	uurr
牪	uutt
劦	uuuc
繠	uuuh
脅	uuuk
䝱	uuum
橤	uuuo
惢	uuup
犇	uuut
勰	uuuu
朤	uuuu
脇	uuuu
姭	uuux
㽰	uuvs
鄎	uuwv
䏮	uuwy
䏐	uuyw
䐗	uvfq
腶	uvhb
䏤	uvhf
胝	uvii
牴	uvii
胛	uvmq
肠	uvre
敷	uvst
懯	uvsu
劜	uvvc
乶	uvvf
甩	uvvq
肊	uvvq
臫	uvvr
㐎	uvvy
旉	uvyf
肪	uvyq
牥	uvyt
胩	uwal
㬴	uwfq
腀	uwgp
朊	uwgq
䏓	uwgq
膦	uwio
脒	uwiq
膾	uwir
㪰	uwiy
腧	uwka
臯	uwlf
翺	uwlh
膩	uwlm
顄	uwlm
㹑	uwlm
鷱	uwlr
函	uwlv
腻	uwly
量	uwmm
脸	uwmo
䤚	uwmq
㫕	uwqm
臆	uwup
脦	uwup
郡	uwvb
邔	uwvb
郙	uwvf
郋	uwvr
朓	uwwy
脁	uwwy
臉	uwxh
犥	uwxo
臕	uwxo
膌	uwyk
腤	uwyq
膔	uwyq
辠	uwyr
妀	uxcb
肗	uxcq
娈	uxcy
犕	uxel
腭	uxfs
牯	uxft
䐟	uxgi
膞	uxik
脖	uxjv
㹀	uxjv
䐂	uxll
脤	uxlo
牰	uxmt
膒	uxnx
焄	uxob
犡	uxpn
䐷	uxrl
腊	uxrm
腗	uxud
䏘	uxwq
䐻	uxwy
䐵	uxxg
牤	uxyt
刔	uyaj
肫	uyaq
犧	uyci
肽	uydq
脍	uyeg
犏	uygp
斒	uygp
䐔	uygp
膄	uyjb
胗	uyke
䏾	uykg
贞	uymh
䐏	uyrm
臍	uyrr
鴂	uyrr
牷	uysg
䏗	uytq
腠	uyug
夬	uywb
犔	uywi
腉	uywq
犠	uywt
腴	uyyw
碊	vaaa
踐	vaaa
䂝	vaad
破	vacd
跛	vacm
磰	vaen
䃆	vafd
踑	vafm
骐	vafn
矵	vajd
㓡	vajt
䟔	valm
䂸	vanf
磝	vast
缷	vavt
磡	vavu
碪	vavv
踸	vavv
磲	vaxo
䟾	vbbb
䘄	vbbm
磉	vbbo
磻	vbcm
蹯	vbcm
旙	vbcm
礑	vbcm
䪛	vbcm
䀾	vbdm
礃	vbht
罉	vbht
骚	vbib
蹚	vbif
䂘	vbii
䟕	vbii
䂢	vbjo
驿	vbkg
硥	vbki
础	vblv
磙	vbmx
硌	vbnm
踟	vbnm
骆	vbnm
路	vbnm
唘	vbnm
鹭	vbno
鷺	vbnr
䠦	vbnr
跭	vboa
䂫	vboa
驯	vbrn
䂠	vbtd
驭	vbxn
䂰	vcaj
硍	vcbd
跟	vcbm
礧	vccc
磃	vcch
蹏	vcch
罏	vccs
驮	vcdn
夨	vcdv
跶	vcep
蹆	vcep
矼	vcfd
碨	vcfo
跨	vcfs
缸	vcft
躆	vcgd
䂜	vcgd
缿	vchf
硤	vchw
蹊	vcic
磎	vcic
骡	vcih
磥	vcih
䃎	vcii
䠑	vcii
䟹	vckf
碷	vcld
踲	vcld
踬	vcly
躞	vcmb
踿	vcmi
碽	vcmm
䠡	vcmm
䟧	vcmm
乪	vcmv
磈	vcmx
䰩	vcmx
礂	vcnm
磤	vcob
踩	vcof
跥	vcof
磢	vcoo
碶	vcpc
蹽	vcqh
䃣	vcqx
䫯	vcrm
骑	vcrn
踦	vcrn
旑	vcrn
碕	vcrn
硽	vcrv
䃴	vcvf
罅	vcvl
磘	vcvt
䠛	vcvt
冀	vcwf
踒	vcxc
䂴	vcyd
䂵	vcym
誉	vcyo
蹈	vcyr
韜	vcyr
蹑	vdbb
䯅	vdbb
骤	vdbi
䃘	vdbi
䠫	vdbi
䠇	vdbl
礥	vdbm
踙	vdbx
韟	vdcl
躩	vddb
躡	vddd
䂾	vddd
骕	vddg
躣	vddp
䠣	vddw
碑	vdel
䠋	vdel
跿	vdfm
碾	vdhf
蹍	vdhf
礫	vdio
躒	vdio
骣	vdjj
礲	vdka
躘	vdka
䠱	vdlb
䠐	vdld
聼	vdlu
䠎	vdma
蹛	vdmp
踣	vdnm
碚	vdnm
䍌	vdnm
屔	vdnq
跜	vdnq
䃇	vdpm
碿	vdqk
砶	vdrd
䃤	vdrr
饏	vdsc
敢	vdst
憨	vdsu
礛	vdts
䠧	vdvf
驰	vdvn
跼	vdvn
礉	vdvs
躈	vdvs
踂	vdvv
蹱	vdwm
䃥	vdwm
䃯	vdwo
硯	vdwq
覩	vdwq
砬	vdyd
磀	vebe
虱	vebm
硟	veed
乒	veer
䠊	vefh
䟦	vegb
礇	vegc
践	vegm
砋	vehd
趾	vehm
䠩	veho
	vehv
磁	veii
礠	veiu
矺	veja
磏	vejg
碰	vekj
踫	vekj
疏	veky
磇	velj
䠘	velj
硇	velo
骢	velu
踽	venn
䠕	veno
跐	venq
䂣	venq
踄	veok
磓	vepe
違	vepv
䢍	vepy
疎	vesf
跌	vetg
礴	veuk
䃩	vexo
砭	vexp
䟪	vexp
䍇	vexp
骇	veyw
硋	veyw
踋	vfav
礓	vfcf
硛	vfdg
跡	vfdg
䃀	vfdx
蹧	vfer
砝	vffd
碼	vffd
䂻	vffd
䃁	vffd
丗	vfff
䠮	vfff
丠	vffh
䟩	vffm
䠆	vffm
厾	vffv
刁	vffv
韔	vffv
䃵	vffx
䃶	vffx
骊	vfgi
躎	vfgm
䃑	vfhb
碎	vfhl
踤	vfhl
砊	vfhq
䟘	vfhq
䃲	vfhs
礋	vfir
卐	vfjf
碝	vfkc
趶	vflf
䍂	vflf
䃪	vflu
碩	vfmm
䠃	vfmm
帯	vfmp
躅	vfob
韣	vfob
砞	vfof
韎	vfof
踡	vfon
礟	vfoo
䟛	vfpm
跠	vfqy
硜	vfrc
踁	vfrc
硬	vfro
磕	vfsm
踕	vfts
礮	vfty
䂶	vfuc
䟚	vfud
碔	vfwe
䟼	vfwe
矹	vfwq
礔	vfwy
躃	vfwy
骧	vfxx
躟	vfxx
硕	vfym
跋	vgbi
韍	vgbi
㸔	vgdm
硚	vgdr
骄	vgdr
碙	vgeh
罁	vgeh
䃃	vgex
硒	vgfd
跴	vgfm
砃	vgfy
跚	vggf
硐	vghf
硺	vgii
碉	vgin
䃝	vgjs
硣	vgjv
踍	vgjv
礄	vgnn
蹻	vgnn
硓	vgnq
硖	vgsd
㻹	vgsi
硾	vgtd
跃	vgtm
䍋	vgtt
趴	vgwm
砚	vgwq
兵	vgwr
踯	vgwv
硲	vgyn
䪏	vgyw
䟜	vgyw
砑	vhad
䃸	vhaf
蹴	vhbi
踞	vhbm
段	vhbx
殾	vhbx
砓	vhbx
䟝	vhbx
蹮	vhcd
躚	vhce
踾	vhcm
䃬	vhcm
䛐	vhcy
覗	vhdw
躨	vheb
踹	vhfk
磹	vhfm
罈	vhfm
䟵	vhfm
司	vhfv
骁	vhfw
硗	vhfw
跷	vhfw
碳	vhgm
䃒	vhgr
碘	vhgw
䠄	vhgw
磖	vhhd
磑	vhhe
碱	vhhf
磟	vhhk
蹘	vhhk
躍	vhhp
䃭	vhhu
翥	vhhx
翈	vhhx
䃌	vhif
䂳	vhif
䟶	vhif
矾	vhii
孠	vhjv
硶	vhlw
䟖	vhmm
岳	vhmr
跺	vhof
砜	vhow
骠	vhpg
磦	vhpg
磪	vhpr
矶	vhqd
碋	vhrn
踨	vhsh
䟯	vhtm
挙	vhto
硙	vhub
蹦	vhuu
磞	vhuu
磩	vhwh
䠞	vhwh
磮	vhwp
硸	vhxq
䃄	vhyd
踥	vhym
躂	viae
䃮	viae
碦	vibn
踉	vicb
硠	vicb
磍	vicn
硳	vidg
䢑	viep
㲳	viet
㘳	vifh
礗	vifm
碇	vifs
碹	vifu
碐	vigb
踜	vigb
踛	vigi
硡	vigm
磴	vihe
蹬	vihe
䠬	vihw
磯	viid
硅	viif
跬	viif
躖	viif
碗	viio
踠	viio
氐	viiq
跢	viiq
乓	viir
乄	viiv
䠪	viiv
磽	viiw
蹺	viiw
跱	vikf
蹜	vikr
硄	vild
砯	vilm
䃔	vinn
砣	vinq
跎	vinq
驼	vinq
䪑	vinq
磔	vioo
䃰	viop
鸱	vioq
骝	vipc
磂	vipc
蹓	vipc
踪	vipg
碂	vipg
骔	vipg
䠉	vipm
蹳	viqb
矽	viqd
䍆	virf
鴟	virr
㪆	viub
骙	viug
䠏	viug
邸	viwv
䯃	vixc
以	viyw
砒	vjad
砙	vjad
旘	vjar
缻	vjat
瓬	vjay
碀	vjbb
踭	vjbb
买	vjcd
䃈	vjdr
碄	vjfd
蹢	vjgx
䂧	vjhk
卌	vjjf
跸	vjlf
骅	vjlf
确	vjlq
碲	vjmp
蹄	vjmp
磅	vjmv
䠙	vjmv
砪	vjnd
踎	vjnm
驺	vjob
砌	vjpc
䟙	vjpc
矷	vjvd
礎	vjvs
踵	vjwm
䟲	vjwq
䪜	vjxc
䃫	vjxc
䠨	vjxc
跪	vjxo
硊	vjxo
㫉	vjxo
礏	vkag
硁	vkcf
韥	vkfm
举	vkgo
丮	vkgv
跊	vkgw
跗	vkkf
驸	vkkf
䂤	vkkf
䟮	vkld
背	vkmh
蹼	vkni
硈	vknm
硏	vkqg
䠥	vkst
䃷	vkui
躊	vkvk
跁	vkvm
鄁	vkwv
硫	vkyd
䟽	vkym
旈	vkyy
䃱	vlaf
碬	vlbb
蝨	vlbb
䪗	vlbb
䠍	vlbb
跂	vlbx
骃	vlcd
䂩	vlcd
硿	vlcf
碅	vlct
䠅	vlct
砤	vldv
䟥	vlee
蹫	vlen
蹂	vleo
韖	vleo
迅	vlep
礖	vlfg
氒	vlfq
卂	vlfv
乎	vlfw
砧	vlhd
䟢	vlhk
跕	vlhm
䍄	vlht
䪓	vlhv
踇	vljn
䠌	vlkm
䃐	vlld
泵	vlmd
砅	vlmd
氹	vlmv
蹿	vlnb
硘	vlnm
䠚	vloe
硱	vlof
砍	vlqd
砽	vlqd
缼	vlqt
䪖	vlrb
踏	vlrm
䂿	vlrm
鳵	vlrr
踗	vlup
䂼	vlup
砖	vlvi
躌	vlvo
矻	vlvv
乯	vlvv
趷	vlvv
砛	vlwd
趻	vlwm
䂛	vlxd
躥	vlyf
跮	vmam
䟠	vmam
骖	vmck
碜	vmck
礌	vmcm
躝	vmfh
䃹	vmfh
礝	vmfk
骏	vmgb
踆	vmgb
旀	vmhk
煑	vmif
砠	vmmd
礯	vmmh
磣	vmmk
䠁	vmml
礸	vmmm
跙	vmmm
躦	vmmm
䟺	vmmm
驵	vmmn
磱	vmmu
躜	vmmy
骀	vmnm
跆	vmnm
碢	vmnm
踻	vmnm
带	vmpm
確	vmpr
礭	vmpr
躙	vmpr
䃻	vmqu
躢	vmrh
磵	vmrm
礵	vmtf
骦	vmtf
跣	vmtm
礀	vmuq
韗	vmxf
蹌	vnbn
礙	vnbs
䃚	vnbt
蹉	vncf
磋	vncf
䍉	vngw
䯄	vngy
礢	vnic
磒	vnmm
蹣	vnmm
䠝	vnmm
硞	vnnm
㗯	vnnq
驶	vnow
䂗	vnqd
砱	vnqx
跉	vnqx
䍅	vnqx
踀	vnsh
蹀	vnvo
碟	vnvo
韘	vnvo
䃠	vnvs
跇	vnvv
砏	vnwd
躁	vnxo
跑	vodb
砲	vodb
䂞	vofd
砵	voff
缽	voff
罙	vofp
硹	vogm
碻	vogn
趵	voii
䟣	voii
碡	vojn
礅	vojs
蹾	vojs
韕	vojv
碃	vokm
骎	vomb
磧	vomm
蹟	vomm
碠	vomr
驹	vonm
跔	vonm
驳	voow
䂚	voow
磜	vopg
鸭	voqm
砰	vosd
䍈	vost
蹅	voum
碴	voum
踘	vowi
䪕	vowi
碛	voym
踱	vpbx
䠜	vpdf
礷	vpds
飛	vped
飝	vped
跹	vpep
蹝	vpes
礣	vpfi
韤	vpfi
礚	vpfs
碤	vpgc
韡	vpgg
蹃	vpgn
蹹	vphh
躏	vphp
磫	vphs
蹤	vphs
韌	vpii
硴	vpjr
蹪	vpmm
䃊	vpmm
驷	vpmn
躪	vpmp
帋	vpmq
磼	vpof
礤	vpop
砹	vpow
䪝	vppb
碓	vprd
踓	vprm
骓	vprn
躤	vprr
礍	vprv
䟰	vpsg
礡	vpuk
躇	vpvf
䂷	vpvh
硆	vpwd
跲	vpwm
飞	vpwv
韐	vpwv
蹒	vpxh
礁	vpxo
蹠	vpxo
罐	vpxp
礶	vpxp
䠰	vpxp
硭	vpxy
䍎	vpyx
砩	vqdr
韚	vqfv
矸	vqgd
䃍	vqgd
䠔	vqgd
礈	vqge
䠀	vqgn
罕	vqgp
磌	vqgw
蹎	vqgw
跞	vqhk
砾	vqhk
蹭	vqir
磳	vqir
跘	vqkg
硝	vqkm
踃	vqkm
韒	vqkm
踊	vqlm
硧	vqlm
踴	vqlu
䃨	vqnb
䂱	vqnw
碸	vqqd
䃅	vqrl
砟	vqtd
䟭	vqtm
骈	vqxg
硑	vqxg
缾	vqxg
跰	vqxg
磸	vqyc
䠓	vqyf
蹲	vqyk
罇	vqyk
躑	vqyw
砗	vrad
碯	vreo
矴	vrfd
蹕	vrff
韠	vrff
䟓	vrfm
䫒	vrfm
蹋	vrhh
䪚	vrhh
礘	vrix
䃂	vrja
砷	vrjj
躐	vrlf
䃳	vrlf
䃏	vrlt
罎	vrme
驲	vrmn
舝	vrmo
昏	vrmq
砢	vrnm
跒	vrnm
骒	vrof
踝	vrof
䂺	vrof
踢	vror
碣	vrov
䲽	vrrd
鴨	vrrm
䲭	vrrq
䃡	vrrr
鴋	vrry
韞	vrsm
跩	vrve
䃖	vrxo
砫	vryd
跓	vrym
驻	vryn
䪒	vryv
蛋	vsbm
䢟	vsep
踈	vsfm
疋	vshv
砡	vsii
䠭	vsjm
胥	vskm
硦	vsld
砕	vslf
碮	vsmd
踶	vsmm
䪘	vsmv
㿿	vssm
䟷	vste
放	vsty
疍	vsum
躕	vtck
磄	vtdn
斫	vted
斱	vtef
礞	vtfg
蹞	vtfm
砆	vtgd
趺	vtgm
䂯	vtif
跅	vtii
䂨	vtii
䂥	vtja
䟨	vtja
䃺	vtjf
䃉	vtjr
礳	vtjv
砂	vtkd
踌	vtkf
䟞	vtkm
踮	vtlh
䠈	vtll
䠖	vtln
䃢	vtlq
磆	vtmd
砿	vtmx
礩	vttm
躓	vttm
碒	vtwd
躔	vtwi
礦	vtxg
矿	vtyd
䂭	vtyd
跤	vtym
䍊	vtyt
硉	vubd
劯	vucd
跻	vudr
踺	vudx
旔	vudx
䪐	vuee
䟤	vuee
踔	vufm
䂽	vufm
䪔	vufv
硃	vugw
跦	vugw
碍	vukf
磗	vukf
䪙	vukf
䠗	vuld
硵	vulo
磠	vulu
碵	vumm
跏	vunm
碭	vuor
踼	vuor
砐	vuqd
趿	vuqm
跀	vuqm
㸴	vutd
跽	vuup
硼	vuuq
砇	vuyd
砄	vuyw
缺	vuyw
趹	vuyw
骥	vvcw
砳	vvdd
跖	vvdm
踷	vvfm
碫	vvhb
堃	vvif
砥	vvii
䟡	vvii
㼱	vvja
书	vvji
码	vvnd
䬡	vvpd
䟗	vvqm
䂡	vvrd
砀	vvre
碈	vvrm
䟬	vvrm
㔏	vvva
磊	vvvd
乭	vvvd
乽	vvvf
䎞	vvvf
骉	vvvn
乜	vvvv
乥	vvvw
趽	vvym
硔	vwfd
碖	vwgp
踚	vwgp
踧	vwhb
䉾	vwih
磷	vwio
蹸	vwio
踰	vwka
䃋	vwka
䟸	vwld
蹨	vwlx
䂹	vwmi
硷	vwmo
验	vwmo
硢	vwof
䟻	vwof
硪	vwtd
㫅	vwud
䂙	vwvd
都	vwvf
邶	vwvh
邱	vwvr
郼	vwvv
邡	vwvy
跳	vwwy
罀	vwwy
䂪	vwwy
礆	vwxh
䠯	vwxp
䃙	vwyd
蹐	vwyk
蹗	vwym
骍	vwyn
硎	vxaj
礰	vxce
蹶	vxel
韛	vxel
蹥	vxep
䃛	vxep
硨	vxfd
䡤	vxff
軰	vxfh
跍	vxfm
研	vxgd
韝	vxgi
䃓	vxgi
趼	vxgm
蹰	vxhk
䟱	vxhk
揅	vxht
磚	vxik
韢	vxiu
躧	vxiw
䃟	vxks
䃗	vxla
距	vxlb
磭	vxlk
碌	vxll
䟿	vxll
䟴	vxlo
煮	vxof
砈	vxon
缹	vxot
驱	vxow
砸	vxpm
礪	vxpn
磾	vxrl
䠤	vxrl
碏	vxrm
踖	vxrm
骋	vxsa
砺	vxta
䠒	vxuq
䊙	vxwi
蹡	vxwk
磺	vxxg
礹	vxxs
砘	vyad
砼	vycf
斺	vydr
砎	vydr
碥	vygp
蹁	vygp
骗	vygp
骟	vyhh
㫆	vyhk
旕	vyjn
於	vyjo
㫈	vyjo
乻	vyjv
㫇	vyjv
跈	vyke
䂦	vyke
罆	vymm
躀	vymm
跄	vyon
磶	vyox
驴	vypn
踳	vyrm
躋	vyrr
硂	vysg
跧	vysg
砨	vyvv
礒	vywt
乆	vywv
㫃	vywy
蹖	vyyr
餞	waaa
䧖	waaa
䄀	waap
陂	wacv
饍	waen
粸	wafi
祺	wafp
麒	wafy
禥	waif
祥	waip
䬺	waiw
刓	wajg
祴	wald
卡	walh
䃼	walp
䧕	wanf
隞	wast
祍	watp
飪	watw
糂	wavv
㵷	wawy
麔	wban
糌	wbar
餟	wbbb
䄌	wbbb
粎	wbbi
韼	wbce
韸	wbcg
䧏	wbcg
䊩	wbcm
䴨	wbdy
䧝	wbfb
隆	wbfl
䃧	wbfv
祎	wbgp
糔	wbib
糛	wbif
隚	wbif
饄	wbif
韷	wblv
飿	wblv
蛬	wbmf
祌	wbmp
䖸	wbmt
䦿	wbmv
蝕	wbmw
餎	wbnm
䧄	wbnm
降	wboa
饓	wbof
䊝	wbup
限	wcbv
䬶	wcbw
阪	wcbx
粄	wcbx
飯	wcbx
禠	wcch
檃	wcco
櫽	wcco
礽	wccp
隱	wccu
䭡	wccu
类	wcdi
邎	wcee
䌛	wceh
式	wcfa
䉺	wcfi
隈	wcfo
餵	wcfo
陓	wcfs
䪦	wcfy
禝	wcgb
隵	wcha
䖎	wchq
陜	wchw
粰	wcjv
禐	wckb
餴	wcll
畨	wcmi
陝	wcmm
䧃	wcmv
隗	wcmx
餽	wcmx
禧	wcnm
糦	wcnm
饎	wcnm
隠	wcou
禊	wcpc
䭜	wcqh
䧦	wcqx
麘	wcrm
陭	wcrn
䄎	wcrn
餣	wcrv
䄋	wcrv
麇	wcty
禗	wcup
䊰	wcvf
禩	wcwf
糞	wcwf
辯	wcwy
餒	wcxc
餧	wcxc
䧌	wcxc
䴧	wcxc
䚻	wcyq
饀	wcyr
䧟	wcyr
䴦	wcyy
巷	wdbf
祀	wdbp
陬	wdbx
䧒	wddv
饌	wddw
陴	wdel
禆	wdel
粺	wdel
障	wdfm
麞	wdfm
陡	wdfv
餌	wdfw
隴	wdka
陪	wdnm
餢	wdnm
䊊	wdot
䬿	wdot
糏	wdqk
粕	wdri
䊥	wdrr
隍	wdsg
韹	wdsg
餭	wdsg
䊗	wdsg
䄓	wdsg
糮	wdts
祂	wdvp
阤	wdvv
䪧	wdvy
䭚	wdwm
粯	wdwq
視	wdwq
䧋	wdwq
粒	wdyi
卸	weav
甙	wefa
陫	wefh
粓	wefi
糢	wefi
饃	wefw
隩	wegc
餉	wegn
隘	wegs
禮	wehe
饖	weho
祉	wehp
阯	wehv
糍	weii
禌	weii
籷	weja
飥	weja
隒	wejg
䭑	wejg
糋	weka
餠	wekq
阩	weld
陞	weli
欫	welq
陹	welr
䧭	welu
粬	wemi
䄔	wenn
禖	weof
騭	weof
陟	weok
骘	weov
䊚	wepe
䭔	wepe
远	wepg
迷	wepi
祑	wetg
䭦	weuk
䣃	wewv
辩	wewy
禯	wexo
陔	weyw
䬵	weyw
麠	wfcf
䊫	wfef
糟	wfer
䄚	wfer
弌	wffa
粻	wffi
祛	wffp
禡	wffp
阹	wffv
䧞	wffv
餦	wffw
禰	wfgm
隬	wfgm
禤	wfhh
粹	wfhl
祽	wfhl
粇	wfhq
阬	wfhq
糫	wfhx
䭞	wfir
陾	wfkc
餪	wfkc
糥	wfkk
陑	wfkm
粫	wfkm
饘	wflu
䄠	wflu
頑	wfmm
頪	wfmm
㹕	wfmu
饠	wfnp
粖	wfof
䬴	wfof
䄜	wfom
䊎	wfon
韴	wfpm
䧅	wfqy
螴	wfrb
陘	wfrc
䪫	wfrc
陳	wfrh
陌	wfrm
粨	wfrm
粳	wfro
敶	wfrs
饁	wfsm
糆	wfum
糬	wfvf
陚	wfwe
阢	wfwq
隦	wfwy
餏	wfxq
䧇	wfxq
禳	wfxx
饟	wfxx
顽	wfym
祓	wgbi
隓	wgcc
䜐	wgcc
䄃	wgcd
䬬	wgcd
隨	wgce
䢫	wgce
嶞	wgch
墮	wgci
隋	wgck
䭉	wgck
隳	wgcl
㯐	wgco
㒮	wgdg
餸	wgep
粞	wgfi
䧈	wgfv
粣	wggf
䬻	wggw
粡	wghf
餇	wghf
粀	wgii
禂	wgin
䧓	wgin
随	wgke
堕	wgki
陏	wgkm
䧀	wgmx
祐	wgnm
粩	wgnq
侖	wgpf
陕	wgsv
祅	wgtp
陲	wgtv
飫	wgtw
䴠	wgty
视	wgwq
䧍	wgyn
䏑	wgyy
䊱	whaf
墬	whai
禒	whaq
餯	whaq
䧘	whaq
督	whbd
錖	whbt
惄	whbu
祋	whbx
叔	whbx
裻	whbx
䬦	whbx
福	whcm
䭄	whdb
餖	whei
䄈	whei
禫	whfm
䊤	whfm
䊃	whfp
隇	whfx
隔	whgr
隑	whhe
䭓	whhe
麙	whhf
䊮	whhp
祤	whhx
禋	whif
陻	whif
䴟	whii
尗	whkh
祿	whll
籼	whmi
麜	whof
䧣	whpg
䴩	whpg
䭨	whpn
籶	whqi
飢	whqw
麂	whqy
隙	whrh
拲	whtf
䄆	whtp
餂	whtw
敊	whub
䧙	whyl
麖	whyy
粮	wicb
䧮	wicu
坖	wifg
䧬	wifm
社	wifp
䧑	wifs
塵	wify
陵	wigb
祾	wigb
糘	wigd
陸	wigi
阱	wigv
隥	wihe
纇	wihm
辮	wihw
颣	wihy
禨	wiid
饑	wiid
陊	wiiq
䬷	wiiq
隢	wiiw
饒	wiiw
飰	winf
䊅	winm
陀	winq
粦	wioa
㔂	wioa
遴	wioe
粼	wiof
䊉	wiof
翷	wioh
甐	wioj
斴	wiot
亃	wiov
鄰	wiow
䚏	wiow
餾	wipc
粽	wipg
館	wipm
劊	wira
朇	wirl
會	wirm
鄶	wirw
䀅	wism
䭢	wiur
院	wiwg
粃	wjai
䃾	wjap
阰	wjav
㼾	wjay
階	wjdr
阫	wjdv
䬪	wjdw
阷	wjfv
佱	wjfw
䊞	wjgx
祢	wjhk
陛	wjif
陥	wjjr
料	wjlf
阧	wjlf
㪴	wjlf
禘	wjmp
䧛	wjmv
䄘	wjmv
隐	wjou
籽	wjvi
䦻	wjvv
隀	wjwm
䄡	wjxc
隡	wjxl
祪	wjxo
陒	wjxo
陷	wjyr
餡	wjyr
㓱	wkaa
逾	wkae
䧨	wkag
俞	wkaj
㼶	wkaj
歈	wkal
毹	wkao
餁	wkat
愈	wkau
觎	wkaw
鄃	wkaw
覦	wkaw
陉	wkcf
㝴	wkfg
籿	wkfi
祙	wkgw
附	wkkf
祔	wkkf
陆	wklv
陨	wkmv
䧤	wkni
祮	wknm
䭋	wkno
糇	wkub
餱	wkub
䄊	wkup
粑	wkvi
禱	wkvk
隯	wkvk
䊭	wkvk
麍	wkyy
侴	wlaj
祣	wlaq
麚	wlbb
䃽	wlbx
䄄	wlcd
䄕	wlcm
麕	wlct
粚	wldv
陁	wldv
陰	wleg
糅	wleo
籵	wlfi
頯	wlfm
類	wlfm
䦹	wlfv
弍	wlga
䊖	wlgr
粘	wlhi
阽	wlhv
䬯	wlhw
墅	wlif
䊈	wljn
恭	wlkf
㳟	wllf
貳	wlmm
阥	wlmv
祵	wlof
隫	wlpm
飾	wlpm
饙	wlpm
飮	wlqw
飲	wlqw
歆	wlqy
䧗	wlrb
䴤	wlty
飭	wluc
䧔	wlup
䄒	wlup
䭃	wlup
粈	wlvi
籺	wlvv
阣	wlvv
䬣	wlvv
辨	wlwy
䪩	wlwy
嬜	wlxc
祻	wlxf
䭅	wlxf
糰	wlxk
野	wlxm
然	wlxo
黙	wlxo
䳿	wlxr
䦽	wlxv
贰	wlym
剑	wmaj
祬	wmap
䬹	wmaw
㸋	wmbc
爒	wmch
糁	wmck
糯	wmfk
隭	wmfk
弎	wmga
陖	wmgb
餕	wmgb
炙	wmiq
阦	wmiv
貣	wmma
黿	wmmg
粗	wmmi
餤	wmmi
䊏	wmmi
糝	wmmk
禶	wmmm
饡	wmmm
㸉	wmmm
祖	wmmp
阻	wmmv
飷	wmmw
麆	wmmy
兘	wmnm
禍	wmnm
飴	wmnm
䴫	wmnq
佥	wmow
䄙	wmrb
敛	wmst
䊁	wmti
䊴	wmwh
阭	wmwq
䄛	wmxc
禈	wmxf
餫	wmxf
䄥	wmxh
麢	wmxn
㥐	wnau
命	wnav
䬥	wncb
彧	wnfk
祸	wngy
䭥	wnic
䧎	wnkm
䬼	wnkm
䢽	wnkv
䭂	wnkv
饈	wnlv
隕	wnmm
韻	wnmm
䊟	wnmm
㖖	wnmy
糙	wnne
祰	wnnm
䧊	wnnm
饉	wnno
阾	wnqx
麀	wnqy
鼋	wnrv
䄇	wnsg
祦	wnug
麌	wnug
㥹	wnup
䭎	wnvo
䄁	wnvv
粉	wnwi
祝	wnwq
剣	wnya
剱	wnyi
㰸	wnyl
㪘	wnys
㑒	wnyw
飹	woav
䪮	wobb
叙	wobx
畬	wocm
飽	wodb
麅	wodb
途	woep
㭟	woff
䬱	woff
余	wofw
䴢	wofy
餚	wogk
禞	wogn
䧚	wogn
餙	wogp
嵞	wohh
峹	wohm
礿	woii
䪨	woii
㙦	woji
斜	wojl
厁	wojq
䧐	wojv
精	wokm
䭇	wokn
糉	wolb
祲	womb
䧫	womg
饐	wone
䊦	wone
䧁	wonm
䬲	wonm
䊛	woob
際	wopg
䄞	wopg
雓	wopr
鸢	woqa
鹅	woqt
粅	wore
䳜	worr
䭍	wosm
䬨	wosq
敘	wost
粍	woti
韵	woty
㲔	woty
敍	woub
餷	woum
悆	woup
陶	wovt
祹	wovt
粷	wowi
陱	wowi
䣄	wowv
瓣	wowy
掣	wpah
制	wpaj
䱥	wpap
餰	wpas
製	wpax
䬢	wpcw
陇	wpdv
観	wpdw
䧰	wpeh
饚	wpfs
韺	wpgc
䊔	wpgc
䭊	wpgc
䄏	wpgt
际	wpgv
籾	wpii
饞	wpji
䧯	wpji
糀	wpjr
歓	wplq
糷	wpmh
隤	wpmm
饋	wpmm
韶	wpnm
祒	wpnm
䧂	wpnm
䬰	wpnm
䭟	wpno
餀	wpow
頀	wppb
䭤	wppe
隿	wpra
䊒	wpri
䊪	wprn
陮	wprv
粁	wpti
阡	wptv
勧	wpuc
餝	wpvy
粭	wpwi
祫	wpwp
餄	wpww
辧	wpwy
㸤	wpwy
糚	wpxk
䭖	wpxo
饢	wpxx
麛	wqdf
䊧	wqdm
禃	wqfp
隊	wqgd
隧	wqge
禭	wqge
墜	wqgi
䊑	wqgn
鐆	wqgt
禛	wqgw
飦	wqgw
粌	wqjj
䉽	wqkg
䬳	wqkg
陗	wqkm
糨	wqnb
祱	wqnw
䬽	wqnw
祶	wqqr
䬾	wqqr
禅	wqrl
祚	wqtp
糑	wqtt
阼	wqtv
飵	wqtw
辫	wqwy
餅	wqxg
禉	wqyf
阵	wrav
饅	wrfb
䊡	wrfb
饆	wrff
䦺	wrfv
飣	wrfw
隅	wrgn
禑	wrgn
禢	wrhh
䭘	wrhy
陧	wrif
隰	wrix
餛	wrja
䊐	wrja
䗝	wrjb
神	wrjj
㫖	wrmh
阳	wrmv
阿	wrnm
娿	wrnx
祼	wrof
粿	wrof
餜	wrof
餲	wrov
鳶	wrra
䳍	wrrf
䲮	wrrg
䲶	wrrg
隟	wrro
䄗	wrrp
糣	wrrr
䭙	wrrr
鵝	wrrt
鵞	wrrt
隝	wrrv
鶕	wrry
饂	wrsm
隖	wrxo
飳	wryw
麈	wryy
禵	wsfm
餗	wsfw
辣	wsfy
㒬	wsgg
䄤	wsjm
粋	wslf
䊓	wsmi
禔	wsmp
隄	wsmv
敉	wsti
䧪	wtcx
糖	wtdn
禟	wtdn
餹	wtdn
䧜	wtdn
䭠	wteg
䉼	wtei
祈	wtep
隲	wtff
饛	wtfg
䃿	wtgp
陈	wthk
粧	wtif
䊌	wtja
䊳	wtjf
䭩	wtjf
䭧	wtjh
饝	wtjv
祷	wtkf
陦	wtkf
粆	wtki
餶	wtmw
䧡	wttj
糠	wttl
鏖	wtwy
䊯	wtxg
餃	wtyw
麏	wuby
阞	wucv
䊕	wudx
䭈	wudx
祕	wuee
飶	wuee
䊇	wufi
陠	wufv
餔	wufw
祆	wugp
陎	wugw
祩	wugw
禣	wukf
糐	wukf
餺	wukf
糭	wulb
糗	wuld
禎	wumm
麐	wunm
䴥	wunm
禓	wuor
糃	wuor
陽	wuor
餳	wuor
忒	wupa
忐	wuph
意	wupy
阴	wuqv
鷾	wurr
䭒	wuup
糧	wuwm
辦	wuwy
辬	wuwy
㦚	wuwy
祯	wuym
䦼	wuyw
祏	wvdp
䧩	wvds
䭛	wvds
遙	wvep
禇	wvfp
陼	wvfv
祠	wvhf
飼	wvhf
埅	wvif
祗	wvii
阺	wvii
䬫	wvii
䬮	wviy
禙	wvkm
䭀	wvle
籸	wvlf
阠	wvlf
䉿	wvlf
䴣	wvlf
祃	wvnp
䉻	wvqi
祇	wvqp
䄑	wvrm
糈	wvsk
断	wvte
㐘	wvvi
禕	wvvp
乵	wvvy
祊	wvyp
防	wvyv
鼗	wwcb
覜	wwdw
逃	wwep
粪	wwfi
粠	wwfi
頫	wwfm
䧆	wwfv
陯	wwgp
阮	wwgv
䬧	wwgw
麟	wwio
隣	wwio
禬	wwir
糩	wwir
䭝	wwir
麋	wwiy
隃	wwka
䄖	wwka
禷	wwlm
粴	wwmi
险	wwmo
䧉	wwmv
険	wwny
除	wwof
餘	wwof
竟	wwqy
鴵	wwrr
䄉	wwtp
餓	wwtw
䪰	wwup
䢼	wwvf
邧	wwvg
祁	wwvp
鄜	wwvy
糡	wwwq
䭗	wwwq
竸	wwww
祧	wwwy
餆	wwwy
麤	wwwy
險	wwxh
䴪	wwxl
禴	wwxp
麊	wwyi
兆	wwyq
隌	wwyv
辡	wwyy
䪭	wwyy
陿	wxch
籹	wxci
糒	wxel
輂	wxff
䊀	wxfi
祜	wxfp
陣	wxfv
劍	wxha
劒	wxhi
劔	wxhi
䊂	wxhk
歛	wxhl
顩	wxhm
劎	wxhp
斂	wxhs
僉	wxhw
塦	wxif
䧠	wxik
䊜	wxik
䧥	wxiu
餑	wxjv
䪬	wxjv
䊋	wxkf
䊘	wxkm
糤	wxks
饊	wxks
粔	wxlb
禄	wxll
粶	wxll
祳	wxlo
陙	wxlo
麎	wxlo
粙	wxmi
䄂	wxmp
龢	wxnc
龤	wxnd
䶳	wxnh
䶵	wxnh
龡	wxnl
龣	wxnl
龥	wxnm
龠	wxnp
鸙	wxnr
饇	wxnx
䧢	wxnx
黒	wxom
阨	wxon
麃	wxoy
禲	wxpn
糲	wxpn
禪	wxrl
䄍	wxrm
㑹	wxrm
隁	wxrx
粝	wxta
糊	wxuq
餬	wxuq
糎	wxwm
䊣	wxxg
麣	wxxs
陋	wxyv
陃	wxyw
飩	wyaw
隉	wycf
粏	wydi
阶	wydr
祄	wydr
餩	wyey
糄	wygp
䭏	wygp
坠	wyif
餿	wyjb
飻	wyke
麝	wykf
脊	wykm
䰪	wykm
鹡	wyko
鶺	wykr
粐	wypi
隮	wyrr
麡	wyrr
䄢	wyrr
䭣	wyrr
䭐	wyup
阸	wyvv
仧	wywh
餼	wywi
麑	wywq
䧧	wywt
队	wywv
飤	wyww
隂	wyxf
禚	wyxo
糕	wyxo
餻	wyxo
䄝	wyyr
輚	xaaa
戕	xaav
娗	xadx
嫸	xaen
娸	xafc
娀	xagd
型	xaif
牂	xaiv
刑	xajg
龉	xanm
娪	xanm
匯	xapr
媣	xaso
厫	xast
䦋	xast
㜜	xast
妊	xatc
厮	xate
䡳	xate
軠	xatf
䡂	xavf
媅	xavv
娺	xbbb
輟	xbbb
蝱	xbbm
䡦	xbbo
䡫	xbce
嫿	xbcf
㛔	xbcg
嬏	xbcm
轓	xbcm
㜭	xbcm
嫄	xbdc
媸	xbfb
駑	xbff
匩	xbfi
胬	xbgy
殹	xbhb
䗟	xbhb
瞖	xbhd
黳	xbhf
翳	xbhh
繄	xbhh
毉	xbhh
瑿	xbhi
㙠	xbhi
㬾	xbhk
贀	xbhm
㗨	xbhn
鹥	xbho
鷖	xbhr
拏	xbht
䃜	xbhv
嫛	xbhx
醫	xbhy
軽	xbif
䋈	xbih
㚭	xbii
㚵	xbjo
孥	xbjv
厖	xbki
娏	xbki
妕	xbmc
䖟	xbmy
輅	xbnm
帑	xbpm
嫦	xbpm
弩	xbqb
䡅	xbrf
鴑	xbrr
医	xbta
努	xbuc
怒	xbup
悘	xbup
砮	xbvd
驽	xbvn
㐐	xbvv
奴	xbxc
㕝	xbxf
嬧	xbxs
嬢	xbxx
娳	xcaj
婬	xcat
龈	xcbh
䡊	xcbx
奶	xccc
轠	xccc
㛢	xccc
歷	xcce
㔸	xcch
㻺	xcci
㽁	xccj
㷴	xccm
㜼	xccm
轊	xcco
曆	xccr
轤	xccs
厤	xcct
䡺	xccu
磿	xccv
軑	xcdf
匞	xcfa
妅	xcfc
㛸	xcfc
鼉	xcfm
㛱	xcfo
姱	xcfs
妦	xcgc
㛵	xcgi
姤	xchf
嘼	xchf
獸	xchl
㰼	xchl
䡾	xchl
婋	xchq
㥦	xchu
鼍	xchv
匧	xchw
㛍	xchw
㜎	xcic
嫘	xcih
㛻	xcii
娐	xcjv
㚺	xcjv
媛	xckb
㕑	xckf
媦	xckm
㛂	xckv
輴	xcld
㚼	xcmc
䡒	xcmf
㽞	xcmm
㜘	xcmm
媿	xcmx
嬉	xcnm
㜻	xcnu
匲	xcnx
婇	xcof
嫽	xcqh
轑	xcqh
镽	xcqh
嬀	xcqx
婍	xcrn
輢	xcrn
㛪	xcrv
姀	xctc
娚	xcuc
媤	xcup
嫐	xcux
嫭	xcvl
疐	xcvs
媱	xcvt
㔴	xcwf
娞	xcxc
婑	xcxc
噐	xcxm
娮	xcyc
嫍	xcyr
轁	xcyr
镼	xdbl
娵	xdbx
輙	xdbx
婡	xddc
匷	xddp
㜹	xddp
㔵	xddw
婢	xdel
䡟	xdel
姫	xdfc
㛅	xdfc
臧	xdfd
嫜	xdfm
㔶	xdfm
輾	xdhf
㜊	xdhf
媺	xdhs
轢	xdio
㜰	xdio
轏	xdjj
龎	xdka
孎	xdlb
厡	xdlm
㜨	xdlu
龌	xdma
媉	xdma
盲	xdmy
婄	xdnm
妮	xdnq
㜔	xdnw
娓	xdot
婂	xdpm
媓	xdsg
嬍	xdss
㕔	xdsu
轞	xdts
㜮	xdts
匜	xdva
她	xdvc
嬓	xdvs
輒	xdvv
䡴	xdwm
娊	xdwq
䡚	xdwq
䙹	xdwq
嚚	xdxm
廸	xdxm
媇	xdyc
㕇	xdyd
劂	xeba
蟨	xebb
遻	xebe
厥	xebl
橜	xebo
鷢	xebr
蹷	xebs
憠	xebu
㖾	xebv
䣞	xebw
娫	xeed
嫫	xefc
姏	xefc
匪	xefh
厞	xefh
婔	xefh
輫	xefh
妘	xegc
㜩	xegc
転	xegf
姠	xegn
㜋	xegs
嬨	xeiu
厇	xeja
奼	xeja
嫌	xejg
媊	xeka
輧	xekq
媲	xelj
䡯	xelu
䶯	xemm
龋	xenn
龇	xenq
媒	xeof
連	xepf
䢎	xepg
迪	xepm
厩	xera
衁	xesm
妷	xetg
軼	xetg
镻	xetg
㦁	xeup
姊	xevr
姂	xexp
姟	xeyw
輆	xeyw
媡	xfah
妩	xfbd
婳	xfcl
厦	xfdb
輈	xfef
㜖	xfer
婭	xffc
媽	xffc
駡	xffm
㜵	xffx
㜳	xffx
䡖	xfgi
㛤	xfgi
嬭	xfgm
镾	xfgm
匟	xfhq
妔	xfhq
䡉	xfhq
嬛	xfhx
轘	xfhx
㜅	xfic
㕓	xfif
妶	xfin
㕄	xfin
嬕	xfir
嬽	xfjc
媆	xfkc
輭	xfkc
輀	xfkm
䎟	xfkm
㚥	xflf
嬙	xfln
牆	xfln
轖	xfln
嬗	xflu
嫼	xfmc
䵤	xfmg
輛	xfmm
頔	xfmm
㛲	xfmm
㜥	xfmm
囂	xfmx
妺	xfof
婘	xfon
姉	xfpm
姨	xfqy
娙	xfrc
輕	xfrc
娻	xfrh
㛐	xfro
鑋	xfrt
卾	xfsa
咢	xfsa
㓵	xfsa
遌	xfse
顎	xfsm
㕎	xfsm
鹗	xfso
鶚	xfsr
鄂	xfsw
覨	xfsw
颚	xfsy
婕	xfts
姮	xfum
媔	xfum
娬	xfwe
軏	xfwq
䡶	xfwy
㕈	xfxq
㛄	xfxq
麗	xfxw
孃	xfxx
嚣	xfyx
妭	xgbi
軷	xgbi
姎	xgcd
軮	xgcd
䦈	xgcf
媠	xgck
媢	xgdm
娇	xgdr
輞	xgex
㛉	xgfc
姗	xggf
姛	xghf
遘	xgie
冓	xgif
姌	xgif
斠	xgil
顜	xgim
婤	xgin
輖	xgin
觏	xgiw
覯	xgiw
姷	xgkm
冑	xglg
㚩	xglg
妐	xgmx
䡌	xgmx
䡆	xgmx
嬌	xgnn
轎	xgnn
姥	xgnq
姍	xgpf
㚴	xgpm
㛈	xgsa
妖	xgtc
娷	xgtc
厜	xgtd
镺	xgtf
䦇	xgvv
輍	xgyn
妠	xgyw
軜	xgyw
厊	xhad
孅	xhaf
刺	xhaj
婮	xhbc
撃	xhbh
繋	xhbh
軗	xhbx
輻	xhcm
㛒	xhei
厨	xhek
㕏	xhel
㛏	xhfc
媏	xhfk
輲	xhfk
㜤	xhfm
姵	xhfp
娆	xhfw
媙	xhfx
㛶	xhgm
婰	xhgw
㜐	xhhe
輱	xhhf
㛾	xhhf
嫪	xhhk
轇	xhhk
嬥	xhhp
轗	xhhu
䎁	xhhx
䍾	xhhx
㛗	xhif
軓	xhii
枣	xhjo
朿	xhkf
㞪	xhmb
奾	xhmc
両	xhmf
軕	xhmf
㔯	xhnm
娴	xhof
㛊	xhof
㛆	xhof
㚯	xhow
嫖	xhpg
孈	xhpn
㜠	xhpr
䡄	xhqf
咒	xhqm
㛠	xhrm
敇	xhst
姡	xhtc
㛧	xhvd
娍	xhvv
两	xhwf
婹	xhxc
棘	xhxh
棗	xhxh
婩	xhxq
僰	xhxy
婛	xhyc
輬	xhyf
㔰	xial
嬸	xibc
娘	xicb
䡙	xicb
轄	xicn
姹	xiej
嫏	xiew
圧	xifd
再	xiff
嬪	xifm
婝	xifs
媗	xifu
婈	xigb
輘	xigb
妌	xigc
嫁	xigd
䡜	xigi
㛬	xigi
嬁	xihe
索	xihk
娃	xiif
厓	xiif
压	xiii
婉	xiio
䡝	xiio
姼	xiiq
䡔	xiiq
㜇	xiiu
㥨	xiiu
嬈	xiiw
剸	xika
專	xikf
甎	xikj
鷒	xikr
㜚	xikr
鄟	xikw
姯	xilc
輄	xilf
㛮	ximb
姳	xinm
䡐	xinq
媴	xinx
轅	xinx
嬼	xipa
媹	xipc
婃	xipg
婠	xipm
輨	xipm
夛	xiqb
媯	xiqx
婞	xiri
婶	xirj
軪	xiuc
妫	xiui
惠	xiup
嬣	xiur
嫔	xivg
輐	xiwg
㛡	xiwg
㛽	xiwi
姲	xixc
邐	xixe
彲	xixk
鸝	xixr
酈	xixw
䚕	xixw
婯	xixx
妣	xjac
瓳	xjaf
瓺	xjaf
㼛	xjag
嬂	xjar
婙	xjbb
妚	xjdc
媘	xjdr
䡡	xjdr
歴	xjeh
姃	xjfc
㛦	xjfc
㚰	xjff
嫣	xjfx
㛟	xjgc
嫓	xjgj
嫡	xjgx
妳	xjhk
匛	xjii
奺	xjii
镹	xjii
㸦	xjii
㐃	xjjx
㛩	xjkm
轍	xjks
媍	xjmm
媂	xjmp
嫎	xjmv
姆	xjnc
娝	xjnm
㛀	xjob
鹁	xjoq
暦	xjrm
鵓	xjrr
㪍	xjst
勃	xjuc
恏	xjup
愂	xjuu
好	xjvc
孛	xjvf
厯	xjvi
媑	xjwm
郣	xjwv
㜬	xjxc
姽	xjxo
輡	xjyr
䯷	xkag
姙	xkat
髿	xkat
髲	xkav
髼	xkbc
鬔	xkbe
䯭	xkbx
鬁	xkca
䯮	xkcc
奘	xkcd
鬏	xkcm
䰂	xkco
䰕	xkcs
䰄	xkcu
䰀	xkcx
㜃	xkcy
髶	xkdf
䯽	xkdn
䰐	xkds
髢	xkdv
鬋	xkea
髟	xkef
鬕	xkef
形	xkeg
鬑	xkeg
䰃	xkek
髷	xkem
髭	xken
鬞	xkeo
䰉	xkfb
髵	xkfk
䯿	xkfl
匵	xkfm
嬻	xkfm
䰅	xkfm
鬈	xkfo
㛹	xkfo
䰔	xkfs
壯	xkfv
髩	xkfv
髡	xkfw
鬟	xkfx
裝	xkfx
鬤	xkfx
髪	xkgb
髯	xkgi
髮	xkgi
鬌	xkgk
髥	xkgl
䯳	xkgm
䯾	xkgn
鬐	xkgr
妹	xkgw
䯴	xkhb
髽	xkhi
䭮	xkhi
髠	xkhq
髺	xkht
鬓	xkig
鬢	xkim
鬃	xkip
鬡	xkir
鬇	xkjb
䯱	xkjd
髬	xkjf
軵	xkkf
鬚	xkkm
髻	xkkn
髹	xkko
䯲	xkkv
弉	xkld
髳	xkle
鬛	xklf
䯵	xkll
䰆	xklo
䰏	xklp
㛣	xkmc
焋	xkmi
鬖	xkmk
䰑	xkmk
胄	xkmm
䯶	xkmm
䰖	xkmm
鬝	xkmr
鬜	xkmu
髧	xkmw
肓	xkmy
䰈	xknc
轐	xkni
姞	xknm
嬯	xknm
鬗	xknm
䯻	xknn
媬	xkno
髰	xknv
鬉	xkob
䯹	xkob
髱	xkod
髤	xkof
䰍	xkol
鬆	xkom
髦	xkot
贋	xkpm
㷳	xkpm
䰎	xkpm
髫	xkpn
雁	xkpr
䰌	xkps
赝	xkpy
髴	xkqd
鬒	xkqg
姸	xkqg
髾	xkqk
鬀	xkqr
鬙	xkqr
鬘	xkrb
鬣	xkrf
贗	xkrm
鬄	xkrr
鴈	xkrr
䰋	xkrx
鬎	xksa
散	xkst
䰒	xktg
䯯	xktk
䯸	xktl
䯼	xktm
銺	xktw
㜲	xkui
䰊	xkuk
娡	xkup
鬅	xkuu
䰓	xkuv
妑	xkvc
䰇	xkvf
鬂	xkvg
嬦	xkvk
䯺	xkvn
娰	xkvy
髣	xkvy
髸	xkwf
髨	xkwg
鬠	xkwr
娤	xkxc
䰁	xkxl
鬍	xkxu
䯰	xkyd
轛	xkyk
鬊	xkyr
剥	xlaj
巨	xlba
嘏	xlbb
婽	xlbb
螶	xlbb
妓	xlbx
䡋	xlbx
姻	xlcd
㸜	xlcf
魇	xlcm
厌	xldd
哭	xldm
狀	xldv
䚄	xldw
媃	xleo
輮	xleo
逯	xlep
嬩	xlfg
黡	xlfm
靥	xlfu
嬹	xlgg
婻	xlgr
蟿	xlhb
㚲	xlhc
擊	xlhh
繫	xlhh
墼	xlhi
檕	xlho
礊	xlhv
罊	xlhv
轚	xlhx
喌	xlij
娒	xljn
录	xllb
餍	xlnc
娢	xlnm
㦺	xloa
蜃	xlob
㲀	xlob
辰	xloc
辱	xlok
脣	xlok
㰮	xlol
䫃	xlom
唇	xlon
㫳	xlor
䢈	xlor
敐	xlos
鄏	xlow
䣅	xlow
轒	xlpm
軟	xlqf
㰢	xlqg
輹	xlrb
姩	xlrf
㛥	xlrm
盝	xlsm
姓	xltc
㪖	xlub
妞	xlvc
厣	xlvm
龁	xlvv
乬	xlvv
巪	xlvv
嫵	xlvx
妗	xlwc
㕂	xlwd
軡	xlwf
䢹	xlwv
妤	xlxc
婟	xlxf
器	xlxm
㜝	xlyf
嫆	xlyn
䡥	xlyn
媼	xlys
轀	xlys
姪	xmac
厔	xmad
輊	xmaf
厠	xmaj
娭	xmbt
輽	xmcc
孂	xmcs
匴	xmdl
娅	xmfc
婾	xmff
孄	xmfh
嬬	xmfk
轜	xmfk
嫮	xmfs
㛖	xmgb
㚮	xmhq
烎	xmig
䑝	xmio
斝	xmjl
姢	xmkm
匥	xmld
㓹	xmma
姐	xmmc
㛝	xmmc
龃	xmmh
婒	xmmi
㜗	xmmk
䡽	xmmm
㜺	xmmm
嬫	xmmo
䑞	xmmo
孆	xmmx
始	xmnm
媧	xmnm
軩	xmnm
㗠	xmnn
轌	xmob
嫻	xmof
嫇	xmrb
彚	xmro
姺	xmtc
孀	xmtf
嫺	xmuq
㛌	xmut
妉	xmwq
㜢	xmxc
媈	xmxf
䡣	xmxf
䡿	xmxh
䡼	xmxn
牄	xnbn
嫅	xncf
輯	xndf
嬵	xndp
䘫	xnfx
軹	xngw
娲	xngy
毄	xnhb
挐	xnht
絮	xnih
尀	xnkf
娟	xnkm
㛕	xnkv
䡭	xnlv
叵	xnma
如	xnmc
軎	xnmf
㜏	xnmm
㛎	xnnm
㖲	xnnn
厪	xnno
嫤	xnno
厑	xnnq
㖛	xnnq
嫨	xnnt
嬿	xnnx
桇	xnof
帤	xnpm
龀	xnqh
姈	xnqx
龄	xnqx
軨	xnqx
鴽	xnrr
龊	xnsh
娖	xnsh
厛	xnte
娱	xnug
恕	xnup
娛	xnvc
娯	xnvg
媟	xnvo
牃	xnvo
嫙	xnvs
㛨	xnvv
妢	xnwc
軦	xnwq
㚾	xnwq
剾	xnxa
敺	xnxb
毆	xnxb
甌	xnxj
歐	xnxl
區	xnxm
嬠	xnxo
鷗	xnxr
㚹	xoav
媰	xobb
妇	xobc
㜦	xock
䡘	xocm
輷	xocy
龅	xodb
軳	xodb
㚿	xodb
軱	xoef
㼋	xoef
頋	xofm
牀	xofv
顾	xofy
杗	xofy
㛓	xogp
殴	xohb
嫊	xoih
妁	xoii
瓯	xoja
婧	xokm
輤	xokm
䂋	xolo
欧	xolq
嫧	xomm
婦	xomp
婷	xomr
厄	xond
嬄	xone
姁	xonm
軥	xonm
㕀	xonm
鸥	xooq
䡈	xoow
鸪	xoqf
匢	xore
姰	xorm
匫	xorr
鴎	xorr
㛁	xosc
軯	xosf
㚪	xotc
軞	xotf
㚬	xoty
㜁	xoum
区	xowa
婅	xowi
娜	xowv
婊	xoxq
㖐	xpbm
媌	xpcm
厐	xpdd
媶	xpdf
㜫	xpds
㜴	xpfd
䡸	xpfm
䡷	xpfs
䘌	xpgb
媖	xpgc
嬅	xpgg
匿	xpgn
婼	xpgn
慝	xpgu
嬆	xphh
䡮	xphs
㜡	xphs
軔	xpii
㜶	xpji
婲	xpjr
嬞	xpjw
媕	xpld
匝	xpma
㚶	xpmc
䦉	xpmf
孏	xpmh
匱	xpmm
嬇	xpmm
轥	xpmp
㠵	xpmy
龆	xpnm
妱	xpnm
軺	xpnm
㸛	xpnm
嬳	xppb
孇	xppb
㜓	xppw
匶	xppy
婎	xprc
㕍	xprd
䧸	xprf
雃	xprg
厲	xprn
勵	xpru
轕	xprv
巟	xpry
奷	xptc
匼	xpwa
姶	xpwc
㕉	xpwd
婏	xpwi
嬎	xpwl
嬔	xpwl
娩	xpwq
輓	xpwq
㛯	xpwu
嫬	xpxo
嫶	xpxo
孉	xpxp
匮	xpym
㛼	xpyr
娹	xqfi
奸	xqgc
厈	xqgd
嬘	xqge
䡵	xqge
軒	xqgf
厰	xqgs
厧	xqgw
嫃	xqgw
䡩	xqgw
姅	xqkg
娋	xqkm
輎	xqkm
㛚	xqlm
䡏	xqmx
娧	xqnw
㜄	xqqc
娣	xqqr
婵	xqrl
妰	xqtc
厏	xqtd
嫋	xqtt
姘	xqxg
軿	xqxg
媨	xqyf
輶	xqyf
厍	xrad
剒	xraj
皵	xrav
厬	xrbn
嫉	xrbt
輜	xrcm
㛴	xreo
逪	xrep
嫚	xrfb
䡬	xrfb
奵	xrfc
輺	xrfc
厅	xrfd
嬝	xrfx
媀	xrgn
婫	xrja
輥	xrja
妽	xrjj
厚	xrjv
饜	xrkc
㱘	xrke
黶	xrkf
擪	xrkh
壓	xrki
厭	xrkl
魘	xrkm
檿	xrko
懕	xrku
靨	xrku
厴	xrkv
嬮	xrkx
戰	xrla
單	xrlf
囅	xrlh
辴	xrlo
鷤	xrlr
鄲	xrlw
昔	xrmf
㜉	xrnk
牁	xrnm
妸	xrnm
軻	xrnm
婐	xrof
輠	xrof
鹊	xroq
㛫	xror
輵	xrov
䧿	xrpr
娨	xrqg
婣	xrrc
鳫	xrrd
鴣	xrrf
鳽	xrrg
娼	xrrm
轈	xrro
鵲	xrrr
媪	xrsm
輼	xrsm
匦	xrsq
㪚	xrst
斮	xrte
䪣	xrtf
朚	xruq
匽	xrxc
㰽	xrxl
䡧	xrxo
鶠	xrxr
郾	xrxw
妵	xryc
軴	xryf
甹	xsam
㕺	xsam
娕	xsfc
嬾	xsfm
匡	xsga
軖	xsgf
匤	xsii
㛞	xsld
嫰	xslq
媞	xsmc
㿼	xsmg
軌	xsqf
䳙	xsrr
嫩	xsst
故	xstf
劻	xsuc
邼	xswv
厉	xtad
䟅	xtdf
媚	xtdm
㜍	xtdn
覱	xtdw
匠	xtea
妡	xtec
斬	xtef
嬚	xteg
龂	xteh
斨	xtev
㜀	xtfc
厢	xtfd
妋	xtgc
䡍	xtgf
㟻	xthm
㨻	xtht
塹	xtif
㛇	xtif
氓	xtja
姄	xtja
䡑	xtja
嫲	xtjf
孊	xtjf
嬤	xtji
嬷	xtjm
㛰	xtjr
妙	xtkc
䭕	xtnc
蹔	xtns
槧	xtof
暫	xtrm
䳻	xtrr
嫞	xttj
牅	xttj
嫝	xttl
㜱	xttm
鏨	xttw
励	xtuc
慙	xtup
磛	xtvd
㕋	xtwd
㜞	xtxc
姣	xtyc
㚧	xtyc
較	xtyf
妃	xubc
肆	xubf
輑	xubf
軙	xubx
历	xucd
䡃	xucf
嬶	xucu
㚦	xudc
畁	xudm
㜯	xudx
妼	xuee
姬	xufc
㕊	xufd
輔	xuff
婥	xufm
姝	xugw
䡕	xuif
㕌	xukf
婖	xulk
䡻	xulv
妲	xumc
媜	xumm
䡠	xumm
䭌	xunc
㚳	xunm
鹕	xuoq
婸	xuor
輰	xuor
媫	xuos
㣽	xupc
怘	xupf
忘	xupy
㚫	xuqc
胡	xuqf
鶘	xurr
鶦	xurr
望	xusg
媳	xuup
輣	xuuq
妏	xuyc
妜	xuyw
妬	xvdc
㜟	xvds
媎	xvfc
娦	xvgw
㚸	xvhf
厎	xvii
軧	xvii
姒	xviy
軐	xvlf
軤	xvlf
㚨	xvlf
匣	xvma
㕅	xvmd
㛿	xvmp
妈	xvnc
骂	xvnm
軝	xvqf
㚱	xvrc
婚	xvrm
婿	xvsk
䀇	xvsm
厒	xvtd
媁	xvvc
軋	xvvf
㐕	xvvm
㽕	xvvv
妨	xvyc
㚤	xwac
剋	xwaj
軾	xwcf
㜆	xwep
娂	xwfc
輁	xwff
兡	xwfr
妧	xwgc
䡇	xwgf
嫷	xwgk
婨	xwgp
輪	xwgp
婌	xwhb
䦊	xwhk
㔳	xwhq
彞	xwil
嫾	xwio
轔	xwio
嬒	xwir
匬	xwka
媮	xwka
輸	xwka
螿	xwkb
奬	xwkc
尅	xwkf
將	xwkf
墏	xwki
漿	xwkl
獎	xwkl
㢡	xwkl
槳	xwko
䵼	xwko
䊢	xwkw
醬	xwky
兙	xwlf
㜣	xwlx
娌	xwmc
厘	xwmd
彛	xwnl
兝	xwnw
兞	xwot
兛	xwpt
匹	xwqa
克	xwqf
婀	xwrn
鴄	xwrr
㔲	xwsq
娥	xwtc
勀	xwuc
勊	xwuc
嬑	xwup
邚	xwvc
邢	xwvg
邮	xwvm
邙	xwvy
兏	xwwq
䣑	xwwv
姚	xwwy
匳	xwxh
厱	xwxh
嬐	xwxh
兢	xwxw
兣	xwxw
㛙	xwyc
㜙	xwyc
㛺	xwyc
厗	xwyd
辜	xwyf
軣	xwyf
轆	xwyf
嫕	xxbu
奻	xxcc
㚣	xxcc
轣	xxce
䡹	xxcs
妝	xxcv
妄	xxcy
㜧	xxel
轋	xxep
㜕	xxep
姑	xxfc
厙	xxfd
㕆	xxfd
軲	xxff
䡛	xxff
妍	xxgc
㕃	xxgd
䵌	xxgh
媾	xxgi
黊	xxgi
䵍	xxgj
䵏	xxgk
䵎	xxgk
䵋	xxgk
黇	xxgl
斢	xxgl
黅	xxgl
䵐	xxgl
鷬	xxgr
黈	xxgr
黄	xxgw
黆	xxgw
輌	xxhm
娾	xxii
嫥	xxik
轉	xxik
孋	xxiw
㛘	xxjv
匨	xxkf
姖	xxlb
媷	xxlk
娽	xxll
娠	xxlo
㜛	xxlq
妯	xxmc
軸	xxmf
㗊	xxmm
嫗	xxnx
䡱	xxnx
軛	xxon
妪	xxow
嫟	xxpn
嬺	xxpu
姧	xxqg
匰	xxrl
嬋	xxrl
䡲	xxrl
厝	xxrm
㛭	xxrm
娉	xxsa
軭	xxsg
匭	xxsq
媩	xxuq
嚴	xxvs
娔	xxwq
嫴	xxwy
姦	xxxc
轟	xxxf
嫹	xxxg
孍	xxxs
㔷	xxyw
軘	xyaf
厕	xyaj
媄	xycd
嫀	xyct
轃	xyct
軚	xydf
妎	xydr
輏	xyff
嫒	xygb
匾	xygp
媥	xygp
䡢	xygp
䡪	xyhh
㚷	xyhk
嫂	xyjb
軫	xyke
㜒	xyld
㛋	xylk
嫱	xyln
㶮	xymi
㕐	xyox
妒	xypc
䡎	xypf
㛛	xyrc
媋	xyrm
姾	xysg
輇	xysg
嬡	xyub
㪅	xyub
輳	xyug
軶	xyvv
仄	xywd
丙	xywf
婗	xywq
輗	xywq
嬟	xywt
轙	xywt
㕒	xywt
邴	xywv
㔱	xyyw
醆	yaaa
䙁	yaaa
䣬	yaaf
被	yacp
䁉	yadm
褀	yafp
贼	yagd
䘬	yagd
䋯	yaih
氧	yait
则	yajm
刏	yajt
裓	yald
补	yalp
羨	yalq
啔	yanm
衽	yatp
肈	yaub
䤁	yavv
裰	ybbb
醊	ybbb
褬	ybbo
䙜	ybce
襎	ybcm
襠	ybcm
袆	ybgp
䋜	ybih
衩	ybii
赆	ybjo
氡	ybjo
袦	yblv
䠳	yblv
衶	ybmp
㲴	ybmt
酪	ybnm
袼	ybnm
赂	ybnm
䙛	ybnx
袶	yboa
氚	ybrt
䠶	ybtr
辤	ybwy
受	ybxw
醸	ybxx
裉	ycbp
贩	ycbx
褫	ycch
氖	ycct
美	ycdi
戻	ycdp
褪	ycep
釂	ycfk
襫	ycfr
袴	ycfs
䠸	ycfs
仝	ycfw
醵	ycgd
毁	ychb
㩓	ychh
裭	ychq
䥣	ycht
裌	ychw
䙎	ycic
酻	ycjv
褑	yckb
酹	yckf
䙉	ycld
㧂	ycmp
醜	ycmx
躱	ycof
褉	ycpc
裿	ycrn
躸	ycrn
裺	ycrv
醃	ycrv
羲	ycsi
酥	yctf
秦	yctg
舅	ycuc
䞏	ycup
躷	ycxc
䆐	ycyc
䘿	ydbl
戺	ydbp
襵	yddd
㒪	yddg
襈	yddw
襯	yddw
裨	ydel
䣵	ydff
䤕	ydio
褛	ydip
襱	ydka
䡁	ydka
䙱	ydlb
㰡	ydlq
䙙	ydlu
焈	ydmi
醅	ydnm
赔	ydnm
㖋	ydnn
䘦	ydnq
袙	ydrp
䲸	ydrr
氘	ydrt
介	ydrw
酏	ydvf
衪	ydvp
㦾	ydvp
䠴	ydyr
刽	yeaj
䘰	yeed
氕	yeet
酣	yeff
韲	yeff
扉	yefh
裶	yefh
䤏	yefh
襖	yegc
酝	yegf
贱	yegm
扄	yegn
会	yegw
醴	yehe
軆	yehe
企	yehw
䣨	yeja
赚	yejg
褃	yekm
䘣	yenq
䤂	yeof
迍	yepa
迏	yepd
逎	yepf
裇	yesm
袟	yetg
郐	yewv
襛	yexo
醲	yexo
贬	yexp
赅	yeyw
氦	yeyw
䠹	yeyw
鼮	yfad
鼯	yfan
鼨	yfbj
䶅	yfbn
鼷	yfcc
鼺	yfcc
鼶	yfch
鼳	yfdl
褄	yfdx
鼸	yfeg
褿	yfer
醩	yfer
䙓	yfff
袪	yffp
㧁	yffp
躼	yffr
氬	yfft
酾	yfgi
鼥	yfgi
襧	yfgm
醉	yfhl
䘹	yfhl
䙒	yfic
䶉	yfic
鼭	yfik
袨	yfin
鼧	yfin
襗	yfir
醳	yfir
䙇	yfkc
䘸	yfki
袻	yfkm
鼣	yfld
衧	yflf
酑	yflf
鼵	yfll
䣿	yfls
鼪	yflt
襢	yflu
䡀	yflu
䶃	yflw
裲	yfmm
頓	yfmm
鼰	yfmm
襬	yfmn
鼲	yfmx
鼢	yfnw
襡	yfob
袜	yfof
䶂	yfoi
鼱	yfok
禽	yfom
醨	yfom
褵	yfom
鼩	yfon
裷	yfon
䙰	yfop
䶄	yfos
䣪	yfpm
䑔	yfpm
鼦	yfpn
䶆	yfpr
氫	yfrc
氭	yfrh
袹	yfrm
鼹	yfrx
醘	yfsm
䑖	yfts
䶈	yfuk
䤄	yfum
鼤	yfuy
鼫	yfvd
廌	yfvx
舃	yfvx
赋	yfwe
䶇	yfxk
鼬	yfxm
袅	yfxq
扆	yfxq
鼠	yfxr
釀	yfxx
鼴	yfxx
顷	yfym
顿	yfym
袚	ygbi
䣮	ygbi
爱	ygbx
䘧	ygcd
袏	ygcf
䙃	ygck
醠	ygcs
赗	ygdm
氥	ygft
袇	ygfy
酮	yghf
袡	ygif
赒	ygin
裯	ygin
酵	ygjv
贿	ygkm
酭	ygkm
衻	yglg
䙂	ygmu
衳	ygmx
扃	ygnm
醢	ygns
䘠	ygow
㓲	ygpa
遍	ygpe
扁	ygpf
騗	ygpf
翩	ygph
甂	ygpj
㼐	ygpo
㲢	ygpo
鶣	ygpr
䤈	ygss
袄	ygtp
裕	ygyn
衲	ygyw
氝	ygyw
䐡	ygyy
䤙	yhab
襳	yhaf
䤘	yhaf
褖	yhaq
裾	yhbp
酘	yhbx
褼	yhcd
褔	yhcm
裋	yhei
襕	yhfh
褍	yhfk
赇	yhfm
醰	yhfm
䙐	yhgr
舍	yhgw
褶	yhhd
䠽	yhhe
醎	yhhf
醪	yhhk
傘	yhhl
扇	yhhx
舘	yhip
䑕	yhkg
尒	yhkw
舒	yhlx
岛	yhmq
氙	yhmt
仚	yhmw
䠺	yhnm
躲	yhof
褾	yhpg
醥	yhpg
䧾	yhpr
䘛	yhqp
凫	yhqq
裥	yhrm
鵨	yhrr
䣶	yhtf
䞌	yhtm
舖	yhuf
䙖	yhuu
䙘	yhwh
䙯	yhws
众	yhww
䙅	yhxc
䣼	yhyf
酿	yicb
躴	yicb
贮	yiff
䘺	yifs
䙋	yifu
裬	yigb
褹	yigi
毀	yihb
䙞	yihe
䋀	yihk
褂	yiia
䤒	yiid
袿	yiif
䘼	yiio
扅	yiiq
袳	yiiq
襓	yiiw
酧	yikf
酳	yikm
醗	yilw
䣾	yimm
酩	yinm
舎	yinm
酡	yinq
袉	yinq
舗	yinu
褤	yinx
舜	yioa
䢬	yioe
䴄	yior
䑟	yios
䘾	yipm
襏	yiqb
醱	yiqb
䘢	yirf
軉	yism
账	yitm
袎	yiuc
䤆	yiug
䙆	yiug
羕	yivi
氨	yixc
軄	yjar
㪢	yjbb
遚	yjbe
㲣	yjbo
鄋	yjbw
叟	yjbx
醂	yjff
醺	yjfm
䙧	yjfm
䙗	yjgx
羑	yjii
㕗	yjim
个	yjjw
䘻	yjkm
戽	yjlf
酙	yjlf
褅	yjmp
仒	yjow
襟	yjpg
㫪	yjrm
褈	yjwm
䘪	yjwq
赡	yjxc
襜	yjxc
䣹	ykaa
袵	ykat
氢	ykcf
衫	ykep
㐱	ykew
酎	ykff
襩	ykfm
顅	ykfm
衬	ykfp
射	ykfr
奉	ykgg
䘷	ykip
袸	ykjv
袝	ykkf
䠵	ykkf
襥	ykki
袱	ykld
肩	ykmp
醭	ykni
襆	ykni
袺	yknm
襭	yknm
褓	ykno
鵳	ykrr
䳞	ykrr
醯	yksm
襒	ykst
䙈	ykub
軇	ykvk
醻	ykvk
酼	ykyf
襨	ykyk
裗	ykyp
襶	ylaw
衼	ylbx
䣫	ylbx
氤	ylcd
裀	ylcd
躻	ylcf
䣭	yldf
戾	yldp
舁	yldr
袘	yldv
财	ylee
䤎	ylen
襷	ylfh
仐	ylfw
酟	ylhf
袮	ylhk
贴	ylhm
扂	ylhp
袩	ylhp
酬	ylij
酶	yljn
㤗	ylkg
泰	yllg
氽	ylmw
啬	ylnm
䣻	ylnm
裍	ylof
袕	ylop
䠻	ylqb
醡	ylqt
㰟	ylqt
複	ylrb
㪐	ylub
䙟	ylvv
衿	ylwp
䤇	ylyb
褣	ylyn
氳	ylys
醞	ylys
䘭	ymap
袯	ymbi
酦	ymbi
酽	ymee
遦	ymep
襴	ymfh
襦	ymfk
醹	ymfk
氩	ymft
酸	ymgb
羙	ymii
赎	ymjc
褦	ymkn
䣲	ymld
䣯	ymmf
赕	ymmi
扊	ymmi
氮	ymmi
裧	ymmi
醈	ymmi
襂	ymmk
醦	ymmk
襸	ymmm
貫	ymmn
袓	ymmp
軂	ymmu
䙬	ymmx
䙤	ymne
贻	ymnm
䙥	ymnq
裈	ymra
襇	ymrm
酰	ymtf
襉	ymuq
衴	ymwq
躭	ymwq
酖	ymwq
醓	ymws
褸	ymxc
軁	ymxc
褌	ymxf
醽	ymxn
䠾	ymyw
䤌	ynbn
褨	yncf
醝	yncf
䑘	yncf
裐	ynkm
䣺	ynkm
扈	ynkv
襔	ynmm
䤍	ynmm
启	ynmp
酷	ynnm
躳	ynnm
醼	ynnx
䣥	ynqf
袊	ynqx
䠲	ynqx
酯	ynrm
酲	ynsg
裎	ynsg
啟	ynst
褋	ynvo
袣	ynvv
酚	ynwf
衯	ynwp
贶	ynwq
躮	ynwr
氛	ynwt
襙	ynxo
戗	yoaa
创	yoaj
丧	yocf
襑	yock
袍	yodb
㼊	yoea
躰	yoff
㦿	yofp
枭	yofq
䙑	yofx
䘴	yogm
酌	yoii
䘤	yoii
醇	yojv
氰	yokm
	yokm
䞍	yokm
酗	yolv
䣴	yolw
䘲	yomb
襀	yomm
购	yomx
袧	yonm
䣱	yonm
仓	yonw
襻	yooh
鸧	yooq
褝	yorl
醕	yorm
䘩	yorm
酕	yotf
袀	yoty
裪	yovt
醄	yovt
躹	yowi
気	yowt
舄	yoxo
裱	yoxq
襐	ypaq
畲	ypcm
初	ypcp
䤊	ypdf
褷	ypes
襪	ypfi
䙦	ypfi
顧	ypfm
襺	ypgb
䤀	ypgn
佘	ypgw
䙕	yphs
襼	ypie
躵	ypiu
襽	ypmh
	ypmm
䙡	ypmm
䠿	ypmm
帍	ypmp
䘜	ypmp
帠	ypmr
袑	ypnm
襍	ypof
褯	yppm
褡	yppw
醀	yprf
雇	yprp
裄	ypsg
袷	ypwp
醮	ypxo
䙮	ypxp
	ypym
䙌	ypym
䙄	ypyr
醛	ypys
躬	yqbr
氟	yqdr
羛	yqdr
襚	yqge
酐	yqgf
躺	yqgn
衦	yqgp
赠	yqir
䙢	yqir
䘟	yqjj
袢	yqkg
䘯	yqkm
㲵	yqkm
伞	yqlf
襁	yqnb
裞	yqnw
裆	yqob
酢	yqtf
劑	yraj
蠢	yrbb
襊	yrdb
齏	yref
裢	yrep
酊	yrff
襅	yrff
褟	yrhh
齋	yrhk
醌	yrja
裩	yrja
氠	yrjj
醒	yrlt
旾	yrma
春	yrmg
齌	yrmi
齎	yrmm
衵	yrmp
氜	yrmt
袔	yrnm
酠	yrnm
䙭	yrns
裸	yrof
躶	yrof
裼	yror
赐	yror
褐	yrov
䙨	yrox
裮	yrrm
䞎	yrrm
裫	yrrp
鳸	yrrp
鵢	yrrr
䤐	yrrr
䳎	yrrr
䳔	yrrr
齊	yrry
氲	yrsm
褞	yrsm
醖	yrsm
齍	yrsm
惷	yrup
襮	yrwl
䤖	yrwl
䶒	yrxc
䁈	ysdm
全	ysgw
綮	ysih
襰	ysjm
䏿	yskm
酔	yslf
盇	ysmd
醍	ysmf
盖	ysmi
褆	ysmp
啓	ysnm
棨	ysof
晵	ysrm
败	ystm
肇	ysub
醣	ytdn
䤓	ytfg
䙩	ytfg
酜	ytgf
衭	ytgp
赃	ytif
釄	ytjf
醿	ytjh
醾	ytjw
軈	ytku
䢭	ytle
羡	ytlq
裤	ytra
褴	ytsm
躿	yttl
䘳	ytwp
褲	ytxf
䘨	ytyp
配	yubf
裙	yubp
肁	yubp
愛	yubq
㪂	yubx
䣦	yucf
㔕	yuct
襣	yucu
袐	yuee
䙣	yuef
䤉	yues
酺	yuff
補	yufp
奏	yugg
袾	yugw
䣷	yugw
赙	yukf
䙏	yukf
㲶	yulu
袒	yump
氱	yuor
䑗	yuor
态	yupd
恙	yupi
忥	yupt
衱	yuqp
㧀	yuqp
䙀	yuuq
䘶	yuwl
袂	yuyw
䙫	yvcw
袥	yvdp
醏	yvff
赌	yvfm
褚	yvfp
䣳	yvhf
袛	yvii
褙	yvkm
䙊	yvmp
䘥	yvmp
䘞	yvnp
䙍	yvpd
㠩	yvpr
衹	yvqp
醑	yvsk
慶	yvub
戹	yvvp
褘	yvvp
亾	yvvw
房	yvyp
䣧	ywaf
䘝	ywap
醚	ywep
酛	ywgf
毇	ywhb
襘	ywir
䊆	ywir
氣	ywit
褕	ywka
䤅	ywka
䠼	ywka
裣	ywmo
裡	ywmp
裃	ywnf
酴	ywof
兒	ywqr
鶂	ywrr
䴊	ywrr
義	ywti
㪒	ywub
醷	ywup
邨	ywva
郳	ywwv
䣡	ywwv
䠷	ywwy
襝	ywxh
醶	ywxh
䤃	ywyf
姜	yxci
䙠	yxel
褳	yxep
酤	yxff
仺	yxff
䫞	yxfm
羮	yxft
褠	yxgi
襋	yxhh
襹	yxiw
釃	yxiw
軅	yxkp
䣰	yxlb
褥	yxlk
氯	yxll
醁	yxll
䘵	yxll
赈	yxlo
裖	yxlo
䢅	yxlo
袖	yxmp
袽	yxnm
軀	yxnx
醧	yxnx
䙔	yxnx
羔	yxoi
躯	yxow
襌	yxrl
軃	yxrl
㲷	yxrl
醋	yxrm
褗	yxrx
躽	yxrx
醐	yxuq
氪	yxwq
䤑	yxxg
釅	yxxs
羹	yxyc
氞	yxyw
㦼	yyaa
䣩	yyaf
躾	yycd
酞	yydf
衸	yydr
䚎	yydw
褊	yygp
醙	yyjb
睂	yyjd
斞	yyjl
袗	yyke
俎	yymm
䝿	yymm
贯	yymn
赊	yypg
舂	yyrg
䞐	yyrm
裑	yyrp
酫	yysg
惥	yyup
憃	yyup
罂	yyvt
䘽	yywq
臾	yywr
仌	yyww
婴	yyxc
鹦	yyxo
赑	yyym
戈	aai
皮	aci
五	aff
其	afi
羊	aij
刂	ajj
卜	ali
氵	aof
壬	atf
卩	avj
丩	avj
戼	bbf
	bbf
尺	bbi
原	bdi
尢	bdv
韦	bgj
虫	bmi
中	bmj
夂	bqi
夊	bqi
川	brj
矢	bti
屮	bvj
釆	bwi
又	bxi
六	byi
艮	cbi
乃	cce
丱	ccj
大	cdi
	cee
工	cff
壴	cff
丰	cgj
虍	chv
田	cmf
禾	cti
爫	cwe
言	cyf
訁	cyf
尸	dbe
肀	dbj
巳	dbv
丣	ddf
來	ddi
耳	dff
走	dfi
臣	dfv
娄	dif
目	dmf
白	drf
也	dvv
豸	dwe
廴	dxi
立	dyf
亲	dyi
丬	dyj
丿	eee
甘	eff
莫	efi
云	egi
戋	egi
止	ehf
䒑	eif
曲	emf
辶	epi
讠	epv
父	ewi
丆	fde
歹	fdi
舟	fei
亙	fff
亜	fff
亞	fff
襾	fff
去	ffi
長	ffi
馬	ffi
	fii
一	fjj
罒	fmf
黑	fmi
早	fmj
巜	fnv
鱼	fqf
亠	fyf
	gde
豕	gdi
耂	gfe
西	gff
执	gfi
㦮	ggi
鬥	ggj
关	gii
冂	gmv
忄	goj
夹	gsi
垂	gtf
夭	gti
八	gwi
牙	hae
居	hbf
戊	hdi
覀	hff
求	hfi
卝	hhf
首	hif
小	hki
山	hmj
彑	hnf
饣	hqv
几	hqv
舌	htf
手	htj
门	huv
从	hwi
习	hxf
妾	hyf
京	hyi
土	iff
井	igj
丶	iii
光	ilv
幺	ini
宀	iov
夕	iqi
乑	iri
来	isi
长	iti
癶	ixi
瓦	jai
七	jav
比	jav
已	jbv
不	jdi
正	jff
林	jfi
丨	jjj
亅	jjj
母	jni
	jqv
化	jrv
钅	jtv
孑	jvf
子	jvf
仑	jwv
彡	kee
爪	kei
士	kff
寸	kfi
㡀	kii
业	kjf
员	kmi
亻	krj
巴	kvv
吂	kyf
㐬	kyv
犬	ldi
廾	ldj
十	lfj
二	lgf
占	lhf
氺	lli
囗	lmf
水	lmi
穴	loi
欠	lqi
用	lqj
	lte
生	ltf
	ltf
丑	lvf
凵	lvj
今	lwv
予	lxj
至	maf
戉	mai
亚	mff
雨	mfi
三	mgf
火	mii
	mlv
且	mmf
門	mmf
黽	mmf
貝	mmi
冎	mmv
冖	mpv
	mti
先	mtv
入	mwi
厶	mxi
廿	nff
下	nfi
	nie
口	nmf
糹	nni
匕	nqv
你	nri
	ntf
分	nwe
亽	nwi
㐄	oaj
彐	obf
瓜	oei
木	ofi
朩	ofi
	ogf
	onv
㔾	onv
鸟	oqf
勹	oqv
平	osj
毛	otv
乂	owi
㐅	owi
尹	pbe
刀	pce
龙	pdi
彳	pej
艹	pfj
卄	pfj
示	pgi
另	pme
四	pmf
㠯	pmf
巾	pmj
魚	pqi
隹	prf
片	prv
千	ptj
合	pwf
弓	qbv
直	qff
革	qfj
干	qgj
丷	qie
	qle
纟	qnf
風	qqi
乍	qtf
	qxi
车	raj
兂	rav
旡	rav
丁	rfj
耒	rgi
日	rmf
巛	rnv
鳥	rri
疒	ryf
主	ryf
丂	sav
扌	sff
束	sfi
王	sgf
亍	sgj
皿	smf
是	smi
九	sqv
攵	sti
万	tae
斤	tej
相	tff
夫	tgi
少	tke
骨	tmf
犭	tqe
金	twf
釒	twf
广	tye
冫	tyf
交	tyi
君	ubf
聿	ubj
己	ubv
力	uce
丌	udj
甫	ufi
天	ugi
旦	umf
囬	umf
心	upi
月	uqf
及	uqi
自	urf
牜	utf
牛	utj
了	uvj
文	uyi
石	vdf
者	vff
北	vhv
	vmf
甲	vmj
马	vnf
兴	voi
㓁	vpi
	vpv
氏	vqv
丘	vrf
缶	vtj
韋	vvj
乙	vvv
乀	vvv
乁	vvv
乚	vvv
乛	vvv
	vvv
	vvv
乊	vwe
方	vye
弋	wai
共	wfi
元	wgv
上	whf
米	wii
里	wmf
礻	wpi
儿	wqv
我	wti
阝	wvj
亼	wwf
飠	wwi
音	wyf
辛	wyj
鹿	wyv
匚	xav
匸	xav
女	xcf
厂	xde
古	xff
	xff
镸	xfi
車	xfj
开	xgj
齿	xhj
由	xmf
吅	xmf
灬	xoi
之	xpi
爿	xve
亡	xyv
屯	yav
太	ydi
酉	yff
	ygi
	yif
贝	ymi
毌	ynf
户	ype
衤	ypi
身	yre
臼	yrf
气	ytv
人	ywi
