工	aaaa
菚	aaau
式	aad
匞	aad
蘛	aade
藄	aadi
匿	aadk
葚	aadn
慝	aadn
茙	aadr
萁	aadw
甙	aafd
苷	aaff
蘜	aafo
菣	aahc
茝	aahh
茞	aahh
藍	aahl
藖	aahm
虦	aahm
芽	aaht
蕥	aahy
剗	aajh
戒	aak
蓳	aakg
蓲	aakk
盞	aalf
蘳	aamf
蘣	aamg
蒆	aamv
茿	aamy
苣	aanf
葉	aans
苉	aaqb
蔕	aaqh
蘙	aatn
荛	aatq
戔	aau
芅	aau
苆	aavr
匶	aawv
莁	aaww
藂	abci
菆	abcu
荫	abef
蘟	aben
茸	abf
芓	abf
蔯	abgi
邛	abh
卭	abh
匩	abhg
菡	abib
蒸	abio
荪	abiu
节	abj
藬	abkm
茁	abmj
芤	abnb
菰	abry
蕯	abtg
蓀	abti
薩	abug
蘵	abuj
萨	abut
匜	abv
蔭	abwc
蒢	abwt
茎	acaf
匥	acak
芭	acb
芧	acbj
蓩	acbl
蓣	acbm
蕷	acbm
鶜	acbo
葇	acbs
茅	acbt
蔘	acce
蓪	acep
苔	ackf
葈	acks
荾	acwt
芆	acyu
莽	adaj
蕻	adaw
蔵	aday
苊	adbb
茇	adcu
苃	adcu
弎	add
藞	addd
戎	ade
葫	adef
萇	adeu
苦	adf
莾	adfa
莀	adfe
蓐	adff
萘	adfi
荂	adfn
葳	adgy
葴	adgy
荐	adhb
葜	adhd
茬	adhf
蔧	adhv
蒧	adhy
藉	adij
藕	adiy
菴	adjn
鄀	adkb
若	adkf
蠚	adkj
匲	adkk
惹	adkn
逽	adkp
苈	adlr
荋	admj
项	admy
蒇	admy
蕆	admy
項	admy
藏	adny
茂	adny
荿	adny
荙	adpu
蒝	adri
藶	adth
芖	adu
蕨	aduw
蕼	advh
戡	adwa
碁	adwd
期	adwe
朞	adwe
基	adwf
斟	adwf
卙	adwf
菶	adwh
綦	adwi
剘	adwj
萶	adwj
蜝	adwj
蟴	adwj
勘	adwl
甚	adwn
惎	adwn
夦	adwq
斯	adwr
棊	adws
蓁	adwt
尠	adwt
其	adwu
欺	adww
匧	adww
歁	adww
莢	adww
諅	adwy
茏	adxr
葢	adyl
荗	adyy
菔	aebc
莩	aebf
萉	aecb
萾	aecl
薍	aecn
蕦	aedm
萠	aeef
薶	aeef
蒯	aeej
藐	aeeq
萲	aefc
藸	aefj
苴	aegf
莇	aegl
苚	aej
﨟	aejn
莻	aekx
荕	aelr
蕣	aeph
薆	aept
蓫	aepu
葋	aeqk
艿	aer
蘨	aeri
菜	aesu
葄	aetf
蕤	aetg
蔿	aeto
散	aety
虅	aeuc
藤	aeui
蕂	aeul
荽	aevf
蓞	aevf
蒵	aexd
芨	aeyu
鞯	afab
韄	afac
鞴	afae
鞾	afaf
韊	afai
鞳	afak
蕡	afam
靾	afan
韉	afao
鞢	afas
韈	afay
邯	afbh
蓋	afcl
靶	afcn
鞣	afcs
芸	afcu
芰	afcu
靫	afcy
甘	afd
弍	afd
薷	afdj
鞑	afdp
蘎	afec
鞵	afed
靻	afeg
鞖	afev
鞱	afev
靸	afey
芏	aff
蕓	affc
鞋	afff
鞲	afff
葑	afff
茥	afff
靯	affg
靬	affh
鞊	affk
韇	affm
韃	affp
蕘	affq
韁	afgg
靰	afgq
鞕	afgq
靺	afgs
鞆	afgw
鞁	afhc
鞐	afhh
蒖	afhw
鞘	afie
鞺	afif
蒜	afii
鞜	afij
鞩	afij
鞝	afik
苿	afiu
莍	afiy
革	afj
芉	afj
鞸	afjf
靼	afjg
鞮	afjh
鞰	afjl
鞨	afjn
韅	afjo
薣	afkc
鞙	afke
薹	afkf
鞓	afkg
蘦	afkk
虂	afkk
鞼	afkm
薳	afkp
鞇	afld
蕾	aflf
匵	aflm
藚	aflm
勒	aflt
鞻	aflv
鞅	afmd
萳	afmf
贰	afmi
貳	afmi
靹	afmw
芌	afnb
薵	afnf
靵	afnf
苇	afnh
鞚	afpa
荸	afpb
葧	afpl
鞍	afpv
芜	afqb
芫	afqb
鞉	afqi
鞄	afqn
鞠	afqo
鞔	afqq
荺	afqu
莰	afqw
鞫	afqy
靮	afqy
韂	afqy
鞞	afrf
靳	afrh
鞡	afru
靪	afsh
韆	afsp
某	afsu
甛	aftd
著	aftj
蓍	aftj
鞒	aftj
鞽	aftk
鞦	afto
荖	aftx
鞂	afty
蕔	afuc
靽	afuf
鞧	afug
蔷	afuk
鞛	afuk
薘	afup
蓻	afuy
鞎	afve
鞀	afvk
鞬	afvp
靭	afvy
靱	afvy
鞥	afwa
蕶	afwc
藝	afwc
薔	afwk
鞈	afwk
靲	afwn
爇	afwo
鞭	afwq
菱	afwt
芙	afwu
靴	afwx
藿	afwy
蓺	afwy
鞃	afxc
靷	afxh
靿	afxl
鞿	afxy
鞟	afyb
鞹	afyb
蘾	afye
韀	afyo
華	agaf
荆	agaj
茾	agaj
荊	agaj
鷨	agao
邼	agbh
萅	agbj
芚	agbn
荎	agcf
菿	agcj
匡	agd
弌	agd
菾	agdn
菁	agef
蒪	agef
莆	agey
芋	agfj
廿	aghg
艹	aghh
卄	aghh
蔫	agho
芐	aghu
苤	agig
芣	agiu
蓴	agjf
荁	agjg
菄	agji
蕙	agjn
莄	agjq
菫	agkg
蒚	agkh
蘁	agkk
葍	agkl
藾	agkm
虉	agko
藗	agkp
荳	agku
蔌	agkw
薑	aglg
萰	agli
劻	aglt
芾	agmh
茦	agmi
蕀	agmi
莿	agmj
蓸	agmj
颟	agmm
蓛	agmt
蔶	agmu
苪	agmw
黃	agmw
七	agn
匚	agn
匸	agn
巧	agnn
戈	agny
弋	agny
瓨	agny
莱	agou
葬	agqa
薞	agqe
塟	agqf
薤	agqg
茢	agqj
薚	agqr
蔜	agqt
茉	agsu
廾	agth
苹	aguh
荚	aguw
莖	agva
萐	agvh
葘	agvl
葝	agvl
萋	agvv
蕐	agwh
薾	agwq
荑	agxw
匤	agyi
蔖	ahag
萛	ahaj
蘆	ahal
萀	aham
藘	ahan
蘧	ahap
菲	ahdd
匪	ahdd
韮	ahdg
繤	ahdi
蕜	ahdn
薉	ahdy
芷	ahf
苜	ahf
蕋	ahhh
煕	ahho
蘃	ahhs
匷	ahhy
菽	ahic
蘋	ahim
荹	ahir
茮	ahiu
苫	ahkf
颐	ahkm
赜	ahkm
賾	ahkm
頤	ahkm
巸	ahkn
熙	ahko
媐	ahkv
蓾	ahlo
孯	ahnb
臤	ahnc
硻	ahnd
腎	ahne
堅	ahnf
朢	ahng
臣	ahnh
卧	ahnh
緊	ahni
蜸	ahnj
臨	ahnk
監	ahnl
盬	ahnl
鹽	ahnl
賢	ahnm
贒	ahnm
頣	ahnm
苢	ahnn
薡	ahnn
覧	ahnq
覽	ahnq
鋻	ahnq
鍳	ahnq
鑒	ahnq
掔	ahnr
擥	ahnr
竪	ahnu
豎	ahnu
婜	ahnv
臥	ahnw
譼	ahny
蔝	ahou
莧	ahqb
薒	ahqo
萈	ahqy
邪	ahtb
牙	ahte
鸦	ahtg
鴉	ahto
迓	ahtp
雅	ahty
藈	ahwd
茈	ahxb
茳	aiaf
蘫	aial
菃	aian
蕖	aias
葓	aiaw
范	aibb
菭	aick
莦	aief
菹	aieg
萷	aiej
蔆	aift
蔳	aige
薄	aigf
萍	aigh
蒲	aigy
菠	aihc
蔋	aihc
蔢	aihv
东	aii
莎	aiit
蕰	aijl
蘯	aijl
蕩	aijr
蕅	aijy
藻	aiks
薀	aill
莈	aimc
荡	ainr
莐	aipq
茪	aiqb
鸫	aiqg
萢	aiqn
蒎	aire
萡	airf
薸	aisi
藫	aisj
菏	aisk
莯	aisu
萿	aitd
落	aitk
藩	aitl
汞	aiu
蓱	aiua
蓡	aivc
薓	aivc
葏	aivh
菬	aivk
蒅	aivs
薻	aivs
虃	aiwg
蕍	aiwj
蒤	aiwt
蒞	aiwu
匯	aiwy
蒗	aiye
薃	aiyk
茫	aiyn
蓅	aiyq
蓽	ajaf
蕞	ajbc
鄚	ajdb
蓦	ajdc
驀	ajdc
墓	ajdf
幕	ajdh
暮	ajdj
蟇	ajdj
募	ajdl
慕	ajdn
摹	ajdr
莫	ajdu
謩	ajdy
萌	ajef
昔	ajf
荲	ajff
蒔	ajff
莳	ajfu
划	ajh
皵	ajhc
萺	ajhf
草	ajj
菖	ajjf
剒	ajjh
蕌	ajjj
蔓	ajlc
蒀	ajlf
躉	ajmh
蠆	ajmj
勱	ajml
邁	ajmp
萬	ajmy
逪	ajpd
鹊	ajqg
葛	ajqn
茰	ajqu
斮	ajrh
菒	ajsu
菓	ajsu
葃	ajtf
虄	ajtg
蓝	ajtl
茧	aju
郾	ajvb
匽	ajvd
鶠	ajvo
鵲	ajwo
菎	ajxx
葺	akbf
蕺	akby
叵	akd
戓	akd
艱	akfe
菋	akfi
囏	akfk
戁	akfn
歎	akfw
臡	akfw
尀	akfy
難	akfy
鄞	akgb
或	akgd
戜	akgd
茣	akgd
堇	akgf
勤	akgl
惑	akgn
懃	akgn
觐	akgq
覲	akgq
斳	akgr
歏	akgw
蕗	akhk
匮	akhm
蒉	akhm
匱	akhm
蕢	akhm
莡	akhu
鄿	akkb
酄	akkb
敺	akkc
毆	akkc
莒	akkf
匰	akkf
蕇	akkf
鹳	akkg
剾	akkj
飌	akkj
區	akkk
虈	akkk
勸	akkl
颧	akkm
顴	akkm
萼	akkn
蕚	akkn
鷗	akko
鸛	akko
觀	akkq
蘄	akkr
歐	akkw
歡	akkw
甌	akky
雚	akky
莂	aklj
蒷	akmu
莴	akmw
酀	akub
燕	akuo
鷰	akuo
嬊	akuv
荶	akwn
蓶	akwy
蔮	alag
蘻	albi
藣	alcx
蘮	aldj
蒽	aldn
茵	aldu
蔑	aldy
苗	alf
薯	alfj
蓒	alfj
巭	alfw
薗	alfy
葨	alge
莗	alj
匣	alk
茄	alkf
茴	alkf
蘲	allf
虆	alli
荔	alll
藟	alll
莮	allr
蘽	alls
蕒	almu
葸	alnu
薎	alpa
鄸	alpb
蘉	alpc
瞢	alph
顭	alpm
夢	alpq
莲	alpu
蓮	alpu
薨	alpx
甍	alpy
鹋	alqg
薥	alqj
萝	alqu
艻	alr
蔪	alrj
功	alt
菌	altu
蔨	alub
蔞	alvf
藪	alvt
匦	alvv
匭	alvv
蒕	alwl
莔	alwm
鶓	alwo
苏	alwu
苬	alwu
蔂	alxi
蘿	alxy
藅	alyj
蕽	amae
芁	amb
芟	amcu
鶧	amdo
英	amdu
蘴	amdu
蓇	amef
苖	amf
苒	amff
巬	amfw
茼	amgk
繭	amhj
芇	amhj
匝	amhk
萜	amhk
顢	amhm
荝	amjj
萴	amjj
苘	amkf
蘡	ammv
萵	amnk
薖	amnp
慐	amnu
苋	amqb
葻	amtj
贡	amu
貢	amu
貣	amu
菵	amun
斢	amwf
黊	amwf
黈	amwg
黇	amwk
黅	amwn
鷬	amwo
黆	amwq
黄	amwu
芮	amwu
萞	amwx
聓	amyb
鞏	amyf
跫	amyh
蛩	amyj
恐	amyn
銎	amyq
芃	amyu
巩	amyy
苠	anab
艺	anb
芑	anb
巨	and
蔚	anff
藯	anfn
葭	anhc
匨	anhf
莊	anhf
葿	anhf
蔣	anhf
葦	anhh
蘠	anhk
蕸	anhp
蔬	anhq
荍	anht
忒	ani
螶	anjj
蘗	anks
薜	anku
勚	anml
勩	anml
贳	anmu
貰	anmu
乬	annb
巪	annb
蕊	annn
蘂	anns
迣	anpv
枼	ansu
荱	antn
苾	antr
戉	anty
芯	anu
荬	anud
世	anv
蓼	anwe
芵	anwu
藋	anwy
苨	anxb
蘹	anye
荩	anyu
苡	anyw
薠	aodm
蘱	aodm
蕿	aoec
薱	aogf
蔊	aojf
藀	aooo
菼	aoou
蒾	aopu
炗	aou
苂	aou
蒌	aovf
薮	aovt
茡	apbf
菪	apdf
藔	apdi
萓	apeg
蔻	apfc
蒙	apfe
茔	apff
蒄	apff
鹲	apfg
萗	apfi
氋	apfn
鸏	apfo
莞	apfq
藆	apfr
蔲	apft
苎	apgf
荢	apgf
萱	apgg
萣	apgh
薲	apgm
藼	apgn
蔩	apgw
莹	apgy
菅	aphn
荥	apiu
萤	apju
蓂	apju
营	apkk
荤	aplj
葷	aplj
劳	aplr
茕	apnf
藌	apnj
蔤	apnm
薴	apns
荧	apou
菀	apqb
蓥	apqf
莺	apqg
蒬	apqy
荦	aprh
蒏	apsg
苧	apsj
荣	apsu
芝	apu
荌	apvf
藛	apvo
葖	apwd
蓿	apwj
蓉	apwk
䓖	apwl
茓	apwu
藭	apwx
蒮	apwy
萦	apxi
芪	aqab
荈	aqah
鬵	aqah
朁	aqaj
蠶	aqaj
兓	aqaq
茋	aqay
苑	aqbb
茒	aqbj
葾	aqbn
葼	aqbt
蒭	aqbt
芶	aqcu
莃	aqdh
薝	aqdy
蔛	aqef
薢	aqeh
葪	aqej
菳	aqf
茚	aqgb
藓	aqgd
蓟	aqgj
蔔	aqgl
葡	aqgy
瓯	aqgy
区	aqi
荀	aqjf
苅	aqjj
驚	aqkc
苟	aqkf
茗	aqkf
蟼	aqkj
葂	aqkl
憼	aqkn
莬	aqkq
擎	aqkr
檠	aqks
敬	aqkt
警	aqky
菟	aqky
殴	aqmc
藑	aqmt
萯	aqmu
苞	aqnb
蘚	aqod
薊	aqoj
蘇	aqot
菊	aqou
炁	aqou
帶	aqph
慸	aqpn
遰	aqpp
鸥	aqqg
茤	aqqu
欧	aqqw
匢	aqre
匫	aqrj
萄	aqrm
葱	aqrn
芴	aqrr
茐	aqry
蔱	aqsc
茆	aqtb
获	aqtd
莥	aqtf
蕕	aqtg
蕏	aqtj
莸	aqtn
荻	aqto
艾	aqu
芕	aqu
匹	aqv
兂	aqv
旡	aqv
萏	aqvf
蕵	aqwe
鴄	aqwo
鴎	aqwo
鴱	aqwo
芡	aqwu
鸢	aqyg
茑	aqyg
匛	aqyi
藰	aqyj
蒥	aqyl
芍	aqyu
葩	arcb
萚	arch
苽	arcy
蓏	arcy
菝	ardc
蘤	areo
苩	arf
荴	arfw
茊	argf
葟	argf
蓵	argh
茩	argk
蒱	argy
薬	aris
莏	arit
茱	ariu
葲	ariu
芹	arj
匠	ark
蘀	arlf
蕪	arlo
菗	armf
蒛	armw
芞	arnb
菦	arpu
蒐	arqc
菢	arqn
蔸	arqq
菂	arqy
藠	arrr
葀	artd
萆	artf
菈	aruf
蒑	arvc
萔	arvk
苵	arwu
蓷	arwy
藥	arxs
薂	aryt
藲	asak
茜	asf
荰	asff
蓕	asff
蔈	asfi
薽	asfy
苯	asgf
莤	asgf
蓜	asgn
蘸	asgo
葙	ashf
艼	asj
蕈	asjj
苛	askf
莕	askf
萙	aspq
菥	asrj
菻	assu
葽	asvf
菘	aswc
藮	aswo
萊	asww
蒁	asyp
苌	atay
殹	atdc
醫	atdg
鹥	atdg
瞖	atdh
莑	atdh
医	atdi
繄	atdi
荞	atdj
蕎	atdk
贀	atdm
翳	atdn
悘	atdn
鷖	atdo
黳	atdo
蓬	atdp
芺	atdu
嫛	atdv
毉	atdw
瑿	atdy
薙	atdy
蒰	atec
蒩	ateg
莠	ater
菙	atfg
荇	atfh
蓗	atfh
芊	atfj
芼	atfn
莛	atfp
薐	atft
董	atgf
苼	atgf
蘍	atgl
翘	atgn
薰	atgo
薫	atgo
尧	atgq
匴	atha
苲	athf
蓰	athh
蒠	athn
莚	athp
蕱	atie
葕	atih
萫	atjf
莉	atjj
藒	atjn
茖	atkf
萂	atkf
莵	atky
萭	atky
蔥	atln
蓖	atlx
薁	atmd
蘈	atmm
薇	atmt
藢	atmt
蕃	atol
萩	atou
蘅	atqh
藜	atqi
蘒	atqn
蘓	atqo
蔾	atqs
菞	atqt
蓹	atrb
薭	atrf
蘌	atri
莪	atry
蕧	attt
蘒	attx
萪	atuf
苸	atuh
蕛	atut
苳	atuu
蘶	atvc
萎	atvf
葎	atvh
萟	atvy
蓯	atwh
蒣	atwt
蘩	atxi
莓	atxy
攻	aty
藊	atya
荓	auaj
蒴	aube
蓘	auce
萒	aucq
蒫	auda
菤	audb
藙	auec
蘢	aued
蕑	auef
葥	auej
苙	auf
菛	auf
荘	auff
蓤	auft
蘭	augi
蓔	augo
葁	augv
莘	auj
萻	aujf
蕫	aujf
蕳	aujf
蔁	aujj
薏	aujn
蕲	aujr
蔀	aukb
蔉	auke
菩	aukf
蔄	aukf
莌	aukq
蔐	aumd
蔏	aumk
藡	aump
蔽	aumt
虌	aumx
蕄	aunu
蒂	auph
蒡	aupy
蒋	auqf
蒟	auqk
薋	auqm
茭	auqu
茨	auqw
藱	aurc
藽	ausq
薪	ausr
蒺	autd
虁	autt
菨	auvf
蔅	auvf
蒹	auvo
蔺	auwy
藺	auwy
苝	auxb
蕁	avaf
艽	avb
莭	avcb
蔇	avcq
菇	avdf
薅	avdf
茛	aveu
茟	avfh
蕭	avfj
荨	avfu
藇	avgw
蓃	avhc
藎	avhl
萧	avij
菉	aviu
茹	avkf
苕	avkf
蕠	avki
蒘	avkr
菑	avlf
虋	avmv
菷	avph
萖	avqb
蕮	avqo
芀	avr
切	avt
莙	avtk
蔒	avto
芛	avtr
茘	avvv
葌	avvv
萸	avwu
袃	avye
荵	avyn
芄	avyu
茷	awau
苍	awbb
蓊	awcn
葰	awct
葮	awdc
茯	awdu
芿	awer
荟	awfc
茌	awff
芢	awff
蔡	awfi
苻	awfu
菕	awga
葊	awga
蘥	awga
葵	awgd
蒨	awge
荃	awgf
莶	awgi
剳	awgj
匬	awgj
萮	awgj
薈	awgj
匼	awgk
荅	awgk
蔹	awgt
蘞	awgt
匳	awgw
薟	awgw
蘝	awgw
蓚	awhe
蓨	awhe
蓧	awhs
莜	awht
苶	awiu
芥	awjj
蛬	awju
藵	awke
茽	awkh
葆	awks
輂	awlj
苮	awmj
巷	awnb
孽	awnb
葔	awnd
蒒	awnh
蘬	awnh
躠	awnh
糵	awno
蘖	awns
恭	awnu
薛	awnu
拲	awrj
荷	awsk
茶	awsu
茠	awsu
荏	awtf
莋	awtf
鷋	awto
荼	awtu
共	awu
莅	awuf
蓓	awuk
葠	awvc
葐	awvl
蔦	awvo
鳶	awvo
芬	awvr
棻	awvs
莝	awwf
葅	awwg
鹀	awwg
巫	awwi
鵐	awwo
遳	awwp
觋	awwq
覡	awwq
蓌	awwt
苁	awwu
花	awxb
芲	awxb
蕟	awxc
蒊	awxx
苓	awyc
蒦	awyc
萑	awyf
隿	awyg
劐	awyj
莟	awyk
蒼	awyk
芩	awyn
菍	awyn
蕉	awyo
舊	awyv
荭	axaf
葒	axaf
虇	axay
芎	axb
葞	axbf
苰	axcu
藧	axec
蒃	axeu
蘏	axfm
荮	axfu
葤	axfu
莼	axgn
蒓	axgn
苐	axht
蘰	axjc
茀	axjj
蕴	axjl
藴	axjl
蔃	axkj
蘊	axll
苭	axlr
蒳	axmw
蕝	axqc
药	axqy
葯	axqy
薌	axtb
薿	axth
蘔	axtm
蘕	axtp
芗	axtr
蔠	axtu
蒻	axuu
蒶	axwv
芘	axxb
荜	axxf
蕬	axxi
蒈	axxr
茲	axxu
苺	axyy
蓆	ayah
蔗	ayao
蓠	aybc
蘺	ayby
茺	aycq
蓭	aydn
蘐	ayec
藷	ayfj
虀	ayhg
苄	ayhu
萕	ayjf
薺	ayjf
荠	ayjj
蔼	ayjn
藹	ayjn
蓑	ayke
蘘	ayke
苀	aymb
蔎	aymc
蒿	aymk
藁	ayms
藳	aymt
匟	aymv
藃	aymw
匾	ayna
萹	ayna
芒	aynb
蔰	aync
菺	ayne
薼	aynf
莣	aynn
薦	ayno
藨	ayno
蘪	ayno
荒	aynq
芦	aynr
荄	aynw
蔍	aynx
葶	ayps
薧	aypx
菧	ayqy
芳	ayr
蘑	aysd
蘼	aysd
藦	aysr
蔴	ayss
葹	aytb
蔟	aytd
蔙	ayth
蒍	ayto
芠	ayu
薕	ayuo
蓈	ayvb
莨	ayve
蓢	ayve
蓎	ayvk
菮	ayvw
萃	aywf
蓙	aywf
菸	aywu
蓄	ayxl
虊	ayxs
蕹	ayxy
陿	badw
陈	baiy
隁	bajv
聝	bakg
聀	bay
子	bbbb
孨	bbbf
聶	bbbf
孴	bbbj
顳	bbbm
陬	bbcy
孖	bbg
聑	bbg
耶	bbh
聉	bbmh
阤	bbn
陉	bcag
郰	bcbh
颞	bccm
聂	bccu
埾	bcff
孡	bckg
焣	bcou
阭	bcqn
棸	bcsu
鄹	bctb
聚	bcti
娶	bcvf
陖	bcwt
取	bcy
隓	bdaa
隋	bdae
墮	bdaf
嶞	bdam
隳	bdan
隨	bdap
阨	bdbn
耾	bdcy
堕	bdef
陏	bdeg
随	bdep
陙	bdfe
陓	bdfn
隇	bdgy
承	bdii
陌	bdjg
陾	bdmd
聏	bdmj
陑	bdmj
陭	bdsk
陦	bdtf
陝	bdty
聗	bdww
陜	bdww
陇	bdxt
隱	bean
檃	beas
櫽	beas
阴	beg
阻	begg
隠	bevn
隫	bfam
耺	bfcy
阹	bfcy
孺	bfdj
隭	bfdj
隢	bffq
陡	bfhy
际	bfiy
阱	bfjh
聐	bfkg
聴	bfln
陆	bfmh
隯	bfnf
阮	bfqn
陼	bftj
陸	bfwf
陵	bfwt
陚	bgah
卫	bgd
孒	bgd
聙	bgeg
陠	bgey
孲	bgfg
聽	bgfn
耳	bghg
聇	bghg
阷	bghg
阫	bgiy
陳	bgji
螴	bgjj
敶	bgjt
隔	bgkh
陋	bgmn
陃	bgmw
阢	bgqn
隞	bgqt
陕	bguw
陘	bgva
隬	bgwq
隵	bhaa
芔	bhbh
陂	bhcy
陫	bhdd
耻	bhg
阯	bhg
蚩	bhgj
旹	bhgj
妛	bhgv
骘	bhic
騭	bhic
陟	bhit
屮	bhk
阽	bhkg
函	bibk
顄	bibm
陗	bieg
卺	bigb
脀	bige
丞	bigf
巹	bign
烝	bigo
氶	bii
隙	biji
隚	bipf
逊	bipi
隲	bitc
孙	biy
阥	biy
陧	bjfg
阳	bjg
隄	bjgh
陽	bjgr
刵	bjh
隅	bjmy
隰	bjxo
凾	bkcb
亟	bkcg
焏	bkco
叾	bkf
聖	bkgf
聩	bkhm
聵	bkhm
隤	bkhm
陨	bkmy
隕	bkmy
职	bkwy
孟	blf
塦	blff
隈	blge
阵	blh
陣	blh
勐	bllt
阞	blt
聃	bmfg
耼	bmfg
祟	bmfi
聘	bmgn
隑	bmgu
出	bmk
孾	bmmv
粜	bmou
糶	bmoy
欪	bmqw
孭	bmy
阠	bnfh
了	bnh
卩	bnh
阝	bnh
凵	bnh
孑	bnhg
也	bnhn
隦	bnku
孔	bnn
巜	bnn
耴	bnn
㔾	bnn
孞	bnu
恥	bny
隣	boqh
隣	boqh
耿	boy
阦	boy
褧	boye
孮	bpfi
院	bpfq
聢	bpgh
辽	bpk
聹	bpns
耽	bpqn
聍	bpsh
迆	bpv
聜	bpwa
聺	bpwi
陀	bpxn
阺	bqay
陒	bqdb
聸	bqdy
陥	bqhj
聎	bqiy
孢	bqnn
陱	bqoy
陊	bqqy
陶	bqrm
聦	bqrn
聊	bqtb
陷	bqvg
隐	bqvn
孤	brcy
阪	brcy
隍	brgg
陎	briy
隗	brqc
聭	brqc
陴	brtf
聛	brtf
陻	bsfg
耵	bsh
阿	bskg
娿	bskv
陞	btaf
降	btah
阩	btah
陹	btaj
艸	btbh
茻	btbh
陁	btbn
聒	btdg
聅	btdy
陲	btfg
阡	btfh
聕	btfk
毦	btfn
隀	btgf
隆	btgg
阼	bthf
聥	btky
聰	btln
隩	btmd
阣	btnn
孼	btwb
蠥	btwj
雟	btwk
糱	btwo
櫱	btws
辥	btwu
孫	btxi
愻	btxn
遜	btxp
孜	bty
聠	buah
職	buaj
联	budy
隴	bued
墜	buef
隧	buep
鐆	bueq
隊	buey
阧	bufh
隌	bujg
障	bujh
陪	bukg
聪	bukn
隡	butg
隒	buvo
隘	buwl
隉	bvag
限	bvey
孻	bvhl
隟	bvjs
聣	bvqn
聡	bwcn
聬	bwcn
隂	bwdy
聄	bwet
坠	bwff
際	bwfi
附	bwfy
陯	bwga
聧	bwgd
险	bwgi
隃	bwgj
隥	bwgu
険	bwgw
險	bwgw
阶	bwjh
隖	bwno
除	bwty
﨩	bwvm
隝	bwvo
鵈	bwvo
聁	bwvt
队	bwy
聆	bwyc
阾	bwyc
陰	bwyc
陮	bwyg
耹	bwyn
墬	bxef
聈	bxlt
聨	bxxa
聫	bxxd
陛	bxxf
聯	bxxg
阰	bxxn
聮	bxxo
階	bxxr
乸	bxyy
埅	byff
孓	byi
卪	byi
隮	byjg
阬	bymn
阸	bynn
孩	bynw
陔	bynw
聤	byps
防	byt
駴	caah
颈	cadm
駥	cadt
骐	cadw
騏	cadw
驧	cafo
驊	cagf
弁	caj
馵	caj
刭	cajh
騲	cajh
騹	cakg
驅	cakk
驠	cako
驩	caky
劲	calt
駏	cang
迳	capd
驱	caqy
駆	caqy
骁	catq
鴘	cawo
戏	cay
巯	cayq
骤	cbci
驟	cbci
预	cbdm
預	cbdm
駬	cbg
邓	cbh
予	cbj
驰	cbn
馳	cbn
豫	cbqe
骛	cbtc
矝	cbtc
矡	cbtc
騖	cbtc
奦	cbtd
矟	cbte
堥	cbtf
鞪	cbtf
鹜	cbtg
鹬	cbtg
瞀	cbth
蟊	cbtj
蝥	cbtj
劀	cbtj
暓	cbtj
矠	cbtj
矞	cbtk
務	cbtl
嵍	cbtm
矜	cbtn
愗	cbtn
氄	cbtn
熃	cbto
鶔	cbto
鶩	cbto
鷸	cbto
遹	cbtp
鍪	cbtq
矛	cbtr
柔	cbts
楘	cbts
敄	cbtt
婺	cbtv
驈	ccbk
騥	ccbs
又	cccc
叕	cccc
敠	cccc
叄	cccd
參	ccce
驂	ccce
垒	cccf
亝	cccf
骉	cccf
叠	cccg
絫	ccci
剟	cccj
剼	cccj
颡	cccm
顙	cccm
叅	cccn
毲	cccn
毿	cccn
鵽	ccco
逫	cccp
遪	cccp
桑	cccs
敪	ccct
厽	cccu
叒	cccu
驫	cccu
欼	cccw
歠	cccw
骖	ccde
驿	ccfh
騒	ccjy
骀	cckg
駘	cckg
斚	ccpf
馻	ccqn
騃	cctd
骏	ccwt
駿	ccwt
双	ccy
驭	ccy
厸	ccy
馭	ccy
騳	ccy
骚	ccyj
騷	ccyj
叁	cddf
毵	cden
参	cder
騞	cdhd
奙	cdjn
畚	cdlf
軬	cdlj
貵	cdmu
駹	cdne
駀	cdnn
騻	cdqq
騵	cdri
骑	cdsk
騎	cdsk
驮	cdy
馱	cdy
駄	cdyy
驵	cegg
駔	cegg
甬	cej
勇	celr
勈	celt
恿	cenu
通	cepk
騱	cexd
螚	cexj
態	cexn
熊	cexo
熋	cexo
能	cexx
馺	ceyy
驖	cfag
馶	cfcy
頚	cfdm
圣	cff
驍	cffq
馯	cfh
怼	cfnu
驝	cfps
驦	cfsh
骦	cfsh
对	cfy
駤	cgcf
馬	cghy
駓	cgig
驑	cgjl
駵	cgjn
駷	cgki
馷	cgmh
驪	cgmx
骊	cgmy
駍	cguh
驉	chag
驢	chal
駊	chcy
騑	chdd
覌	chqn
騨	cijf
駫	ciqn
厼	ciu
驆	cjaf
駻	cjfh
馹	cjg
驲	cjg
騠	cjgh
騴	cjpv
騔	cjqn
骒	cjsy
騍	cjsy
騉	cjxx
邰	ckbh
駽	ckeg
台	ckf
瓵	ckgy
驯	ckh
馴	ckh
馽	ckhj
刣	ckjh
驒	ckkf
乨	cknn
怠	cknu
炱	ckou
迨	ckpd
驶	ckqy
駛	ckqy
枲	cksu
辝	ckuh
巼	ckxb
駰	cldy
骃	cldy
驛	clff
驷	clg
駟	clg
騦	clny
劝	clt
圅	cluf
骡	clxi
騾	clxi
駚	cmdy
騆	cmfk
駎	cmg
駧	cmgk
骋	cmgn
騁	cmgn
岊	cmj
駉	cmkg
騧	cmnk
观	cmqn
颿	cmtj
貟	cmu
贠	cmu
驨	cmwk
骣	cnbb
驏	cnbb
騢	cnhc
巴	cnhn
马	cnng
駶	cnnk
騽	cnrg
駜	cntt
騛	cnuh
駃	cnwy
厶	cny
駅	cnyy
驜	cogw
驎	coqh
騌	cpfi
骔	cpfi
驞	cpgm
遤	cpi
馾	cpqn
驼	cpxn
駝	cpxn
允	cqb
騣	cqbt
騶	cqbt
駣	cqiy
駨	cqjg
驹	cqkg
駒	cqkg
驳	cqqy
駁	cqqy
騊	cqrm
騘	cqrn
駠	cqtb
驺	cqvg
欢	cqwy
鸡	cqyg
骝	cqyl
騮	cqyl
馰	cqyy
駈	crgg
騜	crgg
馸	crh
牟	crhj
劺	crhl
鴾	crho
駯	criy
騡	criy
騩	crqc
骠	csfi
驃	csfi
驔	csjh
騕	csvg
騋	csww
馲	ctan
駞	ctbn
骄	ctdj
驕	ctdk
逘	ctdp
矣	ctdu
欸	ctdw
騈	ctff
駪	ctfq
駳	cthp
骆	ctkg
駱	ctkg
骢	ctln
驄	ctln
騀	ctry
騬	ctux
駇	cty
骈	cuah
駢	cuah
驣	cudc
騚	cuej
騂	cuh
骍	cuh
騿	cujh
駾	cukq
驓	culj
騯	cupy
駮	cuqy
骥	cuxw
驥	cuxw
艰	cvey
驌	cvfj
騝	cvfp
騪	cvhc
骕	cvij
騄	cviy
駋	cvkg
駸	cvpc
骎	cvpc
駗	cwet
騇	cwfk
驸	cwfy
駙	cwfy
騤	cwgd
骙	cwgd
駩	cwgg
验	cwgi
騟	cwgj
験	cwgw
驗	cwgw
皴	cwtc
鵕	cwto
逡	cwtp
夋	cwtu
駼	cwty
鳮	cwvo
驋	cwxc
骅	cwxf
駖	cwyc
难	cwyg
骓	cwyg
騅	cwyg
騐	cwyn
驐	cybt
驻	cygg
駐	cygg
叉	cyi
蚤	cyju
骧	cyke
驤	cyke
驙	cylg
骗	cyna
騙	cyna
骟	cynn
騸	cynn
驴	cynt
馿	cynt
骇	cynw
駭	cynw
騼	cynx
駲	cyth
駺	cyve
馼	cyy
礷	daal
碊	daay
磡	dadl
碪	dadn
厮	dadr
毻	daen
遀	daep
左	daf
礚	dafl
矼	dag
礡	dagf
礛	dahl
礥	dahm
砑	daht
厊	daht
礴	daif
厝	dajd
碏	dajg
勵	dajl
礍	dajn
厲	dajy
厪	dakg
奩	dakk
礶	daky
礣	daly
碤	damd
砸	damh
磺	damw
碽	damy
奆	danf
碟	dans
礞	dape
奁	daqu
砹	daqy
硗	datq
砌	davt
礤	dawi
硴	dawx
硔	dawy
硭	dayn
顾	dbdm
頋	dbdm
耷	dbf
矷	dbg
础	dbmh
厄	dbv
硁	dcag
夿	dcb
磣	dcce
磉	dccs
碜	dcde
硧	dceh
码	dcg
唘	dckf
盋	dclf
翃	dcng
礟	dcqq
友	dcu
厷	dcu
厺	dcu
犮	dcu
礮	dcuq
雄	dcwy
碼	dcy
礪	dday
砈	ddbn
大	dddd
磊	dddf
飆	dddj
靥	dddl
砺	dddn
飙	dddq
猋	dddu
磭	ddfe
砳	ddg
碱	ddgy
碶	ddhd
厦	ddht
磩	ddhy
厌	ddi
奭	ddjj
硽	ddjn
厣	ddlk
黡	ddlo
奤	ddmd
碝	ddmd
硕	ddmy
碩	ddmy
厖	ddne
硥	ddne
励	ddnl
厉	ddnv
磢	ddqq
魇	ddrc
碕	ddsk
礰	ddth
套	ddu
镽	ddui
餍	ddwe
硤	ddww
厐	ddxe
夶	ddy
鬕	dead
戫	deag
髰	dean
髸	deaw
鬗	deay
髢	debb
髶	debf
郁	debh
鬖	dece
髳	dect
髪	dedc
髮	dedc
鬌	dede
鬍	dede
髵	dedj
鬊	dedj
鬅	deee
奟	deef
硼	deeg
鬚	deem
有	def
鬐	defj
髻	defk
髨	defq
鬒	defw
胡	deg
砠	degg
髬	degg
鬎	degj
髩	degn
髡	degq
砽	deh
髲	dehc
髭	dehx
髾	deie
髿	deit
鬘	dejc
鬄	dejr
鬟	dele
鬛	deln
髷	dema
髠	demb
鬞	deme
髯	demf
髥	demf
戞	depa
鄾	depb
迶	depd
鬃	depi
鬢	depm
髧	depq
鬡	deps
憂	dept
鬓	depw
鹕	deqg
鬇	deqh
髱	deqn
鬉	deqt
磘	derm
鬂	derw
鬆	desc
髤	desu
髟	det
髺	detd
髼	deth
鬁	detj
髦	detn
鬏	deto
鬔	detp
長	deu
鬈	deub
龓	deud
鬜	deue
鬋	deuj
鬙	deuj
鬝	deuj
鬑	deuo
鬀	deut
髫	devk
鬣	devn
髽	dewf
鬠	dewj
鶘	dewo
鶦	dewo
髹	dews
磎	dexd
髴	dexj
鬤	deye
髣	deyr
砐	deyy
硺	deyy
奔	dfaj
逩	dfap
磕	dfcl
夽	dfcu
砝	dfcy
圧	dfd
礝	dfdj
鄏	dfeb
脣	dfee
辱	dfef
辰	dfei
蜃	dfej
唇	dfek
敐	dfet
圶	dff
夳	dff
厓	dffd
奎	dfff
硅	dffg
磽	dffq
矸	dfh
厧	dfhw
磌	dfhw
奈	dfiu
夲	dfj
厈	dfk
硈	dfkg
礂	dfkk
礌	dflg
夸	dfnb
郀	dfnb
綔	dfni
刳	dfnj
匏	dfnn
鴮	dfno
砖	dfny
瓠	dfny
硳	dfoy
礵	dfsh
硣	dftb
奲	dftf
硏	dftf
奢	dftj
硓	dftx
夺	dfu
碐	dfwt
砆	dfwy
礭	dfwy
压	dfyi
研	dgah
硦	dgah
碔	dgah
硎	dgaj
揅	dgar
砘	dgbn
厔	dgcf
磗	dgef
碃	dgeg
三	dggg
古	dghg
镸	dghy
磚	dgjf
硬	dgjq
觱	dgke
厨	dgkf
顑	dgkm
感	dgkn
咸	dgky
礓	dglg
碛	dgmy
磧	dgmy
戌	dgny
瓳	dgny
瓺	dgny
砙	dgny
烕	dgoy
矹	dgqn
厫	dgqt
磝	dgqt
砞	dgsy
厂	dgt
丆	dgt
石	dgtg
犬	dgty
砰	dguh
硖	dguw
硜	dgva
威	dgvy
镾	dgwq
碡	dgxy
砡	dgyy
戛	dhau
存	dhbd
破	dhcy
厞	dhdd
砉	dhdf
剨	dhdj
奡	dhdj
慧	dhdn
熭	dhdo
彗	dhdv
奯	dhdy
在	dhfd
砋	dhg
夒	dhht
蹙	dhih
顣	dhim
慼	dhin
戚	dhiy
丰	dhk
砧	dhkg
磠	dhlo
硵	dhlq
碵	dhmy
艳	dhqc
硯	dhqn
兏	dhqv
夏	dhtu
齧	dhvb
契	dhvd
觢	dhve
洯	dhvi
絜	dhvi
蛪	dhvj
恝	dhvn
挈	dhvr
栔	dhvs
耯	diac
耤	diaj
耢	dial
耟	dian
磲	dias
耔	dibg
耛	dick
耙	dicn
耨	didf
頛	didm
耰	didt
硝	dieg
耝	dieg
耡	diel
耘	difc
耩	diff
耕	difj
耫	digm
耚	dihc
耜	dihn
耒	dii
耥	diik
耖	diit
奫	dijg
耦	dijy
䎬	dilc
耞	dilk
耬	dilv
䎱	dilx
厰	dimt
耮	diol
耧	diov
礑	dipl
礃	dipr
硄	diqn
耓	dish
耗	ditn
砂	ditt
泵	diu
夵	diu
耪	diuy
耣	diwa
耠	diwk
耭	dixy
砅	diy
耱	diyd
耲	diye
厚	djbd
皕	djdj
魘	djec
厭	djed
靨	djed
饜	djee
壓	djef
奛	djef
厴	djel
懕	djen
黶	djeo
擪	djer
檿	djes
嬮	djev
百	djf
厘	djfd
碍	djgf
碮	djgh
碭	djgr
矵	djh
砷	djhh
夰	djj
奄	djnb
鹌	djng
剦	djnj
鵪	djno
碣	djqn
厬	djtk
礘	djxo
右	dkf
夻	dkf
夼	dkj
磾	dkkf
礹	dkkt
磒	dkmy
厛	dkrk
厑	dkxv
历	dle
奋	dlf
礋	dlff
碨	dlge
砗	dlh
硨	dlh
厍	dlk
厙	dlk
靣	dlkf
硘	dlkg
礧	dlll
夯	dlr
硱	dlsy
劯	dlt
碅	dlty
磥	dlxi
碘	dmaw
冇	dmb
砓	dmcy
硸	dmdf
顨	dmdj
碳	dmdo
磞	dmee
磆	dmeg
碉	dmfk
奝	dmfk
硐	dmgk
磑	dmgu
布	dmhj
面	dmjd
耎	dmjd
耏	dmje
耐	dmjf
鸸	dmjg
而	dmjj
蠠	dmjj
厕	dmjk
厠	dmjk
勔	dmjl
靧	dmjm
恧	dmjn
靤	dmjn
鴯	dmjo
靦	dmjq
耍	dmjv
矶	dmn
碢	dmnk
硙	dmnn
砚	dmqn
砜	dmqy
碋	dmsk
碸	dmtj
页	dmu
頁	dmu
碙	dmum
磮	dmwa
硶	dmwn
磪	dmwy
砃	dmyg
矾	dmyy
碾	dnae
尷	dnal
乭	dnb
镼	dnbm
臧	dndy
尨	dnee
尮	dnes
尪	dngd
嘏	dnhc
碬	dnhc
碿	dnie
尴	dnjl
虿	dnju
趸	dnkh
尵	dnkm
礔	dnku
劢	dnlt
尳	dnme
郕	dnnb
盛	dnnl
成	dnny
迈	dnpv
尯	dnqb
尥	dnqy
磖	dnrg
砀	dnrt
尰	dntf
戊	dnty
怘	dnu
尲	dnuo
万	dnv
尤	dnv
尢	dnv
磟	dnwe
尬	dnwj
砄	dnwy
礏	dogw
盔	dolf
礯	dooi
磱	dool
磷	doqh
灰	dou
硡	dpdc
磍	dpdk
碂	dpfi
碹	dpgg
碇	dpgh
礗	dpgm
达	dpi
迖	dpi
碗	dpqb
牵	dprh
碦	dptk
硿	dpwa
確	dpwy
砣	dpxn
碈	dqaj
磔	dqas
砥	dqay
厎	dqay
奃	dqay
克	dqb
硊	dqdb
兣	dqdf
兡	dqdj
兢	dqdq
确	dqeh
尅	dqfi
兙	dqfk
碒	dqg
砾	dqiy
剋	dqjk
勊	dqle
勀	dqlt
砲	dqnn
鷞	dqqo
爽	dqqq
奓	dqqu
奅	dqtb
兛	dqtf
兞	dqtn
碀	dqvh
兝	dqwv
砍	dqwy
矽	dqy
鸪	dqyg
磂	dqyl
镹	dqyy
碷	drfh
砶	drg
斫	drh
磃	drhm
原	drii
厡	drii
厵	drii
願	drim
愿	drin
硃	driy
厒	drmk
磈	drqc
礩	drrm
碑	drtf
磤	drvc
镻	drwy
礫	drxs
礉	dryt
磦	dsfi
硒	dsg
砵	dsgg
矴	dsh
厢	dshd
碴	dsjg
磹	dsjh
厅	dsk
攲	dskc
敧	dskc
奇	dskf
砢	dskg
剞	dskj
鵸	dsko
欹	dskw
歴	dssh
礎	dssh
暦	dssj
厯	dssy
碄	dssy
硹	dswc
矺	dtan
厇	dtav
帮	dtbh
邦	dtbh
幚	dtbh
砤	dtbn
硚	dtdj
礄	dtdk
镺	dtdy
厜	dtfg
硾	dtfg
硞	dtfk
礸	dtfm
焘	dtfo
寿	dtfu
砟	dthf
厏	dthf
硟	dthp
邫	dtkc
硌	dtkg
硇	dtlq
磇	dtlx
礇	dtmd
矻	dtnn
磻	dtol
砭	dtpy
硪	dtry
磿	dttd
歷	dtth
厤	dtti
曆	dttj
磫	dtwh
故	dty
硑	duah
蹷	dubh
劂	dubj
蟨	dubj
憠	dubn
鷢	dubo
磀	dubp
橜	dubs
厥	dubw
磙	duce
磋	duda
礢	dude
羍	dudj
磰	dudk
礲	dued
龎	dued
礀	dueg
礈	duep
砬	dug
礒	dugy
眘	duhf
辜	duj
昚	dujf
鹩	dujg
磵	dujg
尞	duji
鷯	dujo
遼	dujp
厗	duk
碚	dukg
磳	dulj
碰	duog
碲	duph
磅	dupy
磸	dusd
冭	duu
磏	duvo
礠	duxn
磁	duxx
厩	dvcq
硍	dvey
肆	dvfh
砕	dvfh
硉	dvfh
礖	dvgw
碌	dviy
磶	dvqo
碯	dvtq
砼	dwag
碫	dwdc
奉	dwfh
磜	dwfi
碖	dwga
奏	dwgd
硂	dwgg
硷	dwgi
硆	dwgk
磴	dwgu
厱	dwgw
礆	dwgw
仄	dwi
泰	dwiu
春	dwjf
砎	dwjh
蠢	dwjj
惷	dwjn
磓	dwnp
秦	dwtu
硢	dwty
舂	dwvf
憃	dwvn
鳫	dwvo
鴣	dwvo
砏	dwvt
郟	dwwb
夾	dwwi
硲	dwwk
赝	dwwm
贋	dwwm
贗	dwwm
頰	dwwm
鴈	dwwo
鵊	dwwo
雁	dwwy
砱	dwyc
奞	dwyf
奪	dwyf
碓	dwyg
奮	dwyl
砛	dwyn
礁	dwyo
磼	dwys
龚	dxaw
聋	dxbf
砻	dxdf
龙	dxe
垄	dxff
䶮	dxgd
砩	dxjh
礙	dxth
砒	dxxn
磯	dxxy
袭	dxye
詟	dxyf
砪	dxyy
礦	dyaw
礅	dybt
硫	dycq
砿	dycy
砫	dygg
太	dyi
丈	dyi
砯	dyiy
盇	dylf
碻	dymk
砊	dymn
碥	dyna
砨	dynn
态	dynu
奒	dynw
硋	dynw
戍	dyny
硛	dyoy
迏	dypi
碠	dyps
礳	dysd
矿	dyt
硠	dyve
磄	dyvk
碎	dywf
砇	dyy
臓	eady
臟	eady
腻	eafm
膩	eafm
腜	eafs
肛	eag
臔	eahm
胨	eaiy
膜	eajd
腊	eajg
臈	eajn
膒	eakk
臙	eako
朠	eamd
脦	eany
朦	eape
臒	eawc
膵	eayf
郛	ebbh
鵩	ebco
服	ebcy
孕	ebf
孚	ebf
朏	ebmh
肔	ebn
乳	ebnn
嗠	ebtk
胫	ecag
腬	ecbs
腏	eccc
夃	eci
蜰	ecju
胎	eckg
戤	ecla
盈	eclf
亂	ecmn
覶	ecmq
辭	ecmu
肥	ecn
豝	ecn
朘	ecwt
肞	ecyy
膸	edap
肱	edcy
胈	edcy
脹	edey
呄	edf
脤	edfe
胯	edfn
脜	edhg
肨	edhh
腌	edjn
腼	edmd
腝	edmd
澃	edmi
胹	edmj
盨	edml
媭	edmv
嬃	edmv
頾	edmx
须	edmy
須	edmy
肬	ednn
脄	edoy
豲	edri
膫	edui
腠	edwd
脥	edww
胧	edxt
肰	edy
肽	edyy
貘	eead
貙	eeak
貓	eeal
貛	eeay
脬	eebg
貀	eebm
貊	eedj
貕	eeed
月	eeee
朤	eeee
豻	eefh
豺	eeft
脟	eefy
朋	eeg
豠	eegg
豾	eegg
貆	eegg
貜	eehc
貋	eejf
貍	eejf
蠫	eejj
貚	eekf
貗	eelv
貒	eemj
豽	eemw
貑	eenc
燹	eeou
遯	eepi
貁	eepw
鹏	eeqg
豿	eeqk
豹	eeqy
豸	eer
貏	eerf
貃	eerg
邈	eerp
貌	eerq
肜	eet
貈	eete
貉	eetk
貔	eetx
貖	eeul
貇	eeve
墾	eevf
脮	eevg
貄	eevh
貂	eevk
懇	eevn
貎	eevq
貐	eewj
鵬	eewo
貅	eews
膎	eexd
豯	eexd
豼	eexx
豚	eey
豩	eey
膹	efam
豮	efam
豶	efam
脚	efcb
肢	efcy
胠	efcy
臑	efdj
頱	efdm
胿	effg
膮	effq
肚	efg
肝	efh
虢	efhm
脙	efiy
肼	efjh
臌	efkc
膨	efke
腩	efmf
肟	efnn
䏝	efny
脖	efpb
豷	efpu
朊	efqn
爰	eftc
豣	eftf
豬	eftj
鶢	efto
櫫	efts
寽	efu
膤	efvg
鶏	efwo
肤	efwy
臛	efwy
肘	efy
豜	egah
肫	egbn
豘	egbn
胵	egcf
悬	egcn
县	egcu
且	egd
膊	egef
腈	egeg
脯	egey
脿	egey
豧	egey
胚	egig
脴	egik
肧	egiy
膞	egjf
刞	egjh
腖	egji
膈	egkh
脨	egki
腷	egkl
脰	egku
助	eglt
肺	egmh
脼	egmy
豕	egty
胓	eguh
脛	egva
脻	egvh
鴡	egwo
雎	egwy
膆	egxi
胰	egxw
臄	ehae
臚	ehal
腓	ehdd
胩	ehhy
臞	ehhy
丯	ehk
胋	ehkg
鼐	ehnn
胪	ehnt
覓	ehqb
辵	ehu
頿	ehxm
膛	eipf
脳	eiqb
胱	eiqn
尕	eiu
膌	eiwe
胆	ejgg
腸	ejgr
刖	ejh
胂	ejhh
蟸	ejju
腽	ejlg
豱	ejlg
腢	ejmy
腂	ejsy
腥	ejtg
脵	ekgd
脭	ekgg
肿	ekhh
膭	ekhm
腭	ekkn
臊	ekks
脶	ekmw
胑	ekwy
膕	elag
胭	eldy
盁	elf
腲	elge
腘	elgy
胛	elh
脇	elll
腮	elny
臅	elqj
肋	elt
爵	elvf
膢	elvg
膃	elwl
胁	elwy
膿	emae
腆	emaw
股	emcy
豛	emcy
腨	emdj
胦	emdy
爯	emff
腗	emgj
胴	emgk
肌	emn
腡	emnk
膼	emnp
觅	emqb
朒	emww
肭	emwy
膗	emwy
腒	endg
腛	engf
腵	enhc
豭	enhc
脲	eniy
肊	enn
肠	enrt
乃	ent
甩	env
膠	enwe
胒	enxn
臎	enyf
腅	eooy
膦	eoqh
脒	eoy
臗	epay
受	epcu
辤	epcu
迌	epd
爱	epdc
辸	epe
脓	epey
腙	epfi
脘	epfq
腟	epgf
腚	epgh
臏	epgm
逐	epi
腪	eplh
愛	epnt
腕	epqb
舜	epqh
膑	eprw
胺	epvg
腔	epwa
膣	epwf
胝	eqay
朡	eqbt
脃	eqcn
脆	eqdb
脪	eqdh
豨	eqdh
膽	eqdy
朓	eqiy
朐	eqkg
豞	eqkg
脕	eqkq
褜	eqne
胞	eqnn
胸	eqqb
脗	eqrk
肳	eqrt
脎	eqsy
肷	eqwy
肑	eqyy
胍	ercy
脈	erey
腯	erfh
胉	erg
肵	erh
脌	erhf
腺	eriy
膴	erlo
鹞	ermg
繇	ermi
颻	ermj
鷂	ermo
遥	ermp
飖	ermq
脾	ertf
胅	erwy
彩	eset
膘	esfi
刴	esjh
胢	eskg
采	esu
朶	esu
腰	esvg
膝	eswi
胮	etah
胀	etay
胣	etbn
膖	etdp
腁	etff
腄	etfg
胻	etfh
臜	etfm
臢	etfm
膬	etfn
脡	etfp
甤	etgd
腫	etgf
胜	etgg
臐	etgo
胙	ethf
脠	ethp
脷	etjh
膓	etjr
腹	etjt
胳	etkg
膍	etlx
爳	etnb
鄬	etnb
用	etnh
噕	etnk
肐	etnn
爲	etno
胏	etnt
膰	etol
彡	ettt
腇	etvg
豵	etwh
脢	etxy
爫	etyt
胼	euah
膱	euaj
腃	eudb
腾	eudc
騰	eudc
塍	eudf
䲢	eudg
幐	eudh
羘	eudh
膡	eudh
滕	eudi
縢	eudi
螣	eudj
膳	eudk
勝	eudl
賸	eudm
鰧	eudo
黱	eudo
榺	euds
媵	eudv
朕	eudy
謄	eudy
朧	eued
胖	eufh
膶	eugg
朣	eujf
腤	eujg
臆	eujn
脱	eukq
豴	eumd
腣	euph
膪	eupk
膀	eupy
胶	euqy
膁	euvo
膉	euwl
腿	evep
豤	evey
妥	evf
舀	evf
腱	evfp
肗	evg
膄	evhc
爭	evhj
臘	evln
肍	evn
腉	evqn
腦	evtq
鵎	evwo
腴	evwy
肒	evyy
肕	evyy
腶	ewdc
胗	ewet
脍	ewfc
肸	ewfh
胕	ewfy
腀	ewga
脸	ewgi
腧	ewgj
膾	ewgj
肹	ewgn
膯	ewgu
臉	ewgw
脫	ewkq
膇	ewnp
朌	ewvt
腳	ewwb
脞	ewwf
朎	ewyc
脽	ewyg
臇	ewym
肣	ewyn
腍	ewyn
膲	ewyo
谿	exdk
鷄	exdo
奚	exdu
雞	exdy
腞	exey
乿	exin
脂	exjg
胇	exjh
膙	exkj
膷	extb
肶	exxn
胟	exyy
朜	eybg
脑	eybh
脝	eybh
脏	eyfg
及	eyi
豖	eyi
臍	eyjg
脐	eyjh
剢	eyjh
膻	eylg
肮	eymn
脉	eyni
豟	eynn
臕	eyno
胲	eynw
豥	eynw
膔	eynx
肪	eyt
臁	eyuo
朖	eyve
膅	eyvk
腑	eywf
脺	eywf
腋	eywy
膟	eyxf
臃	eyxy
胘	eyxy
﨤	eyyp
墈	fadl
堪	fadn
霰	faet
卋	faf
鼖	fafc
霸	fafe
雸	faff
坩	fafg
墸	fafj
壒	fafl
墷	fagf
臷	fagf
韯	fahg
壏	fahl
卉	faj
塻	fajd
蛓	faji
堰	fajv
哉	fakd
域	fakg
墐	fakg
塸	fakk
壦	faky
载	fald
載	falk
戴	falw
霙	famd
翸	famn
贲	famu
賁	famu
墴	famw
歕	famw
胾	famw
堞	fans
烖	faoi
靀	fape
尭	faqb
墆	faqh
酨	fasg
栽	fasi
枽	fasu
桒	fasu
塔	fawk
塂	fawn
塨	fawn
埖	fawx
截	fawy
垬	fawy
裁	faye
塃	fayq
邗	fbh
壭	fbj
凷	fbk
地	fbn
逇	fbpv
霳	fbtg
壣	fbxg
弆	fcaj
叝	fcbc
却	fcbh
霿	fcbh
霱	fcbk
霧	fcbl
雺	fcbt
霚	fcbt
墋	fcce
頍	fcdm
叆	fcec
埇	fceh
刦	fcjh
朅	fcjn
坮	fckg
唟	fckx
攰	fcle
盍	fclf
动	fclt
劫	fclt
翅	fcnd
运	fcpi
迲	fcpi
魂	fcrc
埃	fctd
去	fcu
支	fcu
云	fcu
攳	fcvf
叇	fcvp
刧	fcvt
刼	fcvy
鳷	fcwo
埈	fcwt
鼁	fcxf
堶	fdae
坺	fdcy
雼	fdf
震	fdfe
堐	fdff
垮	fdfn
坧	fdg
堿	fdgy
墄	fdhy
埯	fdjn
壥	fdlf
雳	fdlr
坜	fdlt
堧	fdmd
需	fdmj
颥	fdmm
顬	fdmm
顸	fdmy
頇	fdmy
墭	fdnl
城	fdny
垯	fdpy
塽	fdqq
塬	fdri
埼	fdsk
垹	fdtb
壢	fdth
靂	fdth
埲	fdwh
堾	fdwj
埉	fdww
垅	fdxt
垺	febg
霾	feef
堋	feeg
埒	fefy
埓	fefy
坥	fegg
霢	fere
垜	fesy
埰	fesy
塪	fevg
霡	feyi
雭	feyu
圾	feyy
壩	ffae
墳	ffam
邽	ffbh
邿	ffbh
霴	ffci
靅	ffcm
霒	ffcn
霕	ffcn
霼	ffco
靆	ffcp
靉	ffct
雲	ffcu
坛	ffcy
壖	ffdj
圭	fff
亖	fff
墵	fffc
土	ffff
垚	ffff
堼	ffff
壵	ffff
鞤	ffff
幇	fffh
幫	fffh
犎	fffh
顤	fffm
翹	fffn
遶	fffp
堯	fffq
墝	fffq
封	fffy
奊	ffgy
埴	ffhg
填	ffhw
卦	ffhy
隷	ffii
款	ffiw
刲	ffjh
墘	ffjn
郌	ffkc
壊	ffle
劸	fflt
雩	ffnb
鄠	ffnb
壔	ffnf
圬	ffnn
恚	ffnu
霊	ffog
坃	ffqn
堵	fftj
寺	ffu
墙	ffuk
墶	ffup
墻	ffwk
堎	ffwt
鼃	ffxf
麉	ffyx
坉	fgbn
垤	fgcf
博	fgef
埥	fgeg
埔	fgey
埡	fgfg
圩	fgfh
二	fgg
干	fggh
十	fgh
士	fghg
墕	fgho
雫	fghu
雨	fghy
寸	fghy
圷	fghy
坯	fgig
坏	fgiy
塼	fgjf
垣	fgjg
埬	fgji
埂	fgjq
塥	fgkh
堛	fgkl
壃	fglg
堜	fgli
垭	fgog
坪	fguh
霋	fgvv
坘	fgxg
塐	fgxi
壉	fhae
墟	fhag
趞	fhaj
壚	fhal
趪	fhaw
越	fhay
趣	fhbc
趉	fhbm
坡	fhcy
霏	fhdd
趄	fheg
直	fhf
矗	fhfh
赶	fhfk
趌	fhfk
趬	fhfq
址	fhg
圵	fhg
垰	fhgh
趚	fhgi
趔	fhgj
趰	fhgq
赴	fhhi
趠	fhhj
趈	fhhk
埱	fhic
趙	fhie
趟	fhik
埗	fhit
赻	fhit
趕	fhjf
趧	fhjh
亍	fhk
坫	fhkg
趗	fhkh
趮	fhks
嗭	fhkx
赲	fhle
盐	fhlf
塷	fhlo
趩	fhlw
赸	fhmk
趓	fhms
趐	fhnd
垇	fhng
赳	fhnh
悳	fhnn
趘	fhnn
垆	fhnt
惪	fhnu
起	fhnv
赽	fhnw
趯	fhny
趤	fhpd
赿	fhqa
趛	fhqd
赵	fhqi
趂	fhqi
趒	fhqi
垷	fhqn
趜	fhqo
趍	fhqq
趨	fhqt
赹	fhqu
趋	fhqv
赼	fhqw
趆	fhqy
趎	fhri
赾	fhrk
趃	fhrw
趏	fhtd
趫	fhtk
趱	fhtm
趲	fhtm
趀	fhtt
走	fhu
趇	fhud
﨣	fhuf
趥	fhug
趦	fhuk
趑	fhuw
趢	fhvi
超	fhvk
趁	fhwe
趖	fhwf
颠	fhwm
顛	fhwm
赺	fhwn
趝	fhwn
趭	fhwo
鷏	fhwo
真	fhwu
埧	fhwy
趡	fhwy
圤	fhy
霮	fian
霟	fiaw
靋	fidh
霄	fief
霪	fief
祘	fifi
霈	figh
霑	fihk
未	fii
埫	fimk
霘	fimk
礼	finn
壋	fipl
霃	fipq
垙	fiqn
霂	fisu
孷	fitb
釐	fitf
犛	fith
漦	fiti
氂	fitn
嫠	fitv
剺	fitv
斄	fitw
示	fiu
霶	fiuy
垱	fivg
墚	fivs
霗	fiwc
塉	fiwe
霐	fixc
皳	fiyc
裘	fiye
霔	fiyg
求	fiyi
盚	fiyl
慦	fiyn
逑	fiyp
救	fiyt
戟	fjay
朝	fjeg
壜	fjfc
坓	fjff
塒	fjff
埋	fjfg
韩	fjfh
垾	fjfh
亁	fjfn
埘	fjfy
冓	fjgf
斠	fjgf
坦	fjgg
堤	fjgh
顜	fjgm
遘	fjgp
觏	fjgq
覯	fjgq
場	fjgr
刊	fjh
刌	fjh
坤	fjhh
汬	fjiu
亓	fjj
霷	fjjr
井	fjk
墁	fjlc
塭	fjlg
堣	fjmy
電	fjnb
塌	fjng
韓	fjnh
乹	fjnn
进	fjpk
堨	fjqn
埸	fjqr
堁	fjsy
乾	fjtn
刱	fjvw
斡	fjwf
幹	fjwf
螒	fjwj
翰	fjwn
鶾	fjwo
榦	fjws
倝	fjwy
雗	fjwy
堒	fjxx
丼	fjyi
郆	fkbh
霵	fkby
颉	fkdm
頡	fkdm
埍	fkeg
袁	fkeu
吉	fkf
喆	fkfk
嚞	fkfk
埕	fkgg
圳	fkh
露	fkhk
墤	fkhm
壝	fkhp
酃	fkkb
龗	fkkd
喪	fkke
墠	fkkf
霝	fkkk
賷	fkkm
堮	fkkn
壧	fkkt
孁	fkkv
靈	fkkw
劼	fklt
霣	fkmu
埚	fkmw
埙	fkmy
塤	fkmy
翓	fkng
迼	fkpd
臺	fkpf
欯	fkqw
鼓	fkuc
敼	fkuc
皷	fkuc
鼔	fkuc
彭	fkue
鼚	fkue
鼙	fkuf
壴	fkuf
尌	fkuf
鼞	fkuf
噽	fkug
鼘	fkug
瞽	fkuh
蟚	fkuj
鼜	fkuj
喜	fkuk
嘉	fkuk
嚭	fkuk
囍	fkuk
鼛	fkuk
壾	fkun
憙	fkun
熹	fkuo
鼕	fkuu
鼟	fkuu
歖	fkuw
甏	fkuy
鴶	fkwo
遠	fkwp
霬	flaw
堌	fldg
雷	flf
墿	flff
靐	flfl
堽	flgh
夁	flld
協	flll
靁	flll
皾	flmc
覿	flmq
賣	flmu
畞	flqy
塿	flvg
堺	flwj
协	flwy
塄	flyt
霻	fmau
坄	fmcy
堓	fmdf
雵	fmdu
靊	fmdu
坱	fmdy
塴	fmee
霌	fmfk
垌	fmgk
塏	fmgu
圸	fmh
击	fmk
坰	fmkg
堝	fmnk
垲	fmnn
垛	fmsy
堸	fmtj
献	fmud
南	fmuf
堈	fmum
遖	fmup
埛	fmwk
埁	fmwn
墔	fmwy
坝	fmy
垻	fmy
坍	fmyg
魗	fnac
壽	fnaf
垊	fnan
翿	fnan
燾	fnao
堀	fnbm
墛	fnff
霨	fnff
堩	fngg
霞	fnhc
韨	fnhc
壻	fnhe
堳	fnhg
韦	fnhk
韫	fnhl
违	fnhp
覟	fnhq
韬	fnhv
韧	fnhy
墀	fnih
夀	fnkf
霹	fnku
壀	fnku
聲	fnmb
殸	fnmc
磬	fnmd
漀	fnmi
馨	fnmj
韾	fnmj
毊	fnmk
罄	fnmm
鏧	fnmq
撀	fnmr
謦	fnmy
圯	fnn
圮	fnn
圠	fnn
迃	fnpv
声	fnr
霫	fnrf
场	fnrt
志	fnu
忈	fnu
塀	fnua
卖	fnud
觌	fnuq
亏	fnv
亐	fnv
逺	fnwp
块	fnwy
坭	fnxn
专	fnyi
赧	fobc
郝	fobh
頳	fodm
赭	fofj
赫	fofo
墣	fogy
赪	fohm
赬	fohm
覝	fohq
赨	fojy
赮	fonc
埮	fooy
赩	foqc
赥	foqw
螫	fotj
赦	foty
赤	fou
灻	fou
赯	foyk
郣	fpbb
孛	fpbf
鹁	fpbg
勃	fpbl
愂	fpbn
鵓	fpbo
鷇	fpdc
蠧	fpdj
槖	fpds
塚	fpey
豰	fpfc
塜	fpfe
霥	fpfe
壺	fpfg
垸	fpfq
垨	fpfy
彀	fpgc
觳	fpgc
嗀	fpgc
殼	fpgc
瑴	fpgc
皼	fpgc
瞉	fpgc
穀	fpgc
糓	fpgc
縠	fpgc
轂	fpgc
嗀	fpgc
塇	fpgg
壸	fpgg
壼	fpgg
埞	fpgh
螜	fpgj
靌	fpgm
懿	fpgn
亄	fpgn
愨	fpgn
鷧	fpgo
壹	fpgu
过	fpi
塓	fpju
辻	fpk
迀	fpk
壷	fpkg
毂	fplc
堚	fplh
疐	fplh
壳	fpmb
殻	fpmc
悫	fpmn
坈	fpmn
慤	fpmn
壶	fpog
埦	fpqb
売	fpqb
坾	fpsh
垞	fpta
榖	fptc
垵	fpvg
埪	fpwa
堗	fpwd
塎	fpwk
靏	fpwo
堔	fpws
坹	fpwy
壱	fpxb
索	fpxi
坨	fpxn
坁	fqan
坻	fqay
元	fqb
圥	fqb
邧	fqbh
堫	fqbt
兘	fqck
垝	fqdb
顽	fqdm
頑	fqdm
埆	fqeh
坖	fqff
雿	fqiu
垗	fqiy
刓	fqjh
坸	fqkg
鼋	fqkn
堍	fqky
雹	fqnb
坞	fqng
垉	fqnn
远	fqpv
垑	fqqy
圽	fqrt
均	fqug
鋆	fquq
无	fqv
埳	fqvg
埩	fqvh
靎	fqwo
坎	fqwy
黿	fqxf
朮	fqyi
塯	fqyl
霤	fqyl
怷	fqyn
圴	fqyy
坂	frcy
坬	frcy
坵	frgg
堭	frgg
垢	frgk
圻	frh
墲	frlo
塊	frqc
埤	frtf
墽	fryt
坼	fryy
堙	fsfg
墂	fsfi
圢	fsh
霜	fshf
鹴	fshg
鸘	fsho
墰	fsjh
坷	fskg
霦	fsse
霖	fssu
塛	fssy
雬	fsu
圫	ftan
孝	ftbf
教	ftbt
埄	ftdh
墧	ftdk
塳	ftdp
垁	ftdy
才	fte
耂	fte
郉	ftfb
埵	ftfg
圲	ftfh
垳	ftfh
幵	ftfh
雮	ftfn
霆	ftfp
栞	ftfs
堹	ftgf
耊	ftgf
考	ftgn
壎	ftgo
垍	fthg
鼒	fthn
埏	fthp
都	ftjb
殾	ftjc
者	ftjf
翥	ftjn
乽	ftjn
煮	ftjo
煑	ftjo
覩	ftjq
塲	ftjr
斱	ftjr
垎	ftkg
塩	ftkl
雾	ftlr
墺	ftmd
塮	ftmf
垧	ftmk
霺	ftmt
圪	ftnn
墦	ftol
耇	ftqk
耉	fttk
垀	ftuh
雽	ftuh
塖	ftux
老	ftxb
耋	ftxf
耆	ftxj
耈	ftxk
耄	ftxn
霉	ftxy
坆	fty
攼	fty
圦	ftyy
垪	fuah
埢	fudb
堘	fudf
垟	fudh
墡	fudk
達	fudp
壠	fued
靇	fued
丧	fueu
雴	fuf
報	fufc
騺	fufc
壌	fufe
褺	fufe
墊	fuff
坢	fufh
漐	fufi
縶	fufi
幸	fufj
蟄	fufj
盩	fufl
贄	fufm
慹	fufn
鷙	fufo
逹	fufp
摯	fufr
執	fufy
瓡	fufy
謺	fufy
垃	fug
垶	fuh
墥	fujf
堷	fujg
墹	fujg
墇	fujh
境	fujq
培	fukg
增	fulj
増	fulj
啬	fulk
墑	fumd
墒	fumk
塝	fupy
壛	fuqv
墫	fusf
壿	fusf
霎	fuvf
塧	fuwl
霠	fuwn
赱	fuyu
垠	fvey
雪	fvf
垏	fvfh
壗	fvhl
埭	fviy
埐	fvpc
埽	fvph
霓	fvqb
堄	fvqn
堖	fvtq
邞	fwbh
塕	fwcn
塅	fwdc
垘	fwdy
鄻	fwfb
鄼	fwfb
驇	fwfc
坴	fwff
替	fwfj
暬	fwfj
辇	fwfl
勎	fwfl
勢	fwfl
輦	fwfl
賛	fwfm
熱	fwfo
燅	fwfo
鵱	fwfo
逵	fwfp
摰	fwfr
槷	fwfs
坿	fwfy
埶	fwfy
埨	fwga
堬	fwgj
垥	fwgk
墖	fwgl
墱	fwgu
霯	fwgu
鬹	fwhh
規	fwhq
槼	fwhs
嫢	fwhv
夫	fwi
圿	fwjh
堢	fwks
鬶	fwmh
规	fwmq
椝	fwms
堠	fwnd
埠	fwnf
垖	fwnn
塢	fwno
塠	fwnp
夌	fwtu
鳱	fwvo
雰	fwvr
坋	fwvt
嗇	fwwk
﨏	fwwk
赍	fwwm
賫	fwwm
鳺	fwwo
墢	fwxc
鼀	fwxf
零	fwyc
坽	fwyc
霍	fwyf
堆	fwyg
埝	fwyn
坅	fwyn
靍	fwyo
鸖	fwyo
靃	fwyy
毐	fxdr
堟	fxey
塡	fxhw
坲	fxjh
坳	fxlt
堦	fxxr
霛	fxxx
坶	fxyy
墌	fyao
壙	fyaw
墎	fybb
霩	fybb
埻	fybg
垴	fybh
墩	fybt
垿	fycb
堉	fyce
霅	fyf
圡	fyi
霽	fyjf
霁	fyjj
霭	fyjn
靄	fyjn
壤	fyke
壞	fyle
壇	fylg
壈	fylt
塙	fymk
坑	fymn
垓	fynw
塶	fynx
塆	fyox
壕	fype
雱	fyr
坊	fyt
圹	fyt
雯	fyu
埌	fyve
墉	fyvh
塘	fyvk
埣	fywf
壪	fyxx
坟	fyy
琖	gaay
邢	gabh
璂	gadf
琪	gadw
形	gaet
弐	gafd
玵	gafg
瓂	gafl
玒	gag
璍	gagf
琊	gahb
武	gahd
鹉	gahg
璼	gahl
虣	gahm
鵡	gaho
玡	gaht
弄	gaj
型	gajf
刑	gajh
开	gak
瑾	gakg
琙	gakg
瓘	gaky
瑛	gamd
貮	gami
璜	gamw
璊	gamy
玴	gann
烎	gaou
璥	gaqt
璓	gate
瓁	gawc
鳽	gawo
瑹	gawt
珙	gawy
雃	gawy
瑘	gbbh
瓍	gbdp
珥	gbg
邨	gbnb
旾	gbnj
顿	gbnm
頓	gbnm
迍	gbnp
屯	gbnv
璚	gcbk
瑈	gcbs
戩	gcca
晉	gccj
郅	gcfb
臶	gcfb
至	gcff
臸	gcff
到	gcfj
臵	gcfk
鵄	gcfo
致	gcft
臻	gcft
臹	gcfy
玛	gcg
珆	gckg
玧	gcqn
丟	gcu
瑪	gcy
瑵	gcyj
瑚	gdeg
珛	gdeg
瓇	gdet
蝅	gdgj
蠺	gdgj
珬	gdgy
瑊	gdgy
珔	gdhb
玤	gdhh
天	gdi
沗	gdiu
奣	gdje
昋	gdjf
蚕	gdju
吞	gdkf
瑌	gdmd
顼	gdmy
頊	gdmy
忝	gdnu
珹	gdny
迗	gdpi
琦	gdsk
瓑	gdth
璙	gdui
琫	gdwh
瑃	gdwj
鴌	gdwo
瑧	gdwt
珑	gdxt
琈	gebg
郬	gebh
靜	geeh
青	gef
瑗	gefc
玥	geg
珇	gegg
郙	gehb
尃	gehf
盙	gehl
乶	gehn
懯	gehn
鵏	geho
逋	gehp
靚	gehq
敷	geht
喸	gehx
甫	gehy
旉	gehy
靗	geiq
靓	gemq
瑷	gepc
靛	geph
璦	gept
靘	geqc
䴖	geqg
静	geqh
瑶	germ
靔	gern
靝	gero
表	geu
瑫	gevg
鶄	gewo
琢	geyy
邘	gfbh
珐	gfcy
瓀	gfdj
珪	gffg
亞	gfgd
堊	gfgf
蝁	gfgj
惡	gfgn
鵶	gfgo
琧	gfgy
玕	gfh
瑱	gfhw
球	gfiy
琎	gfjp
于	gfk
盂	gflf
瓄	gflm
璹	gfnf
玮	gfnh
瓙	gfno
迂	gfpk
玩	gfqn
琽	gftj
珯	gftx
瓉	gfwm
玞	gfwy
珷	ggah
琶	ggcb
璷	gget
玗	ggfh
玨	ggg
王	gggg
璱	gggt
戋	gggy
五	gghg
环	ggiy
瑼	ggjf
璢	ggjl
璤	ggjn
珸	ggkg
瓎	ggkm
瑓	ggli
一	ggll
玙	ggng
瑟	ggnt
珁	ggny
瑨	ggoj
璈	ggqt
琹	ggsu
玶	gguh
琴	ggwn
珡	ggwu
琵	ggxx
瑇	ggxy
珏	ggyy
瓛	ghad
璩	ghae
瓐	ghal
琥	gham
玻	ghcy
正	ghd
琲	ghdd
頙	ghdm
鄢	ghgb
靕	ghge
焉	ghgo
下	ghi
琡	ghic
琸	ghjh
丅	ghk
玷	ghkg
颪	ghmj
乤	ghnb
亙	ghng
丏	ghnn
忑	ghnu
丐	ghnv
璿	ghph
現	ghqn
璨	ghqo
政	ghty
鴊	ghwo
玼	ghxn
璖	gias
奀	gidu
琑	gieg
甭	giej
琺	gifc
邳	gigb
丕	gigf
歪	gigh
覔	gihq
不	gii
否	gikf
盃	gilf
琐	gimy
瑣	gimy
瑺	giph
还	gipi
璫	gipl
珖	giqn
嫑	gisv
孬	givb
珰	givg
珱	givg
鴀	giwo
畱	gjal
丣	gjan
理	gjfg
卝	gjgd
亘	gjgf
芈	gjgh
瑅	gjgh
刯	gjgj
茍	gjgk
瑒	gjgr
蘷	gjgt
羐	gjgy
雈	gjgy
刬	gjh
鄟	gjhb
專	gjhf
瑁	gjhg
珅	gjhh
剸	gjhj
惠	gjhn
鷒	gjho
甎	gjhy
東	gjii
鶇	gjio
琩	gjjg
丌	gjk
瑥	gjlg
郠	gjqb
甦	gjqg
更	gjqi
瑆	gjtg
琨	gjxx
璟	gjyi
琝	gjyy
郚	gkbh
琄	gkeg
吾	gkf
丗	gkgd
珵	gkgg
帯	gkgh
羋	gkgh
彧	gkgy
玔	gkh
叓	gkhc
囊	gkhe
嚢	gkhe
蠹	gkhj
蟗	gkhj
璐	gkhk
璝	gkhm
橐	gkhs
櫜	gkhs
栆	gkhu
珿	gkhy
整	gkih
束	gkii
剌	gkij
勅	gkil
赖	gkim
賴	gkim
頼	gkim
慗	gkin
鵣	gkio
鶒	gkio
鷘	gkio
速	gkip
遫	gkip
遬	gkip
揧	gkir
敕	gkit
辢	gkiu
欶	gkiw
亜	gkjg
悪	gkjn
卅	gkk
噩	gkkk
璪	gkks
畐	gklf
副	gklj
疈	gkll
鶝	gklo
逼	gklp
鞷	gkmf
鹝	gkmg
鬲	gkmh
融	gkmj
鬸	gkml
翮	gkmn
鷊	gkmo
鬺	gkmr
鬷	gkmt
鬴	gkmy
逜	gkpd
带	gkph
吏	gkqi
敔	gkty
豇	gkua
豌	gkub
郖	gkub
豉	gkuc
豆	gkuf
豍	gkuf
剅	gkuj
頭	gkum
毭	gkun
豏	gkuo
逗	gkup
事	gkvh
剚	gkvj
画	glbj
珚	gldy
盏	glf
環	glge
畺	glgg
玾	glh
柬	glii
鶫	glio
卌	glk
珈	glkg
珕	glll
瓃	glll
琏	glpy
璉	glpy
玏	glt
琾	glwj
曹	gmaj
遭	gmap
琠	gmaw
叀	gmcu
瑞	gmdj
再	gmfd
珃	gmfg
琱	gmfk
専	gmfu
珮	gmgh
珟	gmgq
靑	gmhg
䴓	gmhg
巿	gmhk
帀	gmhk
鳾	gmho
迊	gmhp
兩	gmhy
棘	gmii
朿	gmii
棗	gmii
刺	gmij
敇	gmit
枣	gmiu
僰	gmiw
曺	gmjf
襾	gmjg
勣	gmlt
珊	gmmg
両	gmmk
璎	gmmv
瓔	gmmv
玑	gmn
恵	gmnu
现	gmqn
责	gmu
責	gmu
邴	gmwb
丙	gmwi
瓗	gmwk
琌	gmwn
两	gmww
璀	gmwy
珼	gmy
郦	gmyb
酈	gmyb
彨	gmye
彲	gmye
鹂	gmyg
玬	gmyg
鸝	gmyo
逦	gmyp
邐	gmyp
婯	gmyv
麗	gmyx
丽	gmyy
瑉	gnaj
珉	gnan
琚	gndg
珝	gng
与	gngd
欤	gngw
瑕	gnhc
瑂	gnhg
瑋	gnhh
玌	gnn
玘	gnn
邷	gnnb
瓪	gnnc
瓧	gnnf
瓩	gnnf
瓼	gnnf
甅	gnnf
瓸	gnnj
瓱	gnnn
瓲	gnnn
瓰	gnnv
瓦	gnny
戸	gnr
玚	gnrt
珌	gntt
攷	gnty
忢	gnu
丂	gnv
璆	gnwe
玦	gnwy
璻	gnyf
夨	gnyi
慭	godn
严	godr
戬	goga
鄑	gogb
亚	gogd
垩	gogf
晋	gogj
恶	gogn
璞	gogy
来	goi
灭	goi
赉	gomu
琰	gooy
璘	goqh
辷	gpd
迋	gpd
琮	gpfi
琓	gpfq
瑄	gpgg
琔	gpgh
璸	gpgm
璌	gpgw
琯	gphn
珲	gplh
琿	gplh
璭	gplp
琬	gpqb
瑸	gprw
瑢	gpwk
琛	gpws
瑏	gpwt
殘	gqaa
殣	gqag
殢	gqah
琘	gqaj
尶	gqal
殜	gqas
殛	gqbg
殆	gqck
麺	gqdd
琋	gqdh
殗	gqdn
殑	gqdq
殝	gqdt
殎	gqdw
殍	gqeb
殂	gqeg
豗	gqei
殱	gqfg
殖	gqfh
殰	gqfm
殪	gqfu
麸	gqfw
殏	gqfy
琻	gqg
殌	gqga
尫	gqgd
殭	gqgg
殐	gqgi
残	gqgy
殩	gqho
歹	gqi
珧	gqiy
珎	gqiy
裂	gqje
珣	gqjg
䴕	gqjg
列	gqjh
虺	gqji
劽	gqjl
殟	gqjl
烈	gqjo
烮	gqjo
鮤	gqjo
鴷	gqjo
迾	gqjp
銐	gqjq
姴	gqjv
殫	gqkf
玽	gqkg
殒	gqkm
殞	gqkm
殨	gqkm
㱮	gqkm
殬	gqlf
殁	gqmc
殃	gqmd
瑍	gqmd
瓊	gqmt
玸	gqnn
殯	gqpm
殡	gqpw
殥	gqpw
卼	gqqb
歿	gqqc
殉	gqqj
殙	gqqj
麹	gqqo
歾	gqqr
歽	gqrh
殊	gqri
瑤	gqrm
聱	gqtb
珋	gqtb
骜	gqtc
驁	gqtc
獒	gqtd
殀	gqtd
殠	gqtd
歼	gqtf
鳌	gqtg
殅	gqtg
螯	gqtj
嗸	gqtk
殈	gqtl
赘	gqtm
嶅	gqtm
贅	gqtm
熬	gqto
鰲	gqto
鷔	gqto
遨	gqtp
鏊	gqtq
殇	gqtr
摮	gqtr
殤	gqtr
嫯	gqtv
鼇	gqtx
敖	gqty
謷	gqty
殚	gquf
殕	gquk
兀	gqv
兀	gqv
琤	gqvh
肂	gqvh
殔	gqvi
殄	gqwe
餮	gqwe
飱	gqwe
殲	gqwg
殓	gqwi
殦	gqwo
殮	gqww
死	gqxv
瑠	gqyl
殧	gqyn
玖	gqyy
玓	gqyy
碧	grdf
珀	grg
瑝	grgg
璳	grim
珠	griy
瑔	griy
璑	grlo
珤	grmh
瑰	grqc
瓆	grrm
琕	grtf
瓅	grxs
璬	gryt
膥	gsdw
玎	gsh
末	gsi
珂	gskg
唜	gskx
璴	gssh
琳	gssy
瑮	gssy
琜	gsww
琒	gtdh
琇	gtet
珘	gtey
珩	gtfh
玝	gtfh
瓒	gtfm
瓚	gtfm
珽	gtfp
珗	gtfq
珄	gtgg
琍	gtjh
珞	gtkg
瑀	gtky
璁	gtln
珦	gtmk
琁	gtnh
璠	gtol
瓈	gtqi
珴	gtry
麦	gtu
瑽	gtwh
珻	gtxy
玫	gty
瑳	guda
珜	gudh
琷	gudn
瓏	gued
瑐	guej
璲	guep
瓓	gugi
平	guhk
璋	gujh
璄	gujq
琣	gukg
璔	gulj
瓋	gump
珓	guqy
亊	guvh
郏	guwb
夹	guwi
刾	guwj
颊	guwm
頬	guwm
珶	guxt
巠	gvaf
璕	gvaf
剄	gvaj
勁	gval
頸	gvam
鵛	gvao
逕	gvap
巰	gvaq
珢	gvey
坙	gvff
珒	gvfh
璛	gvfj
璵	gvgw
郪	gvhb
疌	gvhi
璶	gvhl
鶈	gvho
妻	gvhv
琭	gviy
璅	gvjs
玿	gvkg
珺	gvtk
瑙	gvtq
玳	gway
玱	gwbn
玜	gwcy
瑖	gwdc
珍	gwet
瑜	gwgj
璯	gwgj
珨	gwgk
璒	gwgu
玠	gwjh
壐	gwmf
蠒	gwmj
鸍	gwmo
邇	gwmp
爾	gwmq
覼	gwmq
璽	gwmy
瑡	gwnh
瑦	gwno
兲	gwu
鳿	gwvo
玢	gwvt
玐	gwy
玲	gwyc
琟	gwyg
琀	gwyk
瑲	gwyk
玪	gwyn
璡	gwyp
瑑	gxey
瑻	gxfm
互	gxgd
璏	gxgx
繛	gxij
素	gxiu
夷	gxwi
鴺	gxwo
玭	gxxn
瑎	gxxr
璣	gxxy
纛	gxyi
毒	gxyy
璃	gybc
琉	gycq
珫	gycq
珳	gyet
琂	gyg
斑	gygg
玣	gyhy
玉	gyi
玊	gyi
琼	gyiy
璾	gyjg
瓖	gyke
瓌	gyle
璮	gylg
班	gytg
璇	gyth
瑯	gyvb
琅	gyve
瑭	gyvk
琗	gywf
玹	gyxy
玟	gyy
虐	haag
瞸	haas
睰	hadk
皻	haec
虘	haeg
豦	haei
劇	haej
勮	hael
遽	haep
覰	haeq
戲	haga
齾	hagb
獻	hagd
瞱	hagf
眶	hagg
鬳	hagh
覻	hagq
瞒	hagw
甗	hagy
頥	hahm
戱	haja
瞙	hajd
虛	hajg
虞	hakd
瞘	hakk
鸆	hako
矔	haky
虏	hale
膚	hale
瞄	halg
矒	halh
勴	hall
盧	hall
虜	hall
顱	halm
慮	haln
鸕	halo
虥	hama
彪	hame
甝	hamf
虤	hamm
贙	hamm
虪	hamo
覤	hamq
虝	hamr
虎	hamv
瞞	hamy
歫	hang
虑	hani
虙	hant
眓	hany
戯	haoa
虚	haog
觑	haoq
覷	haoq
歔	haow
虡	haow
矇	hape
䲣	haqt
䱷	haqt
眍	haqy
虗	harg
虨	hase
虖	hath
處	hatm
歑	hatw
虍	hav
矆	hawc
虧	hawn
雐	hawy
虔	hayi
齰	hbaj
齛	hban
齖	hbat
齱	hbbc
齝	hbck
齮	hbdk
齟	hbeg
齻	hbfw
眲	hbg
齬	hbgk
齜	hbhx
齒	hbj
齥	hbjt
齵	hbjy
齪	hbkh
齶	hbkn
齞	hbkw
齫	hbls
齷	hbnf
齓	hbnn
齳	hbpl
齣	hbqk
齙	hbqn
齺	hbqt
齗	hbrh
齭	hbrr
齼	hbsh
齽	hbsi
齚	hbtf
齕	hbtn
齲	hbty
齴	hbue
齸	hbul
齩	hbuq
齦	hbve
齨	hbvg
齠	hbvk
齯	hbvq
齡	hbwc
齘	hbwj
齔	hbxn
瞲	hcbk
颇	hcdm
頗	hcdm
皯	hcfh
皮	hci
眙	hckg
皹	hcpl
皰	hcqn
眸	hcrh
攴	hcu
睃	hcwt
矋	hday
郹	hdbh
睚	hdff
睳	hdff
劌	hdgj
顪	hdgm
翽	hdgn
歲	hdgy
歳	hdgy
非	hdhd
奜	hdhd
猆	hdhd
裴	hdhe
餥	hdhe
韭	hdhg
盽	hdhh
蜚	hdhj
剕	hdhj
辈	hdhl
輩	hdhl
悲	hdhn
翡	hdhn
靟	hdhn
棐	hdhs
婓	hdhv
斐	hdhy
頉	hdmy
䴗	hdqg
狊	hdu
瞭	hdui
睶	hdwj
鶪	hdwo
眬	hdxt
肯	hef
眀	heg
瞬	heph
瞹	hept
睬	hesy
睜	hevh
睵	hfak
瞌	hfcl
歧	hfcy
眃	hfcy
眭	hffg
歭	hffy
盰	hfh
瞋	hfhw
眎	hfiy
眛	hfiy
瞦	hfkk
盶	hfqn
睹	hftj
睦	hfwf
瞡	hfwq
睖	hfwt
矐	hfwy
盹	hgbn
眰	hgcf
丄	hgd
睛	hgeg
盱	hgfh
鬦	hggf
鬪	hggf
鬥	hggh
鬧	hggh
鬩	hggq
鬬	hggr
鬭	hggr
鬫	hggt
鬨	hggw
鬮	hggx
眐	hghg
眄	hghn
凸	hgmg
眪	hgmw
矖	hgmx
歵	hgmy
瞔	hgmy
睐	hgoy
眜	hgsy
睫	hgvh
眱	hgxw
矑	hhal
瞁	hhdy
上	hhgg
止	hhgg
歮	hhhf
瞐	hhhf
目	hhhh
丨	hhll
亅	hhll
鼑	hhnn
愳	hhnu
煛	hhou
瞾	hhpa
鷪	hhpo
睍	hhqn
卡	hhu
歨	hhu
戵	hhwa
矍	hhwc
氍	hhwn
鸜	hhwo
瞿	hhwy
眦	hhxn
卜	hhy
裻	hice
督	hich
惄	hicn
錖	hicq
叔	hicy
颦	hidf
顰	hidf
频	hidm
頻	hidm
睄	hieg
敊	hihc
瞠	hipf
矘	hipo
步	hir
縣	hiti
懸	hitn
歩	hitr
眇	hitt
尗	hiu
睅	hjfh
旧	hjg
睼	hjgh
眒	hjhh
卓	hjj
逴	hjpk
児	hjqb
睗	hjqr
桌	hjsu
睲	hjtg
鵫	hjwo
战	hkay
梷	hkcs
頕	hkdm
奌	hkdu
睊	hkeg
占	hkf
睈	hkgg
敁	hkhc
瞆	hkhm
瞶	hkhm
覘	hkhq
瞣	hkkn
矂	hkks
觇	hkmq
乩	hknn
点	hkou
迠	hkpd
眖	hkqn
盀	hlf
睤	hlgj
卣	hlnf
逌	hlnp
鹺	hloa
鹷	hloc
鹶	hlon
鹻	hloo
鹵	hlou
鹸	hlow
鹼	hlow
鹹	hloy
鹾	hlqa
禼	hlqc
卤	hlqu
卥	hlry
睏	hlsy
瞜	hlvg
欳	hmaw
睓	hmaw
眏	hmdy
睭	hmfk
眮	hmgk
卨	hmnk
遉	hmpi
贞	hmu
貞	hmu
凣	hmv
眠	hnan
瞰	hnbt
颅	hndm
鼎	hndn
睱	hnhc
睸	hnhg
矚	hnij
県	hniu
凹	hnmg
兕	hnmq
鸬	hnqg
卢	hnr
瞩	hnty
忐	hnu
郻	hnvb
矅	hnwy
眤	hnxn
齢	hobc
歯	hobj
瞨	hogy
睒	hooy
瞇	hopy
瞵	hoqh
䁖	hovg
眯	hoy
瞎	hpdk
肻	hpef
睆	hpfq
叡	hpgc
壑	hpgf
壡	hpgf
睻	hpgg
睿	hpgh
矉	hpgm
瞚	hpgw
瞑	hpju
睴	hplh
矃	hpns
睕	hpqb
眈	hpqn
眝	hpsh
敹	hptt
睧	hqaj
眂	hqan
眡	hqay
見	hqb
覎	hqbd
餐	hqce
韰	hqcg
粲	hqco
睎	hqdh
瞻	hqdy
覞	hqhq
眺	hqiy
眴	hqjg
眗	hqkg
眳	hqkg
睌	hqkq
矎	hqmt
覐	hqqq
眵	hqqy
覹	hqtt
歺	hqu
盷	hqug
睁	hqvh
眅	hrcy
眽	hrey
瞃	hrfh
盺	hrh
瞴	hrlo
矈	hrpy
睥	hrtf
眣	hrwy
瞟	hsfi
盯	hsh
瞫	hsjh
睞	hsww
歬	hteu
睡	htfg
眊	htfn
歱	htgf
矄	htgo
矏	hthy
矀	htmt
盵	htnn
矁	hton
瞅	htoy
眨	htpy
睋	htry
瞛	htwh
睠	hudb
眻	hudh
眹	hudy
矓	hued
瞯	hueg
眫	hufh
瞤	hugg
瞳	hujf
瞷	hujg
瞕	hujh
矙	hunt
睇	huxt
眼	hvey
睷	hvfp
瞍	hvhc
睩	hviy
眧	hvkg
睨	hvqn
龄	hwbc
龈	hwbe
龌	hwbf
龃	hwbg
龊	hwbh
齿	hwbj
龉	hwbk
龆	hwbk
龅	hwbn
龁	hwbn
龂	hwbr
龇	hwbx
龀	hwbx
龋	hwby
瞈	hwcn
眕	hwet
睔	hwga
睽	hwgd
睑	hwgi
睮	hwgj
瞺	hwgj
盻	hwgn
瞪	hwgu
瞼	hwgw
睺	hwnd
辪	hwnu
具	hwu
仧	hwu
瞗	hwvo
鳪	hwvo
盼	hwvt
睉	hwwf
睢	hwyg
瞧	hwyo
砦	hxdf
些	hxff
祡	hxfi
眥	hxhf
歶	hxjy
呰	hxkf
啙	hxkk
眑	hxlt
赀	hxmu
貲	hxmu
胔	hxmw
此	hxn
觜	hxqe
鈭	hxqf
鮆	hxqo
矊	hxrh
柴	hxsu
姕	hxvf
飺	hxwe
鴜	hxwo
雌	hxwy
紫	hxxi
訾	hxyf
矌	hyaw
瞝	hybc
瞮	hyct
瞓	hykh
睙	hynd
眿	hyni
盳	hynn
眆	hyt
瞊	hyvk
睟	hywf
眩	hyxy
盿	hyy
灆	iaal
淺	iaay
漭	iada
濝	iadi
渃	iadk
澒	iadm
頮	iadm
颒	iadm
湛	iadn
澌	iadr
淇	iadw
浳	iaeg
潵	iaet
泔	iafg
濭	iafl
湈	iafs
江	iag
澕	iagf
洭	iagg
懑	iagn
满	iagw
淽	iahg
洍	iahh
瀶	iahk
濫	iahl
灠	iahq
漠	iajd
濗	iajh
澫	iajy
淢	iakg
漌	iakg
漚	iakk
漢	iakw
灌	iaky
灘	iaky
渵	ialg
瀎	ialy
渶	iamd
満	iamm
懣	iamn
潢	iamw
滿	iamy
汇	ian
洰	iang
泄	iann
渠	ians
渫	ians
泧	iany
濛	iape
潆	iapi
涝	iapl
溁	iaps
滢	iapy
鸿	iaqg
滯	iaqh
灊	iaqh
潛	iaqj
懘	iaqn
濍	iaqn
沤	iaqy
渮	iask
柒	iasu
浇	iatq
灡	iaui
潇	iavj
瀟	iavj
沏	iavt
濩	iawc
溚	iawk
濸	iawk
港	iawn
鴻	iawo
鍙	iawq
洪	iawy
滙	iawy
瀳	iayo
淓	iayt
灄	ibbb
滠	ibcc
瀡	ibdp
洱	ibg
汓	ibg
滍	ibhj
涵	ibib
洆	ibig
凼	ibk
濻	ibkm
泐	iblt
泏	ibmh
池	ibn
氾	ibn
漋	ibtg
滁	ibwt
泾	icag
汿	icbh
沀	icbh
潏	icbk
滪	icbm
澦	icbm
渘	icbs
涰	iccc
滲	icce
渗	icde
涌	iceh
湧	icel
慂	icen
泽	icfh
治	ickg
沇	icqn
洠	icrh
涘	ictd
浚	icwt
滩	icwy
汉	icy
溤	icy
溞	icyj
汊	icyy
濿	iday
汯	idcy
沷	idcy
湖	ideg
洧	ideg
瀀	idet
涱	idey
沯	idf
渀	idfa
浱	idfe
漘	idfe
涯	idff
溽	idff
滣	idfk
洿	idfn
沽	idg
沰	idg
澸	idgn
減	idgy
滅	idgy
洊	idhb
滟	idhc
湱	idhd
沣	idhh
潔	idhi
尜	idiu
洡	idiy
湹	idjf
洦	idjg
淹	idjn
沥	idlt
湎	idmd
渜	idmd
洏	idmj
湏	idmy
浝	idne
沋	idnn
厳	idnt
洃	idoy
㳠	idpy
漺	idqq
源	idri
渏	idsk
涛	idtf
瀝	idth
尖	idu
潦	idui
湊	idwd
淎	idwh
溙	idwi
湷	idwj
溱	idwt
浹	idww
泷	idxt
汏	idy
汱	idy
汰	idyy
濦	iean
浮	iebg
溋	iecl
淝	iecn
淜	ieeg
肖	ief
湲	iefc
瀦	iefj
渓	iefw
浖	iefy
沮	iegg
漞	iehq
削	iejh
揱	iejr
灂	ielf
涭	iepc
逍	iepd
滛	ierm
淫	ietf
潙	ieto
滔	ievg
浽	ievg
淨	ievh
溪	iexd
鸂	iexo
汲	ieyy
涿	ieyy
灞	ifae
瀐	ifag
泋	ifah
渽	ifak
濆	ifam
溨	ifas
瀻	ifaw
溘	ifcl
法	ifcy
汥	ifcy
沄	ifcy
濡	ifdj
尘	iff
坔	iff
澐	iffc
湗	ifff
洼	iffg
澆	iffq
洔	iffy
汢	ifg
汗	ifh
汁	ifh
淔	ifhg
滇	ifhw
沬	ifiy
沶	ifiy
浗	ifiy
潮	ifje
溝	ifjf
澣	ifjf
濣	ifjf
汫	ifjh
瀚	ifjn
漧	ifjn
澎	ifke
溒	ifke
澍	ifkf
洁	ifkg
瀆	iflm
湳	ifmf
渎	ifnd
濤	ifnf
污	ifnn
汚	ifnn
浾	ifoy
浡	ifpb
濲	ifpc
瀔	ifpc
瀫	ifpc
溹	ifpi
渤	ifpl
涜	ifpq
潱	ifpu
沅	ifqn
灀	ifsh
瀮	ifss
涍	iftb
渚	iftj
洘	iftn
漖	iftt
涬	ifuf
澾	ifup
澪	ifwc
淕	ifwf
潜	ifwj
濇	ifwk
濽	ifwm
淩	ifwt
瀖	ifwy
汧	igah
沌	igbn
洷	igcf
添	igdn
濪	igec
溥	igef
清	igeg
瀞	igeh
浦	igey
汙	igfh
盓	igfl
汪	igg
潖	iggc
濏	iggt
泟	ighg
沔	ighn
漹	igho
漙	igjf
洹	igjg
涷	igji
澑	igjl
潓	igjn
浭	igjq
灢	igke
浯	igkg
滞	igkh
滆	igkh
涑	igki
溂	igkj
瀜	igkj
湢	igkl
濑	igkm
瀨	igkm
瀬	igkm
潄	igkt
浢	igku
漱	igkw
湅	igli
洅	igmf
淸	igmg
沛	igmh
沞	igmh
洓	igmi
漕	igmj
灑	igmx
渍	igmy
漬	igmy
汅	ignn
溍	igoj
涞	igoy
洌	igqj
滶	igqt
沫	igsy
泙	iguh
浃	iguw
涇	igva
湽	igvl
淒	igvv
濔	igwq
溼	igxf
沍	igxg
溸	igxi
洟	igxw
浅	igy
澞	ihad
滮	ihae
澽	ihae
滹	ihah
瀘	ihal
淲	iham
滤	ihan
濾	ihan
碆	ihcd
錃	ihcq
婆	ihcv
波	ihcy
渄	ihdd
湨	ihdy
濊	ihdy
泪	ihg
沚	ihg
澁	ihhh
灈	ihhy
淑	ihic
濒	ihim
瀕	ihim
涉	ihit
渺	ihit
渉	ihit
渋	ihiy
淖	ihjh
沾	ihkg
惉	ihkn
滷	ihlo
浈	ihmy
湞	ihmy
濎	ihnn
泸	ihnt
濬	ihph
覍	ihqb
瀣	ihqg
涀	ihqn
澯	ihqo
小	ihty
濉	ihwy
泚	ihxn
氺	ihyy
濷	iiay
消	iieg
水	iiii
淼	iiiu
尛	iiiu
渁	iiiy
涾	iijg
淌	iimk
溑	iimy
漟	iipf
澢	iipl
灙	iipo
洸	iiqn
硰	iitd
裟	iite
鲨	iitg
渻	iith
乷	iitn
鯊	iito
逤	iitp
挲	iitr
桬	iits
沙	iitt
娑	iitv
沝	iiy
滭	ijaf
渱	ijag
瀑	ijai
沓	ijf
戦	ijfa
溡	ijff
濹	ijff
涅	ijfg
浬	ijfg
涆	ijfh
単	ijfj
濐	ijfj
汨	ijg
汩	ijg
鼝	ijgc
淏	ijgd
淂	ijgf
泹	ijgg
淵	ijgg
浉	ijgh
湜	ijgh
盪	ijgl
燙	ijgo
湯	ijgr
璗	ijgy
虩	ijim
滉	ijiq
淐	ijjg
漫	ijlc
温	ijlg
澷	ijly
湡	ijmy
溻	ijng
洩	ijnt
湿	ijog
渴	ijqn
渇	ijqx
巣	ijsu
淉	ijsy
湦	ijtg
滥	ijtl
灦	ijxm
濕	ijxo
混	ijxx
浊	ijy
灗	ijyg
澋	ijyi
灏	ijym
灝	ijym
渂	ijyy
湒	ikbg
濈	ikby
浥	ikcn
涓	ikeg
呇	ikf
洖	ikgd
塣	ikgf
浧	ikgg
汌	ikh
沖	ikhh
潞	ikhk
溃	ikhm
潰	ikhm
瀢	ikhp
浞	ikhy
渑	ikjn
潬	ikkf
澏	ikkm
漶	ikkn
湂	ikkn
澡	ikks
涡	ikmw
涢	ikmy
溳	ikmy
況	ikqn
漍	ilag
潩	ilaw
涸	ildg
瀱	ildj
洇	ildy
渭	ileg
溷	iley
泴	ilf
畄	ilf
畓	ilf
澤	ilff
涠	ilfh
濖	ilfj
潶	ilfo
泗	ilg
沺	ilg
獣	ilgd
渨	ilge
澴	ilge
淠	ilgj
洄	ilkg
泇	ilkg
灅	illf
潿	ilnh
涟	ilpy
漣	ilpy
濁	ilqj
聻	ilrb
魙	ilrc
壍	ilrf
渐	ilrh
漸	ilrh
嬱	ilrv
涃	ilsy
氻	ilt
溿	iluf
漊	ilvg
瀭	ilwj
溫	ilwl
溭	ilwt
泅	ilwy
潀	ilwy
漯	ilxi
濺	imaa
灔	imac
濃	imae
浀	imag
灎	imal
澧	imau
淟	imaw
没	imcy
灧	imdc
漄	imdf
湍	imdj
灩	imdl
湠	imdo
灃	imdu
泱	imdy
漰	imee
滑	imeg
鼡	imfh
淍	imfk
油	img
洞	imgk
涄	imgn
洬	imgq
溦	imgt
澂	imgt
溰	imgu
溅	imgy
汕	imh
测	imjh
測	imjh
瀃	imjr
潉	imjx
尚	imkf
尙	imkf
沿	imkg
泂	imkg
幤	imkh
氅	imkn
敞	imkt
瀴	immv
渦	imnk
濄	imnp
漴	impi
沨	imqy
溄	imth
渢	imtj
潂	imug
浻	imwk
涔	imwn
汭	imwy
漼	imwy
浿	imy
浵	imye
盕	imyl
汎	imyy
澱	inac
湣	inaj
泯	inan
潺	inbb
淈	inbm
澉	inbt
涺	indg
汛	infh
潳	infj
漏	infy
渥	ingf
汈	ingg
泀	ingk
溊	inhc
湑	inhe
沑	inhf
湄	inhg
湋	inhh
漽	inih
灟	inij
浺	inkh
澼	inku
瀷	inlw
涮	inmj
汜	inn
潠	innw
瀈	inpl
漝	inrg
烫	inro
汤	inrt
湉	intd
浘	intn
泌	intt
泼	inty
泦	invn
漻	inwe
濯	inwy
決	inwy
埿	inxf
泥	inxn
沁	iny
濢	inyf
瀥	inyk
浕	inyu
泤	inyw
沢	inyy
灇	iogc
濧	iogf
澲	iogw
瀵	iolw
濴	iooi
瀠	iooi
瀯	iook
澇	iool
濙	iooo
灐	iooq
濚	ioos
淡	iooy
瀅	iooy
潾	ioqh
溇	iovg
洣	ioy
黉	ipaw
学	ipbf
敩	ipbt
浤	ipdc
瀗	ipdn
涋	ipdy
浓	ipey
尝	ipfc
滱	ipfc
溕	ipfe
坣	ipff
瀽	ipfh
淙	ipfi
浣	ipfq
泻	ipgg
渲	ipgg
淀	ipgh
濱	ipgm
演	ipgw
漃	iphc
涫	iphn
覚	iphq
泶	ipiu
渖	ipjh
溟	ipju
蛍	ipju
裳	ipke
堂	ipkf
甞	ipkf
常	ipkh
劏	ipkj
嘗	ipkj
営	ipkk
當	ipkl
赏	ipkm
賞	ipkm
黨	ipko
党	ipkq
掌	ipkr
棠	ipks
牚	ipkt
瓽	ipky
浑	iplh
渾	iplh
労	iplr
峃	ipmj
沉	ipmn
觉	ipmq
澝	ipne
滵	ipnm
濵	ipnm
濘	ipns
淧	ipnt
涴	ipqb
鲎	ipqg
鸴	ipqg
沈	ipqn
浶	iprh
滨	iprw
泞	ipsh
栄	ipsu
浨	ipsy
喾	iptk
瀋	iptl
滓	ipuh
濅	ipvc
洝	ipvg
瀉	ipvo
涳	ipwa
湥	ipwd
浫	ipwf
漥	ipwf
潌	ipwf
溶	ipwk
滘	ipwk
鴬	ipwo
深	ipws
泬	ipwy
溛	ipwy
沱	ipxn
涽	iqaj
汦	iqan
滐	iqas
黋	iqaw
泜	iqay
光	iqb
汹	iqbh
沟	iqcy
沒	iqcy
洈	iqdb
淆	iqde
浠	iqdh
澹	iqdy
澥	iqeh
淦	iqg
渔	iqgg
澛	iqgj
洮	iqiy
泺	iqiy
沵	iqiy
洵	iqjg
尡	iqjx
潒	iqke
泃	iqkg
洺	iqkg
浼	iqkq
瀺	iqky
涣	iqmd
渙	iqmd
韑	iqnh
泡	iqnn
耀	iqny
瀂	iqoj
淗	iqoy
漁	iqoy
辉	iqpl
輝	iqpl
濥	iqpw
洶	iqqb
淘	iqrm
淴	iqrn
沕	iqrt
泖	iqtb
潴	iqtj
漪	iqtk
汮	iqug
淊	iqvg
浄	iqvh
盜	iqwl
汐	iqy
渹	iqyg
瀏	iqyj
溜	iqyl
兤	iqyw
汋	iqyy
汣	iqyy
汳	ircy
泒	ircy
湃	irdf
滜	irdf
派	irey
垽	irff
泊	irg
湟	irgg
洉	irgk
浜	irgw
沂	irh
汼	irhh
沠	irhy
洙	iriy
湶	iriy
潕	irlo
淿	irmh
峾	irmj
淛	irmj
汽	irnn
滊	irno
溾	irqc
浙	irrh
渒	irtf
澔	irtk
溵	irvc
湁	irwk
泆	irwy
潅	irwy
漑	irxq
濼	irxs
激	iryt
泝	iryy
涁	iset
溎	isff
湮	isfg
漂	isfi
渿	isfi
洒	isg
酒	isgg
泍	isgg
汀	ish
湘	ishg
渣	isjg
潭	isjh
河	iskg
滒	iskk
潥	isoy
灪	isre
湐	isrg
淅	isrh
潸	isse
漜	issf
濋	issh
澿	issi
澘	issj
潹	isss
漤	issv
淋	issy
溧	issy
滼	issy
淞	iswc
漆	iswi
瀒	iswk
淶	isww
沐	isy
沭	isyy
洚	itah
汑	itan
澨	itaw
沲	itbn
活	itdg
浲	itdh
潪	itdj
漨	itdp
鋈	itdq
沃	itdy
瀊	itel
洀	itey
涶	itfg
汘	itfh
汻	itfh
洐	itfh
濳	itfj
浩	itfk
灒	itfm
涏	itfp
洗	itfq
鍌	itfq
湩	itgf
泩	itgg
湰	itgg
溴	ithd
省	ithf
泎	ithf
洎	ithg
漇	ithh
濞	ithj
沜	ithn
涎	ithp
潲	itie
浰	itjh
漡	itjr
洛	itkg
渪	itky
潈	itle
洫	itlg
潨	itli
漗	itln
劣	itlr
澳	itmd
瀩	itmm
澚	itmn
瀓	itmt
汔	itnn
泲	itnt
渊	itoh
潘	itol
湫	itoy
泛	itpy
少	itr
涐	itry
涤	itsy
潃	itte
滗	ittn
毟	ittn
澓	ittt
泘	ituh
溗	itux
泈	ituy
瀄	itvb
涹	itvg
潷	itvh
漎	itwh
潻	itwi
塰	itxf
瀿	itxi
湚	itxn
海	itxy
汷	ity
洴	iuah
渆	iuaj
溯	iube
滚	iuce
溠	iuda
淃	iudb
溬	iudc
瀁	iude
洋	iudh
漛	iudi
潫	iudi
渕	iudj
浂	iudy
瀧	iued
湇	iueg
湔	iuej
澻	iuep
泮	iufh
泣	iug
渼	iugd
润	iugg
潤	iugg
澜	iugi
漾	iugi
瀾	iugi
溔	iugo
湵	iugy
潼	iujf
涧	iujg
湆	iujg
澗	iujg
漳	iujh
灨	iujm
滝	iujn
澺	iujn
滰	iujq
滾	iuke
灛	iukf
涪	iukg
涚	iukq
渷	iukq
潧	iulj
滴	iumd
滳	iumk
潎	iumt
湴	iuog
潽	iuoj
渧	iuph
滂	iupy
澬	iuqm
滧	iuqt
洨	iuqy
灁	iuri
澊	iusf
湭	iusg
瀙	iusq
澵	iusr
澖	iusy
濶	iutd
滻	iutg
渞	iuth
濓	iuto
浐	iutt
灍	iuuw
淁	iuvg
溓	iuvo
溢	iuwl
濨	iuxn
涕	iuxt
滋	iuxx
潣	iuyy
潯	ivaf
湼	ivag
溉	ivcq
泿	ivey
当	ivf
堻	ivff
澅	ivfg
津	ivfh
潚	ivfj
湕	ivfp
浔	ivfy
汝	ivg
澙	ivgo
溲	ivhc
濜	ivhl
渌	iviy
漅	ivjs
沼	ivkg
洳	ivkg
灉	ivky
淄	ivlg
氿	ivn
浸	ivpc
淣	ivqn
潟	ivqo
灚	ivqq
染	ivsu
涒	ivtk
粱	ivwo
梁	ivws
涩	ivyh
澀	ivyh
涊	ivyn
汍	ivyy
浌	iway
沧	iwbn
滃	iwcn
洑	iwdy
脊	iwef
洕	iweg
鹡	iweg
鶺	iweo
沴	iwet
浍	iwfc
举	iwfh
漈	iwfi
涻	iwfk
溌	iwfq
泭	iwfy
瀹	iwga
淪	iwga
渰	iwga
湀	iwgd
洤	iwgg
渝	iwgj
澮	iwgj
洽	iwgk
潝	iwgn
潋	iwgt
瀲	iwgt
澄	iwgu
澰	iwgw
滫	iwhe
滺	iwhn
滌	iwhs
浟	iwht
涗	iwkq
湺	iwks
溮	iwnh
溩	iwno
濮	iwoy
滏	iwqu
挙	iwrj
溆	iwtc
潊	iwtc
塗	iwtf
漵	iwtt
涂	iwty
兴	iwu
氼	iwu
涖	iwug
湓	iwvl
汾	iwvt
洢	iwvt
溣	iwwa
瀸	iwwg
浴	iwwk
潑	iwxc
沦	iwxn
沎	iwxn
汃	iwy
汄	iwy
泠	iwyc
湌	iwye
誉	iwyf
雀	iwyf
準	iwyf
淮	iwyg
蠽	iwyj
浛	iwyk
滄	iwyk
汵	iwyn
淰	iwyn
潐	iwyo
潗	iwys
渳	ixbg
泓	ixcy
漲	ixde
湪	ixey
澠	ixg
淥	ixgi
瀰	ixgq
沸	ixjh
漒	ixkj
泑	ixlt
涨	ixty
溺	ixuu
潍	ixwy
濰	ixwy
沘	ixxn
湝	ixxr
渡	iyac
瀇	iyaw
漷	iybb
漓	iybc
淳	iybg
涥	iybh
潡	iybt
灕	iyby
淯	iyce
流	iycq
鎏	iycq
澈	iyct
瑬	iycy
注	iygg
乼	iygn
汴	iyhy
涼	iyiy
瀍	iyjf
済	iyjg
湻	iyjg
濟	iyjg
济	iyjh
浏	iyjh
滖	iyke
瀼	iyke
瀤	iyle
澶	iylg
澟	iylt
沩	iyly
滈	iymk
沆	iymn
滬	iync
灋	iync
涙	iynd
淚	iynd
泳	iyni
汒	iynn
瀌	iyno
淭	iyns
沪	iynt
漉	iynx
瀛	iyny
灜	iyny
湙	iyod
滦	iyos
湾	iyox
洂	iyoy
濠	iype
湸	iypm
渟	iyps
灖	iysd
汸	iyt
游	iytb
湤	iytb
浒	iytf
滸	iytf
洲	iyth
漩	iyth
溈	iyto
尐	iyu
濂	iyuo
浪	iyve
滽	iyvh
漮	iyvi
溏	iyvk
淬	iywf
淤	iywu
液	iywy
滀	iyxl
灤	iyxs
灣	iyxx
泫	iyxy
澭	iyxy
汶	iyy
氵	iyyg
暱	jaak
蠂	jaas
昻	jabj
蟒	jada
蠎	jada
蟖	jadr
蜞	jadw
蚶	jafg
畢	jafk
鷝	jafo
虹	jag
曄	jagf
曅	jagh
螨	jagw
蚜	jaht
蟆	jajd
暯	jajd
蜡	jajg
蝘	jajv
蠇	jajy
蜮	jakg
螼	jakg
曣	jako
暵	jakw
蠸	jaky
蠴	jalj
昮	jalr
蠛	jaly
暎	jamd
蝧	jamd
蟥	jamw
曂	jamw
蜹	jamw
暪	jamy
蟎	jamy
昛	jang
蚷	jang
煚	jano
蝶	jans
蠓	jape
曚	jape
蝾	japs
螮	jaqh
曔	jaqt
蠮	jatn
晓	jatq
蛲	jatq
蟏	javj
蠨	javj
蠖	jawc
暴	jawi
晎	jawy
謈	jawy
最	jbcu
虸	jbg
蜬	jbib
蟶	jbkg
蜢	jblg
朂	jblr
曓	jbmf
昢	jbmh
虵	jbn
昪	jcaj
蝚	jcbs
蝃	jccc
肾	jcef
蛹	jceh
坚	jcff
蛏	jcfg
蚂	jcg
贤	jcmu
蚆	jcn
蛑	jcrh
竖	jcuf
晙	jcwt
紧	jcxi
螞	jcy
曞	jday
蠣	jday
蚅	jdbn
蛂	jdcy
蛎	jddn
蝴	jdeg
蛕	jdeg
晨	jdfe
蜄	jdfe
蝰	jdff
晇	jdfn
鷐	jdfo
蛄	jdg
蟵	jdgf
蝛	jdgy
蚌	jdhh
暳	jdhv
蛨	jdjg
昦	jdjj
晻	jdjn
蝒	jdmd
蝡	jdmd
暊	jdmy
蝢	jdmy
蛖	jdne
蚘	jdnn
晟	jdny
晠	jdny
螈	jdri
旲	jdu
暸	jdui
蟟	jdui
蟩	jduw
蜯	jdwh
蝽	jdwj
暙	jdwj
螓	jdwt
昃	jdwu
蛺	jdww
昽	jdxt
蜉	jebg
猒	jedy
冐	jef
暖	jefc
蝯	jefc
蛶	jefy
明	jeg
蚏	jeg
蛆	jegg
勗	jegl
琞	jegy
盟	jelf
焽	jeou
曌	jepa
暧	jepc
曖	jept
暚	jerm
蟡	jeto
螇	jexd
昅	jeyy
蟦	jfam
暁	jfaq
蠘	jfay
野	jfcb
墅	jfcf
蜐	jfcl
昙	jfcu
蚑	jfcy
里	jfd
蠕	jfdj
曘	jfdj
黙	jfdo
圼	jff
曇	jffc
蛙	jffg
晆	jffg
曉	jffq
蟯	jffq
時	jffy
旰	jfh
旪	jfh
虷	jfh
昧	jfiy
蛷	jfiy
旱	jfj
蟛	jfke
蛣	jfkg
暿	jfkk
蟢	jfkk
蝻	jfmf
暔	jfmf
黒	jfou
曀	jfpu
蚖	jfqn
暑	jftj
暏	jftj
蝫	jftj
螧	jftj
蛯	jftx
蟽	jfup
蚨	jfwy
曤	jfwy
时	jfy
蚈	jgah
旽	jgbn
蛭	jgcf
晊	jgcf
昊	jgdu
晴	jgeg
蜻	jgeg
晡	jgey
蜅	jgey
旦	jgf
旴	jgfh
虶	jgfh
旺	jgg
蚟	jgg
昰	jghf
韪	jghh
韙	jghh
题	jghm
題	jghm
鶗	jgho
遈	jghp
尟	jght
晸	jght
是	jghu
匙	jghx
虾	jghy
蚽	jgig
量	jgjf
暷	jgjf
晅	jgjg
蝀	jgji
蟪	jgjn
蝆	jgkf
晤	jgkg
螎	jgkh
曧	jgkj
蝲	jgkj
蝠	jgkl
鼌	jgkn
暕	jgli
师	jgmh
昁	jgmh
螬	jgmj
昞	jgmw
昺	jgmw
蛃	jgmw
曬	jgmx
蜽	jgmy
蛚	jgqj
逿	jgqp
昜	jgqr
敭	jgqt
昩	jgsy
蚲	jguh
蛱	jguw
蛵	jgva
蜨	jgvh
鴠	jgwo
鼂	jgxf
螦	jgxi
蛦	jgxw
蝳	jgxy
曥	jhal
蠦	jhal
蚾	jhcy
暃	jhdd
冒	jhf
朄	jhgi
刂	jhh
蠼	jhhc
蠷	jhhy
晫	jhjh
暢	jhjr
申	jhk
曱	jhk
甴	jhk
蛅	jhkg
勖	jhlt
曰	jhng
早	jhnh
畅	jhnr
虫	jhny
迧	jhpk
晛	jhqn
蜆	jhqn
畃	jhqy
毷	jhtn
蟕	jhxe
虲	jhy
蟝	jias
蛸	jieg
蝋	jimh
螳	jipf
蟐	jiph
蟷	jipl
曭	jipo
晃	jiqb
晄	jiqn
曝	jjai
昌	jjf
晘	jjfh
昍	jjg
蚎	jjg
蜵	jjgg
蛳	jjgh
蝭	jjgh
暘	jjgr
蝪	jjgr
蝐	jjhg
曑	jjje
曟	jjje
晶	jjjf
晿	jjjg
曐	jjjg
曡	jjjg
日	jjjj
蠱	jjjl
蝿	jjjn
蟲	jjju
蟃	jjlc
蝹	jjlg
焸	jjou
暥	jjpv
蝎	jjqn
暍	jjqn
蜴	jjqr
晹	jjqr
蠍	jjqw
蜾	jjsy
暒	jjtg
蜫	jjxx
暻	jjyi
蜎	jkeg
蜈	jkgd
冔	jkgf
蚛	jkhh
蝇	jkjn
暺	jkkf
蟬	jkkf
曮	jkkt
蜗	jkmw
蟈	jlag
鄤	jlcb
曼	jlcu
蝟	jleg
蛊	jlf
昷	jlf
曎	jlff
蠌	jlff
曙	jlfj
蟔	jlfo
蠉	jlge
蝈	jlgy
蛼	jlh
蛔	jlkg
蛠	jlll
蠝	jlll
蠋	jlqj
螹	jlrh
蜠	jlty
螻	jlvg
螺	jlxi
曪	jlxy
蛐	jmag
晪	jmaw
映	jmdy
螖	jmeg
蚺	jmfg
蚦	jmfg
蜩	jmfk
晭	jmfk
蚰	jmg
晍	jmgk
暟	jmgu
螘	jmgu
帅	jmhh
顒	jmhm
颙	jmhm
愚	jmhn
遇	jmhp
禺	jmhy
旵	jmj
蜖	jmjd
蠳	jmmv
虮	jmn
蝸	jmnk
蚬	jmqn
蛧	jmqq
蝄	jmun
蠵	jmwk
蚋	jmwy
蛽	jmy
蚒	jmyg
蜛	jndg
蛡	jng
暅	jngg
暇	jnhc
蝦	jnhc
蝑	jnhe
蝞	jnhg
暐	jnhh
虯	jnhh
曯	jnij
蠾	jnij
虬	jnn
蟤	jnnw
遢	jnpd
旸	jnrt
曳	jnte
毾	jntn
曵	jnty
电	jnv
蟉	jnwe
曜	jnwy
蚗	jnwy
蠗	jnwy
昵	jnxn
蚭	jnxn
蚇	jnyy
显	jogf
顕	jogm
曗	jogw
蟧	jool
蠑	joos
晱	jooy
暽	joqh
炅	jou
蝼	jovg
炚	joy
曢	jpdi
螛	jpdk
晥	jpfq
暄	jpgg
蝖	jpgg
蝊	jpgh
蠙	jpgm
螾	jpgw
螟	jpju
暝	jpju
晖	jplh
暉	jplh
晕	jplj
暈	jplj
蜿	jpqb
晼	jpqb
晏	jpvf
鷃	jpvo
螲	jpwf
蛇	jpxn
曻	jqah
蚔	jqan
蚳	jqay
昂	jqbj
蝬	jqbt
蛫	jqdb
晞	jqdh
蟾	jqdy
曕	jqdy
蠏	jqeh
晁	jqiu
晀	jqiy
晩	jqjq
蟓	jqke
昫	jqkg
蚼	jqkg
煦	jqko
晚	jqkq
冕	jqkq
蜔	jqlg
蝜	jqmy
蚫	jqnn
蛥	jqqy
敡	jqrc
剔	jqrj
蜪	jqrm
惖	jqrn
鶍	jqro
逷	jqrp
易	jqrr
昒	jqrt
昴	jqtb
昀	jqug
蚐	jqug
蜭	jqvg
鹖	jqwg
曷	jqwn
毼	jqwn
鶡	jqwo
遏	jqwp
歇	jqww
欥	jqwy
旳	jqyy
虳	jqyy
昄	jrcy
蛌	jrcy
暤	jrdf
蝗	jrgg
蚯	jrgg
昕	jrh
蚚	jrh
螔	jrhm
暭	jrif
蛛	jriy
蟱	jrlo
暣	jrno
螝	jrqc
晣	jrrh
蜱	jrtf
昳	jrwy
蛈	jrwy
曒	jryt
蚸	jryy
颗	jsdm
顆	jsdm
褁	jseu
螵	jsfi
晒	jsg
虰	jsh
敤	jshc
果	jsi
曋	jsjh
蟫	jsjh
蚵	jskg
夥	jsqq
晰	jsrh
蜥	jsrh
晽	jssy
杲	jsu
蜙	jswc
蚞	jsy
昇	jtaj
虴	jtan
蛞	jtdg
蜂	jtdh
蜘	jtdk
蟜	jtdk
蜏	jtet
旿	jtfh
晧	jtfk
蚝	jtfn
蜓	jtfp
戥	jtga
星	jtgf
蝩	jtgf
甠	jtgg
﨡	jtgg
曛	jtgo
蝂	jthc
螑	jthd
昨	jthf
蚱	jthf
曍	jthf
晷	jthk
螅	jthn
蜒	jthp
暞	jths
蜊	jtjh
蟍	jtjs
蝮	jtjt
蛒	jtkg
蝺	jtky
蟌	jtln
螕	jtlx
晌	jtmk
晑	jtmk
蜁	jtnh
虼	jtnn
蟠	jtol
蟋	jton
蛾	jtry
蝌	jtuf
昸	jtuy
蜲	jtvg
暰	jtwh
晦	jtxy
暀	jtyg
临	jtyj
监	jtyl
鉴	jtyq
览	jtyq
蛢	juah
蟙	juaj
暛	juda
蜷	judb
蛘	judh
蟮	judk
蜣	judn
曨	jued
蠬	jued
昱	juf
蚪	jufh
曦	jugy
蟻	jugy
蝉	jujf
曈	jujf
暗	jujg
蟑	jujh
暲	jujh
蜕	jukq
螪	jumk
螃	jupy
蠀	juqm
蛟	juqy
晈	juqy
蝤	jusg
螏	jutd
昗	juu
螊	juvo
螠	juwl
晜	juxt
螆	juxx
蟳	jvaf
旯	jvb
蝍	jvcb
螁	jvep
蛝	jvey
妟	jvf
蟰	jvfj
归	jvg
螋	jvhc
曃	jvip
昭	jvkg
蛁	jvkg
照	jvko
蠟	jvln
晲	jvqn
蜺	jvqn
旫	jvt
虭	jvt
蟘	jwam
蚮	jway
暡	jwcn
螉	jwcn
蚣	jwcy
昖	jwcy
昣	jwet
暩	jwfi
蚹	jwfy
蜦	jwga
暌	jwgd
蝓	jwgj
蛤	jwgk
螩	jwhs
蚧	jwjh
蛻	jwkq
螄	jwnh
螐	jwno
蚥	jwqy
蜍	jwty
蟂	jwvs
昐	jwvt
蚡	jwvt
蛜	jwvt
晔	jwxf
蛉	jwyc
昤	jwyc
蠄	jwyc
蜼	jwyg
晗	jwyk
蛿	jwyk
螥	jwyk
昑	jwyn
蚙	jwyn
蟭	jwyo
暹	jwyp
蝝	jxey
蠅	jxg
蚓	jxhh
昲	jxjh
曊	jxjm
蚴	jxlt
曏	jxtb
昆	jxxb
蜌	jxxf
鹍	jxxg
顯	jxxm
蚍	jxxn
鵾	jxxo
蝔	jxxr
歞	jxxw
蟣	jxxy
蟅	jyao
曠	jyaw
螭	jybc
蜳	jybg
暾	jybt
蜟	jyce
昿	jycy
蠩	jyfj
蛀	jygg
影	jyie
颢	jyim
顥	jyim
景	jyiu
晾	jyiy
蠐	jyjg
蛴	jyjh
曩	jyke
蠰	jyke
蟺	jylg
暠	jymk
蚢	jymn
蝙	jyna
蜧	jynd
昹	jyni
虻	jynn
昈	jynt
晐	jynw
螰	jynx
蠔	jype
蝏	jyps
蚁	jyqy
昘	jyr
旷	jyt
昉	jyt
蚄	jyt
蝣	jytb
暆	jytb
暶	jyth
旻	jyu
蠊	jyuo
蝷	jyut
螂	jyvb
蜋	jyve
螗	jyvk
晬	jywf
蜶	jywf
蟀	jyxf
昡	jyxy
蚿	jyxy
蚊	jyy
旼	jyy
喏	kadk
啿	kadn
嘶	kadr
唭	kadw
囈	kafc
嚡	kaff
咁	kafg
嘞	kafl
叿	kag
嘩	kagf
哐	kagg
嚂	kahl
囕	kahq
呀	kaht
嗼	kajd
唶	kajg
囆	kajj
噶	kajn
噧	kajy
嘔	kakk
嚥	kako
嘆	kakw
嚾	kaky
喵	kalg
咂	kamh
唝	kamy
嗊	kamy
呓	kann
呭	kann
喋	kans
唠	kapl
噆	kaqj
囌	kaqt
哎	kaqy
呕	kaqy
哓	katq
囒	kaui
嚄	kawc
嗬	kawk
嗒	kawk
嗏	kaws
嚿	kawv
哄	kawy
嚆	kayk
囁	kbbb
嗫	kbcc
唨	kbeg
咠	kbf
吇	kbg
咡	kbg
叩	kbh
嗤	kbhj
咄	kbmh
吔	kbn
吼	kbnn
戢	kbny
啊	kbsk
邑	kcb
噊	kcbk
啜	kccc
嘇	kcce
嗓	kccs
嗵	kcep
吗	kcg
咍	kckg
吧	kcn
吮	kcqn
哞	kcrh
唉	kctd
唆	kcwt
叹	kcy
嗎	kcy
咗	kdag
呃	kdbn
吰	kdcy
嘠	kdea
喐	kdeb
哊	kdeg
嚘	kdet
喯	kdfa
喹	kdff
啀	kdff
嗕	kdff
咵	kdfn
咕	kdg
喊	kdgy
喴	kdgy
嘎	kdha
囓	kdhb
喫	kdhd
噄	kdhi
嚖	kdhn
嗄	kdht
嘒	kdhv
嘁	kdhy
嚈	kdjd
喱	kdjf
咟	kdjg
唵	kdjn
呖	kdlt
喕	kdmd
咘	kdmh
顺	kdmy
順	kdmy
哤	kdne
咴	kdoy
哒	kdpy
嚦	kdth
嘹	kdui
噘	kduw
唪	kdwh
嗪	kdwt
唊	kdww
咙	kdxt
吠	kdy
呔	kdyy
哹	kebg
啂	kebn
肙	kef
喛	kefc
哷	kefy
咀	kegg
瓹	kegy
剈	kejh
嚼	kelf
嗳	kepc
噯	kept
鹃	keqg
嗂	kerm
啋	kesy
噅	keto
哸	kevg
鵑	kewo
嗘	kexd
吸	keyy
啄	keyy
喷	kfam
噴	kfam
哋	kfbn
嗑	kfcl
吱	kfcy
呍	kfcy
呿	kfcy
嚅	kfdj
哇	kffg
啩	kffh
嘵	kffq
吐	kfg
叶	kfh
嗔	kfhw
唗	kfhy
味	kfiy
呩	kfiy
嘲	kfje
嘭	kfke
咭	kfkg
嘻	kfkk
鄙	kflb
啚	kflk
喃	kfmf
嚋	kfnf
嚇	kfoo
哧	kfoy
哱	kfpb
嚏	kfph
嚔	kfph
嗦	kfpi
噎	kfpu
呒	kfqn
嘟	kftb
哮	kftb
嗜	kftj
啫	kftj
嘋	kftt
咾	kftx
啈	kfuf
噠	kfup
呋	kfwy
嚯	kfwy
吋	kfy
咞	kgah
哢	kgah
郢	kgbh
噸	kgbm
吨	kgbn
咥	kgcf
吴	kgdu
啨	kgeg
哺	kgey
呈	kgf
啞	kgfg
吁	kgfh
噁	kgfn
噖	kggn
嘕	kgho
吓	kghy
呸	kgig
吥	kgiy
哶	kgjf
咺	kgjg
哽	kgjq
囔	kgke
唔	kgkg
唖	kgkg
嗝	kgkh
喇	kgkj
哣	kgku
嗽	kgkw
嘈	kgmj
唡	kgmw
囇	kgmx
啧	kgmy
啢	kgmy
嘖	kgmy
号	kgnb
饕	kgne
飸	kgne
鸮	kgng
號	kgnm
鴞	kgno
咓	kgny
哑	kgog
逞	kgpd
咧	kgqj
嚽	kgqm
嗷	kgqt
唛	kgty
呯	kguh
啑	kgvh
啛	kgvv
嗉	kgxi
咦	kgxw
嚱	khaa
踐	khaa
噳	khad
囐	khad
噱	khae
嘘	khag
噓	khag
嘑	khah
蹛	khah
躇	khaj
踖	khaj
躤	khaj
蹃	khak
嚧	khal
唬	kham
距	khan
跇	khan
踸	khan
跷	khaq
蹀	khas
蹒	khaw
踑	khaw
躏	khay
蹣	khay
躪	khay
躡	khbb
蹑	khbc
踙	khbc
嚙	khbh
踂	khbn
踊	khce
跆	khck
蹫	khck
踴	khcl
跁	khcn
蹂	khcs
踆	khct
跋	khdc
啡	khdd
踌	khdf
蹰	khdf
跖	khdg
跍	khdg
蹽	khdi
踳	khdj
踦	khdk
跨	khdn
跶	khdp
蹖	khdv
蹶	khdw
噦	khdy
蹊	khed
啃	kheg
跀	kheg
跙	kheg
踩	khes
跥	khes
蹈	khev
趿	khey
踋	khfb
踍	khfb
跂	khfc
跬	khff
跱	khff
踛	khff
躊	khff
跿	khfh
跊	khfi
踷	khfj
躂	khfp
蹺	khfq
踜	khft
趺	khfw
蹎	khfw
趼	khga
踁	khga
趶	khgf
跮	khgf
踕	khgh
踈	khgi
蹧	khgj
踎	khgk
踾	khgl
贵	khgm
貴	khgm
蹟	khgm
遗	khgp
遣	khgp
遺	khgp
躎	khgq
跠	khgw
躧	khgx
践	khgy
跛	khhc
踧	khhc
躩	khhc
躆	khhe
趾	khhg
踄	khhi
踔	khhj
跕	khhk
跐	khhx
咔	khhy
躣	khhy
踃	khie
蹐	khie
蹚	khif
踏	khij
嚬	khim
蹕	khjf
啅	khjh
踶	khjh
蹋	khjn
踢	khjr
踼	khjr
踝	khjs
跩	khjt
中	khk
呫	khkg
踀	khkh
蹪	khkm
躁	khks
盅	khlf
躅	khlj
跏	khlk
蹥	khlp
蹦	khme
跚	khmg
踹	khmj
踻	khmk
跺	khms
踞	khnd
蹍	khne
蹘	khne
蹡	khnf
跼	khnk
跽	khnn
忠	khnu
躃	khnu
趹	khnw
跜	khnx
躍	khny
噛	khob
蹸	khoh
蹼	khoy
踠	khpb
蹿	khph
踪	khpi
蹜	khpj
迚	khpk
躥	khpn
跎	khpx
跪	khqb
踭	khqh
跳	khqi
跞	khqi
跔	khqk
蹓	khql
跑	khqn
哯	khqn
踘	khqo
蹨	khqo
跢	khqq
趵	khqy
踲	khrh
躌	khrh
跦	khri
踬	khrm
蹏	khrm
躓	khrm
躒	khrs
躈	khrt
跌	khrw
跅	khry
跴	khsg
蹅	khsg
跒	khsk
蹮	khsn
躚	khsp
跃	khtd
踵	khtf
鹭	khtg
跭	khth
蹝	khth
蹤	khth
路	khtk
踟	khtk
蹻	khtk
蹯	khtl
躜	khtm
躦	khtm
趷	khtn
踿	khto
鷺	khto
跹	khtp
跣	khtq
踒	khtv
踽	khty
踇	khty
足	khu
蹉	khua
跰	khua
踯	khub
踡	khub
躑	khub
蹢	khud
躘	khud
蹲	khuf
跘	khuf
蹱	khuf
踫	khug
蹄	khuh
躝	khui
蹭	khuj
踣	khuk
躢	khun
跤	khuq
躨	khut
踥	khuv
躙	khuy
跟	khve
躐	khvn
踺	khvp
蹆	khvp
踚	khwa
啮	khwb
跄	khwb
跉	khwc
蹳	khwc
跈	khwe
跗	khwf
跧	khwg
踨	khwh
踰	khwj
跲	khwk
蹌	khwk
趻	khwn
踗	khwn
蹹	khwn
蹬	khwu
趴	khwy
踓	khwy
嘴	khxe
跸	khxf
躖	khxg
蹞	khxm
躀	khxm
呲	khxn
喍	khxs
卟	khy
蹁	khya
踱	khyc
躞	khyc
踉	khye
躟	khye
躔	khyf
踤	khyf
躕	khyf
跓	khyg
跻	khyj
躋	khyj
踮	khyk
蹴	khyn
跡	khyo
蹠	khyo
趽	khyt
蹾	khyt
蹗	khyx
哨	kieg
啵	kihc
嘙	kihv
唦	kiit
唢	kimy
嗩	kimy
嘡	kipf
嚐	kipj
噹	kipl
咣	kiqn
吵	kitt
嗨	kity
嗶	kjaf
嚗	kjai
嘬	kjbc
嘢	kjfb
哩	kjfg
哻	kjfh
呾	kjgg
啺	kjgr
呻	kjhh
唱	kjjg
嗢	kjlg
喁	kjmy
黾	kjnb
喝	kjqn
嗮	kjsg
虽	kju
喅	kjug
雖	kjwy
噐	kkak
嚚	kkak
郘	kkbh
骂	kkcf
唈	kkcn
駡	kkcu
器	kkdk
嚣	kkdk
嚻	kkdk
囂	kkdk
嚴	kkdt
哭	kkdu
吕	kkf
鄂	kkfb
卾	kkfb
鹗	kkfg
颚	kkfm
顎	kkfm
咢	kkfn
鶚	kkfo
遌	kkfp
覨	kkfq
吅	kkg
呺	kkgn
串	kkhk
嘳	kkhm
患	kkhn
哫	kkhy
戰	kkja
鄲	kkjb
囅	kkje
辴	kkje
單	kkjf
丳	kkjk
鷤	kkjo
鄵	kkkb
碞	kkkd
品	kkkf
嘽	kkkf
劋	kkkj
口	kkkk
喦	kkkm
嵒	kkkm
氉	kkkn
噪	kkks
喿	kkks
獸	kkld
哵	kklj
嘼	kklk
鼍	kkln
鼉	kklx
咒	kkmb
㖞	kkmw
嘂	kknk
斝	kkpf
呪	kkqn
槑	kkss
遻	kkup
呮	kkwy
喌	kkyh
嘓	klag
嗯	kldn
咽	kldy
喟	kleg
嚜	klff
嚸	klfk
嘿	klfo
啭	klfy
呬	klg
喂	klge
噮	klge
囀	klgf
啯	klgy
呷	klh
唓	klh
嚃	klip
别	kljh
咖	klkg
嗋	klle
嘪	klmy
嗹	klpy
噣	klqj
啰	klqy
另	klr
叻	klt
嚺	klup
嘍	klvg
囉	klxy
噥	kmae
嗣	kmak
翤	kman
唺	kmaw
郧	kmbh
鄖	kmbh
吺	kmcy
嘊	kmdf
啱	kmdg
喘	kmdj
咉	kmdy
嘣	kmee
嗗	kmeg
呥	kmfg
啁	kmfk
哃	kmgk
吊	kmhj
勋	kmlt
勛	kmlt
嘤	kmmv
嚶	kmmv
叽	kmn
喎	kmnk
哕	kmqy
哚	kmsy
吶	kmty
员	kmu
員	kmu
囎	kmuj
剐	kmwj
鶰	kmwo
呙	kmwu
呐	kmwy
嗺	kmwy
呗	kmy
唄	kmy
呡	knan
啒	knbm
噉	knbt
啹	kndg
吳	kndu
喔	kngf
叼	kngg
呞	kngk
呉	kngw
吜	knhf
叫	knhh
喡	knhh
囑	knij
噼	knku
唰	knmj
噀	knnw
咇	kntt
嘱	knty
嘐	knwe
吷	knwy
嚁	knwy
呢	knxn
吣	kny
噿	knyf
呎	knyy
嚉	kogf
噗	kogy
嘮	kool
啖	kooy
噒	koqh
喽	kovg
咪	koy
吙	koy
嗐	kpdk
哝	kpey
噻	kpff
唍	kpfq
喧	kpgg
啶	kpgh
喗	kplh
嘧	kpnm
嚀	kpns
啘	kpqb
哰	kprh
咛	kpsh
咤	kpta
喀	kptk
咹	kpvg
啌	kpwa
嚓	kpwi
噾	kpwj
咜	kpxn
呧	kqay
兄	kqb
唏	kqdh
嘫	kqdo
噡	kqdy
嘝	kqef
唃	kqeh
唫	kqg
噜	kqgj
史	kqi
咷	kqiy
咰	kqjg
別	kqjh
呴	kqkg
喣	kqko
嚵	kqky
唤	kqmd
喚	kqmd
呜	kqng
咆	kqnn
嚕	kqoj
哅	kqqb
哆	kqqy
啕	kqrm
唿	kqrn
吻	kqrt
唙	kqto
呁	kqug
啗	kqvg
喼	kqvn
焁	kqwo
吹	kqwy
鸣	kqyg
嚠	kqyj
唣	kran
呱	krcy
嗥	krdf
哌	krey
唕	krfh
喤	krgg
听	krh
啣	krhb
哖	krhf
吽	krhh
嗁	krhm
噑	krif
咮	kriy
嘸	krlo
嚹	krmh
啲	krqy
啪	krrg
哳	krrh
咑	krsh
啤	krtf
唞	kruf
啦	krug
呹	krwy
喞	krxb
嚛	krxs
噭	kryt
喖	ksdg
嘌	ksfi
哂	ksg
呠	ksgg
唒	ksgg
叮	ksh
喳	ksjg
嘾	ksjh
呵	kskg
唽	ksrh
噤	kssi
啉	kssy
呆	ksu
喓	ksvg
嘜	kswq
唻	ksww
呏	ktah
吒	ktan
噬	ktaw
咶	ktdg
嘺	ktdk
唀	ktet
唾	ktfg
吀	ktfh
吘	ktfh
哘	ktfh
哠	ktfk
囋	ktfm
喢	ktfv
喠	ktgf
嚑	ktgo
嗅	kthd
咋	kthf
嘷	kthf
咱	kthg
川	kthh
嘥	kthh
喒	kthj
嚊	kthj
唌	kthp
嘚	ktjf
唎	ktjh
呂	ktkf
咯	ktkg
啝	ktkg
囖	ktly
噢	ktmd
响	ktmk
吃	ktnn
噃	ktol
啾	ktoy
嚟	ktqi
哦	ktry
呼	ktuh
咚	ktuy
唩	ktvg
呚	kty
咊	kty
叺	ktyy
嗍	kube
嗟	kuda
啳	kudb
嗴	kudc
咩	kudh
唴	kudn
咲	kudy
嚨	kued
呌	kufh
吖	kuhh
啴	kujf
噇	kujf
喑	kujg
噫	kujn
噷	kujw
哾	kukq
噌	kulj
嘀	kumd
㘚	kunt
㘎	kunt
啼	kuph
嗙	kupy
嚪	kuqv
咬	kuqy
噂	kusf
嚫	kusq
噺	kusr
喭	kute
唼	kuvg
嗛	kuvo
唥	kuwc
嗌	kuwl
嗞	kuxx
噚	kvaf
唧	kvcb
嘅	kvcq
呶	kvcy
哏	kvey
哪	kvfb
嘯	kvfj
嗖	kvhc
嚍	kvhl
啸	kvij
嗈	kvkc
嘨	kvoj
唚	kvpc
唲	kvqn
叧	kvr
叨	kvt
吚	kvtt
呛	kwbn
咃	kwbn
嗡	kwcn
哙	kwfc
啥	kwfk
咐	kwfy
啽	kwga
喩	kwgb
喻	kwgj
噲	kwgj
哈	kwgk
噏	kwgn
嗱	kwgr
噔	kwgu
噞	kwgw
吤	kwjh
嗰	kwld
喉	kwnd
嗚	kwno
嗲	kwqq
哬	kwsk
嘦	kwsv
咻	kwsy
喺	kwti
唋	kwty
只	kwu
鳴	kwvo
嘄	kwvs
吩	kwvt
咿	kwvt
唑	kwwf
唂	kwwk
哗	kwxf
吪	kwxn
叭	kwy
噙	kwyc
呤	kwyc
喰	kwye
唯	kwyg
唅	kwyk
嗆	kwyk
嗿	kwym
吟	kwyn
唸	kwyn
噍	kwyo
鷕	kwyo
喙	kxey
嚩	kxgf
吲	kxhh
咈	kxjh
呦	kxlt
叱	kxn
哟	kxqy
喲	kxqy
哛	kxwv
哔	kxxf
咝	kxxg
噝	kxxi
吡	kxxn
喈	kxxr
嘰	kxxy
吆	kxy
呣	kxyy
喥	kyac
嗻	kyao
嚝	kyaw
啍	kybg
哼	kybh
噋	kybt
囄	kyby
唷	kyce
唁	kyg
噈	kyin
嚌	kyjg
哜	kyjh
嚷	kyke
嗃	kymk
吭	kymn
唳	kynd
咏	kyni
呝	kynn
咳	kynw
嚎	kype
喨	kypm
嚰	kysd
嚤	kysr
嘛	kyss
嚒	kysx
嗾	kytd
啷	kyvb
哴	kyve
嘃	kyvh
啐	kywf
唹	kywu
囃	kywy
呟	kyxy
噰	kyxy
呅	kyy
轼	laag
軾	laag
輚	laay
羁	lafc
羈	lafc
羇	lafk
軭	lagg
轞	lahl
羃	lajh
轕	lajn
國	lakg
罭	lakg
爴	laky
轥	lauy
異	lawu
輁	lawy
輙	lbcy
囝	lbd
礊	lbmd
墼	lbmf
繫	lbmi
蟿	lbmj
轚	lbml
罊	lbmm
擊	lbmr
檕	lbms
辄	lbnn
輒	lbnn
轻	lcag
輮	lcbs
罞	lcbt
辍	lccc
畷	lccc
罬	lccc
輟	lccc
轰	lccu
輽	lcdl
羆	lceo
罷	lcex
圗	lcfd
軽	lcfg
囜	lci
囼	lckd
軩	lckg
圎	lcmi
罵	lcu
畯	lcwt
轭	ldbn
軛	ldbn
軷	ldcy
固	ldd
囿	lded
罟	ldf
轱	ldg
軲	ldg
轗	ldgn
輱	ldgy
轊	ldhv
因	ldi
罨	ldjn
盢	ldlf
輭	ldmd
輀	ldmj
恩	ldnu
罽	ldoj
欭	ldqw
畸	ldsk
輢	ldsk
畴	ldtf
轣	ldth
轑	ldui
辏	ldwd
輳	ldwd
轃	ldwt
畎	ldy
軑	ldy
轪	ldy
軚	ldyy
罦	lebf
輣	leeg
胃	lef
罝	legf
圂	lei
慁	lenu
轁	levg
轒	lfam
囩	lfci
圔	lfcl
罴	lfco
罢	lfcu
転	lfcy
轜	lfdj
罣	lfff
畦	lffg
罫	lffh
畤	lffy
轩	lfh
軒	lfh
置	lfhf
団	lfi
畊	lfjh
囲	lfjk
辕	lfke
瞏	lfke
轅	lfke
園	lfky
罱	lfmf
疇	lfnf
围	lfnh
转	lfny
黓	lfoa
黭	lfoa
黦	lfob
默	lfod
黩	lfod
黪	lfoe
黲	lfoe
墨	lfof
黚	lfof
黫	lfof
黥	lfoi
黯	lfoj
黠	lfok
點	lfok
黝	lfol
黸	lfol
黜	lfom
黷	lfom
黔	lfon
黗	lfon
黤	lfon
黮	lfon
黟	lfoq
黕	lfoq
黖	lfoq
黢	lfot
黑	lfou
黰	lfow
黣	lfoy
黬	lfoy
黵	lfoy
园	lfqv
团	lfte
署	lftj
圉	lfuf
睪	lfuf
鸅	lfuo
斁	lfut
歝	lfuw
轌	lfvg
轖	lfwk
輘	lfwt
畉	lfwy
囤	lgbn
軘	lgbn
轾	lgcf
輊	lgcf
囯	lgd
圊	lged
圑	lgef
輤	lgeg
畏	lgeu
辅	lgey
圃	lgey
輔	lgey
軖	lgg
囸	lghd
罡	lghf
車	lghh
囨	lgii
罘	lgiu
團	lgjf
轉	lgjf
畀	lgjj
圄	lgkd
睘	lgke
鹮	lgkg
辐	lgkl
輻	lgkl
翾	lgkn
還	lgkp
疅	lglg
輌	lgmm
辆	lgmw
輛	lgmy
车	lgnh
軏	lgqn
軯	lguh
輕	lgva
輺	lgvl
鑋	lgvq
国	lgyi
轤	lhal
軙	lhcy
罪	lhdd
輫	lhdd
罩	lhjj
四	lhng
皿	lhng
囗	lhng
罒	lhng
甲	lhnh
轳	lhnt
輎	lieg
塁	liff
囦	lii
疂	lipg
遝	lipi
輄	liqn
眔	liu
軣	liu
罼	ljaf
畼	ljgr
輰	ljgr
輼	ljlg
辒	ljlg
輵	ljqn
輠	ljsy
辊	ljxx
輥	ljxx
辑	lkbg
輯	lkbg
驾	lkcf
駕	lkcu
回	lkd
罥	lkef
軎	lkf
圖	lkfk
加	lkg
甽	lkh
圚	lkhm
毄	lkmc
圆	lkmi
圓	lkmi
贺	lkmu
賀	lkmu
乫	lknb
迦	lkpd
廻	lkpd
迴	lkpd
軦	lkqn
哿	lksk
架	lksu
毠	lktn
妿	lkvf
嗧	lkwa
鴐	lkwo
轵	lkwy
軹	lkwy
袈	lkye
畕	llf
圛	llff
圜	llge
轘	llge
奰	llld
礨	llld
脅	llle
壘	lllf
壨	lllf
畾	lllf
疉	lllg
疊	lllg
纍	llli
轟	lllj
田	llll
轠	llll
罍	lllm
勰	llln
氎	llln
鸓	lllo
劦	lllr
櫐	llls
姭	lllv
罳	llnu
轋	llpy
男	llr
嬲	llvl
轀	llwl
圐	llye
繋	lmci
撃	lmcr
軗	lmcy
圌	lmdj
輲	lmdj
軮	lmdy
畘	lmfg
輖	lmfk
轴	lmg
軸	lmg
軕	lmh
買	lmu
辋	lmun
輞	lmun
鷶	lmwo
軜	lmwy
軓	lmyy
罠	lnab
辗	lnae
輾	lnae
囻	lnav
轏	lnbb
囙	lnd
顋	lndm
罻	lnff
軐	lnfh
翈	lng
圍	lnhh
轧	lnn
劜	lnn
軋	lnn
力	lnt
思	lnu
疁	lnwe
轇	lnwe
罹	lnwy
轛	logf
轐	logy
辚	loqh
疄	loqh
轔	loqh
辖	lpdk
轄	lpdk
边	lpe
畳	lpeg
輐	lpfq
輨	lphn
连	lpk
連	lpk
畹	lpqb
軝	lqan
軧	lqay
轹	lqiy
斀	lqjc
斣	lqjf
劅	lqjj
鸀	lqjo
蜀	lqju
歜	lqjw
軥	lqkg
輓	lqkq
軳	lqnn
逻	lqpi
囫	lqre
罗	lqu
畇	lqug
輡	lqvg
软	lqwy
軟	lqwy
鸭	lqyg
輷	lqyg
罶	lqyl
畂	lqyy
畈	lrcy
畖	lrcy
罛	lrcy
軱	lrcy
磛	lrdf
堑	lrff
塹	lrff
輴	lrfh
斩	lrh
斬	lrh
覱	lrhq
暂	lrjf
暫	lrjf
蹔	lrkh
慙	lrnu
錾	lrqf
鏨	lrqf
椠	lrsu
槧	lrsu
轶	lrwy
軼	lrwy
轢	lrxs
輏	lsgg
町	lsh
困	lsi
甼	lsj
轲	lskg
軻	lskg
罧	lssu
轿	ltdj
轎	ltdk
輈	ltey
辀	ltey
輧	ltff
軠	ltfg
軞	ltfn
畽	ltgf
囷	lti
輹	ltjt
畧	ltkf
略	ltkg
辂	ltkg
輅	ltkg
轓	ltol
轷	ltuh
軤	ltuh
图	ltui
畮	ltxy
畋	lty
軿	luah
圈	ludb
畻	ludf
圏	ludn
畔	lufh
轙	lugy
疃	lujf
罯	lujf
罿	lujf
罾	lulj
図	luqi
较	luqy
較	luqy
輶	lusg
罤	luxt
囡	lvd
婁	lvf
圕	lvfj
甊	lvgy
罺	lvjs
轈	lvjs
轺	lvkg
軺	lvkg
辎	lvlg
輜	lvlg
轨	lvn
軌	lvn
遱	lvpd
輗	lvqn
輑	lvtk
氀	lvtn
數	lvty
鷜	lvwo
轫	lvyy
軔	lvyy
圙	lwdd
轸	lwet
畛	lwet
軫	lwet
囶	lwfd
軵	lwfy
圇	lwga
輪	lwga
辁	lwgg
輇	lwgg
输	lwgj
輸	lwgj
办	lwi
囚	lwi
畍	lwjh
界	lwjj
朙	lwme
囧	lwmv
畟	lwtu
畭	lwty
鴨	lwvo
鴫	lwvo
輍	lwwk
眾	lwwy
轮	lwxn
囵	lwxv
囮	lwxv
囹	lwyc
軨	lwyc
圀	lwye
軡	lwyn
罖	lwyu
羄	lxhj
累	lxiu
羂	lxke
軪	lxlt
邏	lxwp
羅	lxwy
毘	lxxb
辔	lxxk
轡	lxxk
毗	lxxn
辙	lyct
轍	lyct
圁	lyd
畩	lyey
詈	lyf
罸	lyfu
罜	lygf
軴	lygg
輬	lyiy
辌	lyiy
罚	lyjj
罰	lyjj
囥	lymv
甿	lynn
軶	lynn
畡	lynw
輆	lynw
辘	lynx
轆	lynx
羉	lyxi
圞	lyxs
圝	lyxx
賤	maay
曲	mad
農	made
蠈	madj
嵁	madn
贼	madt
賊	madt
贜	mady
巈	mafo
嵌	mafw
屸	mag
鄷	magb
艶	magc
豑	magt
豊	magu
峫	mahb
岈	maht
岽	maiu
刪	majh
嶱	majn
贎	majy
冊	mak
嶇	makk
巏	maky
岠	mang
崂	mapl
嵘	maps
嵽	maqh
嶜	maqj
岖	maqy
峣	matq
覥	mawq
觍	mawq
敟	mawt
典	mawu
戝	may
邮	mbh
邖	mbh
郥	mbh
崡	mbib
貤	mbn
嶐	mbtg
峅	mcah
岜	mcb
嵾	mcce
贂	mcce
峄	mcfh
凤	mci
禸	mci
贻	mckg
貽	mckg
殳	mcu
峻	mcwt
賐	mcwt
巁	mday
贆	mddd
峟	mdef
贿	mdeg
賄	mdeg
賬	mdey
岩	mdf
赈	mdfe
賑	mdfe
崖	mdff
峚	mdff
崕	mdff
岸	mdfj
岵	mdg
崴	mdgy
嵅	mdgy
嵗	mdgy
酆	mdhb
艷	mdhc
豓	mdhl
豔	mdhl
鳳	mdho
巎	mdht
豒	mdht
豐	mdhu
央	mdi
凮	mdjd
崦	mdjn
盎	mdlf
輋	mdlj
剬	mdmj
峏	mdmj
耑	mdmj
颛	mdmm
顓	mdmm
遄	mdmp
歂	mdmw
崸	mdmy
頔	mdmy
峸	mdny
賎	mdny
贓	mdny
炭	mdou
鸯	mdqg
屵	mdr
崎	mdsk
嶏	mdsn
嶚	mdui
嶛	mdui
嶡	mduw
嶥	mduw
賰	mdwj
鴦	mdwo
峽	mdww
嵟	mdwy
髒	meaa
嶾	mean
骮	meay
骷	medg
顝	medm
骻	medn
髓	medp
髄	medp
崩	meef
豳	meei
剻	meej
骽	meev
骨	mef
胄	mef
嵈	mefc
嶳	meff
骭	mefh
髐	mefq
岄	meg
骬	megf
髆	megf
岨	megg
骾	megq
骳	mehc
髗	mehl
骴	mehx
髁	mejs
髃	mejy
髑	melj
髏	melv
骰	memc
體	memu
骪	memy
髎	mene
髅	meov
髂	mepk
髕	mepm
髋	mepq
髌	mepw
髉	mepy
髖	mepy
鹘	meqg
骲	meqn
骶	meqy
髀	merf
骺	merk
骵	mesg
屷	met
骼	metk
骿	meua
髊	meua
骹	meuq
髈	meuy
崢	mevh
骩	mevn
骫	mevy
骱	mewj
鶻	mewo
嵠	mexd
髇	meyk
骯	meym
髍	meys
岌	meyu
骸	meyw
岋	meyy
賳	mfak
嶻	mfay
凨	mfci
岐	mfcy
冉	mfd
冃	mfd
冄	mfd
嶿	mfdj
亗	mff
崶	mfff
嶀	mffn
嶢	mffq
嶤	mffq
峙	mffy
屽	mfh
巅	mfhm
巔	mfhm
嵮	mfhw
赇	mfiy
賕	mfiy
購	mfjf
郮	mfkb
周	mfkd
彫	mfke
翢	mfkn
鵰	mfko
週	mfkp
雕	mfky
贖	mflm
赎	mfnd
嶹	mfnf
岏	mfqn
貦	mfqn
崁	mfqw
赌	mftj
賭	mftj
财	mftt
財	mftt
峔	mftx
崚	mfwt
崋	mgaf
赋	mgah
岍	mgah
賦	mgah
峌	mgcf
赙	mgef
賻	mgef
崝	mgeg
䝼	mgeg
䞍	mgeg
峬	mgey
岯	mgig
凬	mgjd
峘	mgjg
崠	mgji
崬	mgji
畁	mgjj
峺	mgjq
戙	mgka
敱	mgkc
同	mgkd
獃	mgkd
峿	mgkg
剴	mgkj
颽	mgkj
凱	mgkm
顗	mgkm
迵	mgkp
覬	mgkq
敳	mgkt
豈	mgku
嶆	mgmj
甹	mgnb
屿	mgng
崃	mgoy
夙	mgqi
峛	mgqj
峢	mgqj
屼	mgqn
岼	mguh
峡	mguw
崨	mgvh
峓	mgxw
贱	mgy
巇	mhaa
帴	mhaa
巘	mhad
巚	mhad
幙	mhad
幪	mhae
幊	mham
幉	mhas
帺	mhaw
幭	mhay
幓	mhce
帊	mhcn
岥	mhcy
貱	mhcy
凪	mhd
帗	mhdc
帪	mhde
帳	mhde
帱	mhdf
帞	mhdj
幁	mhdm
幍	mhev
幬	mhff
帏	mhfh
帾	mhfj
幩	mhfm
円	mhgd
峠	mhgh
幅	mhgl
帻	mhgm
幘	mhgm
帓	mhgs
帔	mhhc
帖	mhhk
帧	mhhm
幀	mhhm
帩	mhie
幥	mhir
幔	mhjc
帽	mhjh
幜	mhji
幆	mhjn
幌	mhjq
巾	mhk
幝	mhkf
贴	mhkg
岾	mhkg
貼	mhkg
幧	mhks
帜	mhkw
幗	mhlg
帼	mhly
帆	mhmy
冂	mhn
幈	mhna
幄	mhnf
由	mhng
幃	mhnh
贝	mhny
貝	mhny
幞	mhoy
帵	mhpb
幏	mhpe
幰	mhpn
帎	mhpq
幎	mhpu
峴	mhqn
幨	mhqy
帕	mhrg
幠	mhro
帙	mhrw
帄	mhsh
幖	mhsi
幯	mhtb
帲	mhtf
幡	mhtl
幒	mhtn
帐	mhty
帡	mhua
幢	mhuf
幱	mhui
幛	mhuj
幟	mhuj
帨	mhuq
帹	mhuv
帿	mhwd
帢	mhwk
帉	mhwv
帷	mhwy
幮	mhyf
巌	midt
峭	mieg
埊	miff
崉	mijg
贘	mipm
汖	miu
巀	miwa
嵴	miwe
囬	mjdd
廽	mjdp
逥	mjdp
嵵	mjff
崼	mjgh
崵	mjgr
则	mjh
則	mjh
賵	mjhg
赗	mjhg
嵎	mjmy
嵑	mjqn
赐	mjqr
賜	mjqr
岿	mjvf
崐	mjxx
崑	mjxx
嶯	mkby
冋	mkd
賗	mkkh
嵓	mkkk
崿	mkkn
贃	mkkn
巖	mkkt
巗	mkkt
迥	mkpd
贶	mkqn
岲	mkqn
貺	mkqn
嶉	mkwy
崮	mldf
崓	mldg
嶧	mlff
嵔	mlge
岬	mlh
嶵	mlhd
崽	mlnu
屴	mlr
嶃	mlrh
崭	mlrj
嶄	mlrj
嶁	mlvg
嶩	mmae
賟	mmaw
岟	mmdy
峀	mmf
冑	mmff
賙	mmfk
赒	mmfk
岫	mmg
册	mmgd
删	mmgj
峒	mmgk
峝	mmgk
嵦	mmgu
甖	mmgy
屾	mmh
凧	mmhk
岀	mmj
崱	mmjj
山	mmmm
贔	mmmu
赑	mmmu
巊	mmmv
鑍	mmqf
岘	mmqn
岗	mmqu
岚	mmqu
罂	mmrm
罌	mmrm
嵐	mmtj
贁	mmty
崗	mmum
婴	mmvf
嬰	mmvf
鹦	mmvg
鸚	mmvo
鸎	mmwo
賏	mmy
譻	mmyf
岷	mnan
岂	mnb
崛	mnbm
崫	mnbm
崌	mndg
嶎	mnff
嶈	mnhf
嵋	mnhg
剀	mnjh
冎	mnmb
剮	mnmj
咼	mnmk
凯	mnmn
過	mnmp
觊	mnmq
旤	mnmq
歄	mnmw
屺	mnn
乢	mnn
嶍	mnrg
囘	mnv
嵺	mnwe
賿	mnwe
赆	mnyu
嶪	mogw
嶫	mogw
贌	mogy
巆	mook
嶗	mool
嶸	moos
赕	mooy
賧	mooy
嶙	moqh
嵝	movg
迪	mpd
廸	mpd
峵	mpdc
崇	mpfi
賩	mpfi
贮	mpgg
辿	mpk
賱	mplh
貯	mpsh
峖	mpvg
崆	mpwa
嵱	mpwk
賝	mpws
岤	mpwy
岮	mpxn
崏	mqaj
嵥	mqas
岻	mqay
貾	mqay
见	mqb
觃	mqbd
岇	mqbj
嵏	mqbt
嵕	mqbt
购	mqcy
峗	mqdb
峞	mqdb
崤	mqde
赡	mqdy
嶦	mqdy
贍	mqdy
崅	mqeh
嶰	mqeh
崟	mqf
崯	mqg
飐	mqhk
飓	mqhw
风	mqi
冈	mqi
罓	mqi
賯	mqjb
峋	mqjg
刚	mqjh
刿	mqjh
嶑	mqke
岣	mqkg
巉	mqky
飔	mqln
翙	mqng
飏	mqnr
飚	mqoo
网	mqqi
羀	mqql
飗	mqql
飑	mqqn
嵚	mqqw
嶔	mqqw
岉	mqrt
峁	mqtb
嶽	mqtd
岁	mqu
飕	mqvc
峥	mqvh
嵧	mqyl
贩	mrcy
岅	mrcy
販	mrcy
岶	mrg
凰	mrgd
岴	mrgg
崲	mrgg
岓	mrh
嵬	mrqc
崥	mrtf
嶊	mrwy
嶘	msaa
嵿	msdm
凩	msi
嵖	msjg
剁	msjh
贉	msjh
岢	mskf
崊	mssy
朵	msu
崾	msvg
崧	mswc
崍	msww
嵀	msyg
账	mtay
峰	mtdh
峯	mtdh
峤	mtdj
嶠	mtdk
岆	mtdy
崻	mtff
崜	mtfg
峼	mtfk
巑	mtfm
貹	mtgg
岝	mthf
岞	mthf
嵲	mths
颰	mtjc
颼	mtjc
颳	mtjd
飇	mtjd
颩	mtje
颵	mtje
飂	mtje
颴	mtjh
颹	mtjh
風	mtji
飃	mtji
飉	mtji
峲	mtjj
颲	mtjj
颾	mtjj
飍	mtjj
颭	mtjk
颱	mtjk
飀	mtjl
飅	mtjl
颮	mtjn
颸	mtjn
颷	mtjo
飈	mtjo
颺	mtjr
颬	mtjt
飋	mtjt
颫	mtjw
颶	mtjw
峉	mtkf
赂	mtkg
峈	mtkg
賂	mtkg
賉	mtlg
嶶	mtmt
几	mtn
屹	mtnn
嶓	mtol
贬	mtpy
貶	mtpy
峨	mtry
峩	mtry
嵙	mtuf
嵊	mtux
峂	mtuy
巍	mtvc
崣	mtvf
嵂	mtvh
嵷	mtwh
嵸	mtwh
败	mty
敗	mty
內	mtyi
賆	muah
朑	muan
胐	mubm
脧	muct
嵯	muda
嵳	muda
巃	mued
巄	mued
贚	mued
岦	muf
嵄	mugd
嶬	mugy
峷	muj
嶂	mujh
赔	mukg
賠	mukg
嵜	mukh
﨑	mukh
赠	mulj
嶒	mulj
贈	mulj
剛	mumj
岡	mumk
朥	muol
崹	muph
嵭	mupy
脁	muqi
胊	muqk
峧	muqy
賋	muqy
嶟	musf
崷	musg
嵃	mute
嵼	mutg
巙	mutt
膧	muuf
赚	muvo
凲	muvo
嵰	muvo
賺	muvo
賹	muwl
巕	muwv
肦	muwv
嵫	muxx
罔	muyn
峎	mveu
峍	mvfh
嶼	mvgw
贐	mvhl
岧	mvkf
岹	mvkg
崰	mvlg
屶	mvr
峮	mvtk
岃	mvyu
屻	mvyy
嵡	mwcn
赊	mwfi
賒	mwfi
崘	mwga
崙	mwga
峑	mwgf
崄	mwgi
嵛	mwgj
崳	mwgj
峆	mwgk
峇	mwgk
嶖	mwgn
嶝	mwgu
嶮	mwgw
峜	mwhf
峳	mwht
内	mwi
岕	mwjj
冏	mwkd
巋	mwnh
嵨	mwno
嶭	mwnu
賖	mwty
嶋	mwvo
嶌	mwvo
鳯	mwvo
鵙	mwvo
岎	mwvt
肉	mwwi
峪	mwwk
酅	mwyb
岭	mwyc
岺	mwyc
崔	mwyf
嵢	mwyk
巂	mwyk
賶	mwyk
嶲	mwym
嶺	mwym
岑	mwyn
岒	mwyn
嶕	mwyo
嶣	mwyo
巓	mxhm
岪	mxjj
嵹	mxkj
岰	mxlt
嶷	mxth
嵶	mxuu
幽	mxxi
雘	myac
崞	mybg
丹	myd
彤	myet
訔	myf
赃	myfg
賍	myfg
賘	myfy
凡	myi
峕	myjf
刐	myjh
巐	myma
嵩	mymk
嵪	mymk
貥	mymn
赅	mynw
峐	mynw
賅	mynw
嵉	myps
崺	mytb
崀	myve
嵻	myvi
嵣	myvk
崒	mywf
崪	mywf
賥	mywf
鴅	mywo
恜	naag
悈	naah
愖	nadn
愜	nadw
展	naei
愅	nafh
羾	nag
恇	nagg
戼	nagn
惬	nagw
慳	nahf
懢	nahl
异	naj
羿	naj
敯	najc
慔	najd
昬	najf
惜	najg
刡	najh
愺	najh
蟁	najj
愝	najv
惐	nakg
慬	nakg
慪	nakk
懄	nakl
懽	naky
懵	nalh
懜	nalq
懱	naly
愥	namd
愩	namy
慲	namy
怇	nang
怈	nann
屟	nans
惵	nans
屉	nanv
怴	nany
懞	nape
憯	naqj
憽	naqn
怄	naqy
懂	natf
睯	nath
暋	natj
愍	natn
敃	naty
民	nav
殿	nawc
臀	nawe
壂	nawf
鴖	nawo
臋	naww
恾	nayn
慌	nayq
孱	nbbb
懾	nbbb
慑	nbcc
憜	nbde
聼	nbfn
邔	nbh
屈	nbmk
鶌	nbmo
忚	nbn
屙	nbsk
饏	nbte
憨	nbtn
敢	nbty
忬	ncbh
憰	ncbk
惙	nccc
慘	ncce
惨	ncde
悀	nceh
愑	ncel
怪	ncfg
怿	ncfh
怡	nckg
恈	ncrh
悛	ncwt
慅	ncyj
惰	ndae
墯	ndaf
翇	ndcu
居	ndd
恹	nddy
懮	ndet
悵	ndey
屒	ndfe
恗	ndfn
怙	ndg
憾	ndgn
恠	ndhf
懳	ndhn
慽	ndhy
懨	ndjd
剧	ndjh
愐	ndmd
愞	ndmd
怖	ndmh
頨	ndmy
忧	ndnn
恢	ndoy
慡	ndqq
憭	ndui
鶋	ndwo
悏	ndww
翜	ndww
忕	ndy
忲	ndyy
懚	nean
愋	nefc
怚	negg
懓	nept
愮	nerm
慆	nevg
慀	nexd
忣	neyy
懴	nfag
愤	nfam
憤	nfam
屆	nfbk
层	nfci
厾	nfci
恸	nfcl
怯	nfcy
忮	nfcy
忶	nfcy
翄	nfcy
懦	nfdj
憢	nffq
恃	nffy
忓	nfh
丮	nfhk
慎	nfhw
屚	nfi
叞	nfic
褽	nfie
尉	nfif
犚	nfih
螱	nfij
慰	nfin
熨	nfio
怽	nfiy
蝨	nfjj
卂	nfk
憉	nfke
懛	nfkf
恄	nfkg
憘	nfkk
懤	nfnf
懗	nfoo
悖	nfpb
懥	nfph
迅	nfpk
怃	nfqn
忨	nfqn
屠	nftj
愭	nftj
鷵	nfto
恅	nftx
导	nfu
悻	nfuf
懎	nfwk
鳵	nfwo
忖	nfy
忳	ngbn
屋	ngcf
恎	ngcf
剭	ngcj
刁	ngd
悿	ngdn
愽	ngef
情	ngeg
悑	ngey
忹	ngg
怔	nghg
卐	nghg
恆	nghg
怌	ngig
怀	ngiy
慱	ngjf
恒	ngjg
憓	ngjn
孠	ngkb
司	ngkd
悟	ngkg
悚	ngki
愊	ngkl
懒	ngkm
懶	ngkm
覗	ngkq
慒	ngmj
怲	ngmw
慠	ngqt
屍	ngqx
怦	nguh
悽	ngvv
愫	ngxi
恞	ngxw
懅	nhae
憈	nhag
臦	nhah
臩	nhaj
燛	nhao
郿	nhbh
叏	nhcu
収	nhcy
怶	nhcy
翍	nhcy
眉	nhd
戕	nhda
弉	nhda
奘	nhdd
悱	nhdd
奬	nhdd
屝	nhdd
牂	nhdd
狀	nhdd
獎	nhdd
爿	nhde
裝	nhde
墏	nhdf
壯	nhdf
將	nhdf
醬	nhdg
牅	nhdh
漿	nhdi
螿	nhdj
牁	nhdk
牄	nhdk
牆	nhdk
焋	nhdo
銺	nhdq
斨	nhdr
槳	nhds
牀	nhds
牃	nhds
妝	nhdv
娤	nhdv
胥	nhef
叚	nhfc
丑	nhfd
遐	nhfp
卍	nhgh
疎	nhgi
戄	nhhc
懼	nhhy
疋	nhi
疍	nhjg
悼	nhjh
蛋	nhju
丩	nhk
郼	nhkb
韕	nhkb
韍	nhkc
韒	nhke
韔	nhke
韛	nhke
韚	nhkf
韝	nhkf
韟	nhkf
韠	nhkf
韡	nhkf
怗	nhkg
韋	nhkh
韣	nhkj
韐	nhkk
韗	nhkl
韞	nhkl
韥	nhkm
韢	nhkn
違	nhkp
韎	nhks
韖	nhks
韘	nhks
韜	nhkv
韌	nhky
韤	nhky
鹛	nhqg
悓	nhqn
收	nhty
舝	nhvh
鶥	nhwo
惧	nhwy
疏	nhyq
屑	nied
悄	nieg
尿	nii
氹	nii
劚	nilj
屬	nilj
斸	nilr
惝	nimk
憆	nipf
戃	nipo
悩	niqb
恍	niqn
犀	nirh
遲	nirp
懪	njai
悭	njcf
悝	njfg
悍	njfh
怛	njgg
惿	njgh
翨	njgh
愓	njgr
丱	njhg
愰	njiq
慢	njlc
愠	njlg
愒	njqn
惕	njqr
惈	njsy
惺	njtg
惃	njxx
憬	njyi
悒	nkcn
悁	nkeg
吢	nkf
悮	nkgd
悜	nkgg
忡	nkhh
翀	nkhh
愦	nkhm
憒	nkhm
憚	nkkf
愕	nkkn
懆	nkks
屌	nkmh
愪	nkmy
悞	nknd
怳	nkqn
孹	nkub
礕	nkud
臂	nkue
襞	nkue
壁	nkuf
䴙	nkug
辟	nkuh
幦	nkuh
躄	nkuh
繴	nkui
憵	nkun
糪	nkuo
鷿	nkuo
鸊	nkuo
避	nkup
鐾	nkuq
擘	nkur
檗	nkus
劈	nkuv
嬖	nkuv
鼊	nkux
譬	nkuy
璧	nkuy
甓	nkuy
怾	nkwy
慖	nlag
翼	nlaw
乪	nld
屇	nld
懌	nlff
怬	nlg
愄	nlge
懁	nlge
恛	nlkg
愶	nlle
恊	nlll
愢	nlny
慩	nlpy
翴	nlpy
惭	nlrh
慚	nlrh
悃	nlsy
忇	nlt
屢	nlvd
慺	nlvg
慍	nlwl
愣	nlyt
憹	nmae
届	nmd
惴	nmdj
怏	nmdy
愲	nmeg
惆	nmfk
怞	nmg
恫	nmgk
愷	nmgu
刷	nmhj
屃	nmi
屓	nmi
恻	nmjh
惻	nmjh
屭	nmmm
恺	nmnn
惘	nmun
凥	nmv
慛	nmwy
忛	nmyy
惽	nnaj
怋	nnan
選	nnap
巽	nnaw
己	nngn
巳	nngn
斲	nngr
尸	nngt
巺	nngw
忸	nnhf
愇	nnhh
屫	nnhk
书	nnhy
局	nnkd
乙	nnll
乚	nnll
乛	nnll
⺄	nnll
忆	nnn
忋	nnn
繠	nnni
已	nnnn
橤	nnns
惢	nnnu
慴	nnrg
怭	nntt
忌	nnu
乜	nnv
憀	nnwe
鵋	nnwo
快	nnwy
怩	nnxn
羽	nnyg
屎	noi
憦	nool
惔	nooy
憐	noqh
屡	novd
屪	npdi
迉	npe
悰	npfi
愃	npgg
悺	nphn
慏	npju
恽	nplh
惲	nplh
翚	nplj
翬	nplj
懧	npns
惋	npqb
忱	npqn
愘	nptk
悾	npwa
屄	npwi
愹	npwk
惛	nqaj
忯	nqan
怟	nqay
忷	nqbh
惾	nqbt
翪	nqbt
㥮	nqbt
恑	nqdb
恡	nqdc
悕	nqdh
憺	nqdy
懈	nqeh
惍	nqg
恌	nqiy
惸	nqjb
恂	nqjg
怐	nqkg
翑	nqkg
悗	nqkq
愌	nqmd
怉	nqnn
恟	nqqb
恀	nqqy
惚	nqrn
愡	nqrn
惂	nqvg
㤘	nqvg
忺	nqwy
鸤	nqyg
懰	nqyj
習	nrf
翫	nrfq
怕	nrg
惶	nrgg
忻	nrh
憮	nrlo
飁	nrmj
忾	nrnn
愾	nrno
愧	nrqc
惞	nrqw
懫	nrrm
怢	nrwy
翐	nrwy
憿	nryt
慓	nsfi
恓	nsg
忊	nsh
杘	nsi
憛	nsjh
憟	nsoy
憷	nssh
惏	nssy
慄	nssy
怵	nsyy
屜	ntan
屧	ntas
怅	ntay
悸	ntbg
邲	ntbh
发	ntcy
恬	ntdg
憍	ntdk
必	nte
屘	ntfb
屐	ntfc
屗	ntff
屛	ntff
忏	ntfh
忤	ntfh
悎	ntfk
尾	ntfn
毣	ntfn
慥	ntfp
性	ntgg
憡	ntgi
慟	ntgl
怍	nthf
屣	nthh
覕	nthq
悧	ntjh
虱	ntji
慯	ntjr
愎	ntjt
恪	ntkg
属	ntky
恤	ntlg
憁	ntln
屨	ntlv
懊	ntmd
恦	ntmk
忔	ntnn
憣	ntol
屦	ntov
愀	ntoy
屩	nttk
履	nttt
鴓	ntwo
悔	ntxy
改	nty
攺	nty
恲	nuah
屏	nuak
习	nud
惓	nudb
羼	nudd
懩	nude
慻	nudh
遅	nudp
买	nudu
憪	nueg
翌	nuf
怑	nufh
翋	nug
飞	nui
憧	nujf
惮	nujf
愔	nujg
慞	nujh
憶	nujn
屖	nuk
悦	nukq
憎	nulj
層	nulj
遟	nupk
恔	nuqy
愱	nutd
飛	nuth
飝	nuth
翣	nuvf
慊	nuvo
悌	nuxt
懻	nuxw
悯	nuyy
憫	nuyy
憳	nvaf
慨	nvcq
怓	nvcy
恨	nvey
忰	nvfh
翆	nvfj
妀	nvg
懙	nvgw
怊	nvkg
忉	nvt
惱	nvtq
尻	nvv
怆	nwbn
慃	nwcn
恱	nwcq
忪	nwcy
戮	nwea
鄝	nweb
鹨	nweg
剹	nwej
勠	nwel
顟	nwem
鷚	nweo
翏	nwer
雡	nwey
憏	nwfi
惀	nwga
恮	nwgg
愉	nwgj
懀	nwgj
恰	nwgk
憕	nwgu
憸	nwgw
乆	nwi
夬	nwi
刔	nwjh
忦	nwjh
悅	nwkq
翭	nwnd
恘	nwsy
悇	nwty
翵	nwvo
鳲	nwvo
翂	nwvt
懺	nwwg
鴂	nwwo
戳	nwya
怜	nwyc
愯	nwyc
翟	nwyf
惟	nwyg
愴	nwyk
懏	nwym
忴	nwyn
惗	nwyn
憔	nwyo
鸐	nwyo
惯	nxfm
慣	nxfm
憴	nxg
愼	nxhw
恉	nxjg
怫	nxjh
怮	nxlt
迡	nxpv
懝	nxth
愵	nxuu
尼	nxv
悂	nxxf
屁	nxxv
惤	nxyx
懭	nyaw
惇	nybg
恼	nybh
悙	nybh
憞	nybt
惦	nyhk
忭	nyhy
尺	nyi
乄	nyi
㣺	nyi
憱	nyin
惊	nyiy
翞	nyiy
昼	nyjg
懠	nyjg
懹	nyke
悋	nykg
咫	nykw
懐	nyle
懷	nyle
憻	nylg
懔	nyli
懍	nylt
翯	nymk
忼	nymn
惼	nyna
悷	nynd
怺	nyni
忙	nynn
心	nyny
迟	nypi
懡	nysc
戂	nysd
尽	nyuu
悢	nyve
慵	nyvh
慷	nyvi
翠	nywf
悴	nywf
以	nywy
慉	nyxl
怰	nyxy
忟	nyy
忄	nyyh
烒	oaag
煁	oadn
糂	oadn
燍	oadr
粸	oadw
糤	oaet
粓	oafg
煂	oafh
煤	oafs
灴	oag
燁	oagf
熞	oahf
烥	oahh
爁	oahl
糮	oahl
爦	oahq
灷	oaj
糢	oajd
焟	oajg
爡	oajj
燤	oajy
熰	oakk
熯	oakw
爟	oaky
煐	oamd
焫	oamw
熿	oamw
熕	oamy
糚	oanf
炬	oang
粔	oang
煠	oans
炼	oanw
熸	oaqj
糣	oaqj
燪	oaqn
烵	oaqy
糒	oate
烧	oatq
爤	oaui
糷	oaui
爑	oawo
粪	oawu
烡	oawu
糀	oawx
烘	oawy
粠	oawy
籽	obg
邩	obh
炪	obmh
灺	obn
鬯	obxb
烃	ocag
燏	ocbk
糅	ocbs
煣	ocbs
糝	occe
糁	ocde
熥	ocep
炲	ockg
粑	ocn
焌	ocwt
糔	ocyj
爄	oday
糲	oday
炦	odcy
類	oddm
粝	oddn
糊	odeg
煳	odeg
烠	odeg
粻	odey
煃	odff
炻	odg
煘	odgy
炐	odhh
糎	odjf
粨	odjg
煗	odmd
糆	odmd
粫	odmj
糥	odmj
烦	odmy
煩	odmy
頪	odmy
烣	odoy
爏	odth
类	odu
燎	odui
粀	odyy
粏	odyy
烰	oebg
粰	oebg
焩	oeeg
煖	oefc
粗	oegg
爝	oelf
燰	oept
熎	oerm
熖	oevg
烼	oey
燌	ofam
焼	ofaq
熆	ofcl
糯	ofdj
燸	ofdj
烓	offg
燒	offq
灶	ofg
籵	ofh
煹	ofjf
熺	ofkk
糦	ofkk
爧	ofkw
煵	ofmf
燽	ofnf
炜	ofnh
爀	ofoo
焃	ofoy
烤	oftn
粩	oftx
燵	ofup
燯	ofwc
籿	ofy
邺	ogbh
炖	ogbn
业	ogd
煿	ogef
糐	ogef
精	ogeg
烳	ogey
炡	oghg
炋	ogiy
烜	ogjg
粳	ogjq
焐	ogkg
煏	ogkl
煉	ogli
糟	ogmj
炳	ogmw
粖	ogsy
凿	ogub
鄴	ogub
黻	oguc
叢	oguc
丵	oguf
對	oguf
黹	ogui
懟	ogun
糳	oguo
鸈	oguo
鑿	oguq
黺	oguv
業	oguw
黼	oguy
菐	oguy
烴	ogva
彂	ogxd
爐	ohal
爈	ohan
爠	ohhy
焯	ohjh
粘	ohkg
炶	ohkg
爘	ohqe
粯	ohqn
燦	ohqo
焇	oieg
糛	oipf
爣	oipo
炒	oitt
粆	oitt
熦	oiwy
熚	ojaf
爗	ojaf
爆	ojai
熶	ojbc
焨	ojeg
粴	ojfg
焊	ojfh
糧	ojgf
炟	ojgg
煶	ojgh
煬	ojgr
糃	ojgr
灲	ojh
熀	ojiq
焻	ojjg
爞	ojjj
熳	ojlc
煴	ojlg
焬	ojqr
粿	ojsy
焺	ojta
煋	ojtg
煜	ojug
燳	ojvo
焜	ojxx
烛	ojy
燝	ojyi
焆	okeg
燀	okkf
焒	okkg
煰	okkk
燥	okks
熉	okmy
炾	okqn
炽	okwy
熼	olaw
糞	olaw
煾	oldn
烟	oldy
煟	oleg
畨	olf
燡	olff
爅	olff
糬	olfj
畑	olg
煨	olge
糫	olge
糰	olgf
炠	olh
熁	olle
燲	ollm
燭	olqj
焑	olsy
熡	olvg
熅	olwl
燶	omae
粬	omag
炈	omcy
煓	omdj
炴	omdy
粙	omg
烔	omgk
粡	omgk
灿	omh
籼	omh
熴	omjx
炯	omkg
粣	ommg
籶	omn
煱	omnk
煈	omtj
焵	omum
焹	omun
烱	omwk
熣	omwy
烿	omye
煀	onbm
籸	onfh
煆	onhc
糈	onhe
炄	onhf
粈	onhf
煝	onhg
煒	onhh
糏	onie
爥	onij
焗	onnk
熠	onrg
断	onrh
炀	onrt
熤	onug
熮	onwe
炔	onwy
燿	onwy
烬	onyu
粎	onyy
郯	oobh
糭	oobt
顃	oodm
烾	ooff
爜	oogc
敥	oohc
煔	oohk
覢	oohq
剡	oojh
飊	oooj
火	oooo
燚	oooo
燊	ooos
爃	ooos
焱	ooou
歘	ooow
膋	oope
褮	oope
塋	oopf
煢	oopf
醟	oopg
犖	ooph
滎	oopi
禜	oopi
縈	oopi
螢	oopj
營	oopk
勞	oopl
嵤	oopm
焭	oopm
罃	oopm
憥	oopn
熒	oopo
鶯	oopo
覮	oopq
鎣	oopq
榮	oops
檾	oops
嫈	oopv
瑩	oopy
甇	oopy
謍	oopy
燐	ooqh
欻	ooqw
炎	oou
鶑	oowo
炏	ooy
顲	ooym
爎	opdi
糘	opey
粽	opfi
烷	opfq
煊	opgg
迷	opi
熐	opju
熍	opkk
煇	oplh
焥	opqb
烢	opta
焢	opwa
熔	opwk
焪	opwx
炨	opxn
粼	oqab
鄰	oqab
粦	oqah
焝	oqaj
亃	oqan
翷	oqan
遴	oqap
斴	oqar
甐	oqay
灮	oqb
煼	oqbt
糉	oqbt
烯	oqdh
燃	oqdo
焔	oqhj
烁	oqiy
烑	oqiy
焕	oqmd
煥	oqmd
炮	oqnn
粷	oqoy
粅	oqrt
焰	oqvg
炊	oqwy
熘	oqyl
灼	oqyy
炍	orcy
粄	orcy
粕	org
煌	orgg
炘	orh
熂	orno
焮	orqw
焷	ortf
粺	ortf
爍	orxs
燩	oryt
煙	osfg
熛	osfi
粞	osg
灯	osh
烞	oshy
燂	osjh
炣	oskg
爩	osre
炑	osy
炢	osyy
灹	otan
籷	otan
炧	otbn
粚	otbn
烽	otdh
燆	otdk
熢	otdp
烐	otey
烆	otfh
粁	otfh
焅	otfk
粍	otfn
糙	otfp
烶	otfp
烍	otfq
煄	otgf
燻	otgo
爋	otgo
糗	othd
炸	othf
糌	othj
熄	othn
烻	othp
烙	otkg
烅	otlg
熜	otln
燠	otmd
炿	otmy
籺	otnn
燔	otol
煍	otoy
熪	otqq
烀	otuh
炵	otuy
烸	otxy
敉	oty
炇	oty
秌	oty
熾	ouaj
烊	oudh
烪	oudy
爖	oued
燗	oueg
糋	ouej
燧	ouep
煫	ouey
烂	oufg
料	oufh
炓	oufh
粒	oug
爛	ougi
糕	ougo
燨	ougy
爔	ougy
燑	oujf
燱	oujn
糡	oujq
焙	oukg
熷	oulj
熵	oumk
焖	ouny
燜	ouny
爓	ouqv
烄	ouqy
燇	ousf
煪	ousg
熑	ouvo
熌	ouwy
焍	ouxt
糍	ouxx
燘	ouyy
燬	ovac
燖	ovaf
煺	ovep
娄	ovf
粋	ovfh
熽	ovfj
煡	ovfp
籹	ovg
燼	ovhl
粶	oviy
炤	ovkg
爉	ovln
灱	ovt
数	ovty
籾	ovyy
炝	owbn
焧	owcn
炂	owcy
煅	owdc
烩	owfc
爚	owga
烇	owgg
燴	owgj
糩	owgj
烚	owgk
粭	owgk
熻	owgn
燈	owgu
炌	owjh
糇	ownd
熓	owno
烌	owsy
粉	owvt
焀	owwk
炛	owxb
烨	owxf
炩	owyc
焳	owyg
焓	owyk
熗	owyk
焾	owyn
燋	owyo
粌	oxhh
纇	oxim
颣	oxim
炥	oxjh
糨	oxkj
糑	oxuu
粃	oxxn
煯	oxxr
熫	oyao
爌	oyaw
焞	oybg
燉	oybt
焴	oyce
粧	oyfg
炷	oygg
炞	oyhy
爙	oyke
燷	oyli
燣	oylt
熇	oymk
炕	oymn
粇	oymn
燺	oyms
煸	oyna
糄	oyna
熩	oync
煽	oynn
爊	oyno
炉	oynt
粐	oynt
烗	oynw
熝	oynx
麊	oynx
煷	oypm
米	oyty
燫	oyuo
粮	oyve
烺	oyve
糠	oyvi
糖	oyvk
煻	oyvk
焿	oyvw
粹	oywf
焠	oywf
焲	oywy
炫	oyxy
炆	oyy
灬	oyyy
宦	pahh
宧	pahh
寛	pahq
寬	pahy
寞	pajd
冪	pajh
宽	pamq
冣	pbcu
字	pbf
宻	pcum
翝	pdcn
宏	pdcu
宥	pdef
寡	pdev
宕	pdf
宸	pdfe
割	pdhj
害	pdhk
豁	pdhk
鶷	pdho
寕	pdls
宬	pdny
寄	pdsk
宊	pdu
寮	pdui
実	pdwu
宠	pdxr
肎	pef
宜	pegf
冝	pegf
农	pei
寀	pesu
寪	peto
家	peu
冢	peyu
冡	pfeu
寘	pfhw
崈	pfim
賨	pfim
鶎	pfio
宗	pfiu
寋	pfjb
骞	pfjc
騫	pfjc
褰	pfje
塞	pfjf
蹇	pfjh
宑	pfjj
赛	pfjm
賽	pfjm
鶱	pfjo
搴	pfjr
寨	pfjs
寒	pfju
弿	pfjx
謇	pfjy
完	pfqb
寇	pfqc
冦	pfqc
冠	pfqf
鵍	pfqo
宼	pfqv
宯	pftb
守	pfu
室	pgcf
寈	pgef
宇	pgfj
顁	pghm
定	pghu
賓	pgim
顮	pgim
宣	pgjg
寭	pgjn
翧	pgjn
富	pgkl
冨	pgkl
憲	pgln
戭	pgma
寅	pgmw
写	pgng
寳	pgqm
寚	pgrm
寶	pgrm
寁	pgvh
宝	pgyu
寂	phic
寊	phmu
宐	phng
官	phnn
悹	phnn
鼏	phnn
逭	phnp
宵	pief
寖	pivc
幂	pjdh
寔	pjgh
审	pjhj
寓	pjmy
鄍	pjub
覭	pjuq
冥	pjuu
鼆	pjux
宴	pjvf
宺	pkgq
宫	pkkf
宲	pksu
宮	pktk
郓	plbh
鄆	plbh
顐	pldm
寰	plge
皲	plhc
皸	plhc
军	plj
軍	plj
運	plpk
寠	plvf
鶤	plwo
冗	pmb
宂	pmb
寷	pmdu
宙	pmf
冚	pmj
鴧	pmwo
甯	pnej
寢	pnhc
寐	pnhi
寤	pnhk
寱	pnhs
寎	pnhw
寣	pnhy
寍	pnlf
寜	pnlh
鸋	pnlo
寧	pnls
賔	pnmu
寗	pntf
蜜	pntj
密	pntm
宓	pntr
寥	pnwe
廴	pny
叜	pocu
灾	pou
冞	pou
宩	pou
之	pppp
宛	pqbb
鹓	pqbg
邥	pqbh
剜	pqbj
惌	pqbn
鵷	pqbo
瓭	pqgy
沊	pqii
宨	pqiu
冤	pqky
寃	pqky
寏	pqmd
鸩	pqqg
冘	pqv
鴆	pqwo
寙	prcy
宾	prgw
牢	prhj
冟	prxb
宁	psj
冧	pssu
宋	psu
宅	ptab
宎	ptdu
宒	ptfn
宪	ptfq
客	ptkf
额	ptkm
額	ptkm
愙	ptkn
審	ptol
覾	ptoq
宷	ptou
裓	puaa
襼	puac
襽	puai
襺	puaj
褡	puak
襤	pual
袣	puan
褋	puas
褗	puav
褀	puaw
襔	puay
襪	puay
襵	pubb
袦	pubm
衪	pubn
裰	pucc
襂	puce
褬	pucs
褦	pucx
衩	pucy
袏	puda
袸	pudb
袚	pudc
褉	pudd
裖	pude
褥	pudf
袥	pudg
袹	pudj
袻	pudj
襫	pudj
裿	pudk
袴	pudn
裺	pudn
实	pudu
裌	pudw
褑	puec
寵	pued
袓	pueg
衫	puet
衱	puey
衼	pufc
袪	pufc
褤	pufe
袿	puff
褠	puff
褂	pufh
衦	pufh
袆	pufh
褚	pufj
襦	pufj
袺	pufk
襩	pufm
襭	pufm
襓	pufq
裬	puft
衭	pufw
襶	pufw
衬	pufy
褹	pufy
裱	puge
衧	pugf
襋	pugi
褿	pugj
褔	pugl
襀	pugm
襰	pugm
襧	pugq
袜	pugs
裋	pugu
褄	pugv
襹	pugx
補	pugy
裲	pugy
被	puhc
裶	puhd
褃	puhe
裃	puhh
袩	puhk
裭	puhm
补	puhy
衤	pui
褝	puif
襠	puil
裆	puiv
宰	puj
襊	pujc
裡	pujf
襅	pujf
袒	pujg
衵	pujg
裫	pujg
褆	pujh
襮	puji
裮	pujj
褴	pujl
褞	pujl
褐	pujn
褟	pujn
裼	pujr
裸	pujs
裩	pujx
裐	puke
襌	pukf
裎	pukg
衶	pukh
䙡	pukm
䙌	pukm
襙	puks
裀	puld
襗	pulf
襡	pulj
裢	pulp
褳	pulp
裍	puls
褸	pulv
襬	pulx
襛	pume
衻	pumf
袡	pumf
袖	pumg
褍	pumj
裯	pumk
衲	pumw
袇	pumy
裾	pund
褘	punh
褶	punr
袐	punt
袂	punw
襈	punw
袯	puny
襨	puof
裧	puoo
褛	puov
襆	puoy
褣	pupk
裈	pupl
褌	pupl
衴	pupq
袕	pupw
袉	pupx
衹	puqa
襐	puqe
袧	puqk
裪	puqm
袍	puqn
袳	puqq
袀	puqu
袛	puqy
襜	puqy
裨	purf
袙	purg
袾	puri
褫	purm
袟	purw
襟	pusi
褾	pusi
袔	pusk
褼	pusn
寴	pusq
襻	pusr
袘	putb
袄	putd
襖	putd
衽	putf
褈	putf
袶	puth
裄	puth
褷	puth
袮	puti
襣	putj
袼	putk
裇	putl
襎	putl
襸	putm
裑	putt
複	putt
宍	puu
褨	puua
裷	puub
襱	puud
褙	puue
襉	puue
袢	puuf
褅	puuh
襕	puui
襴	puui
裥	puuj
襇	puuj
襚	puup
裞	puuq
襯	puuq
襒	puut
寝	puvc
裉	puve
襑	puvf
裙	puvk
袑	puvk
袽	puvk
褪	puvp
襷	puvr
初	puvt
衳	puwc
袊	puwc
襏	puwc
袱	puwd
袗	puwe
袝	puwf
袵	puwf
襳	puwg
裣	puwi
衸	puwj
褕	puwj
襘	puwj
裕	puwk
袷	puwk
衿	puwn
褓	puws
襍	puws
衯	puwv
襝	puww
襥	puwy
褖	puxe
襁	puxj
袎	puxl
褊	puya
褵	puyc
襢	puyg
褯	puyh
裤	puyl
褲	puyl
裗	puyq
袨	puyx
鞌	pvaf
宄	pvb
頞	pvdm
安	pvf
冩	pvqo
寫	pvqo
案	pvsu
宭	pvtk
鴳	pvwo
空	pwaf
窢	pwag
窍	pwan
鵼	pwao
穿	pwat
窃	pwav
窷	pwbb
窿	pwbg
窋	pwbm
窡	pwcc
窓	pwcn
梥	pwcs
窫	pwdd
竂	pwdi
宿	pwdj
鶟	pwdo
突	pwdu
窚	pwdy
窰	pwem
窙	pwfb
窦	pwfd
窐	pwff
察	pwfi
罕	pwfj
穽	pwfj
竇	pwfm
竃	pwfn
窥	pwfq
窺	pwfq
窛	pwfv
窴	pwfw
窾	pwfw
竈	pwfx
窒	pwgf
穻	pwgf
窀	pwgn
竀	pwgq
窉	pwgw
窅	pwhf
窧	pwhj
窏	pwif
窪	pwif
窠	pwjs
窤	pwjx
窜	pwkh
窝	pwkw
穷	pwlr
窶	pwlv
帘	pwmh
窩	pwmk
穵	pwnb
窹	pwnk
窟	pwnm
窲	pwof
窭	pwov
窌	pwqb
窎	pwqg
窕	pwqi
窇	pwqn
穸	pwqu
窞	pwqv
窂	pwrh
窑	pwrm
竅	pwrt
窳	pwry
窊	pwry
穼	pwsu
罙	pwsu
竊	pwtc
穾	pwtd
窄	pwtf
宱	pwtf
窖	pwtk
竆	pwtk
窸	pwtn
窻	pwtn
竁	pwtn
窆	pwtp
窗	pwtq
窮	pwtx
穴	pwu
㓁	pwu
竉	pwud
窨	pwuj
窯	pwuo
邃	pwup
窔	pwuq
究	pwvb
寑	pwvc
窘	pwvk
竄	pwvn
窼	pwvs
彮	pwwe
窬	pwwj
容	pwwk
窵	pwwo
鴪	pwwo
窱	pwws
穹	pwxb
窈	pwxl
窽	pwxw
隺	pwyd
寉	pwyf
窣	pwyf
鹤	pwyg
寯	pwym
鶴	pwyo
它	pxb
宆	pxb
宖	pxcu
實	pxfm
迱	pxpv
寲	pxth
祴	pyaa
禥	pyaf
禖	pyas
祺	pyaw
祁	pybh
祂	pybn
祃	pycg
禡	pycy
祓	pydc
禊	pydd
祳	pyde
祷	pydf
祜	pydg
祏	pydg
祐	pydk
禲	pydy
禐	pyec
祖	pyeg
礽	pyet
祛	pyfc
禱	pyff
社	pyfg
祎	pyfh
禃	pyfh
祙	pyfi
禇	pyfj
禧	pyfk
祮	pyfk
祾	pyft
禛	pyfw
祆	pygd
宔	pygf
祬	pygf
禣	pygf
福	pygl
禰	pygq
祉	pyhg
祯	pyhm
禎	pyhm
視	pyhq
礻	pyi
神	pyjh
禔	pyjh
禵	pyjm
禢	pyjn
禓	pyjr
祼	pyjs
禑	pyjy
祦	pykd
禪	pykf
祌	pykh
祝	pykq
祸	pykw
祻	pyld
禗	pyln
禤	pyln
祵	pyls
禝	pylt
禩	pylw
祋	pymc
禯	pyme
禂	pymk
禍	pymk
视	pymq
禮	pymu
冖	pyn
祤	pyng
禕	pynh
祠	pynk
礼	pynn
祀	pynn
祕	pynt
辶	pyny
禷	pyom
禈	pypl
祇	pyqa
祪	pyqb
祧	pyqi
祢	pyqi
祹	pyqm
祗	pyqy
礿	pyqy
禆	pyrf
祈	pyrh
祩	pyri
禠	pyrm
祑	pyrw
禋	pysf
禫	pysj
祅	pytd
祣	pyte
祚	pytf
祍	pytf
祰	pytk
禶	pytm
祥	pyud
禙	pyue
禅	pyuf
禉	pyug
禘	pyuh
禚	pyuo
禭	pyup
祱	pyuq
祶	pyut
禌	pyux
祲	pyvc
禄	pyvi
祒	pyvk
禴	pywa
祔	pywf
祄	pywj
禬	pywj
祫	pywk
禒	pyxe
祿	pyxi
禨	pyxy
禳	pyye
祽	pyyf
禞	pyyk
禟	pyyk
宀	pyyn
祊	pyyt
鉽	qaag
鐷	qaas
錢	qaay
锘	qadk
鍩	qadk
頯	qadm
鍖	qadn
鐁	qadr
錤	qadw
鑶	qady
鏾	qaet
钳	qafg
鉗	qafg
氒	qafj
鐯	qafj
䦃	qafj
鑉	qafl
釭	qag
鏵	qagf
铘	qahb
鋣	qahb
鏗	qahf
舛	qahh
鑑	qahl
鑦	qahm
鑬	qahq
桀	qahs
釾	qaht
䥺	qaht
鑮	qaif
銾	qaiy
镆	qajd
鏌	qajd
昏	qajf
错	qajg
錯	qajg
钷	qakg
鉕	qakg
鏂	qakk
鑎	qakm
鑵	qaky
锚	qalg
錨	qalg
鑖	qaly
鍈	qamd
锳	qamd
帋	qamh
鉔	qamh
鐄	qamw
鏋	qamy
钜	qang
鉅	qang
鉪	qann
鍱	qans
钺	qany
铽	qany
鉞	qany
鋱	qany
铹	qapl
鐕	qaqj
銰	qaqy
鑝	qatp
铙	qatq
钄	qaui
氏	qav
鍣	qavk
镬	qawc
鑊	qawc
匒	qawk
鎝	qawk
錵	qawx
鉷	qawy
釴	qay
鈛	qay
邸	qayb
鸱	qayg
氐	qayi
鋩	qayn
铓	qayn
鴟	qayo
錺	qayt
鑷	qbbb
鎁	qbbh
镊	qbcc
駌	qbcu
鋷	qbcy
铒	qbg
釨	qbg
鉺	qbg
钌	qbh
卬	qbh
夘	qbh
邜	qbh
釕	qbh
眢	qbhf
鐊	qbjr
凶	qbk
盌	qblf
锰	qblg
錳	qblg
鈯	qbmh
夗	qbn
釶	qbn
銸	qbnn
怨	qbnu
迎	qbpk
兇	qbqb
鸳	qbqg
锕	qbsk
錒	qbsk
鄒	qbtb
皺	qbtc
鶵	qbto
芻	qbtt
雛	qbty
妴	qbvf
鴛	qbwo
色	qcb
鐍	qcbk
鍒	qcbs
錣	qccc
鏒	qcce
鎟	qccs
銿	qceh
铎	qcfh
勾	qci
鈶	qckg
钯	qcn
鈀	qcn
鈗	qcqn
鉾	qcrh
鋑	qcwt
鎷	qcy
钗	qcyy
釵	qcyy
危	qdbb
頠	qdbm
鈪	qdbn
敎	qdbt
郄	qdcb
钹	qdcy
鈜	qdcy
鈸	qdcy
郩	qdeb
殽	qdec
肴	qdef
铕	qdeg
銪	qdeg
鍸	qdeg
鋹	qdey
锛	qdfa
錛	qdfa
鋠	qdfe
鍷	qdff
鎒	qdff
錼	qdfi
銙	qdfn
钴	qdg
鈷	qdg
鉐	qdg
銊	qdgy
鍼	qdgy
銌	qdhb
锲	qdhd
鍥	qdhd
鏏	qdhv
鏚	qdhy
銇	qdiy
銆	qdjg
匎	qdjn
郗	qdmb
希	qdmh
钸	qdmh
鈽	qdmh
鵗	qdmo
欷	qdmw
瓻	qdmy
顉	qdmy
铖	qdny
銭	qdny
鋮	qdny
然	qdou
鋴	qdqn
鏯	qdqq
厃	qdr
錡	qdsk
锜	qdsk
矦	qdtd
铸	qdtf
鋳	qdtf
镣	qdui
鐐	qdui
镢	qduw
鐝	qduw
鋏	qdww
詹	qdwy
甔	qdwy
釱	qdy
钛	qdyy
鈦	qdyy
觨	qeai
觾	qeao
觵	qeaw
鋢	qebg
觭	qedk
錋	qeeg
觙	qeey
锾	qefc
鍰	qefc
觟	qeff
锊	qefy
觩	qefy
鋝	qefy
钥	qeg
鈅	qeg
鉏	qegg
觫	qegi
锄	qegl
鋤	qegl
觥	qeiq
觘	qeit
角	qej
觛	qejg
触	qejy
觶	qekf
觸	qelj
觔	qelt
觿	qemk
觽	qemm
觓	qenh
觖	qenw
鑀	qept
觗	qeqa
觤	qeqb
觼	qeqt
觝	qeqy
鎐	qerm
觻	qers
觚	qery
钐	qet
釢	qet
釤	qet
觡	qetk
觞	qetr
觧	qeud
斛	qeuf
觯	qeuf
觪	qeuh
觲	qeuh
鋖	qevg
解	qevh
觮	qevi
蟹	qevj
邂	qevp
觬	qevq
觹	qewm
鵤	qewo
鈒	qeyy
钑	qeyy
鐵	qfag
鐼	qfam
鐡	qfau
鎑	qfcl
鈘	qfcy
鉣	qfcy
勻	qfd
鑐	qfdj
銈	qffg
鐃	qffq
钍	qfg
釷	qfg
针	qfh
針	qfh
釬	qfh
镇	qfhw
鎮	qfhw
銢	qfiy
銶	qfiy
鎱	qfke
銡	qfkg
镭	qflg
鐳	qflg
鑟	qflm
鑄	qfnf
釫	qfnn
鋕	qfny
鋍	qfpb
鎍	qfpi
鈨	qfqn
﨧	qftb
銒	qftf
锗	qftj
鍺	qftj
铐	qftn
銬	qftn
釮	qftt
铑	qftx
銠	qftx
﨨	qfuf
鐽	qfup
錴	qfwf
鐟	qfwj
鑚	qfwm
錂	qfwt
鈇	qfwy
鳠	qgac
鈃	qgah
錻	qgah
钘	qgah
鉶	qgaj
铏	qgaj
鳓	qgal
鲽	qgas
鲯	qgaw
鲰	qgbc
印	qgbh
钝	qgbn
鈍	qgbn
鲬	qgce
鲹	qgce
銍	qgcf
铚	qgcf
鳋	qgcj
鲐	qgck
鲃	qgcn
鲅	qgdc
鲔	qgde
鲕	qgdj
䲠	qgdj
鱿	qgdn
鳡	qgdn
鳜	qgdw
鎛	qgef
镈	qgef
锖	qgeg
錆	qgeg
鳐	qgem
铺	qgey
匍	qgey
鋪	qgey
錶	qgey
鱼	qgf
鲑	qgff
錏	qgfg
釪	qgfh
鳍	qgfj
鲒	qgfk
鲼	qgfm
鐚	qgfn
鲓	qgfn
鲮	qgft
鳕	qgfv
鲭	qgge
錱	qggf
鲆	qggh
鲾	qggl
鲀	qggn
鲠	qggq
鲡	qggy
鲏	qghc
鲱	qghd
钲	qghg
鉦	qghg
鲇	qghk
钙	qghn
鲈	qghn
鈣	qghn
鲿	qgic
銔	qgif
鉟	qgig
钚	qgiy
鈈	qgiy
鳗	qgjc
鲁	qgjf
鲤	qgjf
鲥	qgjf
鲣	qgjf
鏄	qgjf
鳀	qgjh
錬	qgji
鲳	qgjj
鐂	qgjl
鳁	qgjl
鳎	qgjn
鏸	qgjn
鲲	qgjx
鋙	qgkg
铻	qgkg
镉	qgkh
鎘	qgkh
鋉	qgki
鑩	qgkk
匐	qgkl
鍢	qgkl
鳄	qgkn
鋀	qgku
鏉	qgkw
鲴	qgld
鳂	qgle
鳏	qgli
鍊	qgli
鳃	qgln
鲢	qglp
鲉	qgmg
鏪	qgmj
鲗	qgmj
鲷	qgmk
鲖	qgmk
鳢	qgmu
鈵	qgmw
鳚	qgnf
鲺	qgnj
鱾	qgnn
鳛	qgnr
鋄	qgoc
铔	qgog
鳞	qgoh
錽	qgot
铼	qgoy
鲩	qgpq
䲟	qgqb
鲍	qgqn
鳇	qgrg
鲌	qgrg
鳈	qgri
鲘	qgrk
鳔	qgsi
鲄	qgsk
鲊	qgtf
鲧	qgti
鳤	qgtn
鳅	qgto
鲦	qgts
鳆	qgtt
稣	qgty
鲜	qgud
鳟	qguf
鳉	qguf
䲡	qgug
匉	qguh
鳝	qguk
鳒	qguo
鲛	qguq
铗	qguw
鳑	qguy
鋞	qgva
鲫	qgvb
鲟	qgvf
鲪	qgvk
鲻	qgvl
鍿	qgvl
鲵	qgvq
鱽	qgvt
鲙	qgwc
鲋	qgwf
鲶	qgwn
鑈	qgwq
銕	qgxw
钱	qgy
鳊	qgya
鳣	qgyg
鳙	qgyh
鲸	qgyi
鲚	qgyj
鲂	qgyt
钰	qgyy
鈺	qgyy
钀	qhad
鐻	qhae
鏬	qhah
鐪	qhal
鑪	qhal
錿	qham
鑢	qhan
鎼	qhar
鑡	qhbh
铍	qhcy
鈙	qhcy
鈹	qhcy
鐬	qhdy
錹	qheg
钼	qhg
鉬	qhg
钁	qhhc
䦆	qhhc
鉲	qhhy
鑺	qhhy
亇	qhj
鋽	qhjh
钻	qhkg
鉆	qhkg
夞	qhkx
鏀	qhlo
鍞	qhmy
鈻	qhnn
鐤	qhnn
迯	qhpi
鋧	qhqn
外	qhy
钋	qhy
釙	qhy
頫	qidm
销	qieg
銷	qieg
鼗	qifc
鍅	qifc
玺	qigy
覙	qihq
覜	qihq
乐	qii
兆	qii
錔	qijg
鐋	qijr
鋿	qimk
锁	qimy
鎖	qimy
铴	qinr
镗	qipf
鏜	qipf
鏛	qiph
逃	qipi
迩	qipi
鐺	qipl
鑜	qipm
钂	qipo
鎲	qipq
镋	qipq
鐣	qipr
鏿	qips
銧	qiqn
鎃	qire
钞	qitt
鈔	qitt
尔	qiu
淾	qiu
铛	qivg
鴵	qiwo
釥	qiy
鏎	qjaf
鑤	qjai
郇	qjbh
铿	qjcf
旬	qjd
锂	qjfg
鋰	qjfg
銲	qjfh
鈤	qjg
锝	qjgf
鍀	qjgf
钽	qjgg
鉭	qjgg
鍉	qjgh
鍚	qjgr
钊	qjh
刈	qjh
釗	qjh
鉮	qjhh
鎤	qjiq
錩	qjjg
锠	qjjg
亀	qjjn
镘	qjlc
鏝	qjlc
鎾	qjlg
鍝	qjmy
龟	qjnb
鎉	qjng
迿	qjpd
銞	qjqf
鍻	qjqn
锡	qjqr
錫	qjqr
锞	qjsy
錁	qjsy
鍟	qjtg
锟	qjxx
錕	qjxx
鉵	qjy
鐛	qjyi
鍓	qkbg
邭	qkbh
句	qkd
鋗	qkeg
勨	qkel
象	qkeu
名	qkf
釦	qkg
鋘	qkgd
锃	qkgg
鋥	qkgg
钏	qkh
釧	qkh
钟	qkhh
鈡	qkhh
鏴	qkhk
鐀	qkhm
鑓	qkhp
鋜	qkhy
铝	qkkg
鋁	qkkg
鋛	qkkh
锷	qkkn
鍔	qkkn
鐰	qkks
劬	qklt
铞	qkmh
銱	qkmh
锅	qkmw
免	qkqb
鸲	qkqg
勉	qkql
鵵	qkqo
逸	qkqp
够	qkqq
欨	qkqw
兔	qkqy
鉂	qkqy
斪	qkrh
敂	qkty
鴝	qkwo
鉙	qkwy
雊	qkwy
酁	qkxb
劖	qkxj
毚	qkxy
甸	qld
锢	qldg
錮	qldg
铟	qldy
銦	qldy
鐸	qlff
钿	qlg
鈿	qlg
鍡	qlge
鐶	qlge
镮	qlge
鎠	qlgh
钾	qlh
鉀	qlh
鉫	qlkg
鑸	qllf
鑘	qlll
錷	qlnn
锶	qlny
鍶	qlny
链	qlpy
鏈	qlpy
镯	qlqj
鐲	qlqj
锣	qlqy
鏩	qlrh
釛	qlt
鏤	qlvg
鎅	qlwj
镙	qlxi
鏍	qlxi
鑼	qlxy
錪	qmaw
鈠	qmcy
錌	qmdf
鍴	qmdj
奂	qmdu
鉠	qmdy
鏰	qmee
镚	qmee
觰	qmfj
錭	qmfk
觴	qmfr
铀	qmg
鈾	qmg
铜	qmgk
銅	qmgk
鎧	qmgu
铡	qmjh
鍘	qmjh
铅	qmkg
鉛	qmkg
銏	qmmg
銟	qmmh
釠	qmn
鍋	qmnk
铠	qmnn
鐹	qmnp
钢	qmqy
鎽	qmth
负	qmu
負	qmu
鋼	qmum
奐	qmwd
鑴	qmwk
烉	qmwo
夐	qmwt
敻	qmwt
钠	qmwy
鈉	qmwy
鏙	qmwy
钡	qmy
鋇	qmy
钒	qmyy
釩	qmyy
馍	qnad
馑	qnag
鍲	qnaj
鈱	qnan
饶	qnaq
馓	qnat
饣	qnb
饵	qnbg
饳	qnbm
饴	qnck
馂	qnct
锯	qndg
鋸	qndg
馁	qnev
饽	qnfb
馌	qnfl
邬	qngb
乌	qngd
馕	qnge
馎	qngf
鉰	qngk
饨	qngn
饾	qngu
饯	qngy
鍜	qnhc
钮	qnhf
鈕	qnhf
鏘	qnhf
镅	qnhg
鎇	qnhg
鍏	qnhh
钃	qnij
馒	qnjc
刨	qnjh
馃	qnjs
馄	qnjx
蚀	qnjy
馈	qnkm
鐴	qnku
馉	qnme
饥	qnmn
钇	qnn
钆	qnn
釓	qnn
釔	qnn
釲	qnn
饲	qnnk
锔	qnnk
鋦	qnnk
饧	qnnr
馔	qnnw
鐉	qnnw
炰	qnou
馆	qnpn
馏	qnql
饱	qnqn
馋	qnqu
馅	qnqv
饮	qnqw
饭	qnrc
饩	qnrn
钖	qnrt
馇	qnsg
饤	qnsh
饦	qnta
饫	qntd
饪	qntf
饰	qnth
饷	qntk
饹	qntk
饬	qntl
铋	qntt
鉍	qntt
饿	qnty
䥽	qnty
饼	qnua
馐	qnuf
饺	qnuq
包	qnv
馊	qnvc
鏐	qnwe
镠	qnwe
饸	qnwk
馀	qnwt
鈌	qnwy
鑃	qnwy
铌	qnxn
鈮	qnxn
鈊	qny
饻	qnye
鉯	qnyw
鈬	qnyy
鱯	qoac
魽	qoaf
鰹	qoaf
魟	qoag
鰙	qoak
鰸	qoak
鰳	qoal
鮔	qoan
鰈	qoas
鰋	qoav
鯕	qoaw
鱑	qoaw
鱴	qoay
鱹	qoay
鯫	qobc
鯭	qobl
鮿	qobn
鑁	qobt
魣	qocb
鯒	qoce
鯵	qoce
鰺	qoce
鰠	qocj
鮐	qock
鱊	qock
鰇	qocs
鮻	qoct
鰢	qocy
鮁	qodc
鮪	qode
鰖	qode
鰗	qode
鮕	qodg
鮖	qodg
爒	qodi
鮞	qodj
鰆	qodj
魷	qodn
鮬	qodn
鱤	qodn
鱖	qodw
鯎	qody
鰄	qody
鰔	qody
鱱	qody
鰀	qoec
鰩	qoem
鱁	qoep
鱫	qoet
鮾	qoev
魥	qoey
魼	qofc
鮭	qoff
鯥	qoff
鯐	qofh
鮇	qofi
鯺	qofj
鰭	qofj
鱬	qofj
鮚	qofk
鱚	qofk
鰪	qofl
鱩	qofl
鱝	qofm
鮳	qofn
魭	qofq
鱙	qofq
鯪	qoft
鱈	qofv
鮱	qofx
鯄	qofy
鯖	qoge
鑆	qogf
鱄	qogf
魱	qogg
魾	qogg
魳	qogh
鮃	qogh
鯟	qogi
鰊	qogi
鯻	qogj
鰽	qogj
鯃	qogk
鱷	qogk
鰏	qogl
鰿	qogm
魨	qogn
鯁	qogq
鮧	qogw
鱺	qogx
镤	qogy
鏷	qogy
鯆	qogy
鮍	qohc
鯡	qohd
鱋	qohg
鮛	qohi
鮎	qohk
鱸	qohl
鯱	qohm
鰬	qohy
鱥	qohy
匊	qoi
灳	qoi
鮹	qoie
鱨	qoij
魦	qoit
鯋	qoit
鰻	qojc
魯	qojf
鯉	qojf
鰣	qojf
鯹	qojg
魝	qojh
鯷	qojh
鯧	qojj
鱪	qojj
鰛	qojl
鰨	qojn
鯣	qojr
鰑	qojr
鯤	qojx
鰅	qojy
鱓	qokf
鰐	qokn
鱢	qoks
鯝	qold
鰃	qole
鱞	qole
魻	qolh
鰥	qoli
鱰	qolj
鮰	qolk
鰮	qoll
鰓	qoln
鰱	qolp
鮂	qolw
鱡	qomd
鮋	qomg
鰂	qomj
鮦	qomk
鯛	qomk
鰴	qomt
鱧	qomu
魶	qomw
鰕	qonc
鱂	qonf
鮙	qong
鯴	qonj
魢	qonn
鰼	qonr
鮅	qont
鱗	qooh
鐒	qool
鑅	qoos
锬	qooy
錟	qooy
鰘	qopf
鰚	qopg
鰰	qoph
鯮	qopi
鰫	qopk
鯶	qopl
魫	qopq
鯇	qopq
鮟	qopv
鮀	qopx
鮠	qoqb
鮣	qoqb
鱌	qoqe
鏻	qoqh
鯑	qoqh
鮡	qoqi
鮈	qoqk
鰡	qoql
鮑	qoqn
鱻	qoqo
鮸	qoqq
魩	qoqr
鯼	qoqt
魡	qoqy
魬	qorc
鮊	qorg
鰉	qorg
鮢	qori
鰁	qori
鯯	qorj
鮜	qork
鱳	qors
鯂	qosg
鰾	qosi
鱏	qosj
魺	qosk
鯠	qosw
魠	qota
鯚	qotb
鮓	qotf
鮏	qotg
鯀	qoti
鯏	qotj
鮥	qotk
鯌	qotk
鯦	qotk
鱎	qotk
鱕	qotl
魸	qotn
魹	qotn
鰍	qoto
鯅	qotp
鯓	qott
鰒	qott
鮗	qotu
鯘	qotv
穌	qoty
魞	qoty
鱵	qoty
炙	qou
魚	qou
鮩	qoua
鮮	qoud
鱶	qoue
鱃	qouf
鱒	qouf
鰌	qoug
鱆	qouj
鱛	qouj
鱔	qouk
鰜	qouo
鮫	qouq
鮵	qouq
鮷	qout
鯜	qouv
鰦	qoux
鰟	qouy
鯽	qovb
鮼	qovc
鱘	qovf
镂	qovg
鯞	qovh
鱐	qovj
鮉	qovk
鮶	qovk
鯔	qovl
鱲	qovn
鰎	qovp
鯢	qovq
魛	qovt
鱮	qovw
鮘	qowa
鯩	qowa
魿	qowc
鱍	qowc
鮲	qowd
鯸	qowd
鮒	qowf
鰤	qowh
鰶	qowi
魪	qowj
鱠	qowj
鮯	qowk
鯰	qown
鰞	qowo
鵴	qowo
鷠	qowo
鯾	qowq
鮴	qows
鰷	qows
鮽	qowt
魵	qowv
魤	qowx
魜	qowy
鱜	qoxb
鱦	qoxg
鮄	qoxj
鮨	qoxj
鰯	qoxu
魮	qoxx
钬	qoy
鈥	qoy
銤	qoy
鯿	qoya
鯙	qoyb
鱣	qoyg
鱅	qoyh
鯨	qoyi
鱇	qoyi
鱭	qoyj
鰝	qoyk
魧	qoym
魲	qoyn
鯍	qoyq
魴	qoyt
鯲	qoyu
鮌	qoyx
魰	qoyy
鯳	qoyy
鑧	qpay
鋐	qpdc
鎋	qpdk
镓	qpey
鎵	qpey
鑳	qpfh
錝	qpfi
鋎	qpfq
鍹	qpgg
锭	qpgh
錠	qpgh
鑌	qpgm
夤	qpgw
鏔	qpgw
錧	qphn
鍕	qplh
鑏	qpns
鋺	qpqb
鈂	qpqn
镔	qprw
铵	qpvg
銨	qpvg
镩	qpwh
镲	qpwi
鑔	qpwi
鏥	qpwj
鎔	qpwk
镕	qpwk
鑹	qpwn
铊	qpxn
鉈	qpxn
鎺	qpyg
錉	qqaj
銽	qqak
胷	qqbe
卶	qqbh
匈	qqbk
鍐	qqbt
铯	qqcn
銫	qqcn
钩	qqcy
鈎	qqcy
爼	qqeg
夡	qqfk
鍂	qqg
镥	qqgj
匁	qqi
匇	qqi
铄	qqiy
铫	qqiy
鉨	qqiy
銚	qqiy
銁	qqjg
鐌	qqke
铭	qqkg
鉤	qqkg
銘	qqkg
鋔	qqkq
鑱	qqky
镵	qqky
钨	qqng
翗	qqng
鉋	qqnn
铇	qqnn
鑥	qqoj
迻	qqpi
鑫	qqqf
夠	qqqk
金	qqqq
鉹	qqqy
鋾	qqrm
锪	qqrn
鍃	qqrn
鍯	qqrn
鎩	qqsc
铩	qqsy
铆	qqtb
鉚	qqtb
多	qqu
爻	qqu
钧	qqug
鈞	qqug
憌	qqun
郺	qqvc
錎	qqvg
铮	qqvh
錚	qqvh
钦	qqwy
欽	qqwy
釸	qqy
鍧	qqyg
镏	qqyl
鎦	qqyl
钓	qqyy
釣	qqyy
钣	qrcy
鈑	qrcy
鈲	qrcy
勿	qre
甮	qrej
鍎	qrfh
锧	qrfm
铂	qrg
鉑	qrg
鍠	qrgg
锽	qrgg
銗	qrgk
鋲	qrgw
釿	qrh
鈝	qrhh
釽	qrhy
铢	qriy
銖	qriy
曶	qrjf
刎	qrjh
锦	qrmh
錦	qrmh
匋	qrmk
遙	qrmp
鎎	qrno
忽	qrnu
锨	qrqw
鍁	qrqw
鑕	qrrm
錍	qrtf
铁	qrwy
鉄	qrwy
鑠	qrxs
匆	qryi
怱	qryn
弑	qsaa
镖	qsfi
鏢	qsfi
钵	qsgg
鉢	qsgg
钉	qsh
釘	qsh
刹	qsjh
镡	qsjh
鐔	qsjh
钶	qskg
鈳	qskg
鎶	qskk
殺	qsmc
錰	qsoy
鑻	qsqr
杀	qsu
閷	qsuw
錸	qsww
鈢	qsy
弒	qsya
剎	qsyj
鉥	qsyy
獲	qtac
狨	qtad
獏	qtad
獴	qtae
猎	qtaj
猫	qtal
獦	qtan
玂	qtar
犽	qtat
猉	qtaw
獚	qtaw
獾	qtay
狘	qtay
卯	qtbh
狲	qtbi
猻	qtbi
猛	qtbl
犯	qtbn
乮	qtbn
犼	qtbn
鉇	qtbn
犸	qtcg
獝	qtck
狁	qtcq
猱	qtcs
狻	qtct
獁	qtcy
猰	qtdd
猢	qtde
狵	qtde
狜	qtdg
銛	qtdg
铦	qtdg
锋	qtdh
鋒	qtdh
獠	qtdi
獂	qtdi
鑙	qtdj
猗	qtdk
鐈	qtdk
犹	qtdn
懖	qtdn
鏠	qtdp
獉	qtdt
獶	qtdt
獿	qtdt
獗	qtdw
狹	qtdw
犾	qtdy
鉃	qtdy
犭	qte
猨	qtec
狙	qteg
猙	qteh
猺	qtem
锈	qtet
銹	qtet
铥	qtfc
銩	qtfc
猿	qtfe
锤	qtfg
鈓	qtfg
錘	qtfg
钎	qtfh
犴	qtfh
釺	qtfh
狋	qtfi
猪	qtfj
獳	qtfj
锆	qtfk
狤	qtfk
鋯	qtfk
獖	qtfm
鑽	qtfm
铤	qtfp
鋌	qtfp
铣	qtfq
獟	qtfq
銑	qtfq
橥	qtfs
犲	qtft
锸	qtfv
鍤	qtfv
狫	qtfx
猜	qtge
锺	qtgf
猼	qtgf
鍾	qtgf
狂	qtgg
夝	qtgg
狉	qtgg
狟	qtgg
鉎	qtgg
犻	qtgh
鏼	qtgi
獭	qtgm
獺	qtgm
钅	qtgn
鑂	qtgo
鵟	qtgo
逛	qtgp
獮	qtgq
獓	qtgt
狭	qtgw
狓	qthc
玃	qthc
猅	qthd
鈼	qthf
獹	qthl
猇	qthm
鎴	qthn
鋋	qthp
镍	qths
鎳	qths
獩	qthy
猟	qtih
猀	qtit
獌	qtjc
狸	qtjf
猂	qtjf
猩	qtjg
狚	qtjg
狮	qtjh
鋓	qtjh
猖	qtjj
猲	qtjn
猓	qtjs
鏫	qtjs
鍑	qtjt
猑	qtjx
独	qtjy
狷	qtke
铬	qtkg
鉻	qtkg
狆	qtkh
玁	qtkt
猥	qtle
猬	qtle
獧	qtle
狎	qtlh
獨	qtlj
鏓	qtln
猡	qtlq
獑	qtlr
鎞	qtlx
玀	qtly
鐭	qtmd
猾	qtme
狦	qtmf
鉓	qtmh
猦	qtmj
猯	qtmj
匔	qtmk
狪	qtmk
猧	qtmk
銄	qtmk
鋵	qtmn
銵	qtmt
鎫	qtmt
猠	qtmw
匑	qtmx
狈	qtmy
狽	qtmy
獕	qtmy
儿	qtn
勹	qtn
猳	qtnc
狃	qtnf
猸	qtnh
峱	qtnm
釳	qtnn
狔	qtnx
夕	qtny
獜	qtoh
鐇	qtol
悐	qton
鏭	qton
逖	qtop
狄	qtoy
锹	qtoy
獛	qtoy
鍬	qtoy
狩	qtpf
猔	qtpi
獱	qtpm
狞	qtps
獰	qtps
猽	qtpu
狖	qtpw
狰	qtqh
獬	qtqh
狶	qtqh
狝	qtqi
狣	qtqi
鑗	qtqi
狥	qtqj
狗	qtqk
狍	qtqn
猣	qtqt
犳	qtqy
猈	qtrf
獆	qtrf
獔	qtrf
狛	qtrg
猘	qtrj
狾	qtrr
獥	qtrt
狐	qtry
锇	qtry
鋨	qtry
猹	qtsg
猍	qtsw
狇	qtsy
狏	qttb
狧	qttd
狅	qttf
獋	qttf
狌	qttg
猁	qttj
狢	qttk
獢	qttk
犵	qttn
獯	qtto
狿	qttp
獇	qtuc
獞	qtuf
猶	qtug
獐	qtuj
獈	qtul
猐	qtun
狡	qtuq
獍	qtuq
獙	qtut
鉖	qtuy
卿	qtvb
獀	qtvc
狠	qtve
錗	qtvg
犰	qtvn
獵	qtvn
獡	qtvo
猊	qtvq
犱	qtvy
狯	qtwc
狑	qtwc
猴	qtwd
猤	qtwd
獅	qtwh
鏦	qtwh
猃	qtwi
獪	qtwj
猞	qtwk
獊	qtwk
狳	qtwt
獫	qtww
猚	qtwy
猭	qtxe
狴	qtxf
猕	qtxi
狒	qtxj
狕	qtxl
獼	qtxq
鋂	qtxy
乂	qty
鉌	qty
猵	qtya
狱	qtyd
獄	qtyd
狼	qtye
猏	qtye
獽	qtye
猝	qtyf
狺	qtyg
釒	qtyg
犿	qtyh
猄	qtyi
犺	qtym
鸑	qtyo
犷	qtyt
獤	qtyt
獷	qtyw
釞	qtyy
鉼	quah
鎙	qube
匀	qud
鎈	quda
锩	qudb
錈	qudb
鐥	qudk
䦅	qudk
錓	qudn
鎹	qudp
鑨	qued
鐗	queg
鎆	quej
鐩	quep
钭	qufh
斘	qufh
鈄	qufh
鉡	qufh
鉝	qug
鍆	qug
锎	quga
鐦	quga
镁	qugd
鎂	qugd
镧	qugi
鑭	qugi
锌	quh
鋅	quh
鐘	qujf
锏	qujg
鐧	qujg
鏱	qujh
镱	qujn
鐿	qujn
镜	qujq
鏡	qujq
锫	qukg
錇	qukg
锐	qukq
鋭	qukq
鏳	qulj
镝	qumd
鏑	qumd
钔	qun
镨	quoj
鐠	quoj
鍗	quph
镑	qupy
鎊	qupy
锵	quqf
铰	quqy
鉸	quqy
鐏	qusf
鏟	qutg
铲	qutt
鎌	quvo
镒	quwl
鎰	quwl
鉳	quxn
锑	quxt
銻	quxt
鎡	quxx
镃	quxx
鐞	qvaf
邹	qvbh
匓	qvcc
银	qvey
銀	qvey
刍	qvf
臽	qvf
銉	qvfh
鏽	qvfj
键	qvfp
鍵	qvfp
钕	qvg
釹	qvg
皱	qvhc
锼	qvhc
鎪	qvhc
争	qvhj
録	qviy
鏁	qvjs
铷	qvkg
鉊	qvkg
銣	qvkg
锱	qvlg
錙	qvlg
鑞	qvln
镴	qvln
鎻	qvmy
釚	qvn
急	qvnu
燄	qvoo
锓	qvpc
鋟	qvpc
鹐	qvqg
欿	qvqw
釖	qvt
煞	qvto
勼	qvv
鵮	qvwo
雏	qvwy
釰	qvyy
釻	qvyy
釼	qvyy
鎓	qwcn
鈆	qwcy
锻	qwdc
鍛	qwdc
鉁	qwet
鉜	qwfy
錀	qwga
鑰	qwga
鍨	qwgd
铨	qwgg
銓	qwgg
鍮	qwgj
铪	qwgk
匌	qwgk
鉿	qwgk
镎	qwgr
鎿	qwgr
镫	qwgu
鐙	qwgu
鐱	qwgw
鎀	qwhe
鏅	qwhe
勽	qwi
鉩	qwiy
銳	qwkq
鍭	qwnd
鎢	qwno
鎚	qwnp
匃	qwnv
銝	qwsy
銋	qwtf
欠	qwu
鵭	qwvo
鈖	qwvt
锉	qwwf
銼	qwwf
鑯	qwwg
鋊	qwwk
鏺	qwxc
铧	qwxf
鈋	qwxn
釟	qwy
铃	qwyc
鈴	qwyc
镌	qwye
飧	qwye
鎸	qwye
鎨	qwyf
锥	qwyg
錐	qwyg
鋡	qwyk
鎗	qwyk
鐫	qwym
钤	qwyn
鈐	qwyn
錜	qwyn
鐎	qwyo
鏶	qwys
鐑	qxfk
鏆	qxfm
錄	qxgi
鈏	qxhh
鈟	qxhh
鎭	qxhw
銯	qxiy
鉘	qxjh
镄	qxjm
鐨	qxjm
镪	qxkj
鏹	qxkj
匂	qxv
鈚	qxxn
锴	qxxr
鍇	qxxr
鐖	qxxy
鉧	qxyy
镀	qyac
鍍	qyac
鏣	qyao
鑛	qyaw
錞	qybg
镦	qybt
鐓	qybt
錥	qyce
铳	qycq
锍	qycq
銃	qycq
鋶	qycq
鉱	qycy
訇	qyd
铱	qyey
锿	qyey
銥	qyey
鎄	qyey
鉒	qygg
久	qyi
勺	qyi
夊	qyi
鍄	qyiy
鑇	qyjg
镶	qyke
鑲	qyke
铈	qymh
鈰	qymh
镐	qymk
鎬	qymk
钪	qymn
鈧	qymn
鍽	qyna
鹱	qync
錑	qynd
袅	qyne
鸟	qyng
岛	qynm
凫	qynm
釯	qynn
䥇	qynn
䦂	qynn
镳	qyno
鑣	qyno
枭	qyns
鈩	qynt
匄	qynv
鸵	qynx
鏕	qynx
麁	qynx
灸	qyou
粂	qyou
钫	qyt
鈁	qyt
孵	qytb
鍦	qytb
毈	qytc
镞	qytd
鏃	qytd
镟	qyth
銂	qyth
鏇	qyth
贕	qytm
邎	qytp
卵	qyty
镰	qyuo
鐮	qyuo
鄮	qyvb
鎯	qyvb
锒	qyve
鋃	qyve
鹠	qyvg
镛	qyvh
鏞	qyvh
鏮	qyvi
劉	qyvj
鎕	qyvk
留	qyvl
贸	qyvm
貿	qyvm
鶹	qyvo
遛	qyvp
斵	qyvr
錊	qywf
鏲	qyxh
铉	qyxy
鉉	qyxy
鈫	qyy
拭	raag
擛	raas
皂	rab
搑	rabg
掿	radk
揕	radn
撕	radr
掑	radw
撒	raet
拑	rafg
擆	rafj
扛	rag
撶	ragf
皣	ragf
捓	rahb
摼	rahf
挋	rahh
攬	rahq
擓	raiy
摸	rajd
措	rajg
擖	rajn
揠	rajv
掝	rakg
摳	rakk
擹	rakw
攤	raky
描	ralg
撗	ramw
摃	ramy
拒	rang
抴	rann
揲	rans
拣	ranw
捞	rapl
摕	raqh
撍	raqj
擏	raqt
抠	raqy
挠	ratq
擭	rawc
攃	rawi
搭	rawk
搽	raws
拱	rawy
找	ray
攝	rbbb
揶	rbbh
摄	rbcc
报	rbcy
掫	rbcy
撱	rbde
挕	rbg
邤	rbh
拯	rbig
摂	rbiy
掹	rblg
拙	rbmh
扡	rbn
搎	rbti
拚	rcah
抒	rcbh
揉	rcbs
掇	rccc
摻	rcce
撡	rccn
搡	rccs
㧐	rccy
掺	rcde
撪	rcdl
捅	rceh
择	rcfh
反	rci
掻	rcjy
抬	rckg
把	rcn
皅	rcn
返	rcpi
抁	rcqn
挨	rctd
捘	rcwt
摊	rcwy
払	rcy
瓜	rcyi
搔	rcyj
瓥	rcyj
瓟	rcyn
瓞	rcyw
扠	rcyy
瓝	rcyy
扼	rdbn
拔	rdcy
抜	rdcy
擾	rdet
掁	rdey
捹	rdfa
振	rdfe
捱	rdff
搙	rdff
拜	rdfh
拝	rdfh
捺	rdfi
皋	rdfj
撦	rdfj
挎	rdfn
翱	rdfn
鷎	rdfo
摦	rdfy
拓	rdg
撼	rdgn
揻	rdgy
搣	rdgy
拵	rdhb
揳	rdhd
摵	rdhy
揼	rdiy
擫	rdjd
掩	rdjn
抪	rdmh
颀	rdmy
頎	rdmy
拋	rdnl
扰	rdnn
拻	rdoy
挞	rdpy
摤	rdqq
掎	rdsk
挷	rdtb
攊	rdth
撩	rdui
撅	rduw
揍	rdwd
捧	rdwh
搸	rdwt
摏	rdwv
挾	rdww
拢	rdxt
扙	rdyy
捊	rebg
掤	reeg
揺	refb
援	refc
捋	refy
抈	reg
抯	regg
拥	reh
覛	rehq
皭	relf
授	repc
皧	rept
摇	rerm
挅	resy
採	resy
扔	ret
撝	reto
挼	revg
搯	revg
掙	revh
扱	reyy
擮	rfay
搕	rfcl
技	rfcy
抎	rfcy
抾	rfcy
擩	rfdj
挂	rffg
掛	rffh
摴	rffn
撓	rffq
皢	rffq
持	rffy
扗	rfg
扞	rfh
瞂	rfhc
盾	rfhd
攧	rfhm
鶞	rfho
遁	rfhp
搷	rfhw
抺	rfiy
捄	rfiy
皁	rfj
撠	rfja
擀	rfjf
搆	rfjf
擡	rfkf
拮	rfkg
撷	rfkm
擷	rfkm
擂	rflg
擜	rfmd
揇	rfmf
乕	rfmh
质	rfmi
貭	rfmi
逓	rfmp
擣	rfnf
扝	rfnn
抟	rfny
捇	rfoy
挬	rfpb
撎	rfpu
挝	rfpy
抚	rfqn
抏	rfqn
搘	rftj
拷	rftn
撻	rfup
撵	rfwl
攆	rfwl
攅	rfwm
摫	rfwq
掕	rfwt
扶	rfwy
攉	rfwy
皬	rfwy
挵	rgah
邱	rgbh
扽	rgbn
卮	rgbv
挃	rgcf
捯	rgcj
巵	rgcv
丘	rgd
掭	rgdn
搏	rgef
掅	rgeg
皘	rgeg
捕	rgey
皇	rgf
掗	rgfg
扜	rgfh
抂	rgg
扌	rghg
抷	rgig
皝	rgiq
抔	rgiy
摶	rgjf
挭	rgjq
皩	rgjq
郈	rgkb
后	rgkd
攮	rgke
垕	rgkf
捂	rgkg
搹	rgkh
捒	rgki
揦	rgkj
劶	rgkl
揊	rgkl
攋	rgkm
逅	rgkp
摗	rgkw
揀	rgli
拺	rgmi
岳	rgmj
抦	rgmw
攦	rgmx
掚	rgmy
皟	rgmy
屔	rgnx
挜	rgog
搢	rgoj
遑	rgpd
挒	rgqj
扤	rgqn
抹	rgsy
皌	rgsy
乒	rgtr
抨	rguh
挟	rguw
挳	rgva
捷	rgvh
捿	rgvv
擟	rgwq
兵	rgwu
挗	rgxw
乓	rgyu
據	rhae
摣	rhag
䴘	rhag
摢	rhah
掳	rhal
擄	rhal
攎	rhal
虒	rham
摅	rhan
攄	rhan
鷉	rhao
遞	rhap
歋	rhaw
卸	rhbh
披	rhcy
排	rhdd
掯	rheg
看	rhf
年	rhfk
鵇	rhfo
扯	rhg
挊	rhgh
攫	rhhc
拤	rhhy
掓	rhic
捗	rhit
掉	rhjh
牛	rhk
吿	rhkf
拈	rhkg
揁	rhmy
挸	rhqn
欫	rhqw
犇	rhth
皉	rhxn
扑	rhy
爬	rhyc
坕	rhyf
爪	rhyi
爮	rhyn
㧟	rian
邾	ribh
捎	rieg
皐	rifj
翶	rifn
朱	rii
挱	riit
摚	ripf
擋	ripl
攩	ripo
搅	ripq
撹	ripq
撑	ripr
撐	ript
挄	riqn
灥	riri
楽	risu
挘	ritl
毮	ritn
抄	ritt
泉	riu
挡	rivg
鴸	riwo
鼄	rixf
撮	rjbc
擝	rjel
捏	rjfg
捚	rjfg
捍	rjfh
皔	rjfh
抇	rjg
担	rjgg
提	rjgh
揚	rjgr
捑	rjgy
捜	rjhc
抻	rjhh
摱	rjlc
揾	rjlg
搨	rjng
拽	rjnt
揭	rjqn
掦	rjqr
掲	rjqx
捰	rjsy
揽	rjtq
掍	rjxx
撔	rjyi
揖	rkbg
擑	rkby
挹	rkcn
捐	rkeg
扣	rkg
挰	rkgg
撌	rkhm
捉	rkhy
撣	rkkf
捛	rkkg
操	rkks
捌	rklj
拐	rklt
损	rkmy
損	rkmy
拀	rkqn
抧	rkwy
摑	rlag
擺	rlcx
摁	rldn
畠	rlf
摆	rlfc
擇	rlff
搟	rlfh
鄦	rlgb
擐	rlge
揋	rlge
舞	rlgh
無	rlgo
鷡	rlgo
橆	rlgs
掴	rlgy
甒	rlgy
押	rlh
捙	rlh
拁	rlkg
搚	rlle
攌	rlle
拹	rlll
攂	rlll
揌	rlny
摙	rlpy
擉	rlqj
斶	rlqj
摲	rlrh
捆	rlsy
劤	rlt
劧	rlt
劰	rlt
扐	rlt
撂	rltk
摟	rlvg
擻	rlvt
搵	rlwl
摞	rlxi
攞	rlxy
擃	rmae
缸	rmag
捵	rmaw
罐	rmay
缷	rmbh
投	rmcy
揣	rmdj
抰	rmdy
搰	rmeg
抩	rmfg
皗	rmfk
抽	rmg
挏	rmgk
皚	rmgu
缻	rmgy
製	rmhe
罅	rmhh
緜	rmhi
制	rmhj
帛	rmhj
罏	rmhl
掣	rmhr
罉	rmir
罎	rmjc
缶	rmk
罁	rmmm
撄	rmmv
攖	rmmv
皑	rmnn
撾	rmnp
缺	rmnw
缹	rmou
罀	rmqi
缼	rmqw
㧏	rmqy
缿	rmrk
缽	rmsg
罈	rmsj
挆	rmsy
缾	rmua
罇	rmuf
掆	rmum
攜	rmwk
摧	rmwy
抐	rmwy
皠	rmwy
罆	rmxm
搌	rnae
抿	rnan
气	rnb
掘	rnbm
撖	rnbt
氢	rnca
戶	rnd
据	rndg
氪	rndq
氖	rner
扟	rnfh
挧	rng
氫	rnga
氰	rnge
握	rngf
氩	rngg
揯	rngg
搄	rngg
氬	rngg
氭	rngi
氞	rngw
揟	rnhe
扭	rnhf
摪	rnhf
摨	rnih
氜	rnjf
刏	rnjh
氠	rnjh
氘	rnjj
氲	rnjl
氱	rnjr
氚	rnkj
擗	rnku
氤	rnld
氳	rnll
氙	rnmj
氝	rnmw
扎	rnn
癿	rnn
挶	rnnk
忥	rnnu
撰	rnnw
氮	rnoo
氣	rnou
氨	rnpv
気	rnqu
摺	rnrg
所	rnrh
乺	rnrn
扬	rnrt
氥	rnsf
捤	rntn
氕	rntr
氡	rntu
拨	rnty
摒	rnua
氧	rnud
搱	rnuh
氯	rnvi
摎	rnwe
氛	rnwv
抉	rnwy
擢	rnwy
紥	rnxi
氟	rnxj
抳	rnxn
抋	rny
拟	rnyw
氦	rnyw
択	rnyy
擈	rogw
撲	rogy
攚	rook
撈	rool
掞	rooy
撛	roqh
搂	rovg
擞	rovt
迫	rpd
廹	rpd
搳	rpdk
攇	rpdn
攐	rpfe
攓	rpfh
皖	rpfq
捖	rpfq
揎	rpgg
掟	rpgh
擯	rpgm
捾	rphn
近	rpk
挥	rplh
揮	rplh
抭	rpmn
擰	rpns
捥	rpqb
抌	rpqn
摈	rprw
拧	rpsh
挓	rpta
揢	rptk
按	rpvg
控	rpwa
揬	rpwd
搾	rpwf
撺	rpwh
擦	rpwi
摍	rpwj
搈	rpwk
挖	rpwn
攛	rpwn
摉	rpwq
探	rpws
搉	rpwy
搲	rpwy
攨	rpwy
拕	rpxn
捪	rqaj
扺	rqan
搩	rqas
抵	rqay
皃	rqb
抑	rqbh
搊	rqbt
魑	rqcc
魃	rqcc
鬾	rqcc
魈	rqce
鬽	rqce
魁	rqcf
魓	rqcf
魊	rqcg
魖	rqcg
鬼	rqci
魅	rqci
魒	rqci
魀	rqcj
魍	rqcn
魐	rqco
鬿	rqcr
魉	rqcw
魌	rqcw
抅	rqcy
魆	rqcy
魋	rqcy
魎	rqcy
魕	rqcy
撚	rqdo
擔	rqdy
捔	rqeh
捦	rqg
撸	rqgj
挑	rqiy
拘	rqkg
挽	rqkq
搀	rqku
攙	rqky
换	rqmd
換	rqmd
抱	rqnn
兜	rqnq
擼	rqoj
掬	rqoy
揿	rqqw
撳	rqqw
拸	rqqy
掏	rqrm
搖	rqrm
揔	rqrn
摋	rqsc
抣	rqug
掐	rqvg
挣	rqvh
欣	rqwy
扻	rqwy
揈	rqyg
捣	rqym
的	rqyy
扚	rqyy
鋬	rrcq
扳	rrcy
皈	rrcy
皞	rrdf
硩	rrdf
挀	rrey
埑	rrff
揗	rrfh
拍	rrg
拞	rrgg
揘	rrgg
捳	rrgm
捠	rrgw
折	rrh
抙	rrh
斦	rrh
搋	rrhm
擨	rrhw
抓	rrhy
皡	rrif
晢	rrjf
蜇	rrju
哲	rrkf
啠	rrkf
踅	rrkh
撫	rrlo
劕	rrmj
質	rrmu
乴	rrnb
悊	rrnu
烲	rrou
焎	rrou
逝	rrpk
魄	rrqc
銴	rrqf
掀	rrqw
皛	rrrf
皨	rrrf
掱	rrrj
白	rrrr
梊	rrsu
捭	rrtf
娎	rrvf
抶	rrwy
擽	rrxs
皪	rrxs
裚	rrye
誓	rryf
撽	rryt
皦	rryt
拆	rryy
摽	rsfi
拪	rsg
打	rsh
揸	rsjg
撢	rsjh
抲	rskg
搮	rssy
抍	rtah
托	rtan
扥	rtan
拖	rtbn
逰	rtbp
括	rtdg
捀	rtdh
挢	rtdj
撟	rtdk
摓	rtdp
擌	rtdw
扷	rtdy
搬	rtec
郫	rtfb
捶	rtfg
鹎	rtfg
扦	rtfh
卑	rtfj
皓	rtfk
捁	rtfk
攒	rtfm
攢	rtfm
撬	rtfn
鵯	rtfo
挺	rtfp
插	rtfv
揷	rtfv
揰	rtgf
手	rtgh
挿	rtgh
搝	rthd
拃	rthf
皥	rthf
攥	rthi
擤	rthj
揝	rthj
扸	rthn
挻	rthp
摥	rtjr
挌	rtkg
摠	rtln
擙	rtmd
拠	rtmn
扢	rtnn
播	rtol
皤	rtol
揪	rtoy
抸	rtpy
皒	rtry
斤	rtth
擶	rtuj
擳	rtvb
捼	rtvg
摐	rtwh
撘	rtwk
挴	rtxy
敀	rty
扖	rtyy
拼	ruah
皏	ruah
搠	rube
搓	ruda
掷	rudb
捲	rudb
攁	rude
撯	rudh
搼	rudr
攏	rued
撊	rueg
揃	ruej
拦	rufg
抖	rufh
拌	rufh
拉	rug
捫	rug
撋	rugg
攔	rugi
撞	rujf
掸	rujf
揞	rujg
摬	rujq
掊	rukg
搃	rukn
捝	rukq
摘	rumd
擿	rump
撇	rumt
扪	run
掽	ruog
揥	ruph
搒	rupy
皎	ruqy
挍	ruqy
擲	rusb
撙	rusf
揂	rusg
摌	rutg
搁	rutk
擱	rutk
接	ruvg
搛	ruvo
搤	ruwl
揹	ruxe
兠	ruxq
挮	ruxt
撏	rvaf
揑	rvag
揤	rvcb
摡	rvcq
拫	rvey
挪	rvfb
揵	rvfp
挦	rvfy
扫	rvg
攑	rvgh
搜	rvhc
捸	rviy
摷	rvjs
招	rvkg
擸	rvln
抛	rvlt
扏	rvn
殷	rvnc
慇	rvnn
掃	rvph
掜	rvqn
攪	rvqq
拶	rvqy
捃	rvtk
垫	rvyf
鸷	rvyg
絷	rvyi
蛰	rvyj
势	rvyl
贽	rvym
热	rvyo
挚	rvyr
执	rvyy
扨	rvyy
抢	rwbn
捴	rwcn
抮	rwet
摖	rwfi
捨	rwfk
拊	rwfy
掄	rwga
揜	rwga
掵	rwgb
揆	rwgd
拴	rwgg
捡	rwgi
揄	rwgj
拾	rwgk
搿	rwgr
撜	rwgu
撿	rwgw
失	rwi
扴	rwjh
挩	rwkq
劮	rwlt
摀	rwno
搥	rwnp
怣	rwnu
迭	rwpi
拰	rwtf
捈	rwty
摿	rwuj
扵	rwuy
搗	rwvm
掰	rwvr
扮	rwvt
挫	rwwf
攕	rwwg
鴩	rwwo
撥	rwxc
抡	rwxn
扒	rwy
擒	rwyc
拎	rwyc
皊	rwyc
㩳	rwyc
携	rwye
搇	rwye
推	rwyg
搶	rwyk
勧	rwyl
擕	rwym
捻	rwyn
扲	rwyn
撨	rwyo
観	rwyq
歓	rwyw
墍	rxaf
曁	rxag
旣	rxaq
槩	rxas
皀	rxb
卽	rxbh
皍	rxbj
攭	rxej
掾	rxey
掼	rxfm
摜	rxfm
指	rxjg
拂	rxjh
摾	rxkj
拗	rxlt
抝	rxnn
撧	rxqc
擬	rxth
搦	rxuu
批	rxxn
揩	rxxr
樂	rxxs
拇	rxyy
摭	ryao
擴	ryaw
摛	rybc
撴	rybt
攡	ryby
撤	ryct
拡	rycy
挔	ryey
拄	rygg
掂	ryhk
抃	ryhy
斥	ryi
掠	ryiy
擠	ryjg
挤	ryjh
攘	ryke
擅	rylg
搞	rymk
皜	rymk
抗	rymn
揙	ryna
捩	rynd
掮	ryne
搧	rynn
攗	ryno
皫	ryno
护	rynt
攈	rynt
攟	rynt
摝	rynx
攍	ryny
揨	ryps
掋	ryqy
攠	rysd
擵	rysr
扩	ryt
揓	rytb
鸄	ryto
邀	rytp
敫	ryty
譥	ryty
搪	ryvk
掶	ryvw
捬	rywf
捽	rywf
掖	rywy
摔	ryxf
撁	ryxh
搐	ryxl
擁	ryxy
抆	ryy
栻	saag
械	saah
櫙	saak
棧	saay
榵	sabg
栉	sabh
桏	sabh
樭	sadf
楛	sadg
櫀	sadi
楉	sadk
椹	sadn
棋	sadw
欌	sady
橵	saet
杢	saf
覊	safc
覇	safe
柑	safg
覉	safk
樲	safm
楳	safs
杠	sag
樺	sagf
框	sagg
橫	sagw
榧	sahd
樫	sahf
栕	sahh
檻	sahl
欖	sahq
枒	saht
欂	saif
栋	saiy
模	sajd
橗	saje
棤	sajg
椻	sajv
槿	sakg
棫	sakg
樞	sakk
櫃	sakm
欟	sakq
權	saky
櫣	salp
櫗	saly
楧	samd
横	samw
槓	samy
樠	samy
柜	sang
枻	sann
楪	sans
檬	sape
槆	saqj
橬	saqj
檧	saqn
枢	saqy
柩	saqy
樥	sath
桡	satq
欗	saui
櫹	savj
檴	sawc
﨓	sawf
櫒	sawi
榙	sawk
檋	sawl
櫵	sawo
欍	sawv
椛	sawx
栱	sawy
杙	say
欇	sbbb
椰	sbbh
棷	sbcy
椭	sbde
橢	sbde
李	sbf
杍	sbg
栮	sbg
樄	sbgi
邒	sbh
極	sbkg
檉	sbkg
柮	sbmh
杝	sbn
槂	sbti
櫲	scbe
壄	scbf
杼	scbh
橘	scbk
懋	scbn
楙	scbs
楺	scbs
柕	scbt
棳	sccc
槮	scce
槡	sccs
椮	scde
桳	scdf
桶	sceh
樋	scep
柽	scfg
树	scfy
杩	scg
枱	sckg
杷	scn
桙	scrh
梭	scwt
权	scy
榪	scy
杈	scyy
楕	sdae
檶	sdak
櫔	sday
枙	sdbn
柭	sdcy
栯	sdeg
楜	sdeg
櫌	sdet
棖	sdey
桭	sdfe
楏	sdff
槈	sdff
櫉	sdff
桍	sdfn
槬	sdfy
枯	sdg
柘	sdg
橱	sdgf
椷	sdgy
楲	sdgy
栫	sdhb
楔	sdhd
櫘	sdhn
榎	sdht
槥	sdhv
槭	sdhy
栢	sdjg
槗	sdkk
枥	sdlt
柨	sdmh
栭	sdmj
顶	sdmy
頂	sdmy
杤	sdnn
遷	sdnp
桟	sdny
樉	sdqq
榞	sdri
椅	sdsk
梆	sdtb
梼	sdtf
櫪	sdth
橭	sduh
橑	sdui
橛	sduw
楱	sdwd
棒	sdwh
椿	sdwj
榛	sdwt
樁	sdwv
梜	sdww
栊	sdxt
杕	sdy
枤	sdy
杖	sdyy
檼	sean
棴	sebc
桴	sebg
楹	secl
棚	seeg
楥	sefc
枂	seg
査	segf
柤	segg
橓	seph
櫾	seri
榣	serm
桗	sesy
棌	sesy
杉	set
橳	seul
桵	sevg
槄	sevg
榽	sexd
极	seyy
椓	seyy
欛	sfae
枿	sfah
橨	sfam
鄄	sfbh
榼	sfcl
枝	sfcy
枟	sfcy
檽	sfdj
垔	sff
橒	sffc
桂	sffg
樗	sffn
橈	sffq
杜	sfg
甄	sfgy
杆	sfh
植	sfhg
槙	sfhw
樾	sfhy
彯	sfie
隸	sfii
剽	sfij
飄	sfij
勡	sfil
顠	sfim
翲	sfin
飘	sfiq
票	sfiu
柰	sfiu
歀	sfiw
标	sfiy
瓢	sfiy
柡	sfiy
梂	sfiy
橶	sfja
榸	sfjf
構	sfjf
檊	sfjf
枾	sfjg
榬	sfke
樹	sfkf
檯	sfkf
桔	sfkg
橲	sfkk
櫺	sfkk
欞	sfkw
檑	sflg
櫝	sflm
楠	sfmf
椟	sfnd
檮	sfnf
杇	sfnn
梽	sfny
桲	sfpb
杬	sfqn
歅	sfqw
楮	sftj
榰	sftj
栲	sftn
材	sftt
栳	sftx
樯	sfuk
橽	sfup
樰	sfvg
檣	sfwk
櫕	sfwm
槻	sfwq
棱	sfwt
枎	sfwy
槸	sfwy
村	sfy
醆	sgaa
酣	sgaf
醛	sgag
枅	sgah
梇	sgah
醋	sgaj
醧	sgak
醼	sgao
酏	sgbn
杶	sgbn
醊	sgcc
醦	sgce
桎	sgcf
椡	sgcj
酸	sgct
本	sgd
酉	sgd
醐	sgde
酭	sgde
酤	sgdg
醢	sgdl
醃	sgdn
酞	sgdy
醎	sgdy
酻	sgeb
酹	sgef
榑	sgef
釂	sgef
棈	sgeg
酵	sgfb
酝	sgfc
醻	sgff
椏	sgfg
酐	sgfh
杅	sgfh
醏	sgfj
醹	sgfj
醽	sgfk
醘	sgfl
酛	sgfq
酜	sgfw
酎	sgfy
枉	sgg
酽	sggd
酑	sggf
醩	sggj
釃	sggx
酾	sggy
酺	sggy
丁	sgh
醵	sghe
西	sghg
柾	sghg
覀	sghg
酟	sghk
朩	sghy
柸	sgig
桮	sgik
杯	sgiy
槫	sgjf
醒	sgjg
桓	sgjg
醍	sgjh
棟	sgji
橊	sgjl
醖	sgjl
桺	sgjn
橞	sgjn
梗	sgjq
醌	sgjx
欜	sgke
梧	sgkg
酲	sgkg
槅	sgkh
梀	sgki
楋	sgkj
櫮	sgkk
楅	sgkl
櫴	sgkm
釅	sgkt
梪	sgku
樕	sgkw
醳	sglf
橿	sglg
楝	sgli
醞	sgll
酘	sgmc
醲	sgme
杮	sgmh
栜	sgmi
槽	sgmj
酮	sgmk
醠	sgml
醴	sgmu
柄	sgmw
欐	sgmx
樍	sgmy
醪	sgne
醑	sgne
翉	sgng
配	sgnn
朽	sgnn
酦	sgny
桠	sgog
榗	sgoj
醈	sgoo
醚	sgop
醭	sgoy
梾	sgoy
逎	sgpd
酧	sgpf
醡	sgpf
醓	sgpl
酖	sgpq
酡	sgpx
酗	sgqb
栵	sgqj
酩	sgqk
醄	sgqm
杌	sgqn
酌	sgqy
醜	sgrc
酊	sgsh
醥	sgsi
醰	sgsj
酠	sgsk
醂	sgss
枺	sgsy
酢	sgtf
酷	sgtk
酪	sgtk
酕	sgtn
醺	sgto
酰	sgtq
酶	sgty
酥	sgty
醝	sgua
醸	sgue
酙	sguf
枰	sguh
醅	sguk
醷	sgun
桱	sgva
醙	sgvc
酔	sgvf
醁	sgvi
棲	sgvv
醱	sgwc
酫	sgwg
醮	sgwo
檷	sgwq
醗	sgwq
酴	sgwt
酚	sgwv
醶	sgww
醀	sgwy
酳	sgxe
枑	sgxg
榡	sgxi
酯	sgxj
桋	sgxw
栈	sgy
醇	sgyb
醨	sgyc
釄	sgyd
酿	sgye
釀	sgye
醉	sgyf
酬	sgyh
醿	sgyi
醕	sgyj
醣	sgyk
醯	sgyl
醾	sgyo
酼	sgyq
樝	shag
櫨	shal
椃	sham
櫖	shan
榩	shay
櫇	shcm
柀	shcy
棑	shdd
檅	shdy
相	shg
杫	shg
桛	shgh
欔	shhc
欋	shhy
椒	shic
棹	shjh
槕	shjs
枮	shkg
樐	shlo
桢	shmy
楨	shmy
檙	shnn
栌	shnt
想	shnu
梘	shqn
椇	shwy
橴	shxi
朴	shy
梢	sieg
桫	siit
樘	sipf
檔	sipl
欓	sipo
橖	sips
橕	sipt
桄	siqn
杪	sitt
档	sivg
桜	sivg
樑	sivs
榉	siwh
﨔	siwr
樶	sjbc
杳	sjf
榯	sjff
梩	sjfg
桿	sjfh
皶	sjgc
查	sjgf
棏	sjgf
柦	sjgg
棩	sjgg
鸉	sjgo
楊	sjgr
柛	sjhh
榥	sjiq
覃	sjj
椙	sjjg
橸	sjjj
螙	sjju
槾	sjlc
榅	sjlg
榻	sjng
栧	sjnt
楬	sjqn
棵	sjsy
槛	sjtl
榄	sjtq
鷣	sjwo
棍	sjxx
楫	skbg
檝	skby
可	skd
梋	skeg
杏	skf
桯	skgg
枵	skgn
杊	skh
樻	skhm
樿	skkf
梠	skkg
梙	skkh
榀	skkk
楍	skkk
槵	skkn
橾	skks
欕	skkt
柺	sklt
柷	skqn
戨	sksa
哥	sksk
歌	sksw
枴	skvt
枳	skwy
槶	slag
棝	sldg
栶	sldy
檡	slff
柶	slg
椳	slge
檈	slge
檲	slgf
椢	slgy
柙	slh
檌	slhd
枷	slkg
欙	slli
栛	slll
櫑	slll
楒	slny
梿	slpy
槤	slpy
椤	slqy
梱	slsy
朸	slt
棞	slty
樓	slvg
櫢	slvt
楐	slwj
榲	slwl
樏	slxi
欏	slxy
楞	slyt
檂	smae
柵	smah
欁	smas
椣	smaw
杸	smcy
椯	smdj
柍	smdy
榾	smeg
枏	smfg
柟	smfg
椆	smfk
柚	smg
桐	smgk
梬	smgn
榿	smgu
杣	smh
栅	smmg
樱	smmv
櫻	smmv
机	smn
楇	smnk
桤	smnn
檛	smnp
枧	smqn
枫	smqy
㭎	smqy
楓	smtj
贾	smu
賈	smu
棡	smum
棢	smun
欈	smwk
梣	smwn
梤	smwv
枘	smwy
槯	smwy
梖	smy
枬	smyg
杋	smyy
榐	snae
朰	snb
樼	snbb
橄	snbt
椐	sndg
栩	sng
楃	sngf
柌	sngk
椵	snhc
楈	snhe
杻	snhf
梉	snhf
橻	snhf
楣	snhg
朻	snhh
椲	snhh
榍	snie
樨	snih
欘	snij
蚻	snju
檘	snku
札	snn
杞	snn
梮	snnk
梞	snny
槢	snrg
杨	snrt
榓	sntl
梶	sntn
柲	sntt
榌	snuh
樛	snwe
櫂	snwy
紮	snxi
柅	snxn
杺	sny
欉	sogc
檏	sogw
樸	sogy
橩	soof
檆	sook
櫿	sook
橯	sool
棪	sooy
橉	soqh
杰	sou
粟	sou
楼	sovg
廼	spd
迺	spd
槣	spdk
櫶	spdn
椬	speg
榢	spey
棕	spfi
梡	spfq
榁	spgf
楦	spgg
椗	spgh
檳	spgm
棺	sphn
榠	spju
楎	splh
橣	spne
櫁	spnj
樒	spnm
檸	spns
椀	spqb
枕	spqn
槟	sprw
柠	spsh
楁	sptk
榟	spuh
桉	spvg
椌	spwa
榨	spwf
檫	spwi
樎	spwj
榕	spwk
棎	spws
榷	spwy
柼	spwy
柁	spxn
榊	spyh
桝	sqah
棔	sqaj
桰	sqak
榤	sqas
柢	sqay
枊	sqbh
栁	sqbh
桞	sqbh
椶	sqbt
栬	sqcn
构	sqcy
桅	sqdb
桸	sqdh
橪	sqdo
檐	sqdy
槲	sqef
桷	sqeh
檞	sqeh
橹	sqgj
桃	sqiy
栎	sqiy
栒	sqjg
橡	sqke
枸	sqkg
梚	sqkq
欃	sqky
枹	sqnn
櫓	sqoj
櫯	sqot
椈	sqoy
樊	sqqd
礬	sqqd
鬰	sqqe
欎	sqqf
欝	sqqf
蠜	sqqj
燓	sqqo
鐢	sqqq
攀	sqqr
棥	sqqs
栘	sqqy
楤	sqrn
榝	sqsc
樧	sqsc
柳	sqtb
梑	sqto
枃	squg
檭	sqve
棦	sqvh
杴	sqwy
榴	sqyl
橮	sqym
杓	sqyy
杦	sqyy
梍	sran
板	srcy
柧	srcy
槔	srdf
栃	srdn
楯	srfh
柏	srg
栀	srgb
梔	srgc
楻	srgg
梹	srgw
析	srh
杽	srh
榹	srhm
枛	srhy
槹	srif
檪	sris
株	sriy
楾	sriy
晳	srjf
蜤	srju
橅	srlo
鬱	srme
棉	srmh
惁	srnu
槐	srqc
櫆	srqf
皙	srrf
櫍	srrm
椞	srsu
椑	srtf
橷	sruq
柣	srwy
権	srwy
梎	srxn
槪	srxq
櫟	srxs
檄	sryt
覈	sryt
柝	sryy
樷	ssbc
郴	ssbh
辳	ssde
櫏	ssdp
彬	sset
埜	ssff
禁	ssfi
標	ssfi
檦	ssfj
栖	ssg
梄	ssgg
梺	ssgh
槱	ssgo
朾	ssh
楂	ssjg
橝	ssjh
柯	sskg
榃	sslf
檒	ssmj
梵	ssmy
槚	ssmy
檟	ssmy
楚	ssnh
焚	ssou
樮	ssoy
棾	sspm
椘	sspu
梦	ssqu
檚	sssh
木	ssss
森	sssu
栗	ssu
婪	ssvf
楆	ssvg
棽	sswn
鷅	sswo
棼	sswv
棶	ssww
林	ssy
麓	ssyx
枡	stah
栙	stah
杔	stan
檱	staw
枨	stay
柂	stbn
栝	stdg
桻	stdh
桥	stdj
椥	stdk
橋	stdk
槰	stdp
枖	stdy
棰	stfg
杵	stfh
桁	stfh
杄	stfh
櫡	stfj
梏	stfk
欑	stfm
橇	stfn
枆	stfn
梃	stfp
栍	stgg
棅	stgi
櫄	stgo
柞	sthf
橰	sthf
梴	sthp
櫋	sthy
椼	stih
楿	stjg
梸	stjh
椱	stjt
格	stkg
楀	stky
桖	stlg
樬	stln
榭	stmf
栴	stmy
杚	stnn
柹	stnt
橎	stol
楸	stoy
覂	stpu
柉	stpy
橁	stqj
覆	sttt
櫤	stuj
柊	stuy
櫛	stvb
樅	stwh
櫷	stxg
梅	stxy
枚	sty
柇	sty
樦	styg
杁	styy
栟	suah
樴	suaj
槎	suda
棬	sudb
样	sudh
橏	sudk
椦	sudl
栚	sudy
櫳	sued
橌	sueg
椾	suej
檖	suep
栏	sufg
枓	sufh
柈	sufh
柆	sug
椚	sug
橍	sugg
様	sugi
樣	sugi
欄	sugi
榚	sugo
檨	sugw
檥	sugy
梓	suh
栤	suiy
椫	sujf
橦	sujf
橺	sujg
樟	sujh
槞	sujn
檍	sujn
樈	sujq
棓	sukg
榈	sukk
櫚	sukk
棁	sukq
橧	sulj
樀	sumd
椪	suog
楴	suph
榜	supy
櫩	suqv
栨	suqw
校	suqy
橂	susd
樽	susf
楢	susg
櫬	susq
榇	susy
槉	sutd
楌	sute
櫊	sutk
檤	sutp
椄	suvg
槏	suvo
榏	suwl
梯	suxt
檓	svac
樳	svaf
楖	svcb
櫭	svcg
概	svcq
根	svey
要	svf
梛	svfb
枠	svfh
橚	svfj
楗	svfp
桪	svfy
桕	svg
櫸	svgh
欅	svgr
棣	sviy
椂	sviy
樔	svjs
柖	svkg
椔	svlg
朹	svn
棂	svoy
梫	svpc
棿	svqn
覅	svqr
桚	svqy
朷	svt
桾	svtk
榋	svvv
楰	svwy
梕	svyn
杒	svyy
栰	sway
枪	swbn
棇	swcn
枩	swcu
松	swcy
椴	swdc
覄	swdu
栿	swdy
桧	swfc
柎	swfy
棆	swga
椧	swgb
楡	swgb
楑	swgd
栓	swgg
检	swgi
榆	swgj
檜	swgj
櫈	swgm
枍	swgn
楩	swgq
橙	swgu
検	swgw
檢	swgw
樇	swhe
樤	swhs
厀	swib
桼	swiu
柗	swkg
梲	swkq
椺	swks
桘	swnn
槌	swnp
栣	swtf
梌	swty
槝	swvm
樢	swvo
椕	swvs
枌	swvt
麯	swwa
郲	swwb
麬	swwc
麮	swwc
麶	swwc
猌	swwd
麵	swwd
桽	swwf
櫼	swwg
麰	swwh
來	swwi
勑	swwl
賚	swwm
顂	swwm
愸	swwn
憖	swwn
憗	swwn
麧	swwn
麪	swwn
麫	swwn
麭	swwn
麴	swwo
鶆	swwo
逨	swwp
麥	swwq
麲	swwq
麨	swwt
麷	swwu
麩	swww
麳	swww
枞	swwy
麱	swwy
橃	swxc
桦	swxf
梻	swxj
杹	swxn
朲	swy
朳	swy
柃	swyc
檎	swyc
欆	swyc
槜	swye
榫	swyf
椎	swyg
梒	swyk
槍	swyk
檇	swym
枔	swyn
棯	swyn
樵	swyo
欚	sxej
椽	sxey
樌	sxfm
槇	sxhw
栺	sxjg
柫	sxjh
柪	sxlt
朼	sxn
杛	sxn
檰	sxrh
榒	sxuu
橼	sxxe
櫞	sxxe
梐	sxxf
枇	sxxn
檵	sxxn
楷	sxxr
機	sxxy
栂	sxyy
樜	syao
櫎	syaw
槨	sybb
樆	sybc
椁	sybg
梈	sybh
橔	sybt
棛	syce
橀	sycl
梳	sycq
堏	syff
櫥	syff
桩	syfg
槠	syfj
櫧	syfj
柱	sygg
术	syi
椋	syiy
櫅	syjg
榱	syke
欀	syke
櫰	syle
檀	sylg
檩	syli
檁	sylt
柿	symh
槁	symk
杭	symn
楄	syna
槴	sync
棙	synd
栐	syni
杧	synn
枦	synt
櫦	synt
怸	synu
核	synw
樚	synx
椖	syny
檺	sype
述	sypi
鶐	sypo
楟	syps
橠	syqe
枋	syt
椸	sytb
栦	syth
檹	sytk
榳	sytp
榔	syvb
桹	syve
樃	syve
槦	syvh
槺	syvi
榶	syvk
椩	syvw
櫠	sywc
椊	sywf
椨	sywf
棜	sywu
棭	sywy
槒	syxl
箋	taau
穁	tabg
筇	tabj
笻	tabj
簸	tadc
簊	tadf
箬	tadk
簛	tadr
箕	tadw
稘	tadw
篋	tadw
笁	taf
簕	tafl
篏	tafw
筐	tagf
箧	tagw
筺	tagy
篚	tahd
夅	tahj
籃	tahl
熈	taho
逄	tahp
笌	taht
徣	tajg
稓	tajg
升	tak
笸	takf
稢	takg
籄	takm
筪	talj
篫	tamr
築	tams
篢	tamu
簧	tamw
穔	tamw
筑	tamy
笹	tanb
秬	tang
衐	tanh
徔	tapy
簪	taqj
乇	tav
彻	tavt
穫	tawc
籆	tawc
衖	tawh
簭	tawk
遾	tawp
筮	taww
长	tayi
竾	tbb
箃	tbcu
季	tbf
秄	tbg
篜	tbio
笜	tbmj
彵	tbn
迤	tbpv
箛	tbry
篨	tbwt
径	tcag
笲	tcaj
笆	tcb
穇	tcce
篸	tcce
䅟	tcde
筩	tcej
笃	tcf
笞	tckf
秮	tckg
么	tcu
篤	tcu
稄	tcwt
私	tcy
矱	tdac
甜	tdaf
矩	tdan
憇	tdan
榘	tdas
叐	tdcu
秡	tdcy
舌	tdd
頢	tddm
箶	tdef
衚	tdeh
圱	tdfg
秙	tdg
舔	tdgn
短	tdgu
箴	tdgy
稧	tdhd
夆	tdhj
蠭	tdhj
逢	tdhp
篲	tdhv
夭	tdi
籍	tdij
筙	tdiu
刮	tdjh
刋	tdjh
乔	tdjj
舓	tdjr
聟	tdkb
敽	tdkc
呑	tdkf
知	tdkg
智	tdkj
喬	tdkk
勪	tdkl
鷮	tdko
敿	tdkt
鼅	tdkx
矲	tdlx
稬	tdmd
舑	tdmf
岙	tdmj
舏	tdnh
稽	tdnj
嵇	tdnm
嵆	tdnm
乱	tdnn
筬	tdny
諬	tdny
舕	tdoo
适	tdpd
舐	tdqa
鸹	tdqg
舚	tdqy
徛	tdsk
矨	tdtd
舙	tdtd
矪	tdte
筹	tdtf
矫	tdtj
矯	tdtk
憩	tdtn
矮	tdtv
敌	tdty
矢	tdu
辞	tduh
簝	tdui
矰	tduj
矬	tdwf
箺	tdwj
谸	tdwk
鴁	tdwo
鴙	tdwo
鴰	tdwo
筴	tdww
雉	tdwy
矧	tdxh
笼	tdxr
艧	teac
艨	teae
舡	teag
艜	teah
艦	teal
穩	tean
艓	teas
舼	teaw
箙	tebc
筟	tebf
稃	tebg
郍	tebh
艋	tebl
舥	tecn
頺	tedm
舿	tedn
舦	tedy
艀	teeb
稝	teeg
艢	tefk
艝	tefv
笡	tegf
租	tegg
徂	tegg
艚	tegj
筯	tegl
稲	tehj
艣	tehl
艫	tehl
舻	tehn
舟	tei
艄	teie
艡	teil
艃	tejf
艒	tejh
甪	tek
舯	tekh
艥	teky
盘	telf
穱	telf
舺	telh
筋	telr
艛	telv
般	temc
磐	temd
褩	teme
稱	temf
鞶	temf
舳	temg
舢	temh
幋	temh
縏	temi
螌	temj
船	temk
盤	teml
舰	temq
鎜	temq
搫	temr
槃	tems
媻	temv
舤	temy
艍	tend
艉	tenn
透	tepe
篴	tepu
舵	tepx
鸼	teqg
艪	teqj
艐	teqt
艬	teqy
秀	ter
舨	terc
簲	terf
舶	terg
艎	terg
艊	terh
徭	term
舾	tesg
舸	tesk
舴	tetf
舽	teth
艂	teth
艞	teti
艁	tetk
艇	tetp
舧	tety
艖	teua
艟	teuf
艏	teuh
籐	teui
籘	teui
艗	teul
艕	teuy
艤	teuy
艘	tevc
稻	tevg
箏	tevh
穏	tevn
舠	tevt
舱	tewb
舩	tewc
舲	tewc
艭	tewc
艙	tewk
艌	tewn
鵃	tewo
艅	tewt
艠	tewu
徯	texd
舭	texx
艑	teya
艔	teyc
艆	teye
艩	teyj
航	teym
舮	teyn
舣	teyq
艈	teyq
舫	teyt
笈	teyu
舷	teyx
彶	teyy
郵	tfab
垂	tfag
籖	tfag
甀	tfay
篕	tfcl
丢	tfcu
秐	tfcy
秓	tfcy
壬	tfd
穤	tfdj
竺	tff
玍	tff
筀	tfff
篈	tfff
徍	tffg
街	tffh
衎	tffh
徺	tffq
穘	tffq
等	tffu
待	tffy
秲	tffy
簙	tfgf
啎	tfgk
秆	tfh
徝	tfhg
稙	tfhg
鸻	tfhg
行	tfhh
衠	tfhh
憄	tfhn
鴴	tfho
稹	tfhw
徒	tfhy
午	tfj
竿	tfj
篝	tfjf
簳	tfjf
千	tfk
郜	tfkb
靠	tfkd
告	tfkf
籉	tfkf
秸	tfkg
鹄	tfkg
穯	tfkk
勂	tfkl
頶	tfkm
鵠	tfko
造	tfkp
德	tfln
徳	tfln
毧	tfnd
毴	tfnd
氁	tfnd
毝	tfne
毶	tfne
籌	tfnf
氊	tfng
毪	tfnh
毜	tfni
氆	tfnj
氇	tfnj
毥	tfnj
毺	tfnj
氌	tfnj
毡	tfnk
毰	tfnk
毳	tfnn
毸	tfnn
毯	tfno
毩	tfno
毱	tfno
毽	tfnp
毨	tfnq
覒	tfnq
毢	tfns
忎	tfnu
毛	tfnv
毬	tfny
廷	tfpd
迁	tfpk
迕	tfpk
頲	tfpm
颋	tfpm
先	tfqb
笎	tfqb
酂	tfqb
酇	tfqb
衏	tfqh
劗	tfqj
赞	tfqm
贊	tfqm
选	tfqp
兟	tfqq
筠	tfqu
幷	tftf
筓	tftf
箸	tftj
逬	tftp
甁	tfty
埀	tfuf
穑	tfuk
乖	tfux
敮	tfvc
臿	tfvd
歃	tfvw
稑	tfwf
簮	tfwj
穡	tfwk
稜	tfwt
籗	tfwy
籱	tfwy
乗	tgai
笄	tgaj
剰	tgaj
筭	tgaj
秷	tgcf
箌	tgcj
生	tgd
箐	tgef
簠	tgel
秿	tgey
稏	tgfg
竽	tgfj
彺	tgg
眚	tghf
征	tghg
徰	tghh
惩	tghn
篶	tgho
秠	tgig
重	tgjf
篿	tgjf
濌	tgjj
動	tgjl
穗	tgjn
憅	tgjn
勲	tgjo
筻	tgjq
稉	tgjq
衙	tgkh
稫	tgkl
籁	tgkm
籟	tgkm
簌	tgkw
稶	tgky
徚	tgli
甥	tgll
勳	tgll
熏	tglo
策	tgmi
箣	tgmj
穂	tgmn
箦	tgmu
簀	tgmu
穲	tgmx
籭	tgmx
積	tgmy
徕	tgoy
秣	tgsy
甧	tgte
甡	tgtg
笺	tgu
秤	tguh
徑	tgva
徢	tgvh
箑	tgvh
秉	tgvi
穪	tgwq
籋	tgwq
算	thaj
籚	thal
箎	tham
籧	thap
簴	thaw
郋	thbh
彼	thcy
秛	thcy
自	thd
篹	thdb
鄓	thdb
篡	thdc
簒	thdc
徘	thdd
籑	thde
纂	thdi
臭	thdu
穢	thdy
乍	thfd
怎	thfn
迮	thfp
牋	thga
牑	thga
版	thgc
牍	thgd
牌	thgf
牉	thgf
牔	thgf
牗	thgh
牏	thgj
牊	thgk
牘	thgm
片	thgn
牎	thgn
牕	thgn
覑	thgq
牒	thgs
牐	thgv
臰	thgx
牖	thgy
牓	thgy
籰	thhc
衢	thhh
徙	thhy
忂	thhy
处	thi
臯	thif
翺	thin
鷱	thio
徏	thit
篎	thit
昝	thjf
咎	thkf
笘	thkf
秥	thkg
齆	thlc
齅	thld
齈	thle
齉	thle
鼾	thlf
齄	thlg
齇	thlg
鼼	thlh
齂	thli
鼻	thlj
劓	thlj
齁	thlk
齃	thln
鼿	thlq
鼽	thlv
齀	thly
鄎	thnb
臫	thnn
息	thnu
郔	thpb
延	thpd
蜑	thpj
邉	thpp
邊	thpp
臱	thpy
筧	thqb
臲	thsb
鷍	thso
臬	thsu
甈	thsy
辠	thuj
臮	thwy
篊	tiaw
笵	tibb
筂	tibb
箈	tick
筲	tief
稍	tieg
箾	tiej
衍	tifh
愆	tifn
簿	tigf
箥	tihc
乑	tii
篞	tijf
簜	tijr
徜	timk
簹	tipl
箔	tirf
箵	tith
籓	titl
箲	titq
秒	titt
尓	tiu
筜	tivf
簗	tivs
馢	tjaa
篳	tjaf
穝	tjbc
忁	tjbi
馛	tjdc
馣	tjdn
馟	tjeb
香	tjf
馞	tjfb
稈	tjfh
筸	tjfj
馩	tjfm
得	tjgf
笪	tjgf
筛	tjgh
徥	tjgh
利	tjh
馡	tjhd
馧	tjjl
馤	tjjn
馝	tjnt
悡	tjnu
馜	tjnx
馪	tjpm
鋫	tjqf
犁	tjrh
梨	tjsu
稞	tjsy
篂	tjtg
馫	tjtj
篮	tjtl
馥	tjtt
复	tjtu
馦	tjuo
馠	tjwk
馚	tjwv
箟	tjxx
箿	tkbf
頟	tkdm
各	tkf
和	tkg
筽	tkgd
程	tkgg
徎	tkgg
种	tkhh
簬	tkhk
篑	tkhm
簣	tkhm
洜	tkiu
筥	tkkf
簞	tkkf
稆	tkkg
鄅	tkmb
筼	tkmu
篔	tkmu
禹	tkmy
惒	tknu
兎	tkqy
敋	tkty
鵅	tkwo
积	tkwy
雒	tkwy
簂	tlag
簚	tlah
穓	tlaw
衊	tlay
範	tlbb
衈	tlbg
卹	tlbh
笝	tlcu
血	tld
甶	tld
箇	tldf
稒	tldg
筃	tldu
篾	tldy
秵	tldy
稩	tleg
备	tlf
盉	tlf
笽	tlf
睾	tlff
衃	tlgi
箅	tlgj
笚	tlj
笳	tlkf
徊	tlkg
簤	tlmu
衄	tlnf
惫	tlnu
粤	tlon
笾	tlpu
囱	tlqi
囟	tlqi
顖	tlqm
恖	tlqn
悤	tlqn
箩	tlqu
欰	tlqw
簐	tlqw
务	tlr
竻	tlr
衇	tlre
囪	tlry
稇	tlsy
衆	tlti
簵	tltk
衉	tltk
箘	tltu
稛	tlty
衅	tluf
簍	tlvf
邍	tlvp
籔	tlvt
衂	tlvy
稷	tlwt
籮	tlxy
穠	tmae
筁	tmaf
秃	tmb
垼	tmcf
役	tmcy
躻	tmda
躾	tmdd
躴	tmde
躼	tmde
射	tmdf
軃	tmdf
軇	tmdf
躰	tmdg
躿	tmdi
篅	tmdj
軄	tmdj
躺	tmdk
躳	tmdk
躸	tmdk
軀	tmdk
軂	tmdl
颓	tmdm
軉	tmdm
頽	tmdm
躵	tmdn
軈	tmdn
躹	tmdo
鵢	tmdo
躯	tmdq
躭	tmdq
躲	tmds
躱	tmds
躶	tmds
身	tmdt
軆	tmdu
躮	tmdv
躷	tmdv
躽	tmdv
軁	tmdv
躬	tmdx
秧	tmdy
軅	tmdy
笛	tmf
簓	tmfe
稠	tmfk
徟	tmfk
秞	tmg
衕	tmgh
筒	tmgk
秱	tmgk
懲	tmgn
微	tmgt
徽	tmgt
徵	tmgt
徴	tmgt
黴	tmgt
秈	tmh
币	tmhk
屲	tmj
向	tmkd
穨	tmkm
逈	tmkp
笧	tmmg
簻	tmnp
奥	tmod
嶴	tmom
笕	tmqb
秽	tmqy
奧	tmtd
粵	tmtn
幑	tmtt
筫	tmu
凢	tmv
処	tmv
鵚	tmwo
笍	tmwu
箆	tmwx
徾	tmyt
竼	tmyu
笢	tnab
乞	tnb
箼	tngf
笥	tngk
徦	tnhc
稰	tnhe
篃	tnhf
徫	tnhh
稦	tnhh
衛	tnhh
衞	tnhh
躗	tnhh
躛	tnhh
讆	tnhy
讏	tnhy
徲	tnih
穉	tnih
刉	tnjh
筷	tnnw
簨	tnnw
迄	tnpv
簈	tntf
秘	tntt
箳	tnua
稺	tnuh
穋	tnwe
籊	tnwy
秜	tnxn
笖	tnyw
释	toch
甃	togy
穙	togy
釆	toi
湬	toiu
稥	tojf
蝵	toju
鄱	tolb
番	tolf
釋	tolf
飜	tolh
勫	toll
翻	toln
鷭	tolo
釉	tomg
簖	tonr
悉	tonu
愁	tonu
釈	tony
簩	tool
鍫	toqf
鹙	toqg
揫	torj
醔	tosg
夈	tou
篓	tovf
媝	tovf
鶖	towo
秋	toy
稼	tpey
秾	tpey
簆	tpfc
簺	tpff
徖	tpfi
筦	tpfq
箮	tpgg
穦	tpgm
管	tphn
箢	tpqb
筞	tpsu
秺	tpta
乏	tpu
箜	tpwa
穃	tpwk
鴔	tpwo
篧	tpwy
簶	tpyi
籛	tqaa
秖	tqan
彽	tqay
秪	tqay
禿	tqb
稯	tqbt
篘	tqbt
衡	tqdh
稀	tqdh
頹	tqdm
簷	tqdy
衔	tqfh
銜	tqfh
穞	tqgj
篯	tqgu
筄	tqiu
称	tqiy
箰	tqjb
筍	tqjf
徇	tqjg
穐	tqjn
笱	tqkf
笣	tqnb
穭	tqoj
笅	tqqu
移	tqqy
笏	tqrr
笷	tqtb
籦	tqtf
犂	tqth
睝	tqth
黎	tqti
黧	tqto
鯬	tqto
鵹	tqto
邌	tqtp
錅	tqtq
棃	tqts
剓	tqtv
笉	tquf
筝	tqvh
籙	tqvi
稳	tqvn
彴	tqyy
犕	trae
箝	traf
箍	trah
簎	traj
牫	tray
牠	trbn
筢	trcb
犙	trce
箨	trch
笟	trcy
牜	trd
牻	trde
牯	trdg
犄	trdk
犡	trdy
犊	trfd
特	trff
簼	trff
牡	trfg
循	trfh
犆	trfh
犢	trfm
牼	trga
篁	trgf
徨	trgg
牾	trgk
籒	trgl
御	trhb
犑	trhd
衘	trhh
禦	trhi
篪	trhm
犋	trhw
笊	trhy
穆	trie
秼	triy
犦	trji
筘	trkf
箉	trkl
籜	trlf
牭	trlg
牞	trlt
犤	trlx
牰	trmg
犅	trmm
犌	trnc
鹅	trng
鵝	trno
鵞	trno
我	trny
牸	trpb
犗	trpk
觕	trqe
籀	trql
惣	trqn
篼	trqq
物	trqr
犓	trqt
牴	trqy
篺	trrf
牪	trrh
犔	trro
牺	trsg
牱	trsk
稗	trtf
犐	trtf
箄	trtf
牲	trtg
牿	trtk
犞	trtk
牦	trtn
牬	trtt
牧	trty
犈	trub
犝	truf
犃	truk
犪	trut
犠	truy
犧	truy
犣	trvn
犍	trvp
牣	trvy
牷	trwg
籡	trww
秩	trwy
牝	trxn
牳	trxy
犏	trya
犉	tryb
犒	tryk
牨	trym
牤	tryn
犥	tryo
徼	tryt
牥	tryt
犜	tryt
篐	tsah
簯	tsaw
徱	tsfi
篻	tsfi
籈	tsfy
徆	tsg
笨	tsgf
箱	tshf
簟	tsjj
笴	tskf
籕	tsql
篥	tssu
箖	tssu
条	tsu
徠	tsww
箂	tsww
術	tsyh
秫	tsyy
秅	ttan
筈	ttdf
秳	ttdg
穚	ttdk
簥	ttdk
篷	ttdp
笑	ttdu
笶	ttdu
秗	ttdy
箠	ttfg
筕	ttfh
秊	ttfj
秊	ttfj
筶	ttfk
穳	ttfm
籫	ttfm
笔	ttfn
秏	ttfn
筳	ttfp
簉	ttfp
筅	ttfq
笙	ttgf
種	ttgf
箽	ttgf
徃	ttgg
竹	ttgh
衝	ttgh
攵	ttgy
笮	tthf
秨	tthf
簰	tthf
簁	tthh
筵	tthp
籩	tthp
筣	ttjj
復	ttjt
稪	ttjt
笿	ttkf
丿	ttll
篦	ttlx
秭	ttnt
笫	ttnt
夂	ttny
篍	ttou
簃	ttqq
篽	ttrb
籞	ttri
筿	ttsu
彳	ttth
禾	tttt
笗	ttuu
箻	ttvh
篵	ttwh
龝	ttxg
秝	tty
箞	tudb
徉	tudh
徿	tued
籠	tued
箭	tuej
穟	tuep
笠	tuf
穣	tufe
科	tufh
秚	tufh
籣	tugi
乎	tuhk
乯	tuhn
従	tuhy
简	tujf
箪	tujf
徸	tujf
穜	tujf
簡	tujf
螽	tujj
篭	tujn
篰	tukb
箁	tukf
稖	tukg
税	tukq
徶	tumt
乥	tunb
徬	tupy
篣	tupy
筊	tuqu
乊	tur
簅	tutg
衜	tuth
冬	tuu
稴	tuvo
鷑	tuwo
剩	tuxj
稊	tuxt
乘	tuxv
稵	tuxx
簢	tuyu
節	tvcb
蠞	tvcj
穊	tvcq
笯	tvcu
衟	tvdh
簋	tvel
很	tvey
委	tvf
律	tvfh
筆	tvfh
簫	tvfj
徤	tvfp
穥	tvgw
籅	tvgw
瓾	tvgy
覣	tvhq
箫	tvij
箓	tviu
笤	tvkf
筎	tvkf
簘	tvoj
逶	tvpd
箒	tvph
魏	tvrc
犩	tvrh
笋	tvtr
笂	tvyu
秇	tvyy
筏	twau
笩	twau
彸	twcy
穄	twfi
符	twfu
稐	twga
籥	twga
篟	twge
筌	twgf
签	twgi
劄	twgj
徻	twgj
箚	twgj
答	twgk
秴	twgk
籲	twgm
箯	twgq
籢	twgt
簦	twgu
簽	twgw
籨	twgw
篠	twhs
筱	twht
黐	twic
黏	twik
黍	twiu
筗	twkh
稅	twkq
篌	twnd
篩	twnh
籂	twph
秹	twtf
筰	twtf
筡	twtu
徐	twty
稌	twty
秂	twu
鵆	twvh
穒	twvo
秎	twvt
聳	twwb
籤	twwg
從	twwh
慫	twwn
熧	twwo
彾	twyc
秢	twyc
笭	twyc
篗	twyc
篒	twye
稚	twyg
衑	twyh
筨	twyk
篬	twyk
稔	twyn
笒	twyn
穛	twyo
穕	twys
龜	txd
胤	txen
篆	txeu
毎	txfj
第	txht
系	txiu
彿	txjh
笰	txjj
箹	txqy
籎	txth
後	txty
篛	txuu
笓	txxb
筚	txxf
秕	txxn
稭	txxr
籪	txxr
穖	txxy
鳘	txyg
繁	txyi
瀪	txyi
緐	txyi
勄	txyl
慜	txyn
鰵	txyo
毓	txyq
敏	txyt
每	txyy
穬	tyaw
簱	tyaw
篱	tybc
稕	tybg
籬	tyby
勶	tycl
徹	tyct
簔	tyge
往	tygg
笇	tyhu
入	tyi
汆	tyiu
稤	tyiy
穧	tyjg
穰	tyke
忀	tyke
簑	tyke
笐	tymb
屳	tymj
稿	tymk
篙	tymk
秔	tymn
肏	tymw
篇	tyna
徧	tyna
稨	tyna
笀	tynb
簄	tync
穮	tyno
兦	tynv
簏	tynx
籝	tyny
籯	tyny
籴	tyou
糴	tyoy
籇	type
込	typi
彷	tyt
箷	tytb
簇	tytd
籏	tytw
簾	tyuo
稂	tyve
筤	tyve
穅	tyvi
篖	tyvk
稡	tywf
箤	tywf
鳰	tywo
箊	tywu
衒	tyxh
稸	tyxl
郱	uabh
疘	uad
瘔	uadd
頩	uadm
瘎	uadn
凘	uadr
疳	uafd
冮	uag
疟	uagd
瓶	uagy
冴	uaht
疨	uaht
閕	uaht
冻	uaiy
并	uaj
竎	uaj
瘼	uajd
戠	uajd
瘄	uajd
癘	uajy
阈	uakg
瘽	uakg
閾	uakg
癱	uaky
癀	uamw
疶	uanv
迸	uapk
痨	uapl
艵	uaqc
剙	uavw
剏	uavy
閧	uawi
瘩	uawk
闀	uawn
鵧	uawo
闻	ubd
聞	ubd
癮	uben
兯	ubj
疗	ubk
疖	ubk
瘾	ubqn
痾	ubsk
朔	ubte
塑	ubtf
癃	ubtg
愬	ubtn
逆	ubtp
遡	ubtp
屰	ubtr
槊	ubts
欮	ubtw
癊	ubwc
痉	ucad
閞	ucak
瘮	ucce
闯	ucd
瘆	ucde
痛	ucek
衮	uceu
冯	ucg
闖	uci
冶	uckg
凴	ucmb
憑	ucnu
兖	ucqb
竢	uctd
疤	ucv
竣	ucwt
痠	ucwt
瘫	ucwy
馮	ucy
瘙	ucyj
齹	udab
羢	udad
差	udaf
卷	udbb
郑	udbh
勌	udbl
羟	udca
闳	udci
閎	udci
羓	udcn
羧	udct
駦	udcu
冹	udcy
竑	udcy
闫	udd
閆	udd
羱	uddi
頖	uddm
羬	uddy
痏	uded
痮	udei
羏	udet
豢	udeu
羺	udfj
羵	udfm
羥	udga
羠	udgw
减	udgy
齤	udhb
瘈	udhd
着	udhf
眷	udhf
瘛	udhn
头	udi
羊	udj
竰	udjf
竡	udjg
判	udjh
奍	udjj
阉	udjn
羯	udjn
痷	udjn
閹	udjn
鵥	udjo
疬	udle
劵	udlr
劷	udlt
羖	udmc
帣	udmh
羰	udmo
羌	udnb
巻	udnb
羗	udnc
痝	udne
羞	udnf
翔	udng
韏	udnh
疣	udnv
疠	udnv
羫	udpa
送	udpi
闼	udpi
羦	udpq
羜	udps
觠	udqe
鲞	udqg
鲝	udqg
鮝	udqo
鮺	udqo
羝	udqy
⺶	udr
叛	udrc
牶	udrh
拳	udrj
桊	udsu
癧	udth
羳	udtl
关	udu
鄯	udub
羴	udud
療	udui
善	uduk
敾	udut
歚	uduw
券	udvr
羚	udwc
凑	udwd
餋	udwe
瘞	udwf
羭	udwj
瘱	udwn
鴹	udwo
羒	udwv
羷	udww
弮	udxb
絭	udxi
勬	udxl
状	udy
羪	udye
飬	udye
養	udye
誊	udyf
羶	udyg
养	udyj
鯗	udyo
羻	udyt
譱	udyy
閒	ued
顡	uedm
疓	uee
痭	ueed
奨	uefd
醤	uefg
龏	uega
聾	uegb
驡	uegc
疽	uegd
礱	uegd
龍	uegd
龑	uegd
龖	uegd
龘	uegd
襲	uege
壟	uegf
龒	uegi
蠪	uegj
鸗	uego
龔	uegw
讋	uegy
覵	uehq
前	uejj
翦	uejn
煎	uejo
剪	uejv
痈	uek
毅	uemc
阌	uepc
閿	uepc
遂	uepi
豙	ueu
凈	uevh
鷳	uewo
瘃	ueyi
阖	ufcl
闔	ufcl
攱	ufcy
兰	uff
闺	uffd
閨	uffd
痔	uffi
壮	ufg
竍	ufh
癫	ufhm
癲	ufhm
阗	ufhw
瘨	ufhw
闐	ufhw
疛	ufi
斗	ufk
半	ufk
閈	ufk
闬	ufk
闧	ufkp
癗	ufld
凟	uflm
乧	ufnb
闱	ufnh
痣	ufni
疞	ufnv
痚	uftb
闭	ufte
閉	ufte
瘏	uftj
闍	uftj
阇	uftj
闥	ufup
闚	ufwq
凌	ufwt
癨	ufwy
装	ufye
開	ugak
痓	ugcf
闰	ugd
闩	ugd
閂	ugd
閏	ugd
美	ugdu
靖	ugeg
凊	ugeg
痡	ugey
瘂	ugfg
閸	ugfg
癋	ugfn
症	ughd
疜	ughi
閇	ughi
慿	ughn
痞	ugik
羨	ugiw
竱	ugjf
凍	ugji
癅	ugjl
痦	ugkd
闘	ugkf
竵	ugkh
辣	ugki
竦	ugki
凁	ugki
瘌	ugkj
癞	ugkm
癩	ugkm
瘷	ugkt
痘	ugku
瘶	ugkw
盖	uglf
阑	ugli
闌	ugli
病	ugmw
恙	ugnu
羹	ugod
痖	ugog
羔	ugou
羙	ugou
羮	ugoy
冽	ugqj
羑	ugqy
羲	ugty
義	ugty
瘗	uguf
閛	uguh
羡	uguw
痙	ugva
姜	ugvf
凄	ugvv
冱	ugxg
羛	ugxj
痍	ugxw
癍	ugyg
羕	ugyi
閠	ugyi
瘧	uhag
疲	uhci
痱	uhdd
阒	uhdi
闃	uhdi
闅	uhhc
癯	uhhy
竨	uhjh
丫	uhk
痁	uhkd
站	uhkg
門	uhng
疵	uhxv
痟	uied
閖	uii
痧	uiit
閯	uiit
闛	uipf
闣	uipl
阔	uitd
闊	uitd
竗	uitt
瘠	uiwe
冰	uiy
頀	ujac
韺	ujad
贑	ujam
戅	ujan
鄣	ujbh
韷	ujbm
间	ujd
間	ujd
彰	ujet
音	ujf
郸	ujfb
冁	ujfe
童	ujff
单	ujfj
勭	ujfl
氃	ujfn
疸	ujgd
韴	ujgh
瘍	ujgr
痩	ujhc
覸	ujhq
闽	uji
痋	uji
閩	uji
章	ujj
阊	ujjd
閶	ujjd
韻	ujkm
瘟	ujld
竜	ujnb
闒	ujnd
阘	ujnd
鷾	ujno
意	ujnu
遧	ujpk
竟	ujqb
竭	ujqn
竸	ujqq
痬	ujqr
韵	ujqu
嬜	ujqv
歆	ujqw
韹	ujrg
韸	ujth
赣	ujtm
贛	ujtm
戆	ujtn
戇	ujtn
韼	ujtp
竷	ujtt
韶	ujvk
鶕	ujwo
鷼	ujwo
閺	ujyi
部	ukbh
问	ukd
問	ukd
袞	ukeu
咅	ukf
瓿	ukgy
冲	ukhh
竒	ukhj
闠	ukhm
阓	ukhm
剖	ukjh
郶	ukkc
闾	ukkd
閭	ukkd
癉	ukkf
闡	ukkf
闆	ukkk
癌	ukkm
勏	uklt
总	uknu
竞	ukqb
兑	ukqb
兗	ukqb
况	ukqn
競	ukqq
敚	ukqt
敨	ukty
疻	ukwi
兾	ulaw
痼	uldd
凅	uldg
凙	ulff
癦	ulff
癏	ulge
闤	ulge
阛	ulge
痹	ulgj
兽	ulgk
瘝	ulii
鄫	uljb
曾	uljf
曽	uljf
朆	uljr
甑	uljy
闸	ulk
閘	ulk
閳	ulk
痂	ulkd
痐	ulkd
瘸	ulkw
癳	ulli
阃	ulsi
閫	ulsi
辦	uluh
瘻	ulvd
瘰	ulxi
癑	umae
闦	umau
痶	umaw
疫	umci
竐	umcy
啇	umdf
端	umdj
適	umdp
敵	umdt
歒	umdw
甋	umdy
凋	umfk
痌	umgk
凒	umgu
闓	umgu
閴	umi
弊	umia
鄨	umic
獘	umid
鳖	umig
瞥	umih
蹩	umih
幣	umih
暼	umij
蟞	umij
憋	umin
鱉	umio
鷩	umio
鐅	umiq
撆	umir
敝	umit
嫳	umiv
彆	umix
斃	umix
鼈	umix
龞	umix
疝	umk
閊	umk
瘿	ummv
癭	ummv
竌	umn
瘑	umnk
闿	umnv
疯	umqi
飒	umqy
闝	umti
瘋	umtj
闏	umtj
颯	umtj
商	umwk
凗	umwy
癜	unac
冺	unan
阚	unbt
闞	unbt
瘺	unfi
翊	ung
瘕	unhc
闈	unhh
闷	uni
悶	uni
癖	unku
闢	unku
乵	unn
疡	unre
閟	unte
竮	unua
瘳	unwe
疦	unwi
决	unwy
痆	unxv
並	uogf
普	uogj
焛	uoi
疢	uoi
痰	uooi
癆	uool
瘘	uovd
竤	updc
竩	upeg
痯	uphn
凕	upju
瘒	uplk
帝	upmh
啻	upmk
鶙	upmo
遆	upmp
竚	upsh
覫	upyq
旁	upyr
阍	uqaj
痻	uqaj
閽	uqaj
疧	uqav
疷	uqay
郊	uqbh
頝	uqdm
奖	uqdu
癚	uqdy
螀	uqfj
将	uqfy
凎	uqg
癣	uqgd
虠	uqhm
浆	uqiu
阄	uqjn
痀	uqkd
竘	uqkg
凂	uqkq
効	uqlt
痪	uqmd
瘓	uqmd
疱	uqnv
癬	uqod
䴔	uqqg
痑	uqqi
瘹	uqqy
酱	uqsg
桨	uqsu
效	uqty
交	uqu
阎	uqvd
閻	uqvd
净	uqvh
竫	uqvh
䦛	uqvh
䦶	uqvh
餈	uqwe
垐	uqwf
咨	uqwk
盗	uqwl
资	uqwm
資	uqwm
恣	uqwn
乲	uqwn
粢	uqwo
鵁	uqwo
栥	uqws
楶	uqws
秶	uqwt
姿	uqwv
次	uqwy
瓷	uqwy
疚	uqyi
瘤	uqyl
瓣	urcu
闎	urii
痸	urmj
瘣	urqc
痺	urtf
兿	urvc
閪	usd
闉	usfd
凐	usfg
瘭	usfi
痲	usfq
鄭	usgb
奠	usgd
猷	usgd
尊	usgf
酋	usgf
蠤	usgj
鷷	usgo
遵	usgp
遒	usgp
親	ushq
闲	usi
閑	usi
疔	usk
閅	usk
疴	uskd
閜	uskd
鹇	usqg
新	usrh
凚	ussi
痳	ussi
凓	ussy
亲	usu
闄	usvd
凇	uswc
鷴	uswo
竔	utah
凞	utao
痵	utbd
疾	utdi
痴	utdk
产	ute
閁	ute
瘢	utec
彦	utee
颜	utem
顔	utem
遃	utep
竏	utfh
竓	utfn
閐	utfn
閮	utfp
冼	utfq
瘇	utgf
癪	utgm
癟	utha
首	uthf
痄	uthf
導	uthf
馘	uthg
噵	uthk
瘜	uthn
道	uthp
闑	uths
夔	utht
瘪	uthx
痢	utjk
阁	utkd
閣	utkd
竬	utky
癓	utmt
癥	utmt
竧	utmt
痜	utmv
疙	utnv
疺	utpi
産	uttg
剷	uttj
癁	uttt
疼	utui
癤	utvb
痿	utvd
亷	utvo
瘲	utwh
痗	utxy
阙	uubw
瘚	uubw
闕	uubw
閚	uud
闁	uud
瘥	uuda
闂	uudb
癢	uude
関	uudi
痒	uudk
癇	uued
冸	uufh
閗	uufk
竝	uug
辡	uuh
瘖	uujd
癎	uujd
闇	uujd
阐	uujf
瘅	uujf
暜	uujf
瘴	uujk
癔	uujn
阅	uukq
痥	uukq
閲	uukq
竲	uulj
竴	uusf
痫	uusi
立	uuuu
閰	uvd
痕	uvei
妾	uvf
冿	uvfh
疩	uvfk
妆	uvg
瘦	uvhc
癰	uvky
癙	uvnn
鹣	uvog
鶼	uvoo
兼	uvou
歉	uvow
甉	uvoy
阋	uvqv
辧	uvuh
瘐	uvwi
阀	uwai
閥	uwai
疮	uwbv
疹	uwee
瘵	uwfi
痊	uwgd
阕	uwgd
闋	uwgd
瘉	uwgj
癐	uwgj
冾	uwgk
閤	uwgk
癒	uwgn
闟	uwgn
竳	uwgu
闪	uwi
閃	uwi
疥	uwjk
閱	uwkq
益	uwlf
鹢	uwlg
蠲	uwlj
鷁	uwlo
瘊	uwnd
凃	uwty
鴗	uwvo
竕	uwvt
痤	uwwf
䦟	uwwf
䦷	uwwf
疭	uwwi
閦	uwww
癈	uwxc
閄	uwy
冷	uwyc
竛	uwyc
閝	uwyc
痽	uwyd
閵	uwyd
飡	uwye
凖	uwyf
准	uwyg
凔	uwyk
瘡	uwyk
癄	uwyo
邶	uxbh
瘬	uxde
鄁	uxeb
背	uxef
丠	uxgf
鹈	uxhg
剃	uxhj
弚	uxhj
鵜	uxho
递	uxhp
弟	uxht
辮	uxiu
疿	uxjk
軰	uxlj
冀	uxlw
北	uxn
凝	uxth
癡	uxth
辫	uxuh
疕	uxv
孳	uxxb
鹚	uxxg
關	uxxg
慈	uxxn
闗	uxxo
鶿	uxxo
鷀	uxxo
兹	uxxu
疪	uxxv
甆	uxxy
訚	uyd
誾	uyd
閍	uye
冫	uyg
疰	uygd
疒	uygg
辛	uygh
丬	uygh
六	uygy
门	uyhn
闵	uyi
閔	uyi
凉	uyiy
凉	uyiy
癠	uyjd
凛	uyli
癝	uyli
凜	uylt
癛	uylt
闹	uymh
閙	uymh
闶	uymv
閌	uymv
闙	uynk
阂	uynw
痎	uynw
閡	uynw
丷	uyt
瘯	uytd
辨	uytu
辩	uyuh
辬	uyuh
辯	uyuh
阆	uyve
閬	uyve
瘁	uywf
瘀	uywu
阏	uywu
閼	uywu
痃	uyxi
癴	uyxr
癵	uyxw
癕	uyxy
嫟	vaak
嬺	vaan
媶	vabg
婼	vadk
媅	vadn
娀	vadt
娸	vadw
姏	vafg
媒	vafs
妅	vag
嬅	vagf
姬	vahh
姫	vahh
舁	vaj
嫫	vajd
鄩	vakb
彠	vakc
尋	vakf
嫤	vakg
嫗	vakk
嬿	vako
嫨	vakw
孉	vaky
媌	valg
毁	vamc
媖	vamd
嫹	vamw
姖	vang
媟	vans
妪	vaqy
嬞	vatf
嫕	vatn
娆	vatq
孏	vaui
嬳	vawc
婲	vawx
娂	vawy
娵	vbcy
嫷	vbde
好	vbg
邚	vbh
媸	vbhj
她	vbn
恏	vbnu
婀	vbsk
塈	vcaf
暨	vcag
鱀	vcao
既	vcaq
孥	vcbf
堲	vcbf
即	vcbh
妤	vcbh
媃	vcbs
娺	vccc
驽	vccf
駑	vccu
砮	vcdf
姢	vceg
妈	vcg
始	vckg
努	vclr
帑	vcmh
胬	vcmw
妑	vcn
怒	vcnu
拏	vcrj
娭	vctd
厹	vcu
鴑	vcwo
鵖	vcwo
弩	vcxb
奴	vcy
媽	vcy
媠	vdae
妭	vdcy
姷	vdeg
媩	vdeg
娠	vdfe
娾	vdff
媷	vdff
姱	vdfn
姑	vdg
妬	vdg
媙	vdgy
妦	vdhh
夓	vdht
媆	vdmd
媔	vdmd
頄	vdmy
娏	vdne
娍	vdny
娔	vdqn
嫄	vdri
婍	vdsk
嫴	vduh
嫽	vdui
媋	vdwj
嫀	vdwt
娐	vebg
媛	vefc
垦	veff
姐	vegg
艮	vei
恳	venu
嫒	vepc
退	vepi
嬡	vept
媱	verm
婇	vesy
奶	vet
婬	vetf
嬀	veto
娞	vevg
嫍	vevg
彟	vfac
那	vfbh
妓	vfcy
妘	vfcy
嬬	vfdj
娃	vffg
嫮	vffn
嬈	vffq
奸	vfh
聿	vfhk
衋	vfhl
建	vfhp
嫃	vfhw
妹	vfiy
卆	vfj
媾	vfjf
書	vfjf
晝	vfjg
妌	vfjh
肅	vfjk
鷫	vfjo
歗	vfjw
媴	vfke
嬯	vfkf
姞	vfkg
嬉	vfkk
畵	vflb
畫	vflg
劃	vflj
嬻	vflm
毀	vfmc
婻	vfmf
嬦	vfnf
娡	vfny
嬄	vfpu
妩	vfqn
妧	vfqn
孀	vfsh
姸	vftf
媎	vftj
姥	vftx
寻	vfu
婞	vfuf
嫱	vfuk
嬙	vfwk
婈	vfwt
妋	vfwy
妍	vgah
娬	vgah
姪	vgcf
婖	vgdn
婧	vgeg
婊	vgey
婭	vgfg
姃	vghg
嫣	vgho
娝	vgik
妚	vgiy
嫥	vgjf
姮	vgjg
娻	vgji
娪	vgkg
娕	vgki
嬾	vgkm
嫩	vgkt
嫰	vgkw
婳	vglb
媡	vgli
姉	vgmh
孋	vgmx
嫧	vgmy
礜	vgnd
舉	vgnh
轝	vgnl
舃	vgno
鸒	vgno
擧	vgnr
歟	vgnw
與	vgnw
譽	vgny
娅	vgog
煭	vgqo
妺	vgsy
娙	vgva
婕	vgvh
嬭	vgwq
嫊	vgxi
姨	vgxw
嫭	vhah
婋	vham
虓	vham
鄋	vhcb
遚	vhcp
叟	vhcu
婔	vhdd
⺻	vhgd
盡	vhgl
賮	vhgm
婌	vhic
婥	vhjh
肀	vhk
媜	vhmy
娊	vhqn
媫	vhvh
娋	vieg
隶	vii
鹔	vijg
剥	vijh
肃	vijk
盥	vilf
盝	vilf
嫦	viph
逮	vipi
逯	vipi
姯	viqn
妙	vitt
录	viu
媣	vivs
旭	vjd
旮	vjf
娌	vjfg
娨	vjfh
妲	vjgg
婣	vjgg
媞	vjgh
婸	vjgr
媢	vjhg
妽	vjhh
娼	vjjg
嫚	vjlc
媪	vjlg
媀	vjmy
鄛	vjsb
剿	vjsj
勦	vjsl
巢	vjsu
婐	vjsy
婫	vjxx
邵	vkbh
卲	vkbh
綤	vkbi
邕	vkcb
雝	vkcy
娟	vkeg
召	vkf
叴	vkf
如	vkg
娱	vkgd
妕	vkhh
嬇	vkhm
娖	vkhy
刟	vkjh
嬋	vkkf
嬠	vkks
孍	vkkt
劭	vklt
帤	vkmh
娲	vkmw
娛	vknd
巶	vknn
恕	vknu
娯	vknw
迢	vkpd
欩	vkqw
挐	vkrj
桇	vksu
鴽	vkwo
絮	vkxi
婟	vldg
姻	vldy
媦	vleg
甾	vlf
嬕	vlff
嫼	vlfo
嬛	vlge
疀	vlgh
舆	vlgw
輿	vlgw
嬽	vlhd
舅	vllr
娚	vllt
嫐	vllv
媤	vlny
巤	vlqn
邋	vlqp
媼	vlwl
鶅	vlwo
嫘	vlxi
姍	vmah
婰	vmaw
婩	vmdf
媏	vmdj
姎	vmdy
姌	vmfg
婤	vmfk
妯	vmg
臖	vmge
舋	vmgg
姵	vmgh
姛	vmgk
娉	vmgn
爨	vmgo
爂	vmgo
媺	vmgt
嬍	vmgt
釁	vmgv
興	vmgw
璺	vmgy
奾	vmh
帠	vmhj
帇	vmhk
姗	vmmg
孆	vmmv
媧	vmnk
孈	vmwk
妠	vmwy
姄	vnan
婮	vndg
媉	vngf
彐	vngg
婽	vnhc
婿	vnhe
妞	vnhf
媚	vnhg
媁	vnhh
孎	vnij
妃	vnn
巛	vnnn
刀	vnt
娓	vntn
妼	vntt
鼥	vnuc
鼷	vnud
鼣	vnud
鼫	vnud
鼳	vnud
鼵	vnud
鼱	vnue
鼭	vnuf
鼪	vnug
鼯	vnuk
鼦	vnuk
鼩	vnuk
鼲	vnul
鼺	vnul
鼬	vnum
鼰	vnum
鼶	vnum
鼠	vnun
鼸	vnuo
鼮	vnup
鼨	vnuu
鼹	vnuv
鼢	vnuv
鼴	vnuv
鼧	vnux
鼤	vnuy
嫪	vnwe
妜	vnwy
嬥	vnwy
妮	vnxn
姒	vnyw
粛	vojk
毇	vomc
嬫	voos
婒	vooy
嫾	voqh
灵	vou
災	vou
彛	vowa
彞	voxa
辺	vpe
嫁	vpey
婃	vpfi
媗	vpgg
婝	vpgh
嬪	vpgm
婠	vphn
婶	vpjh
彚	vpjs
嫇	vpju
媈	vplh
帚	vpmh
嬣	vpns
婉	vpqb
妉	vpqn
嫔	vprw
姹	vpta
嬸	vptl
巡	vpv
廵	vpv
姲	vpvg
嫆	vpwk
婚	vqaj
兒	vqb
郳	vqbh
媰	vqbt
姽	vqdb
姚	vqiy
妳	vqiy
姰	vqjg
姁	vqkg
姳	vqkg
嬎	vqkg
嬔	vqkg
娩	vqkq
婏	vqky
嫓	vqmx
媍	vqmy
舄	vqou
婅	vqoy
學	vqqb
斅	vqqc
礐	vqqd
觷	vqqe
壆	vqqf
澩	vqqi
嚳	vqqk
嶨	vqqm
燢	vqqo
鱟	vqqo
鷽	vqqo
覺	vqqq
斆	vqqt
黌	vqqw
姼	vqqy
雤	vqqy
夛	vqu
婙	vqvh
鶂	vqwo
鸠	vqyg
嬼	vqyj
媹	vqyl
妁	vqyy
奺	vqyy
媓	vrgg
姤	vrgk
娦	vrgw
妡	vrh
姩	vrhf
姝	vriy
嫵	vrlo
婂	vrmh
媿	vrqc
婢	vrtf
妷	vrwy
嬓	vryt
嫖	vsfi
奵	vsh
妸	vskg
杂	vsu
婹	vsvg
婡	vsww
雑	vswy
奼	vtan
姡	vtdg
娇	vtdj
嬌	vtdk
妖	vtdy
尹	vte
妊	vtfg
娷	vtfg
奷	vtfh
娗	vtfp
姺	vtfq
媑	vtgf
姓	vtgg
妰	vthf
臼	vthg
嬶	vthj
媳	vthn
娫	vthp
娳	vtjh
郡	vtkb
群	vtkd
君	vtkd
羣	vtkd
裠	vtke
帬	vtkh
頵	vtkm
焄	vtko
鵘	vtko
覠	vtkq
媲	vtlx
姠	vtmk
九	vtn
姊	vtnt
嬏	vtol
姂	vtpy
娥	vtry
婑	vtvg
孂	vtvl
娒	vtxy
姀	vty
姘	vuah
嬂	vuaj
嫅	vuda
婘	vudb
嫸	vudk
嫺	vueg
媊	vuej
嬘	vuep
嬢	vufe
姅	vufh
媄	vugd
孄	vugi
嬟	vugy
婵	vujf
嫜	vujh
嬑	vujn
婄	vukg
娧	vukq
嫡	vumd
媂	vuph
嫎	vupy
姣	vuqy
媨	vusg
娴	vusy
媇	vusy
嫻	vusy
嫉	vutd
馗	vuth
嫌	vuvo
嬨	vuxn
娣	vuxt
娜	vvfb
嫿	vvfg
姧	vvfh
妇	vvg
奻	vvg
嬩	vvgw
嫂	vvhc
嬧	vvhl
娽	vviy
妱	vvkg
嬹	vvmw
婦	vvph
婗	vvqn
脋	vvve
姦	vvvf
刕	vvvr
女	vvvv
妐	vwcy
婨	vwga
媕	vwga
婾	vwgb
姾	vwgg
媮	vwgj
嬒	vwgj
姶	vwgk
嬆	vwgn
嬁	vwgu
嬐	vwgw
臾	vwi
刅	vwi
妎	vwjh
媬	vwks
惥	vwnu
娰	vwnw
姙	vwtf
斞	vwuf
嬝	vwve
鳩	vwvo
鳭	vwvo
妢	vwvt
孅	vwwg
姈	vwyc
孇	vwyc
婎	vwyg
娢	vwyk
妗	vwyn
嫶	vwyo
嬵	vxrh
嫋	vxuu
蠿	vxxj
妣	vxxn
媘	vxxr
娹	vxyx
姆	vxyy
嫬	vyao
訄	vyd
娮	vyg
丒	vygf
妵	vygg
刃	vyi
丸	vyi
刄	vyi
婛	vyiy
孃	vyke
嬗	vylg
妫	vyly
妔	vymn
媥	vyna
妒	vynt
忍	vynu
姟	vynw
婷	vyps
嬷	vysc
孊	vysd
嫲	vyss
嬤	vysx
妨	vyt
嫙	vyth
媯	vyto
嬚	vyuo
嫏	vyvb
奿	vyvd
娘	vyve
嫞	vyvh
歰	vyvh
嫝	vyvi
妶	vyxy
妏	vyy
侙	waag
僷	waas
俴	waay
傇	wabg
偌	wadk
偡	wadn
倛	wadw
僛	wadw
儰	waeo
仝	waf
垡	waff
垈	waff
佄	wafg
仜	wag
仺	wagf
儖	wahl
伢	waht
借	wajg
偃	wajv
僅	wakg
傴	wakk
傼	wakw
儺	waky
黛	walo
儚	walq
偀	wamd
帒	wamh
岱	wamj
贷	wamu
貸	wamu
僙	wamw
佢	wang
伳	wann
偞	wans
僃	waqe
僀	waqh
僭	waqj
儆	waqt
伛	waqy
牮	warh
柋	wasu
備	wate
憊	watn
侥	watq
供	wawy
代	way
伐	way
袋	waye
戗	wbay
仓	wbb
倻	wbbh
仔	wbg
佴	wbg
创	wbjh
他	wbn
怹	wbnu
鸧	wbqg
伃	wcbh
僪	wcbk
傪	wcce
颂	wcdm
頌	wcdm
俑	wceh
瓮	wcgy
佁	wckg
翁	wcnf
鹟	wcng
勜	wcnl
鶲	wcno
忩	wcnu
兊	wcqb
毤	wcqn
侔	wcrh
枀	wcsu
俟	wctd
公	wcu
俊	wcwt
傩	wcwy
仅	wcy
仏	wcy
傌	wcy
佐	wdag
伌	wdbn
伖	wdcy
侑	wdeg
優	wdet
倀	wdey
倴	wdfa
侲	wdfe
傉	wdff
倷	wdfi
侉	wdfn
估	wdg
仨	wdg
佦	wdg
侟	wdhb
偰	wdhd
仹	wdhh
傶	wdhy
佰	wdjg
俺	wdjn
佑	wdkg
段	wdmc
偄	wdmd
偭	wdmd
佈	wdmh
侕	wdmj
优	wdnn
偧	wdqq
傸	wdqq
傆	wdri
倚	wdsk
俦	wdtf
儮	wdth
做	wdty
傄	wduh
僚	wdui
俸	wdwh
傣	wdwi
偆	wdwj
俠	wdww
伏	wdy
仗	wdyy
俘	webg
俷	wecn
倗	weeg
仴	weg
伹	wegg
佣	weh
偁	wemf
僢	weph
僾	wept
傜	werm
倸	wesy
仍	wet
僞	weto
俀	wevg
傒	wexd
伋	weyy
傤	wfal
儎	wfal
偾	wfam
僨	wfam
郐	wfcb
刽	wfcj
会	wfcu
伎	wfcy
伝	wfcy
佉	wfcy
儒	wfdj
佳	wffg
僥	wffq
侍	wffy
仁	wfg
仕	wfg
什	wfh
仠	wfh
佱	wfhf
值	wfhg
値	wfhn
傎	wfhw
畲	wfil
祭	wfiu
佘	wfiu
俅	wfiy
佅	wfiy
仐	wfj
癷	wfj
傋	wfjf
舒	wfkb
舍	wfkf
儓	wfkf
舎	wfkf
佶	wfkg
僖	wfkk
舘	wfkn
鵨	wfko
舖	wfky
舗	wfky
儥	wflm
儔	wfnf
伟	wfnh
怤	wfnu
传	wfny
俧	wfny
侼	wfpb
発	wfqb
侾	wftb
偖	wftj
侤	wftn
佬	wftx
倖	wfuf
姇	wfvf
佞	wfvg
僣	wfwj
儧	wfwm
倰	wfwt
伕	wfwy
付	wfy
倵	wgah
侀	wgaj
伅	wgbn
侄	wgcf
倒	wgcj
戣	wgda
鄈	wgdb
癸	wgdu
兪	wgeb
鄃	wgeb
傅	wgef
倩	wgeg
俞	wgej
愈	wgen
毹	wgen
逾	wgep
觎	wgeq
儬	wgeq
覦	wgeq
歈	wgew
俌	wgey
俵	wgey
全	wgf
亼	wgf
俹	wgfg
僫	wgfn
伍	wgg
仼	wgg
佂	wghg
傿	wgho
佥	wgif
伾	wgig
剑	wgij
俖	wgik
敛	wgit
伓	wgiy
傳	wgjf
倲	wgji
僡	wgjn
便	wgjq
龠	wgka
弇	wgka
命	wgkb
郃	wgkb
鄧	wgkb
敆	wgkc
龕	wgkd
儾	wgke
合	wgkf
鸽	wgkg
俉	wgkg
倳	wgkh
龣	wgki
剣	wgkj
劍	wgkj
樖	wgkk
盒	wgkl
偪	wgkl
畣	wgkl
盫	wgkl
凳	wgkm
颌	wgkm
頜	wgkm
顩	wgkm
龥	wgkm
翕	wgkn
翖	wgkn
鴿	wgko
鸙	wgko
邆	wgkp
使	wgkq
覴	wgkq
拿	wgkr
搻	wgkr
龤	wgkr
斂	wgkt
龢	wgkt
登	wgku
侸	wgku
豋	wgku
劎	wgkv
歙	wgkw
僉	wgkw
欱	wgkw
歛	wgkw
龡	wgkw
龛	wgkx
剱	wgky
劒	wgky
劔	wgky
鄶	wglb
朇	wglf
僵	wglg
劊	wglj
會	wglj
侖	wgma
侢	wgmf
伂	wgmh
傮	wgmj
俩	wgmw
儷	wgmx
债	wgmy
俪	wgmy
倆	wgmy
債	wgmy
兮	wgnb
侴	wgnj
佤	wgny
俨	wgod
俫	wgoy
例	wgqj
傲	wgqt
伻	wguh
侠	wguw
俓	wgva
倢	wgvh
儞	wgwq
仾	wgxg
傃	wgxi
侇	wgxw
俿	wham
儢	whan
佊	whcy
俳	whdd
企	whf
仩	whg
倶	whgw
佧	whhy
俶	whic
个	whj
倬	whjh
佔	whkg
侦	whmy
偵	whmy
候	whnd
佀	whnn
俔	whqn
儏	whqo
倏	whtd
修	whte
脩	whte
鞗	whtf
跾	whth
絛	whti
偹	whtl
悠	whtn
翛	whtn
倐	whto
儵	whto
焂	whto
鯈	whto
鋚	whtq
鎥	whtq
條	whts
攸	whty
偼	whvh
俱	whwy
佌	whxn
偨	whxs
仆	why
俏	wieg
倘	wimk
僘	wimt
偿	wipc
儅	wipl
償	wipm
儻	wipo
傥	wipq
侊	wiqn
偗	with
仯	witt
氽	wiu
尒	wiu
仦	wiy
儤	wjai
俚	wjfg
但	wjgg
偍	wjgh
偒	wjgr
伸	wjhh
敒	wjht
介	wjj
倡	wjjg
僈	wjlc
偶	wjmy
傝	wjng
偈	wjqn
倮	wjsy
儑	wjxo
倱	wjxx
偮	wkbg
俋	wkcn
俣	wkgd
侱	wkgg
仲	wkhh
僓	wkhm
儙	wkhp
促	wkhy
僤	wkkf
侣	wkkg
偘	wkkk
偔	wkkn
僺	wkks
儼	wkkt
傊	wkmy
俁	wknd
兌	wkqb
侃	wkqn
敓	wkqt
諐	wkqy
堡	wksf
賲	wksm
煲	wkso
保	wksy
侶	wktk
伿	wkwy
個	wldg
佃	wlg
伵	wlg
偎	wlge
儇	wlge
伡	wlh
俥	wlh
伽	wlkg
佪	wlkg
儽	wlli
儡	wlll
侽	wllt
偲	wlny
僆	wlpy
仂	wlt
僌	wlty
僂	wlvg
傫	wlxi
儸	wlxy
儂	wmae
僼	wmau
倎	wmaw
癹	wmcu
伇	wmcy
偳	wmdj
佒	wmdy
傰	wmee
傦	wmeg
倜	wmfk
伷	wmg
佩	wmgh
侗	wmgk
俜	wmgn
仙	wmh
仚	wmj
侧	wmjh
側	wmjh
儩	wmjr
仉	wmn
伣	wmqn
偑	wmtj
儶	wmwk
侺	wmwn
催	wmwy
僝	wnbb
倔	wnbm
倨	wndg
鄔	wngb
偓	wngf
伺	wngk
烏	wngo
歍	wngw
假	wnhc
偦	wnhe
偉	wnhh
僻	wnku
亿	wnn
阜	wnnf
帥	wnnh
師	wnnh
歸	wnnh
蛗	wnnj
侷	wnnk
峊	wnnm
頧	wnnm
顊	wnnm
鴭	wnno
追	wnnp
僎	wnnw
鄇	wntb
侯	wntd
佖	wntt
偋	wnua
亾	wnv
僇	wnwe
伲	wnxn
伈	wny
侭	wnyu
似	wnyw
伬	wnyy
癶	wnyy
儍	wobt
僕	wogy
僗	wool
儝	woos
倓	wooy
僯	woqh
偻	wovg
伙	woy
侎	woy
餞	wpaa
饃	wpad
饛	wpae
饉	wpag
饇	wpak
饚	wpal
餀	wpaq
饊	wpat
餝	wpay
餌	wpbg
飿	wpbm
餟	wpcc
飴	wpck
餕	wpct
餴	wpda
餪	wpdd
餦	wpde
餬	wpde
餣	wpdn
飷	wpeg
餒	wpev
饀	wpev
侬	wpey
傢	wpey
餑	wpfb
僿	wpff
飦	wpfh
倧	wpfi
饎	wpfk
饁	wpfl
饙	wpfm
俒	wpfq
饒	wpfq
饐	wpfu
饢	wpge
餺	wpgf
伫	wpgg
餗	wpgi
儐	wpgm
飩	wpgn
餖	wpgu
餔	wpgy
倌	wphn
饖	wphy
饄	wpif
饓	wpis
饅	wpjc
饆	wpjf
饂	wpjl
餲	wpjn
餳	wpjr
餜	wpjs
餛	wpjx
蝕	wpjy
饋	wpkm
餵	wple
饠	wply
餶	wpme
餇	wpmk
伔	wpmn
飢	wpmn
飼	wpnk
儜	wpns
飶	wpnt
饌	wpnw
餤	wpoo
餫	wppl
館	wppn
倇	wpqb
飹	wpqb
餚	wpqe
餙	wpqh
餆	wpqi
餾	wpql
飽	wpqn
餡	wpqv
飲	wpqw
饞	wpqy
飯	wprc
餽	wprc
餭	wprg
餼	wpro
傧	wprw
餷	wpsg
佇	wpsh
飣	wpsh
俕	wpsy
侘	wpta
飥	wpta
飫	wptd
餂	wptd
飪	wptf
飵	wptf
餠	wptf
飾	wpth
餰	wpth
餉	wptk
餎	wptk
飭	wptl
饡	wptm
餧	wptv
餓	wpty
飠	wpu
餅	wpua
饈	wpuf
餢	wpuk
饍	wpuk
餻	wpuo
餸	wpup
餃	wpuq
餿	wpvc
侒	wpvg
倥	wpwa
餱	wpwd
飻	wpwe
餁	wpwf
傛	wpwk
僒	wpwk
餄	wpwk
餘	wpwt
餩	wpww
傕	wpwy
飤	wpwy
餯	wpxe
佗	wpxn
饑	wpxy
饝	wpyd
餏	wpye
饟	wpye
飳	wpyg
饘	wpyg
飰	wpyh
餹	wpyk
傑	wqas
低	wqay
尣	wqb
爺	wqbb
仰	wqbh
爷	wqbj
㑳	wqbt
爸	wqcb
佹	wqdb
倄	wqde
俙	wqdh
儋	wqdy
釡	wqf
釜	wqfu
尩	wqgd
您	wqin
你	wqiy
佻	wqiy
侚	wqjg
像	wqke
佝	wqkg
佲	wqkg
俛	wqkq
儳	wqky
偩	wqmy
佨	wqnn
爹	wqqq
侈	wqqy
尦	wqqy
斧	wqrj
偬	wqrn
伆	wqrt
俇	wqtg
父	wqu
伨	wqug
㑇	wqvg
仢	wqyy
仮	wrcy
偱	wrfh
伯	wrg
偟	wrgg
伒	wrh
件	wrhh
傂	wrhm
侏	wriy
儛	wrlh
傀	wrqc
俽	wrqw
儨	wrrm
俾	wrtf
佚	wrwy
儌	wryt
僊	wsdn
僄	wsfi
価	wsg
体	wsgg
仃	wsh
何	wskg
價	wsmy
恷	wsnu
烋	wsou
僳	wsoy
鸺	wsqg
僲	wsqh
儊	wssh
僸	wssi
傈	wssy
偠	wsvg
倯	wswc
鵂	wswo
倈	wsww
休	wsy
佭	wtah
仛	wtan
伥	wtay
叙	wtcy
仫	wtcy
俬	wtcy
佸	wtdg
侨	wtdj
倁	wtdk
僑	wtdk
仸	wtdy
俢	wtet
侜	wtey
倂	wtff
偫	wtff
任	wtfg
倕	wtfg
仟	wtfh
仵	wtfh
俈	wtfk
凭	wtfm
赁	wtfm
儹	wtfm
賃	wtfm
恁	wtfn
鵀	wtfo
侹	wtfp
侁	wtfq
栠	wtfs
偛	wtfv
偅	wtgf
働	wtgl
亻	wth
敍	wthc
作	wthf
偺	wthj
倃	wthk
俐	wtjh
傷	wtjr
佫	wtkg
俰	wtkg
偊	wtky
畬	wtlf
侐	wtlg
俻	wtlg
傯	wtln
伤	wtlt
傻	wtlt
峹	wtmj
嵞	wtmm
仡	wtnn
悆	wtnu
僠	wtol
僁	wton
僽	wton
偢	wtoy
途	wtpi
俄	wtry
敘	wtty
余	wtu
厁	wtub
斜	wtuf
佟	wtuy
倭	wtvg
傱	wtwh
雓	wtwy
係	wtxi
侮	wtxy
八	wty
併	wuah
傞	wuda
倦	wudb
儯	wudc
佯	wudh
僐	wudk
儱	wued
僩	wueg
偂	wuej
伴	wufh
位	wug
們	wug
儀	wugy
伞	wuhj
僮	wujf
偣	wujg
僴	wujg
傽	wujh
億	wujn
傹	wujq
倍	wukg
侻	wukq
僧	wulj
们	wun
偙	wuph
傍	wupy
俲	wuql
傚	wuqt
佽	wuqw
佼	wuqy
僔	wusf
偤	wusg
儭	wusq
偐	wute
仒	wuu
傡	wuug
倿	wuvg
傔	wuvo
偝	wuxe
俤	wuxt
弅	wvaj
邠	wvbh
伮	wvcy
颁	wvdm
頒	wvdm
佷	wvey
坌	wvff
伜	wvfh
侓	wvfh
健	wvfp
鴏	wvga
鵿	wvga
鄡	wvgb
鄥	wvgb
鷌	wvgc
鸌	wvgc
裊	wvge
鶳	wvgh
鵦	wvgi
鸔	wvgi
鴚	wvgk
鴼	wvgk
鳨	wvgl
島	wvgm
鳧	wvgm
鳬	wvgm
鷈	wvgm
鳦	wvgn
鳥	wvgo
鶃	wvgq
梟	wvgs
鵌	wvgt
鵔	wvgt
鷻	wvgt
鴤	wvgu
鴃	wvgw
鴥	wvgw
鶀	wvgw
鴕	wvgx
瓫	wvgy
鵻	wvgy
鸃	wvgy
傁	wvhc
儘	wvhl
蚠	wvju
佋	wvkg
侞	wvkg
兺	wvkx
盆	wvlf
儠	wvln
岔	wvmj
贫	wvmu
貧	wvmu
仇	wvn
忿	wvnu
炃	wvou
侵	wvpc
倪	wvqn
分	wvr
侰	wvtk
伊	wvtt
攽	wvty
鳻	wvwo
麄	wvyx
仞	wvyy
仭	wvyy
韱	wwag
耸	wwbf
伧	wwbn
倊	wwcn
傟	wwcn
伀	wwcy
俎	wweg
佾	wweg
侩	wwfc
坐	wwff
傺	wwfi
剉	wwfj
倽	wwfk
夎	wwft
倫	wwga
偸	wwgb
丛	wwgf
佺	wwgg
俭	wwgi
偷	wwgj
儈	wwgj
佮	wwgk
僜	wwgu
倹	wwgw
儉	wwgw
睂	wwhh
伱	wwiy
价	wwjh
谾	wwka
卻	wwkb
郤	wwkb
谹	wwkc
豀	wwkd
豅	wwkd
豂	wwke
谷	wwkf
鹆	wwkg
螸	wwkj
谽	wwkk
豄	wwkm
慾	wwkn
鵒	wwko
逧	wwkp
谺	wwkt
谻	wwkt
豃	wwkt
欲	wwkw
谼	wwkw
佡	wwmh
怂	wwnu
俆	wwty
仌	wwu
份	wwvt
侳	wwwf
傘	wwwf
俗	wwwk
众	wwwu
人	wwww
伦	wwxn
从	wwy
仈	wwy
伶	wwyc
倠	wwyg
傖	wwyk
僋	wwym
儁	wwym
仱	wwyn
僬	wwyo
仑	wxb
倾	wxdm
傾	wxdm
华	wxfj
僶	wxg
伄	wxhh
佛	wxjh
發	wxmc
货	wxmu
貨	wxmu
化	wxn
儗	wxth
仳	wxxn
偕	wxxr
僟	wxxy
儣	wyaw
禽	wybc
邻	wycb
俼	wyce
鸰	wycg
刢	wycj
领	wycm
領	wycm
翎	wycn
鴒	wyco
令	wycu
隻	wycu
瓴	wycy
顀	wydm
隽	wyer
依	wyey
偯	wyey
詧	wyf
储	wyfj
隼	wyfj
儲	wyfj
鶽	wyfo
傠	wyfy
信	wyg
隹	wyg
住	wygg
雋	wyhm
僦	wyin
倞	wyiy
儕	wyjg
侪	wyjh
儴	wyke
售	wykf
儃	wylg
伪	wyly
傐	wymk
伉	wymn
偏	wyna
今	wynb
侌	wync
衾	wyne
酓	wyng
韽	wynj
含	wynk
盦	wynl
贪	wynm
颔	wynm
貪	wynm
頷	wynm
念	wynn
傓	wynn
儦	wyno
鳹	wyno
敜	wynt
侫	wynv
侅	wynw
欦	wynw
僱	wyny
雂	wyny
鹪	wyog
劁	wyoj
顦	wyom
鷦	wyoo
焦	wyou
進	wypd
儫	wype
停	wyps
燞	wyqo
仪	wyqy
集	wysu
仿	wyt
侂	wyta
偽	wyto
倣	wyty
亽	wyu
戧	wyva
食	wyve
俍	wyve
傭	wyvh
創	wyvj
倉	wyvk
傏	wyvk
鶬	wyvo
飮	wyvw
雙	wywc
俯	wywf
倅	wywf
犨	wywh
雧	wyws
讐	wywy
雔	wywy
雥	wywy
雦	wywy
傗	wyxl
伭	wyxy
伩	wyy
雠	wyyy
讎	wyyy
綫	xaay
縙	xabg
绒	xadt
絨	xadt
綨	xadw
繖	xaet
绀	xafg
紺	xafg
缂	xafh
緙	xafh
红	xag
紅	xag
弫	xahh
弬	xahh
繿	xahl
纜	xahq
縸	xajd
緎	xakg
彄	xakk
緢	xalg
緓	xamd
绬	xamd
彉	xamw
弡	xang
绁	xann
紲	xann
弽	xans
緤	xans
练	xanw
繱	xaqn
纄	xatp
绕	xatq
緅	xbcy
弭	xbg
鄳	xbh
弢	xbhc
绌	xbmh
絀	xbmh
弛	xbn
经	xcag
弪	xcag
纾	xcbh
紓	xcbh
繘	xcbk
缀	xccc
綴	xccc
縿	xcce
縔	xccs
経	xcfg
绎	xcfh
強	xcjy
绐	xckg
紿	xckg
緿	xckn
弝	xcn
紦	xcn
弘	xcy
紁	xcyy
绂	xdcy
紘	xdcy
紱	xdcy
纮	xdcy
毋	xde
絠	xdeg
纋	xdet
張	xdey
缛	xdff
縟	xdff
绔	xdfn
絝	xdfn
缄	xdgy
緘	xdgy
縅	xdgy
縬	xdhy
緾	xdjf
絔	xdjg
弼	xdjx
缅	xdmd
緛	xdmd
緬	xdmd
顷	xdmy
頃	xdmy
紌	xdnn
絾	xdny
縓	xdri
绮	xdsk
綺	xdsk
绑	xdtb
綁	xdtb
缭	xdui
繚	xdui
縥	xdwt
綊	xdww
紎	xdy
綒	xebg
绷	xeeg
弸	xeeg
綳	xeeg
絼	xeet
缓	xefc
緩	xefc
组	xegg
組	xegg
剶	xejh
蠡	xejj
劙	xejj
盠	xelf
绶	xepc
綬	xepc
綵	xesy
彖	xeu
绥	xevg
綏	xevg
縚	xevg
鶨	xewo
縘	xexd
级	xeyy
級	xeyy
繊	xfag
纎	xfag
纭	xfcy
紜	xfcy
紶	xfcy
駂	xfcy
繻	xfdj
繧	xffc
絓	xffg
繞	xffq
疆	xfgg
缜	xfhw
縝	xfhw
頴	xfim
颕	xfim
絿	xfiy
毌	xfk
结	xfkg
結	xfkg
繥	xfkk
缬	xfkm
纈	xfkm
續	xflm
遦	xfmp
贯	xfmu
貫	xfmu
续	xfnd
纬	xfnh
綕	xfny
綍	xfpb
続	xfpq
鸨	xfqg
绪	xftj
緒	xftj
緖	xftj
緈	xfuf
盭	xful
繨	xfup
繬	xfwk
纉	xfwm
鴇	xfwo
绫	xfwt
綾	xfwt
纣	xfy
紂	xfy
纯	xgbn
純	xgbn
絰	xgcf
绖	xgcf
緻	xgct
彑	xgd
缚	xgef
縛	xgef
綪	xgeg
弖	xgf
纡	xgfh
弙	xgfh
紆	xgfh
絚	xghg
剝	xgij
彔	xgiu
紑	xgiy
縳	xgjf
絙	xgjg
繐	xgjn
绠	xgjq
綆	xgjq
綀	xgki
缰	xglg
彊	xglg
繮	xglg
練	xgli
弻	xglx
纚	xgmx
绩	xgmy
緉	xgmy
績	xgmy
彝	xgoa
彜	xgoa
缙	xgoj
縉	xgoj
彙	xgps
彘	xgtx
弳	xgva
經	xgva
緁	xgvh
緀	xgvv
彌	xgwq
瓕	xgwy
縤	xgxi
线	xgy
纑	xhal
紴	xhcy
绯	xhdd
緋	xhdd
引	xhh
彏	xhhc
缈	xhit
緲	xhit
绰	xhjh
綽	xhjh
弔	xhk
盄	xhlf
緽	xhmy
黽	xhng
顚	xhnm
鷆	xhno
眞	xhnw
繉	xhqi
絸	xhqn
紪	xhxn
颍	xidm
潁	xidm
绡	xieg
弰	xieg
綃	xieg
弾	xijf
绱	ximk
緔	ximk
絖	xiqn
纱	xitt
紗	xitt
糸	xiu
彃	xjaf
縪	xjaf
繓	xjbc
旨	xjf
缇	xjgh
緹	xjgh
绅	xjhh
紳	xjhh
縨	xjiq
刜	xjjh
縄	xjjn
弗	xjk
缦	xjlc
縵	xjlc
緼	xjlg
缊	xjlg
鄪	xjmb
费	xjmu
費	xjmu
絏	xjnt
艴	xjqc
緆	xjqr
綶	xjsy
缆	xjtq
鴲	xjwo
绲	xjxx
緄	xjxx
缉	xkbg
緝	xkbg
绢	xkeg
弲	xkeg
絹	xkeg
紃	xkh
缋	xkhm
繢	xkhm
缱	xkhp
繾	xkhp
犟	xkjh
勥	xkjl
绳	xkjn
强	xkjy
謽	xkjy
彈	xkkf
繟	xkkf
絽	xkkg
缲	xkks
繰	xkks
縜	xkmy
织	xkwy
孧	xlbf
絪	xldy
緭	xleg
繹	xlff
纆	xlff
细	xlg
細	xlg
缳	xlge
彋	xlge
繯	xlge
綥	xlgj
絗	xlkg
纝	xlli
缌	xlny
緦	xlny
縺	xlpy
綑	xlsy
幼	xlt
糼	xlt
縷	xlvg
縕	xlwl
鴢	xlwo
缧	xlxi
縲	xlxi
纙	xlxy
繷	xmae
紻	xmdy
繃	xmee
縎	xmeg
绸	xmfk
綢	xmfk
紬	xmg
䌷	xmg
絧	xmgk
絅	xmkg
缨	xmmv
纓	xmmv
緺	xmnk
纲	xmqy
綱	xmum
網	xmun
綗	xmwk
纗	xmwk
纳	xmwy
納	xmwy
繀	xmwy
缗	xnaj
緡	xnaj
緪	xngg
縆	xngg
弓	xngn
縀	xnhc
縃	xnhe
纽	xnhf
紐	xnhf
纠	xnhh
糾	xnhh
緯	xnhh
纪	xnn
幻	xnn
乣	xnn
糺	xnn
紀	xnn
繏	xnnw
幺	xnny
糹	xnny
缪	xnwe
繆	xnwe
熲	xodm
颎	xodm
继	xonn
継	xonn
緂	xooy
繗	xoqh
缕	xovg
鬻	xoxh
粥	xoxn
綋	xpdc
縖	xpdk
综	xpfi
綜	xpfi
綄	xpfq
縇	xpgg
纻	xpgg
绽	xpgh
綻	xpgh
繽	xpgm
縯	xpgw
绾	xphn
綰	xphn
緷	xplh
綩	xpqb
紞	xpqn
缤	xprw
紵	xpsh
縡	xpuh
缩	xpwj
縮	xpwj
紽	xpxn
緍	xqaj
纸	xqan
紙	xqan
弤	xqay
緵	xqbt
縐	xqbt
绝	xqcn
絶	xqcn
絺	xqdh
繎	xqdo
繲	xqeh
弥	xqiy
絩	xqiy
绚	xqjg
絢	xqjg
絇	xqkg
絻	xqkq
纔	xqky
綯	xqrm
绹	xqrm
緫	xqrn
绉	xqvg
繺	xqvo
弞	xqwy
约	xqyy
約	xqyy
弧	xrcy
絈	xrg
紤	xrh
絑	xriy
線	xriy
缐	xriy
绵	xrmh
綿	xrmh
綼	xrtf
紩	xrwy
纅	xrxs
缴	xryt
繳	xryt
緸	xsfg
缥	xsfi
縹	xsfi
絤	xsg
絊	xsgg
綇	xsgg
糽	xsh
缃	xshg
緗	xshg
彁	xskk
綝	xssy
絉	xsyy
绛	xtah
絳	xtah
张	xtay
鄊	xtbb
絁	xtbn
觺	xtde
絬	xtdg
疑	xtdh
肄	xtdh
綘	xtdh
繑	xtdk
颖	xtdm
穎	xtdm
缝	xtdp
縫	xtdp
欵	xtdw
矤	xtdy
乡	xte
绣	xtet
綉	xtet
缍	xtfg
紝	xtfg
綞	xtfg
纴	xtfg
纤	xtfh
绗	xtfh
絎	xtfh
缵	xtfm
纘	xtfm
綎	xtfp
緟	xtgf
纁	xtgo
縰	xthh
绺	xthk
綹	xthk
綖	xthp
緮	xtjt
蚃	xtju
络	xtkg
絡	xtkg
總	xtln
繌	xtlt
匕	xtn
纥	xtnn
紇	xtnn
繙	xtol
鄕	xtrb
绦	xtsy
縦	xtuh
终	xtuy
終	xtuy
郷	xtvb
緌	xtvg
飨	xtwe
縱	xtwh
鄉	xtyb
饗	xtye
蠁	xtyj
響	xtyj
嚮	xtyk
絣	xuah
織	xuaj
縌	xubp
縒	xuda
绻	xudb
綣	xudb
絴	xudh
缮	xudk
繕	xudk
繝	xueg
繸	xuep
彅	xuev
绊	xufh
紏	xufh
絆	xufh
弹	xujf
繶	xujn
縂	xukn
綐	xukq
缯	xulj
繒	xulj
缔	xuph
締	xuph
縍	xupy
纐	xuqm
絘	xuqw
绞	xuqy
絞	xuqy
繜	xusf
緧	xusg
缣	xuvo
縑	xuvo
缢	xuwl
縊	xuwl
鶸	xuxo
绨	xuxt
綈	xuxt
弱	xuxu
絕	xvcn
縁	xvey
繣	xvfg
紣	xvfh
彇	xvfj
繡	xvfj
绿	xviy
緑	xviy
缫	xvjs
繅	xvjs
绍	xvkg
弨	xvkg
紹	xvkg
缁	xvlg
緇	xvlg
繍	xvoj
綅	xvpc
糿	xvt
匘	xvtq
綛	xvyn
纫	xvyy
纨	xvyy
紈	xvyy
紉	xvyy
総	xwcn
缎	xwdc
緞	xwdc
絥	xwdy
紾	xwet
绘	xwfc
絵	xwfc
縩	xwfi
弣	xwfy
紨	xwfy
綸	xwga
絟	xwgg
緰	xwgj
繪	xwgj
给	xwgk
給	xwgk
缏	xwgq
緶	xwgq
縧	xwhs
紒	xwjh
緥	xwks
缑	xwnd
緱	xwnd
缒	xwnp
縋	xwnp
纀	xwoy
絍	xwtf
纷	xwvt
紛	xwvt
纖	xwwg
緃	xwwh
綌	xwwk
绤	xwwk
纵	xwwy
纶	xwxn
紷	xwyc
维	xwyg
維	xwyg
紟	xwyn
畿	xxal
繈	xxcj
紭	xxcy
幾	xxdy
缘	xxey
緣	xxey
坒	xxff
毕	xxfj
繩	xxg
丝	xxgf
鸶	xxgg
綠	xxgi
斷	xxgr
毙	xxgx
紖	xxhh
纼	xxhh
顈	xxim
鷥	xxio
絲	xxiy
绋	xxjh
紼	xxjh
繦	xxkj
比	xxn
弜	xxn
毖	xxnt
粊	xxou
皆	xxrf
勓	xxrl
鶛	xxro
枈	xxsu
毞	xxtn
纰	xxxn
紕	xxxn
繼	xxxn
纟	xxxx
彍	xyaw
纊	xyaw
缡	xybc
縭	xybc
弴	xybg
綧	xybg
统	xycq
統	xycq
絋	xycy
紸	xygg
弶	xyiy
綡	xyiy
缠	xyjf
纏	xyjf
纒	xyjf
緕	xyjg
纃	xyjg
縗	xyke
纕	xyke
缞	xyke
繵	xylg
缟	xymk
縞	xymk
编	xyna
編	xyna
綟	xynd
絯	xynw
綂	xyqn
纺	xyt
纩	xyt
紡	xyt
絒	xyth
縼	xyth
綷	xywf
鶭	xywo
繂	xyxf
縴	xyxh
纞	xyxn
婱	xyxv
弦	xyxy
絃	xyxy
纹	xyy
紋	xyy
毑	xyyb
袰	xyye
母	xyyi
试	yaag
試	yaag
诫	yaah
誡	yaah
諓	yaay
度	yaci
剫	yacj
诺	yadk
諾	yadk
谌	yadn
諶	yadn
廝	yadr
諆	yadw
讛	yafc
詌	yafg
諽	yafh
谋	yafs
謀	yafs
讧	yag
訌	yag
譁	yagf
诓	yagg
誆	yagg
衺	yahe
讶	yaht
庌	yaht
訝	yaht
谟	yajd
庴	yajd
謨	yajd
諎	yajg
譪	yajn
谨	yakg
廑	yakg
謹	yakg
謳	yakk
讌	yako
䜩	yako
讙	yaky
庿	yald
鄺	yamb
席	yamh
懬	yamn
廣	yamw
讵	yang
詎	yang
詍	yann
谍	yans
諜	yans
庹	yany
鹧	yaog
庶	yaoi
鷓	yaoo
遮	yaop
廗	yaqh
谮	yaqj
譖	yaqj
讴	yaqy
護	yawc
诬	yaww
庻	yaww
誣	yaww
誮	yawx
谎	yayq
謊	yayq
讘	ybbb
郭	ybbh
诹	ybcy
諏	ybcy
讔	yben
享	ybf
斈	ybf
斊	ybf
廰	ybfn
誀	ybg
廳	ybgn
邝	ybh
邡	ybh
詜	ybhc
亨	ybj
嚲	ybkf
离	ybmc
诎	ybmh
詘	ybmh
離	ybmy
訑	ybn
烹	ybou
鹑	ybqg
墪	ybtf
憝	ybtn
鐜	ybtq
撉	ybtr
敦	ybty
亸	ybuf
塾	ybvf
熟	ybvo
孰	ybvy
廕	ybwc
鶉	ybwo
弃	ycaj
棄	ycas
袤	ycbe
序	ycbk
谲	ycbk
譎	ycbk
諁	yccc
謲	ycce
育	ycef
诵	yceh
誦	yceh
逳	ycep
裛	yceu
褭	yceu
译	ycfh
広	yci
旀	yciy
袬	ycke
诒	yckg
詒	yckg
夣	yclq
充	ycqb
诶	yctd
誒	yctd
誜	ycwt
訍	ycyy
詙	ydcy
詴	ydeg
顏	ydem
彥	yder
誫	ydfe
譇	ydfj
誇	ydfn
诂	ydg
詁	ydg
諴	ydgy
緳	ydhi
譿	ydhn
廈	ydht
庆	ydi
诔	ydiy
誄	ydiy
庵	ydjn
斋	ydmj
庬	ydne
訧	ydnn
诚	ydny
誠	ydny
诙	ydoy
詼	ydoy
謜	ydri
旑	ydsk
诪	ydtf
產	ydtg
讈	ydth
庞	ydxe
彣	yee
谖	yefc
諼	yefc
诅	yegg
詛	yegg
裔	yemk
廫	yene
谣	yerm
謡	yerm
譌	yeto
衣	yeu
哀	yeu
謟	yevg
謑	yexd
诼	yeyy
訯	yeyy
諑	yeyy
庋	yfci
廅	yfcl
詓	yfcy
庄	yfd
譳	yfdj
诖	yffg
詿	yffg
庤	yffi
謣	yffn
譊	yffq
诗	yffy
詩	yffy
计	yfh
讦	yfh
計	yfh
訐	yfh
謓	yfhw
廟	yfje
謿	yfje
講	yfjf
讲	yfjh
廚	yfkf
诘	yfkg
詰	yfkg
譆	yfkk
讀	yflm
讟	yfly
谳	yfmd
諵	yfmf
读	yfnd
譸	yfnf
讳	yfnh
誌	yfny
誖	yfpb
読	yfpq
庑	yfqv
庨	yftb
誟	yftb
詽	yftf
诸	yftj
諸	yftj
褻	yfwe
譛	yfwj
廧	yfwk
讃	yfwm
庱	yfwt
讨	yfy
対	yfy
討	yfy
庒	yfyi
斌	ygah
訮	ygah
贇	ygam
赟	ygam
庉	ygbn
訰	ygbn
庢	ygcf
誈	ygcf
主	ygd
请	ygeg
請	ygeg
庯	ygey
誧	ygey
諘	ygey
訏	ygfh
证	yghg
証	yghg
諌	ygji
譓	ygjn
语	ygkg
語	ygkg
誎	ygki
讍	ygkk
諨	ygkl
谏	ygli
諫	ygli
殶	ygmc
廲	ygmx
謮	ygmy
瓬	ygny
迬	ygpd
廒	ygqt
謸	ygqt
评	yguh
評	yguh
誙	ygva
誱	ygvh
讞	yhad
谑	yhag
謔	yhag
謯	yhag
譃	yhag
謼	yhah
廬	yhal
諕	yham
詖	yhcy
诐	yhcy
诽	yhdd
誹	yhdd
裵	yhde
韲	yhdg
让	yhg
訨	yhg
諔	yhic
店	yhkd
詀	yhkg
斍	yhqb
誢	yhqn
卞	yhu
訿	yhxn
庛	yhxv
讣	yhy
訃	yhy
应	yid
鹫	yidg
蹵	yidh
就	yidn
鷲	yido
诮	yieg
誚	yieg
氷	yii
誻	yijg
剠	yijh
勍	yilt
廠	yimt
譡	yipl
讜	yipo
谠	yipq
訬	yitt
京	yiu
鶁	yiwo
亯	yjf
斉	yjf
齊	yjf
鄽	yjfb
裏	yjfe
裏	yjfe
廛	yjff
斎	yjfi
髙	yjfk
詚	yjgg
諟	yjgh
諹	yjgr
刘	yjh
齑	yjhg
齏	yjhg
訷	yjhh
亰	yjiu
齋	yjiu
齐	yjj
亣	yjj
誯	yjjg
剂	yjjh
剤	yjjh
劑	yjjh
螡	yjju
螤	yjjw
谩	yjlc
謾	yjlc
齍	yjlf
齎	yjmu
庽	yjmy
恴	yjnu
齌	yjou
谒	yjqn
謁	yjqn
裹	yjse
课	yjsy
課	yjsy
謃	yjtg
蚉	yju
斔	yjvw
諿	ykbg
吝	ykf
误	ykgd
誤	ykgd
衰	ykge
训	ykh
訓	ykh
衷	ykhe
訲	ykhh
谴	ykhp
譴	ykhp
讉	ykhp
襄	ykke
譂	ykkf
勷	ykkl
谔	ykkn
諤	ykkn
譟	ykks
讝	ykkt
瓤	ykky
詋	ykqn
识	ykwy
廙	ylaw
畆	ylcy
谓	yleg
謂	yleg
亩	ylf
畗	ylf
譯	ylff
訵	ylg
譞	ylge
褱	ylie
库	ylk
庘	ylk
庫	ylk
皽	ylkc
亶	ylkg
鹯	ylkg
禀	ylki
勯	ylkl
颤	ylkm
顫	ylkm
氈	ylkn
鸇	ylko
邅	ylkp
稟	ylkt
廤	ylkx
讄	ylll
諰	ylny
謰	ylpy
畝	ylqy
廔	ylvd
謱	ylvg
谡	ylwt
謖	ylwt
畒	ylwy
为	ylyi
譨	ymae
亢	ymb
邟	ymbh
设	ymcy
設	ymcy
庙	ymd
諯	ymdj
颃	ymdm
頏	ymdm
詇	ymdy
调	ymfk
調	ymfk
詷	ymgk
讪	ymh
訕	ymh
市	ymhj
廁	ymjk
髜	ymka
鄗	ymkb
敲	ymkc
毃	ymkc
高	ymkf
詗	ymkg
诇	ymkg
髝	ymkl
髚	ymkm
鶮	ymko
槀	ymks
髞	ymks
稾	ymkt
髛	ymkv
歊	ymkw
劥	ymlt
廮	ymmv
讥	ymn
諣	ymnk
迒	ympv
讽	ymqy
諷	ymtj
誷	ymun
讗	ymwk
讷	ymwy
訥	ymwy
訉	ymyy
肈	ynah
啔	ynak
邙	ynbh
誳	ynbm
譀	ynbt
戾	yndi
戻	yndi
户	yne
肩	yned
肓	ynef
望	yneg
顅	ynem
鵳	yneo
讯	ynfh
訊	ynfh
廜	ynfj
诩	yng
詡	yng
词	yngk
詞	yngk
扉	ynhd
諝	ynhe
谞	ynhe
盲	ynhf
訆	ynhh
諱	ynhh
扂	ynhk
応	yni
永	ynii
昶	ynij
鄜	ynjb
麛	ynjb
麚	ynjc
麌	ynjd
朚	ynje
麎	ynje
麝	ynjf
塵	ynjf
麈	ynjg
麆	ynjg
麠	ynjg
麟	ynjh
麖	ynji
蝱	ynjj
麘	ynjj
麞	ynjj
麡	ynjj
麏	ynjk
麐	ynjk
麔	ynjk
麢	ynjk
麂	ynjm
麅	ynjn
麋	ynjo
廌	ynjo
麃	ynjo
鏖	ynjq
麍	ynjq
麑	ynjq
麜	ynjs
麇	ynjt
慶	ynjt
麕	ynjt
麣	ynjt
麒	ynjw
鹿	ynjx
麀	ynjx
麤	ynjx
麙	ynjy
扈	ynkc
启	ynkd
吂	ynkf
啟	ynkt
廦	ynku
赢	ynky
嬴	ynky
羸	ynky
蠃	ynky
臝	ynky
贏	ynky
驘	ynky
鸁	ynky
扁	ynma
騗	ynmc
帍	ynmh
扃	ynmk
翩	ynmn
鶣	ynmo
遍	ynmp
甂	ynmy
记	ynn
記	ynn
氓	ynna
扇	ynnd
戺	ynnn
焈	ynno
忘	ynnu
戹	ynnv
譔	ynnw
誋	ynny
扊	ynoo
巟	ynqb
扅	ynqq
謵	ynrg
杗	ynsu
郂	yntb
肇	ynth
綮	ynti
刻	yntj
晵	yntj
啓	yntk
扄	yntk
劾	yntl
谧	yntl
衁	yntl
謐	yntl
颏	yntm
賌	yntm
頦	yntm
棨	ynts
亥	yntw
欬	yntw
废	ynty
忞	ynu
悥	ynu
戽	ynuf
謘	ynuh
亡	ynv
妄	ynvf
肁	ynvh
谬	ynwe
廖	ynwe
謬	ynwe
顧	ynwm
鳸	ynwo
雇	ynwy
诀	ynwy
訣	ynwy
訫	yny
房	ynye
扆	ynye
訳	ynyy
弈	yoaj
孪	yobf
变	yocu
奕	yodu
譵	yogf
蛮	yoju
帟	yomh
峦	yomj
脔	yomw
恋	yonu
燮	yooc
爕	yooo
夑	yoot
谈	yooy
談	yooy
迹	yopi
谜	yopy
謎	yopy
銮	yoqf
鸾	yoqg
挛	yorj
栾	yosu
変	yotu
亦	you
娈	yovf
鵉	yowo
弯	yoxb
詸	yoy
亪	yoyu
這	ypd
谊	ypeg
誼	ypeg
豪	ypeu
誴	ypfi
亴	ypfv
諠	ypgg
諚	ypgh
这	ypi
谉	ypjh
膏	ypke
诨	yplh
諢	yplh
亮	ypmb
廀	ypoc
訦	ypqn
詝	ypsh
亭	ypsj
诧	ypta
亳	ypta
詫	ypta
讅	yptl
毫	yptn
稁	yptu
詑	ypxn
諙	yqaj
椉	yqas
謋	yqas
底	yqay
诋	yqay
詆	yqay
訩	yqbh
讻	yqbh
謅	yqbt
诡	yqdb
詭	yqdb
誵	yqde
谵	yqdy
譫	yqdy
廨	yqeh
裦	yqge
褎	yqge
褏	yqge
襃	yqge
义	yqi
庣	yqii
誂	yqiy
询	yqjg
詢	yqjg
訽	yqkg
詺	yqkg
谗	yqku
讒	yqky
讂	yqmt
袌	yqne
庖	yqnv
廯	yqod
諊	yqoy
詾	yqqb
袲	yqqe
廞	yqqw
訤	yqqy
誃	yqqy
謠	yqrm
诳	yqtg
誑	yqtg
诌	yqvg
谄	yqvg
諂	yqvg
诤	yqvh
諍	yqvh
廇	yqyl
訋	yqyy
庪	yrfc
諻	yrgg
诟	yrgk
詬	yrgk
訢	yrh
䜣	yrh
謕	yrhm
诛	yriy
誅	yriy
庍	yrk
廡	yrlo
譕	yrlo
旆	yrmh
旊	yrny
廆	yrqc
謉	yrqc
褢	yrqe
庳	yrtf
諀	yrtf
螷	yrtj
蠯	yrtj
亵	yrve
袠	yrwe
詄	yrwy
廏	yrxc
廐	yrxq
譤	yryt
诉	yryy
訴	yryy
諲	ysfg
謤	ysfi
庮	ysgd
订	ysh
訂	ysh
廂	yshd
床	ysi
谭	ysjh
譚	ysjh
庁	ysk
诃	yskg
訶	yskg
謌	yskk
魔	yssc
麽	yssc
黀	yssc
磨	yssd
靡	yssd
塺	yssf
犘	yssh
麻	yssi
縻	yssi
劘	yssj
黁	yssj
麿	yssk
黂	yssm
麾	yssn
糜	ysso
爢	ysso
摩	yssr
穈	ysst
麼	yssx
諃	yssy
庲	ysww
誺	ysww
訹	ysyy
託	ytan
讬	ytan
旗	ytaw
斿	ytbg
施	ytbn
遊	ytbp
庅	ytci
话	ytdg
話	ytdg
旖	ytdk
譑	ytdk
訞	ytdy
膂	ytee
诱	ytet
誘	ytet
膐	ytew
旅	ytey
諈	ytfg
许	ytfh
許	ytfh
诰	ytfk
誥	ytfk
讚	ytfm
庭	ytfp
誔	ytfp
诜	ytfq
詵	ytfq
諥	ytgf
廭	ytgm
旇	ythc
诈	ythf
詐	ythf
詯	ythg
诞	ythp
誕	ythp
旓	ytie
誗	ytjh
詻	ytkg
謥	ytln
谢	ytmf
謝	ytmf
斾	ytmh
斻	ytmn
旃	ytmy
旋	ytnh
讫	ytnn
訖	ytnn
為	ytno
旎	ytnx
旙	ytol
譒	ytol
旐	ytqi
謻	ytqq
旂	ytrh
誐	ytry
旚	ytsi
族	yttd
旌	yttg
旛	yttl
旄	yttn
鷟	ytto
庝	ytui
旞	ytup
诿	ytvg
諉	ytvg
帰	ytvh
旟	ytvw
旍	ytwc
旝	ytwj
譗	ytwk
诲	ytxy
誨	ytxy
放	yty
訸	yty
旜	ytyg
州	ytyh
旒	ytyq
誁	yuah
旘	yuaj
識	yuaj
庰	yuak
详	yudh
詳	yudh
庠	yudk
龐	yued
譋	yueg
譾	yuen
譢	yuep
谫	yuev
謭	yuev
譲	yufe
詊	yufh
谰	yugi
斓	yugi
斕	yugi
讕	yugi
議	yugy
谙	yujg
諳	yujg
譩	yujn
廍	yukb
说	yukq
説	yukq
譄	yulj
谪	yumd
謫	yumd
謪	yumk
讁	yump
諩	yuog
谱	yuoj
譜	yuoj
谛	yuph
諦	yuph
谤	yupy
謗	yupy
谘	yuqk
諮	yuqk
讇	yuqv
詨	yuqy
譐	yusf
谚	yute
諺	yute
劆	yuvj
廉	yuvo
谦	yuvo
謙	yuvo
谥	yuwl
謚	yuwl
譭	yvac
郎	yvcb
廄	yvcc
郒	yvcc
朗	yvce
塱	yvcf
剆	yvcj
勆	yvcl
欴	yvcw
詉	yvcy
郞	yveb
鄘	yveb
郎	yveb
庸	yveh
良	yvei
鷛	yveo
裒	yveu
詪	yvey
旔	yvfp
鄌	yvhb
廋	yvhc
謏	yvhc
唐	yvhk
鶶	yvho
康	yvii
诏	yvkg
詔	yvkg
廱	yvky
亹	yvmg
斖	yvmg
訅	yvn
誛	yvpc
誽	yvqn
鹒	yvwg
庚	yvwi
庾	yvwi
赓	yvwm
賡	yvwm
鶊	yvwo
谀	yvwy
諛	yvwy
譅	yvyh
認	yvyn
訒	yvyy
訙	yvyy
讱	yvyy
庺	ywcs
讼	ywcy
訟	ywcy
诊	ywet
診	ywet
府	ywfi
焤	ywfo
廃	ywfq
腐	ywfw
詂	ywfy
論	ywga
讑	ywga
诠	ywgg
詮	ywgg
谕	ywgj
廥	ywgj
諭	ywgj
譮	ywgj
詥	ywgk
諡	ywgl
證	ywgu
譣	ywgw
庂	ywi
亱	ywjg
斺	ywjh
庎	ywjk
褒	ywke
說	ywkq
詤	ywnq
庥	ywsi
庩	ywti
鵺	ywto
夜	ywty
乻	ywun
旕	ywux
於	ywuy
鳼	ywvo
鴋	ywvo
鴍	ywvo
訜	ywvt
膺	ywwe
座	ywwf
卒	ywwf
鹰	ywwg
谶	ywwg
讖	ywwg
噟	ywwk
顇	ywwm
應	ywwn
鷹	ywwo
譍	ywwy
雜	ywwy
廢	ywxc
论	ywxn
讹	ywxn
訛	ywxn
认	ywy
詅	ywyc
謢	ywyc
﨎	ywyc
谁	ywyg
誰	ywyg
犫	ywyh
誝	ywyk
謒	ywyk
谂	ywyn
庈	ywyn
訡	ywyn
諗	ywyn
谯	ywyo
譙	ywyo
庼	yxdm
廎	yxdm
謴	yxfm
譝	yxg
訠	yxhh
率	yxif
玅	yxit
紊	yxiu
诣	yxjg
詣	yxjg
鄐	yxlb
畜	yxlf
詏	yxlt
牽	yxph
饔	yxte
玈	yxte
壅	yxtf
譺	yxth
罋	yxtm
雍	yxty
甕	yxty
玄	yxu
庀	yxv
孿	yxxb
奱	yxxd
卛	yxxf
矕	yxxh
灓	yxxi
曫	yxxj
蠻	yxxj
巒	yxxm
戀	yxxn
鸞	yxxo
鑾	yxxq
谐	yxxr
攣	yxxr
諧	yxxr
欒	yxxs
變	yxxt
庇	yxxv
孌	yxxv
臠	yxxw
彎	yxxx
譏	yxxy
䜌	yxxy
孶	yxyb
玆	yxyx
誸	yxyx
謶	yyao
廓	yybb
謧	yybc
谆	yybg
諄	yybg
譈	yybt
旈	yycq
庡	yyei
堃	yyff
亠	yyg
誩	yyg
訁	yygg
註	yygg
方	yygt
广	yygt
文	yygy
谅	yyiy
諒	yyiy
讓	yyke
譠	yylg
廪	yyli
丶	yyll
乀	yyll
乁	yyll
廩	yylt
謞	yymk
讠	yyn
谝	yyna
斒	yyna
諞	yyna
庐	yyne
詠	yyni
謆	yynn
该	yynw
該	yynw
廘	yynx
譹	yype
諪	yyps
议	yyqy
访	yyt
訪	yyt
詶	yyth
譧	yyuo
廊	yyvb
斏	yyve
誏	yyve
谇	yywf
誶	yywf
詃	yyxy
譶	yyyf
言	yyyy
