工	aaaa
菚	aaau
匞	aad
匿	aadk
慝	aadn
茙	aadr
蘜	aafo
菣	aahc
茝	aahh
茞	aahh
藍	aahl
藖	aahm
芽	aaht
虦	aahw
蕥	aahy
剗	aajh
戒	aak
蓳	aakg
蓲	aakk
盞	aalf
蘳	aamf
蘣	aamg
苣	aanf
葉	aans
苉	aaqb
蔕	aaqh
蘙	aatn
荛	aatq
戔	aau
藏	aauh
苆	aavr
匶	aawe
荗	aawu
蒆	aawv
莁	aaww
茿	aawy
式	aayi
芅	aayu
藂	abci
萾	abcl
菆	abcu
荫	abef
蘟	aben
茸	abf
芓	abf
邛	abh
卭	abh
匩	abhg
菡	abib
蒸	abio
荪	abiu
节	abj
藬	abkm
莻	abkx
茁	abmj
芤	abnb
艿	abr
菰	abry
蔯	absj
蕯	abtg
蓀	abti
薩	abug
萨	abut
匜	abv
蔭	abwc
蒢	abws
蘵	abyj
芨	abyu
茎	acaf
匥	acak
芭	acb
蔘	acce
蓪	acep
苔	ackf
葈	acks
蓩	acne
芧	acnh
蓣	acnm
蕷	acnm
鶜	acno
葇	acns
茅	acnt
荾	acwt
芆	acyu
蔵	adah
莽	adaj
蕻	adaw
苊	adbb
苃	adcu
茇	adcy
藞	addd
戎	ade
葫	adef
苈	ader
萇	adeu
苦	adf
莾	adfa
莀	adfe
蓐	adff
萘	adfi
荂	adfn
葴	adgk
葳	adgv
荐	adhb
葜	adhd
茬	adhf
苤	adhg
蒧	adhk
芣	adhu
蔧	adhv
菴	adjn
蘷	adjt
鄀	adkb
若	adkf
蠚	adkj
匲	adkk
惹	adkn
逽	adkp
荋	admj
蒇	admu
蕆	admu
项	admy
項	admy
荿	adnb
荙	adpu
蒝	adri
藶	adth
茂	adu
芖	adu
蕨	aduw
蕼	advg
蘛	adwe
菶	adwg
藄	adwi
萶	adwj
葚	adwn
蓁	adwt
萁	adwu
匧	adww
莢	adww
茏	adxy
弎	adyi
葢	adyl
芼	aeb
菔	aebc
莩	aebf
萉	aecb
薍	aecn
蕦	aedm
荔	aeee
萠	aeef
蓞	aeef
蒯	aeej
荕	aeer
萲	aegc
莇	aege
苴	aegf
巭	aegu
藇	aegw
蓃	aehc
苚	aej
薶	aejf
﨟	aejn
茄	aekf
虋	aemv
蕣	aepg
薆	aept
萖	aeqb
葋	aeqk
蕮	aeqo
艻	aer
藐	aerq
菜	aesu
功	aet
葄	aetf
蘨	aeti
蔿	aeto
散	aety
蕂	aeue
藤	aeui
虅	aeuo
荽	aevf
苏	aewu
萸	aewu
蒵	aexd
鞯	afab
韄	afac
鞴	afae
鞲	afaf
鞾	afag
鞳	afak
韊	afal
蕡	afam
靾	afan
韉	afao
鞢	afas
韈	afaw
靸	afby
鞁	afby
蓋	afcl
靶	afcn
鞣	afcs
芸	afcu
芰	afcu
靫	afcy
薷	afdj
鞑	afdp
蘎	afec
鞵	afed
鞱	afee
靻	afeg
勒	afet
鞖	afev
苷	aff
芏	aff
蕓	affc
鞋	afff
葑	afff
茥	afff
靯	affg
靬	affh
鞊	affk
韇	affm
韃	affp
蕘	affq
韁	afgg
靰	afgq
鞕	afgr
靺	afgs
鞆	afgw
鞐	afhh
蒖	afhw
鞘	afie
鞺	afif
蒜	afii
鞜	afij
鞩	afij
鞝	afik
革	afj
芉	afj
靼	afjg
鞸	afjg
鞮	afjh
鞰	afjl
鞨	afjn
韅	afjo
薣	afkc
鞙	afke
薹	afkf
鞓	afkg
蘦	afkk
虂	afkk
鞼	afkm
薳	afkp
鞇	afld
蕾	aflf
匵	aflm
藚	aflm
鞻	aflv
鞅	afmd
萳	afmf
靹	afmw
贰	afmy
貳	afmy
芌	afnb
薵	afnf
靵	afng
苇	afnh
韀	afoo
鞚	afpa
荸	afpb
葧	afpe
鞍	afpv
芜	afqb
芫	afqb
鞉	afqi
鞄	afqn
鞠	afqo
鞔	afqq
荺	afqu
莰	afqw
鞫	afqy
靮	afqy
韂	afqy
鞞	afrf
靳	afrh
鞡	afru
靪	afsh
藉	afsj
韆	afsp
藕	afsy
著	aftj
蓍	aftj
鞒	aftj
鞽	aftk
鞦	afto
荖	aftx
鞂	afty
苿	afu
蕔	afuc
靽	afug
鞧	afug
蔷	afuk
鞛	afuk
薘	afup
蓻	afuy
鞀	afvk
鞬	afvp
靭	afvy
靱	afvy
鞎	afvy
鞥	afwa
蕶	afwc
藝	afwc
薔	afwk
鞈	afwk
靲	afwn
爇	afwo
鞭	afwr
菱	afwt
靴	afwx
藿	afwy
蓺	afwy
鞃	afxc
靿	afxe
靷	afxh
鞿	afxw
鞟	afyb
鞹	afyb
蘾	afye
甙	afyi
弍	afyi
華	agag
荆	agaj
茾	agaj
荊	agaj
鷨	agao
邼	agbh
萅	agbj
芚	agbn
荎	agcf
菿	agcj
匡	agd
菾	agdn
菁	agef
蕤	ageg
藸	agej
蓫	agep
劻	aget
芋	agfj
廿	aghg
艹	aghh
卄	aghh
蔫	agho
芐	aghu
莍	agiy
蓴	agjf
荁	agjg
蕙	agjn
莄	agjr
菫	agkg
蒚	agkh
蘁	agkk
葍	agkl
虉	agko
荳	agku
薑	aglg
芾	agmh
蓸	agmj
颟	agmm
蔶	agmu
苪	agmw
黃	agmw
七	agn
匚	agn
匸	agn
巧	agnn
戈	agny
瓨	agny
葬	agqa
塟	agqf
薤	agqg
茢	agqj
薚	agqr
蔜	agqt
薞	agqv
茉	agsu
廾	agth
芙	agu
荚	agud
苹	aguf
莱	agus
莖	agva
葝	agve
萐	agvh
萋	agvv
蕐	agwg
薾	agwr
荑	agxw
匤	agyi
弌	agyi
萛	ahaj
菲	ahdd
匪	ahdd
韮	ahdg
薉	ahdh
繤	ahdi
蕜	ahdn
蔖	aheg
芷	ahf
苜	ahf
蘧	ahgp
蕋	ahhh
蘋	ahhm
荹	ahhr
蘃	ahhs
匷	ahhy
菽	ahic
茮	ahiu
苫	ahkf
颐	ahkm
赜	ahkm
賾	ahkm
頤	ahkm
巸	ahkn
熙	ahko
媐	ahkv
蘆	ahll
藘	ahln
蓾	ahlo
孯	ahnb
臤	ahnc
硻	ahnd
腎	ahne
堅	ahnf
朢	ahng
臣	ahnh
卧	ahnh
緊	ahni
蜸	ahnj
臨	ahnk
監	ahnl
盬	ahnl
鹽	ahnl
賢	ahnm
贒	ahnm
頣	ahnm
薡	ahnn
煕	ahno
覧	ahnq
覽	ahnq
鋻	ahnq
鍳	ahnq
鑒	ahnq
掔	ahnr
擥	ahnr
竪	ahnu
豎	ahnu
婜	ahnv
臥	ahnw
譼	ahny
蔝	ahou
莧	ahqb
薒	ahqo
萈	ahqy
邪	ahtb
牙	ahte
鸦	ahtg
鴉	ahto
迓	ahtp
雅	ahty
萀	ahwb
藈	ahwd
茈	ahxb
茳	aiaf
蘫	aial
菃	aian
蕖	aias
葓	aiaw
范	aibb
菠	aibu
蔢	aibv
菭	aick
莦	aief
菹	aieg
萷	aiej
蔆	aift
蔳	aige
萍	aigf
茪	aigq
蔋	aihc
东	aii
莎	aiit
蕰	aijl
蘯	aijl
蕩	aijr
蕅	aijy
藻	aiks
薀	aill
荡	ainr
莐	aipq
鸫	aiqg
萢	aiqn
蒎	aire
萡	airf
薄	aisf
薸	aisi
藫	aisj
菏	aisk
蒲	aisu
莯	aisu
萿	aitd
落	aitk
藩	aitl
蔽	aitu
虌	aitx
汞	aiu
蓱	aiua
蓡	aivc
薓	aivc
葏	aivg
菬	aivk
蒅	aivs
薻	aivs
莈	aiwc
虃	aiwg
蕍	aiwj
蒤	aiws
蒞	aiwu
匯	aiwy
蓅	aiyk
薃	aiyk
茫	aiyn
蒗	aiyv
蓽	ajag
蕞	ajbc
皵	ajby
鄚	ajdb
募	ajde
墓	ajdf
蓦	ajdg
幕	ajdh
暮	ajdj
蟇	ajdj
慕	ajdn
驀	ajdo
摹	ajdr
莫	ajdu
謩	ajdy
萌	ajef
昔	ajf
荲	ajff
蒔	ajff
莳	ajfu
划	ajh
萺	ajhf
草	ajj
菖	ajjf
剒	ajjh
蕌	ajjj
蔓	ajlc
蒀	ajlf
勱	ajme
躉	ajmh
蠆	ajmj
邁	ajmp
萬	ajmy
逪	ajpd
鹊	ajqg
葛	ajqn
鵲	ajqo
斮	ajrh
茰	ajru
菒	ajsu
菓	ajsu
葃	ajtf
虄	ajtg
蓝	ajtl
茧	aju
郾	ajvb
匽	ajvd
鶠	ajvo
菎	ajxx
葺	akbf
蕺	akby
叵	akd
戓	akd
莂	akej
菋	akfu
尀	akfy
鄞	akgb
或	akgd
戜	akgd
茣	akgd
勤	akge
堇	akgf
囏	akgk
惑	akgn
懃	akgn
戁	akgn
觐	akgq
覲	akgq
彧	akgr
斳	akgr
艱	akgv
歎	akgw
歏	akgw
臡	akgw
難	akgy
蕗	akhk
匮	akhm
蒉	akhm
匱	akhm
蕢	akhm
莡	akhu
鄿	akkb
酄	akkb
敺	akkc
毆	akkc
勸	akke
莒	akkf
匰	akkf
蕇	akkf
鹳	akkg
剾	akkj
飌	akkj
區	akkk
虈	akkk
颧	akkm
顴	akkm
萼	akkn
蕚	akkn
鷗	akko
鸛	akko
觀	akkq
蘄	akkr
歐	akkw
歡	akkw
甌	akky
雚	akky
蒷	akmu
莴	akmw
酀	akub
燕	akuo
鷰	akuo
嬊	akuv
荶	akwn
蓶	akwy
蔮	alag
蔑	alaw
蘻	albi
藣	alcx
蘮	aldj
蒽	aldn
茵	aldu
莮	aler
苗	alf
薗	alfe
薯	alfj
蓒	alfj
葨	alge
莗	alj
匣	alk
茴	alkf
蘲	allf
虆	alli
藟	alll
蘽	alls
蕒	almu
葸	alnu
薎	alpa
鄸	alpb
蘉	alpc
瞢	alph
顭	alpm
夢	alpq
莲	alpu
蓮	alpu
薨	alpx
甍	alpy
鹋	alqg
薥	alqj
鶓	alqo
萝	alqu
蔪	alrj
菌	altu
蔨	alub
蔞	alvf
藪	alvt
匦	alvv
匭	alvv
蒕	alwl
莔	alwm
苬	alwu
蔂	alxi
蘿	alxy
藅	alyj
蕽	amae
鶧	amdo
英	amdu
蘴	amdu
蓇	amef
苖	amf
苒	amff
冓	amff
斠	amff
顜	amfm
遘	amfp
觏	amfq
覯	amfq
茼	amgk
繭	amhj
芇	amhj
匝	amhk
萜	amhk
顢	amhm
荝	amjj
萴	amjj
苘	amkf
蘡	ammv
萵	amnk
薖	amnp
慐	amnu
苋	amqb
贡	amu
貢	amu
菵	amun
斢	amwf
黊	amwf
黈	amwg
黇	amwk
黅	amwn
鷬	amwo
黆	amwq
黄	amwu
芮	amwu
萞	amwx
苠	anab
艺	anb
芑	anb
巨	and
荱	aneb
苢	anf
蔚	anff
藯	anfn
斲	anfr
葭	anhc
葿	anhf
蔬	anhk
蕸	anhp
荍	anht
螶	anjj
葦	ankg
蘗	anks
薜	anku
勚	anme
勩	anme
贳	anmu
貰	anmu
乬	annb
巪	annb
蕊	annn
蘂	anns
迣	anpv
枼	ansu
苾	antr
芯	anu
荬	anud
世	anv
戉	anv
蓼	anwe
芵	anwu
藋	anwy
苨	anxb
蘹	anye
忒	anyi
荩	anyu
苡	anyw
蓆	aoah
蔗	aoao
薠	aodm
蘱	aodm
蓭	aodn
蕿	aoec
薦	aogo
蔊	aojf
藀	aooo
菼	aoou
蒾	aopu
菧	aoqy
蘑	aosd
蘼	aosd
藦	aosr
蔴	aoss
炗	aou
苂	aou
薱	aouf
薕	aouw
蒌	aovf
蓎	aovk
薮	aovt
菮	aovw
蓙	aowf
薼	aoxf
藨	aoxo
蘪	aoxo
蔍	aoxx
藆	apar
茡	apbf
菪	apdf
藔	apdi
藼	apdn
萓	apeg
藛	apeo
劳	aper
蔻	apfc
蒙	apfe
氋	apfe
茔	apff
蒄	apff
鹲	apfg
萗	apfi
鸏	apfo
莞	apfq
蔲	apft
苎	apgf
荢	apgf
萱	apgg
萣	apgh
薲	apgm
蔩	apgw
莹	apgy
荥	apiu
萤	apju
蓂	apju
营	apkk
荤	aplj
葷	aplj
茕	apnf
菅	apnf
藌	apnj
蔤	apnm
薴	apns
荧	apou
菀	apqb
蓥	apqf
莺	apqg
蒬	apqy
蒏	apsg
苧	apsj
荣	apsu
荦	aptg
芝	apu
荌	apvf
葖	apwd
䓖	apwe
蓿	apwj
蓉	apwk
茓	apwu
藭	apwx
蒮	apwy
萦	apxi
芪	aqab
鬵	aqah
朁	aqaj
蠶	aqaj
兓	aqaq
茋	aqay
苑	aqbb
茒	aqbj
葾	aqbn
蒭	aqbt
芶	aqcu
薝	aqdy
萏	aqef
蔛	aqef
薢	aqeg
葪	aqej
菳	aqf
茚	aqgb
茑	aqgf
蓟	aqgj
荈	aqgj
蔔	aqgl
藓	aqgu
荀	aqjf
葂	aqke
苟	aqkf
茗	aqkf
蟼	aqkj
憼	aqkn
驚	aqko
莬	aqkq
擎	aqkr
檠	aqks
敬	aqkt
警	aqky
菟	aqky
藑	aqmt
萯	aqmu
苞	aqnb
薊	aqoj
蘇	aqot
菊	aqou
炁	aqou
蔦	aqou
蘚	aqou
帶	aqph
慸	aqpn
遰	aqpp
鴄	aqqo
茤	aqqu
匢	aqre
匫	aqrj
葱	aqrn
芴	aqrr
茐	aqry
葡	aqsu
萄	aqtb
茆	aqtb
获	aqtd
莥	aqtg
蕕	aqtg
蕏	aqtj
荻	aqto
莸	aqty
芕	aqu
匹	aqv
兂	aqv
旡	aqv
芡	aqwu
蕵	aqwv
匛	aqyi
藰	aqyj
蒥	aqyl
芍	aqyu
芞	arb
葼	arbt
葩	arcb
萚	arcg
苽	arcy
蓏	arcy
莃	ardh
菝	ardy
蘤	areo
苩	arf
茊	arf
葟	argf
蓵	argh
茩	argk
荴	argu
瓯	argy
区	ari
薬	aris
莏	arit
葲	ariu
芹	arj
苅	arjj
匠	ark
蘀	arlf
菗	armf
菦	arpu
蒐	arqc
鸥	arqg
菢	arqn
鴎	arqo
鴱	arqo
蔸	arqq
欧	arqw
菂	arqy
藠	arrr
蔱	arsc
蒱	arsu
葀	artd
萆	artf
艾	aru
菈	aruf
蒑	arvc
萔	arvk
殴	arwc
蓷	arwy
藥	arxs
薂	aryt
藲	asak
茜	asf
荰	asff
蓕	asff
蔈	asfi
蒪	asfu
薽	asfy
苯	asgf
莤	asgf
蓜	asgn
蘸	asgo
葙	ashf
艼	asj
菄	asjf
蕈	asjj
苛	askf
莕	askf
藾	askm
藗	askp
蔌	askw
萰	aslf
茦	asmb
莿	asmj
蕀	asmm
蓛	asmt
萙	aspq
菥	asrj
菻	assu
莆	asu
葽	asvf
菘	aswc
藮	aswo
萊	asww
蒁	asyp
苌	atay
莠	atbr
殹	atdc
醫	atdg
鹥	atdg
瞖	atdh
莑	atdh
医	atdi
繄	atdi
荞	atdj
蕎	atdk
贀	atdm
翳	atdn
悘	atdn
鷖	atdo
黳	atdo
蓬	atdp
芺	atdu
嫛	atdv
毉	atdw
瑿	atdy
薙	atdy
蒩	ateg
蓗	atfh
芊	atfj
莛	atfp
薐	atft
茱	atfu
蒛	atfw
蘍	atge
董	atgf
苼	atgf
菙	atgf
翘	atgn
薰	atgo
蕪	atgo
薫	atgo
尧	atgq
荇	atgs
苵	atgu
匴	atha
葮	athc
苲	athf
蓰	athh
蒠	athn
莚	athp
蕱	atie
葕	atis
萫	atjf
莉	atjj
藒	atjn
茖	atkf
萂	atkf
莵	atky
萭	atky
蔥	atln
蓖	atlx
薁	atmd
薇	atmt
藢	atmt
孽	atnb
蒒	atnh
蘬	atnh
躠	atnh
糵	atno
蘖	atns
薛	atnu
蕃	atol
萩	atou
藜	atqi
蘒	atqn
蘓	atqo
蘅	atqs
蔾	atqs
菞	atqt
薭	atrf
莪	atry
蓹	attb
蘌	atti
蕧	attt
蘒	attx
蒰	atuc
苸	atuf
萪	atuf
蕛	atut
苳	atuu
蘶	atvc
萎	atvf
葎	atvg
萟	atvy
蓯	atwh
蘈	atwm
蒣	atws
蘩	atxi
莓	atxu
攻	aty
藊	atya
蒫	auaf
臧	auah
荓	auaj
蒴	aube
蓘	auce
萒	aucq
藙	auec
蘢	aued
蕑	auef
葥	auej
苙	auf
菛	auf
匨	aufd
荘	auff
莊	auff
蘠	aufk
蓤	auft
菤	augb
蓔	augo
葁	augv
莘	auj
萻	aujf
蕫	aujf
蕳	aujf
蔁	aujj
薏	aujn
蕲	aujr
蔀	aukb
蔉	auke
菩	aukf
蔄	aukf
莌	aukq
蕄	aunu
蒋	auqf
蔣	auqf
蒟	auqk
薋	auqm
茨	auqw
藱	aurc
茭	auru
蘭	ausl
藽	ausq
薪	ausr
蒺	autd
虁	autt
菨	auvf
蔅	auvf
蒹	auvw
蔺	auwy
藺	auwy
苝	auxb
蕁	avaf
蔇	avaq
艽	avb
莭	avbj
菇	avdf
薅	avdf
蕭	avfj
荨	avfu
茟	avgj
葘	avgl
藎	avhl
萧	avhw
菉	aviu
茹	avkf
苕	avkf
蕠	avki
蒘	avkr
菑	avlf
菷	avph
芀	avr
切	avt
莙	avtk
蔒	avto
芛	avtr
茛	avu
茘	avvv
葌	avvv
袃	avye
荵	avyn
芄	avyu
茷	awau
芁	awb
苍	awbb
芿	awbr
蓊	awcn
葰	awct
芟	awcu
茯	awdu
荟	awfc
茌	awff
芢	awff
蔡	awfi
苻	awfu
菕	awga
葊	awga
蘥	awga
葵	awgd
蒨	awge
荃	awgf
莶	awgg
剳	awgj
匬	awgj
萮	awgj
薈	awgj
匼	awgk
荅	awgk
鷋	awgo
荼	awgs
蔹	awgt
蘞	awgt
巬	awgu
匳	awgw
薟	awgw
蘝	awgw
蓚	awhe
蓨	awhe
蓧	awhs
莜	awht
戍	awi
苶	awiu
芥	awjj
蛬	awju
藵	awke
茽	awkh
葆	awks
輂	awlj
苮	awmj
巷	awnb
葔	awnd
恭	awnu
拲	awrj
荷	awsk
茶	awsu
茠	awsu
荏	awtf
莋	awtf
葻	awtj
共	awu
莅	awuf
蓓	awuk
葠	awvc
葐	awvl
芬	awvr
棻	awvs
莝	awwf
葅	awwg
鹀	awwg
巫	awwi
鵐	awwo
遳	awwp
觋	awwq
覡	awwq
蓌	awwt
苁	awwu
花	awxb
芲	awxb
蕟	awxc
蒊	awxx
聓	awyb
苓	awyc
蒦	awyc
舊	awye
萑	awyf
鞏	awyf
跫	awyh
蛩	awyj
劐	awyj
莟	awyk
蒼	awyk
恐	awyn
芩	awyn
菍	awyn
蕉	awyo
銎	awyq
芃	awyu
巩	awyy
荭	axaf
葒	axaf
虇	axay
芎	axb
葞	axbf
苰	axcu
藧	axec
苭	axer
蒃	axeu
蘏	axfm
荮	axfu
葤	axfu
莼	axgn
蒓	axgn
苐	axht
蘰	axjc
茀	axjj
蕴	axjl
藴	axjl
蔃	axkj
蘊	axll
蒳	axmw
蕝	axqc
药	axqy
葯	axqy
薌	axtb
薿	axth
蘔	axtm
蘕	axtp
芗	axtr
蔠	axtu
苺	axu
蒻	axuu
蒶	axwv
芘	axxb
荜	axxf
蕬	axxi
蒈	axxr
茲	axxu
茺	aycq
蘐	ayec
藷	ayfj
虀	ayhg
苄	ayhu
弋	ayi
萕	ayjf
薺	ayjf
荠	ayjj
蔼	ayjn
藹	ayjn
蓑	ayke
蘘	ayke
蒿	aymk
藁	ayms
藳	aymt
貣	aymu
藃	aymw
匾	ayna
萹	ayna
芒	aynb
蔰	aync
菺	ayne
荒	aynk
莣	aynn
芦	aynr
荄	aynw
葶	ayps
薧	aypx
鸢	ayqg
鳶	ayqo
芳	ayr
蓠	ayrc
蘺	ayry
葹	aytb
蔟	aytd
蔙	ayth
蒍	ayto
芠	ayu
蔐	ayud
蒂	ayuh
蔏	ayuk
藡	ayup
蒡	ayuy
蓈	ayvb
蓢	ayve
莨	ayvu
苀	aywb
蔎	aywc
萃	aywf
菸	aywu
匟	aywv
隿	aywy
蓄	ayxl
虊	ayxs
蕹	ayxy
陿	badw
陈	baiy
隁	bajv
聝	bakg
聀	bay
子	bbbb
孨	bbbf
聶	bbbf
孴	bbbj
顳	bbbm
陬	bbcy
孕	bbf
孖	bbg
聑	bbg
耶	bbh
聉	bbmh
阤	bbn
陂	bby
陉	bcag
郰	bcbh
颞	bccm
聂	bccu
埾	bcff
夃	bci
鄹	bcib
聚	bciu
孡	bckg
戤	bcla
盈	bclf
焣	bcou
阭	bcqn
棸	bcsu
娶	bcvf
陖	bcwt
取	bcy
隓	bdaa
隋	bdae
墮	bdaf
嶞	bdam
隳	bdan
隨	bdap
阨	bdbn
耾	bdcy
堕	bdef
陏	bdeg
随	bdep
呄	bdf
陙	bdfe
陓	bdfn
隇	bdgv
阫	bdhy
承	bdii
陌	bdjg
陾	bdmd
聏	bdmj
陑	bdmj
颇	bdmy
頗	bdmy
陭	bdsk
陦	bdtf
陝	bdty
聗	bdww
陜	bdww
陇	bdxy
隉	beag
隱	bean
檃	beas
櫽	beas
阴	beg
阻	begg
毦	ben
聣	beqn
阞	bet
隠	bevn
隫	bfam
耺	bfcy
阹	bfcy
孺	bfdj
隭	bfdj
隢	bffq
皯	bfh
陡	bfhy
际	bfiy
阱	bfjh
聐	bfkg
聴	bfln
隯	bfnf
阮	bfqn
陼	bftj
陸	bfwf
陵	bfwt
陚	bgay
陆	bgbh
卫	bgd
孒	bgd
聙	bgeg
孲	bgfg
聽	bgfn
耳	bghg
聇	bghg
阷	bghg
隔	bgkh
陋	bgmn
陃	bgmw
阢	bgqn
隞	bgqt
陕	bgud
陘	bgva
隬	bgwr
芔	bhbh
陫	bhdd
耻	bhg
阯	bhg
隵	bhga
蚩	bhgj
旹	bhgj
妛	bhgv
骘	bhhg
騭	bhho
陟	bhht
屮	bhk
阽	bhkg
鼐	bhnn
函	bibk
顄	bibm
陗	bieg
卺	bigb
脀	bige
丞	bigf
巹	bign
烝	bigo
氶	bii
隙	biji
隚	bipf
逊	bipi
隲	bito
尕	biu
孙	biy
阥	biy
陧	bjfg
阳	bjg
隄	bjgh
陽	bjgr
刵	bjh
隅	bjmy
隰	bjxo
凾	bkcb
亟	bkcg
焏	bkco
叾	bkf
聖	bkgf
聩	bkhm
聵	bkhm
隤	bkhm
陨	bkmy
隕	bkmy
职	bkwy
勐	blet
孟	blf
盁	blf
塦	blff
隈	blge
阵	blh
陣	blh
聃	bmfg
耼	bmfg
祟	bmfi
聘	bmgn
隑	bmgu
出	bmk
岀	bmk
孾	bmmv
粜	bmou
糶	bmoy
欪	bmqw
孭	bmy
阠	bnfh
了	bnh
卩	bnh
阝	bnh
凵	bnh
孑	bnhg
也	bnhn
隦	bnku
孔	bnn
巜	bnn
耴	bnn
㔾	bnn
乃	bnt
皮	bnty
孞	bnu
恥	bny
隣	boqg
隣	boqg
耿	boy
阦	boy
褧	boye
辸	bpe
孮	bpfi
院	bpfq
聢	bpgh
辽	bpk
皹	bplh
聹	bpns
耽	bpqn
聍	bpsh
迆	bpv
聜	bpwa
聺	bpwi
陀	bpxn
阺	bqay
陒	bqdb
聸	bqdy
陷	bqeg
陥	bqhj
聎	bqiy
﨩	bqmh
孢	bqnn
皰	bqnn
陱	bqoy
隖	bqoy
隝	bqoy
鵈	bqoy
陊	bqqy
聦	bqrn
陶	bqtb
聊	bqtb
隐	bqvn
孤	brcy
阪	brcy
隍	brgg
隗	brqc
聭	brqc
陴	brtf
聛	brtf
陻	bsfg
耵	bsh
陳	bsjg
刴	bsjh
螴	bsjj
敶	bsjt
阿	bskg
娿	bskv
朶	bsu
陠	bsy
陞	btaf
阩	btah
陹	btaj
艸	btbh
茻	btbh
陁	btbn
聒	btdg
聅	btdy
阡	btfh
聕	btfk
陎	btfy
陲	btgf
隀	btgf
隆	btgg
降	btgh
阼	bthf
聥	btky
聰	btln
隩	btmd
阣	btnn
孼	bttb
蠥	bttj
糱	btto
櫱	btts
辥	bttu
雟	btwk
孫	btxi
愻	btxn
遜	btxp
孜	bty
聠	buah
联	budy
隴	bued
墜	buef
隧	buep
鐆	bueq
隊	buey
阧	bufh
隌	bujg
障	bujh
陪	bukg
聪	bukn
隡	butg
隒	buvw
隘	buwl
孻	bvhl
隟	bvjs
限	bvy
聡	bwcn
聬	bwcn
隂	bwdy
聄	bwet
坠	bwff
際	bwfi
附	bwfy
陯	bwga
聧	bwgd
险	bwgg
隃	bwgj
除	bwgs
隥	bwgu
険	bwgw
險	bwgw
阶	bwjh
聁	bwvt
队	bwy
聆	bwyc
阾	bwyc
陰	bwyc
陮	bwyg
耹	bwyn
墬	bxef
聈	bxet
乸	bxi
聨	bxxa
聫	bxxd
陛	bxxf
聯	bxxg
阰	bxxn
聮	bxxo
階	bxxr
埅	byff
及	byi
孓	byi
卪	byi
隮	byjg
阸	bynn
孩	bynw
陔	bynw
聤	byps
防	byt
職	byuj
阬	bywn
﨤	byyp
颈	cadm
劲	caet
弁	caj
刭	cajh
迳	capd
鴘	caqo
犕	cate
戏	cay
牫	cay
巯	cayk
邓	cbh
牠	cbn
又	cccc
叕	cccc
敠	cccc
叄	cccd
參	ccce
毲	ccce
毿	ccce
犙	ccce
垒	cccf
亝	cccf
叠	cccg
絫	ccci
剟	cccj
剼	cccj
颡	cccm
顙	cccm
叅	cccn
鵽	ccco
逫	cccp
遪	cccp
桑	cccs
敪	ccct
厽	cccu
叒	cccu
欼	cccw
歠	cccw
斚	ccpf
双	ccy
厸	ccy
犡	cday
叁	cddf
毵	cdee
参	cder
牯	cdg
奙	cdjn
畚	cdlf
軬	cdlj
貵	cdmu
牻	cdny
犄	cdsk
勇	ceer
勈	ceet
甬	cej
牦	cen
恿	cenu
通	cepk
劝	cet
牞	cet
螚	cexj
態	cexn
熊	cexo
熋	cexo
能	cexx
頚	cfdm
圣	cff
特	cffy
牡	cfg
犆	cfhg
犢	cflm
犊	cfnd
怼	cfnu
对	cfy
骁	cgaq
驱	cgar
骤	cgbi
驰	cgbn
骖	cgce
驿	cgcg
骉	cgcg
骚	cgcj
骀	cgck
骏	cgct
驭	cgcy
马	cgd
骑	cgdk
骐	cgdw
驮	cgdy
驵	cgeg
骦	cgfh
骊	cggy
驲	cgjg
骒	cgjs
牾	cgkg
驯	cgkh
驶	cgkr
骃	cgld
驷	cglg
骡	cgli
骋	cgmn
骣	cgnb
骔	cgpi
驼	cgpx
驹	cgqk
骝	cgql
驺	cgqv
驳	cgrr
骠	cgsi
骄	cgtj
骆	cgtk
骢	cgtn
骈	cgua
骍	cguh
骥	cguw
牼	cgva
骎	cgvc
骕	cgvw
骙	cgwd
驸	cgwf
骅	cgwf
验	cgwg
骓	cgwy
骗	cgya
骧	cgye
驻	cgyg
驴	cgyn
骟	cgyn
骇	cgyw
犑	chdy
覌	chqn
犋	chwy
厼	ciu
犦	cjai
邰	ckbh
台	ckf
瓵	ckgy
刣	ckjh
乨	cknn
怠	cknu
炱	ckou
迨	ckpd
枲	cksu
辝	ckuh
巼	ckxb
犤	clcx
牭	clg
圅	cluf
牰	cmg
岊	cmj
观	cmqn
貟	cmu
贠	cmu
犅	cmum
犌	cnhc
矝	cnhc
矡	cnhc
奦	cnhd
豫	cnhe
務	cnhe
氄	cnhe
矟	cnhe
堥	cnhf
鞪	cnhf
鹜	cnhg
骛	cnhg
鹬	cnhg
瞀	cnhh
予	cnhj
蟊	cnhj
蝥	cnhj
劀	cnhj
暓	cnhj
矠	cnhj
矞	cnhk
预	cnhm
嵍	cnhm
預	cnhm
巴	cnhn
矜	cnhn
愗	cnhn
熃	cnho
騖	cnho
鶔	cnho
鶩	cnho
鷸	cnho
遹	cnhp
鍪	cnhq
柔	cnhs
楘	cnhs
矛	cnht
敄	cnht
婺	cnhv
厶	cny
駴	coaa
駥	coad
騹	coag
驊	coag
馵	coaj
騲	coaj
驅	coak
駏	coan
驠	coao
驧	coao
駆	coar
驩	coay
駬	cobg
驟	cobi
馳	cobn
馺	coby
駊	coby
騃	cocd
驂	coce
騒	cocj
騷	cocj
駘	cock
驈	cock
騳	coco
驫	coco
馻	cocq
騥	cocs
駿	coct
馭	cocy
騞	codd
駓	codg
騵	codi
騎	codk
騻	codr
騏	codw
馱	cody
駀	cody
駄	cody
駹	cody
騪	coec
騱	coed
駔	coeg
馶	cofc
驖	cofg
馯	cofh
驦	cofh
驍	cofq
驝	cofs
駍	cogf
駤	cogf
馷	cogh
驑	cogl
駵	cogn
驪	cogx
騑	cohd
驢	cohl
驉	coho
馬	coi
騨	coif
駫	coiq
駻	cojf
馹	cojg
驆	cojg
騠	cojh
騔	cojn
騍	cojs
騴	cojv
騉	cojx
駽	coke
驒	cokf
馴	cokh
馽	cokh
駛	cokr
駰	cold
驛	colf
駟	colg
騾	coli
騦	coln
駚	comd
駎	comg
駉	comk
駧	comk
騆	comk
騧	comk
驨	comk
騁	comn
驏	conb
騢	conc
騛	conh
駶	conk
騽	conr
駜	cont
駃	conw
駅	cony
驜	coof
驎	coog
騼	coox
遤	copi
騌	copi
驞	copm
馾	copq
駝	copx
駠	coqb
騊	coqb
駣	coqi
駨	coqj
駒	coqk
騮	coql
騘	coqn
騶	coqt
馰	coqy
騩	corc
駈	corg
騜	corg
馸	corh
騡	cori
駁	corr
騣	cort
驃	cosi
驔	cosj
駷	cosk
騕	cosv
騋	cosw
馲	cota
駞	cotb
駯	cotf
騈	cotf
駱	cotk
驕	cotk
驄	cotn
駳	cotp
駪	cotq
騬	cotx
駇	coty
騀	coty
駢	coua
騂	couh
騚	couj
騿	couj
驓	couj
驣	couo
駾	couq
駮	cour
驥	couw
駸	covc
騄	covi
驌	covj
駋	covk
騝	covp
駖	cowc
驋	cowc
騤	cowd
駗	cowe
駙	cowf
駩	cowg
颿	cowj
騟	cowj
騇	cowk
騐	cown
駼	cows
験	coww
驗	coww
騅	cowy
犥	coxo
騙	coya
驤	coye
駐	coyg
驙	coyg
駲	coyh
馿	coyn
騸	coyn
驐	coyt
駺	coyv
駭	coyw
馼	coyy
騯	coyy
牸	cpbg
犗	cpdk
牴	cqay
允	cqb
犓	cqbt
觕	cqeh
鸡	cqgg
鳮	cqoy
惣	cqrn
物	cqrt
欢	cqwy
犔	croy
牺	csg
牱	cskg
犞	ctdk
逘	ctdp
矣	ctdu
欸	ctdw
牿	ctfk
劺	ctge
牲	ctgg
牜	ctgg
牪	ctgh
牟	ctgj
鴾	ctgo
牬	ctnt
犐	ctuf
牧	cty
犈	cugb
犠	cugy
犧	cugy
犝	cujf
犃	cukg
犪	cutt
犍	cvgp
犣	cvln
艰	cvy
牣	cvyy
牷	cwgg
皴	cwtb
鵕	cwto
逡	cwtp
夋	cwtu
难	cwyg
牝	cxn
牳	cxy
犉	cybg
犜	cybt
叉	cyi
蚤	cyju
犒	cymk
犏	cyna
牤	cynn
牥	cyt
牨	cywn
礷	daal
碊	daay
毻	daee
遀	daep
左	daf
礚	dafl
矼	dag
礛	dahl
礥	dahm
砑	daht
厊	daht
礴	daif
厝	dajd
勵	daje
碏	dajg
礍	dajn
厲	dajy
厪	dakg
奩	dakk
礶	daky
礣	dalw
碤	damd
砸	damh
磺	damw
碽	damy
奆	danf
碟	dans
礞	dape
奁	daru
砹	dary
礡	dasf
硗	datq
砌	davt
礤	dawi
硴	dawx
硔	dawy
硭	dayn
顾	dbdm
頋	dbdm
耷	dbf
矷	dbg
础	dbmh
厄	dbv
破	dby
砐	dbyy
硁	dcag
夿	dcb
磣	dcce
磉	dccs
碜	dcde
硧	dceh
码	dcgg
唘	dckf
翃	dcng
礟	dcor
礮	dcor
碼	dcoy
友	dcu
厷	dcu
厺	dcu
雄	dcwy
犮	dcyi
盋	dcyl
礪	dday
砈	ddbn
大	dddd
磊	dddf
靥	dddf
飆	dddj
飙	dddr
猋	dddu
磭	ddfe
砳	ddg
碱	ddgk
砺	ddgq
碶	ddhd
磩	ddhi
厦	ddht
厌	ddi
奭	ddjj
硽	ddjn
奤	ddlf
厣	ddlk
黡	ddlo
碝	ddmd
硕	ddmy
碩	ddmy
厖	ddny
硥	ddny
魇	ddrc
磢	ddrr
碕	ddsk
礰	ddth
套	ddu
镽	ddui
磡	ddwe
碪	ddwn
厮	ddwr
餍	ddwv
硤	ddww
厐	ddxy
夶	ddy
鬕	dead
戫	deag
髰	dean
髸	deaw
鬗	deay
髢	debb
髶	debf
郁	debh
髲	debu
鬖	dece
髳	dect
髪	dedc
鬌	dede
鬍	dede
髬	dedg
髵	dedj
鬊	dedj
髮	dedy
历	dee
髦	deeb
鬅	deee
奟	deef
硼	deeg
鬚	deem
有	def
鬐	defj
髻	defk
髨	defq
鬒	defw
胡	deg
砠	degg
髩	degn
髡	degq
礖	degw
砽	deh
髭	dehx
髾	deie
髿	deit
鬘	dejc
鬄	dejr
鬟	dele
鬛	deln
髷	dema
鬞	deme
髯	demf
髥	demf
戞	depa
鄾	depb
迶	depd
鬃	depi
鬢	depm
髧	depq
鬡	deps
憂	dept
鬓	depw
鹕	deqg
鬇	deqh
髱	deqn
磶	deqo
鶘	deqo
鶦	deqo
夯	der
鬉	dert
鬂	derw
鬆	desc
鬎	desj
髤	desu
髟	det
劯	det
磘	detb
髺	detd
髼	deth
鬁	detj
鬏	deto
鬔	detp
長	deu
鬈	deub
龓	deud
鬜	deue
鬋	deuj
鬙	deuj
鬝	deuj
鬀	deut
鬑	deuw
髫	devk
鬣	devn
髠	dewb
髽	dewf
鬠	dewj
髹	dews
磎	dexd
髴	dexj
鬤	deye
髣	deyr
奔	dfaj
逩	dfap
磕	dfcl
夽	dfcu
砝	dfcy
圧	dfd
礝	dfdj
鄏	dfeb
脣	dfee
辱	dfef
辰	dfei
蜃	dfej
唇	dfek
敐	dfet
圶	dff
夳	dff
厓	dffd
奎	dfff
硅	dffg
磽	dffq
矸	dfh
厧	dfhw
磌	dfhw
奈	dfiu
夲	dfj
厈	dfk
硈	dfkg
礂	dfkk
礌	dflg
夸	dfnb
郀	dfnb
綔	dfni
刳	dfnj
匏	dfnn
鴮	dfno
砖	dfny
瓠	dfny
硳	dfoy
礵	dfsh
硣	dftb
奲	dftf
奢	dftj
硓	dftx
夺	dfu
碐	dfwt
礭	dfwy
压	dfyi
研	dgah
硦	dgah
硎	dgaj
揅	dgar
碔	dgay
砘	dgbn
厔	dgcf
戌	dgd
硏	dgdf
碃	dgeg
硺	dgey
三	dggg
古	dghg
镸	dghy
磚	dgjf
硬	dgjr
咸	dgkd
觱	dgke
厨	dgkf
顑	dgkm
感	dgkn
礓	dglg
碛	dgmy
磧	dgmy
瓳	dgny
瓺	dgny
砙	dgny
烕	dgoi
励	dgqe
厉	dgqe
矹	dgqn
厫	dgqt
磝	dgqt
砞	dgsy
厂	dgt
丆	dgt
石	dgtg
戊	dgty
犬	dgty
硖	dgud
砰	dguf
硜	dgva
威	dgvd
镾	dgwr
碡	dgxy
砆	dgy
砡	dgyy
戛	dhau
存	dhbd
厞	dhdd
砉	dhdf
奯	dhdh
剨	dhdj
奡	dhdj
慧	dhdn
熭	dhdo
奀	dhdu
彗	dhdv
甭	dhej
在	dhfd
砋	dhg
邳	dhgb
丕	dhgd
歪	dhgh
覔	dhhq
夒	dhht
不	dhi
蹙	dhih
戚	dhii
顣	dhim
慼	dhin
丰	dhk
否	dhkf
砧	dhkg
盃	dhlf
磠	dhlo
硵	dhlr
碵	dhmy
还	dhpi
艳	dhqc
硯	dhqn
鴀	dhqo
兏	dhqv
嫑	dhsv
夏	dhtu
孬	dhvb
齧	dhvb
契	dhvd
觢	dhve
洯	dhvi
絜	dhvi
蛪	dhvj
恝	dhvn
挈	dhvr
栔	dhvs
磲	dias
硝	dieg
硄	digq
奫	dijg
厰	dimt
礑	dipl
礃	dipr
砂	ditt
泵	diu
夵	diu
砅	diy
厚	djbd
皕	djdj
魘	djec
厭	djed
壓	djef
奛	djef
靨	djef
厴	djel
懕	djen
黶	djeo
擪	djer
檿	djes
嬮	djev
饜	djev
百	djf
厘	djfd
碍	djgf
碮	djgh
碭	djgr
矵	djh
砷	djhh
夰	djj
奄	djnb
鹌	djng
剦	djnj
鵪	djno
碣	djqn
厬	djtk
礘	djxo
右	dkf
夻	dkf
夼	dkj
磾	dkkf
礹	dkkt
磒	dkmy
厛	dkrk
厑	dkxv
奋	dlf
礋	dlff
碨	dlge
砗	dlh
硨	dlh
勔	dlje
面	dljf
蠠	dljj
靧	dljm
靤	dljn
靦	dljq
厍	dlk
厙	dlk
靣	dlkf
硘	dlkg
礧	dlll
硱	dlsy
碅	dlty
磥	dlxi
碘	dmaw
冇	dmb
硸	dmdf
顨	dmdj
碳	dmdo
磞	dmee
磆	dmeg
碉	dmfk
奝	dmfk
硐	dmgk
磑	dmgu
布	dmhj
耎	dmjd
耏	dmje
耐	dmjf
鸸	dmjg
而	dmjj
厕	dmjk
厠	dmjk
恧	dmjn
鴯	dmjo
耍	dmjv
碢	dmnk
硙	dmnn
砚	dmqn
碋	dmsk
页	dmu
頁	dmu
碙	dmum
磮	dmwa
硶	dmwn
磪	dmwy
砃	dmyg
碾	dnae
尷	dnal
乭	dnb
郕	dnbh
镼	dnbm
尮	dnbs
尨	dney
尪	dngd
嘏	dnhc
碬	dnhc
碿	dnie
尴	dnjl
尵	dnkm
礔	dnku
盛	dnlf
尳	dnme
尯	dnqb
尥	dnqy
磖	dnrg
砀	dnrt
尰	dntf
怘	dnu
尲	dnuw
成	dnv
尢	dnv
磟	dnwe
尬	dnwj
砄	dnwy
尤	dnyi
礦	doaw
砿	docy
盔	dolf
磱	dooe
礯	dooi
磷	doqg
礳	dosd
矿	dot
灰	dou
礏	douf
磄	dovk
硡	dpdc
磍	dpdk
碂	dpfi
碹	dpgg
碇	dpgh
礗	dpgm
达	dpi
迖	dpi
碗	dpqb
牵	dptg
碦	dptk
硿	dpwa
確	dpwy
砣	dpxn
碈	dqaj
砥	dqay
厎	dqay
奃	dqay
克	dqb
硊	dqdb
兣	dqdf
兡	dqdj
兢	dqdq
勊	dqee
确	dqeh
勀	dqet
兞	dqev
尅	dqfi
兙	dqfk
碒	dqg
鸪	dqgg
磔	dqgs
剋	dqjk
砲	dqnn
鳫	dqoi
鴣	dqoy
奓	dqqu
奅	dqtb
兛	dqtf
碀	dqvh
兝	dqwv
砍	dqwy
矽	dqy
磂	dqyl
镹	dqyy
碷	drfh
砶	drg
斫	drh
磃	drhw
原	drii
厡	drii
厵	drii
願	drim
愿	drin
磈	drqc
礩	drrm
鷞	drro
爽	drrr
碑	drtf
磤	drvc
礫	drxs
礉	dryt
磦	dsfi
磗	dsfy
硒	dsg
砵	dsgg
矴	dsh
厢	dshd
碴	dsjg
磹	dsjh
厅	dsk
攲	dskc
敧	dskc
奇	dskf
砢	dskg
剞	dskj
鵸	dsko
欹	dskw
歴	dssh
礎	dssh
暦	dssj
厯	dssy
碄	dssy
硹	dswc
矺	dtan
厇	dtav
帮	dtbh
邦	dtbh
幚	dtbh
砤	dtbn
硚	dtdj
礄	dtdk
镺	dtdy
厒	dtfb
硞	dtfk
礸	dtfm
焘	dtfo
寿	dtfu
硃	dtfy
厜	dtgf
硾	dtgf
镻	dtgy
碫	dthc
砟	dthf
厏	dthf
硟	dthp
邫	dtkc
硌	dtkg
硇	dtlr
磇	dtlx
礇	dtmd
砾	dtni
矻	dtnn
磓	dtnp
磻	dtol
砭	dtpy
硪	dtry
磿	dttd
歷	dtth
厤	dtti
曆	dttj
磫	dtwh
故	dty
磋	duag
硑	duah
蹷	dubh
劂	dubj
蟨	dubj
憠	dubn
鷢	dubo
磀	dubp
橜	dubs
厥	dubw
磙	duce
礲	dued
龎	dued
礀	dueg
礈	duep
砬	dug
礢	dugv
礒	dugy
眘	duhf
辜	duj
羍	duj
昚	dujf
鹩	dujg
磵	dujg
尞	duji
鷯	dujo
遼	dujp
厗	duk
碚	dukg
磳	dulj
碰	duog
磸	dusd
冭	duu
磰	duuk
磏	duvw
礠	duxn
磁	duxx
厩	dvaq
砕	dvfh
肆	dvgh
硉	dvgh
碌	dviy
碯	dvtr
硍	dvy
砼	dwag
砓	dwcy
碁	dwdf
舂	dwef
朞	dwef
期	dweg
憃	dwen
基	dwff
磜	dwfi
碖	dwga
奏	dwgd
硷	dwgg
硂	dwgg
奉	dwgj
硆	dwgk
硢	dwgs
磴	dwgu
厱	dwgw
礆	dwgw
仄	dwi
泰	dwiu
春	dwjf
剘	dwjh
砎	dwjh
蠢	dwjj
惷	dwjn
蜝	dwju
矶	dwn
戡	dwna
甚	dwnb
勘	dwne
斟	dwnf
卙	dwnf
夦	dwnq
尠	dwnt
惎	dwnu
歁	dwnw
贗	dwqm
鴈	dwqo
欺	dwqw
斯	dwrh
蟴	dwrj
砜	dwry
棊	dwsu
碸	dwtj
秦	dwtu
其	dwu
砏	dwvt
郟	dwwb
夾	dwwi
硲	dwwk
赝	dwwm
贋	dwwm
頰	dwwm
鵊	dwwo
雁	dwwy
綦	dwxi
砱	dwyc
奞	dwyf
奪	dwyf
諅	dwyf
碓	dwyg
奮	dwyl
砛	dwyn
礁	dwyo
磼	dwys
矾	dwyy
砩	dxjh
礙	dxth
砒	dxxn
磯	dxxw
砪	dxy
聋	dxyb
砻	dxyd
䶮	dxyd
袭	dxye
垄	dxyf
龙	dxyi
龚	dxyw
詟	dxyy
礅	dybt
硫	dyck
砫	dygg
太	dyi
丈	dyi
砯	dyiy
盇	dylf
碻	dymk
碥	dyna
砨	dynn
态	dynu
奒	dynw
硋	dynw
硛	dyoy
迏	dypi
碠	dyps
碲	dyuh
磅	dyuy
硠	dyvy
碎	dywf
砊	dywn
砇	dyy
臟	eaah
毧	eade
臓	eadh
腻	eafy
膩	eafy
肛	eag
臔	eahm
胨	eaiy
舁	eaj
膜	eajd
貘	eajd
氁	eajd
腊	eajg
臈	eajn
膒	eakk
貙	eakk
臙	eako
貛	eaky
貓	ealg
朠	eamd
朑	eann
脦	eany
朦	eape
毁	eawc
臒	eawc
膵	eayf
郛	ebbh
鵩	ebco
服	ebcy
孚	ebf
朏	ebmh
貀	ebmh
肔	ebn
乳	ebnn
嗠	ebtk
胫	ecag
腏	eccc
毶	ecde
蜰	ecju
胎	eckg
亂	ecmn
覶	ecmq
辭	ecmu
肥	ecn
腬	ecns
毪	ectg
朘	ecwt
膸	edap
肱	edcy
胈	edcy
脹	edey
脤	edfe
胯	edfn
胚	edhg
脜	edhg
豾	edhg
肨	edhh
脴	edhk
夓	edht
肧	edhy
貊	edjg
腌	edjn
腼	edlf
腝	edmd
澃	edmi
胹	edmj
盨	edml
媭	edmv
嬃	edmv
頾	edmx
须	edmy
須	edmy
肬	edny
脄	edoy
膫	edui
腠	edwd
脥	edww
胧	edxy
肰	edy
肽	edyy
脬	eebg
毝	eee
毳	eeeb
月	eeee
朤	eeee
脅	eeee
脇	eeee
膬	eeee
勰	eeen
劦	eeer
姭	eeev
舀	eef
脟	eefy
朋	eeg
膄	eehc
鹏	eeqg
腉	eeqn
貎	eeqn
鵬	eeqo
肋	eet
肜	eet
脮	eevg
胁	eewy
腴	eewy
膎	eexd
貕	eexd
膹	efam
脚	efcb
肢	efcy
胠	efcy
臑	efdj
頱	efdm
胿	effg
膮	effq
肚	efg
肝	efh
豻	efh
虢	efhw
肼	efjh
臌	efkc
膨	efke
腩	efmf
肟	efnn
䏝	efny
脖	efpb
朊	efqn
腜	efsy
豺	eftt
寽	efu
膤	efvg
毀	efwc
臛	efwy
肘	efy
肫	egbn
胵	egcf
悬	egcn
县	egcu
且	egd
爰	egdc
鶢	egdo
腈	egeg
遯	egep
助	eget
豚	egey
脿	egey
毬	egiy
脙	egiy
膞	egjf
貆	egjg
刞	egjh
膈	egkh
腷	egkl
脰	egku
肺	egmh
脼	egmy
礜	egnd
舉	egng
轝	egnl
舃	egno
鸒	egno
擧	egnr
歟	egnw
與	egnw
譽	egny
鴡	egqo
鶏	egqo
胓	eguf
脛	egva
脻	egvh
雎	egwy
膆	egxi
胰	egxw
肤	egy
鄋	ehcb
遚	ehcp
叟	ehcu
腓	ehdd
毴	ehdd
臄	ehge
貜	ehhc
胩	ehhy
臞	ehhy
丯	ehk
毡	ehkd
胋	ehkg
臚	ehll
胪	ehnt
覓	ehqb
覒	ehqn
辵	ehu
頿	ehxm
胱	eigq
毜	eii
盥	eilf
膛	eipf
脳	eirb
膌	eiwe
貍	ejfg
貋	ejfh
胆	ejgg
腸	ejgr
刖	ejh
胂	ejhh
蠫	ejjj
腽	ejlg
腢	ejmy
腂	ejsy
腥	ejtg
驾	ekcg
駕	ekco
毠	ekeb
加	ekg
脵	ekgd
脭	ekgg
肿	ekhh
膭	ekhm
貚	ekkf
腭	ekkn
臊	ekks
贺	ekmu
賀	ekmu
脶	ekmw
乫	eknb
迦	ekpd
鴐	ekqo
哿	eksk
架	eksu
妿	ekvf
嗧	ekwa
胑	ekwy
袈	ekye
膕	elag
胭	eldy
舅	eler
腲	elge
舆	elgw
輿	elgw
腘	elgy
胛	elh
毸	elni
腮	elny
臅	elqj
爵	elvf
膢	elvg
貗	elvg
膃	elwl
膿	emae
腆	emaw
腨	emdj
貒	emdj
胦	emdy
爯	emff
臖	emge
舋	emgg
腗	emgj
胴	emgk
爨	emgo
爂	emgo
釁	emgv
興	emgw
璺	emgy
帠	emhj
腡	emnk
膼	emnp
觅	emqb
朒	emww
肭	emwy
膗	emwy
豽	emwy
腒	endg
腛	engf
腵	enhc
貑	enhc
脲	eniy
劜	enn
肊	enn
肠	enrt
力	ent
鼷	enud
鼣	enud
鼫	enud
鼳	enud
鼵	enud
鼱	enue
鼭	enuf
鼪	enug
鼯	enuk
鼦	enuk
鼩	enuk
鼲	enul
鼺	enul
鼬	enum
鼰	enum
鼠	enun
鼮	enup
鼨	enuu
鼹	enuv
鼢	enuv
鼴	enuv
鼶	enuw
鼸	enuw
鼧	enux
鼤	enuy
鼥	enuy
甩	env
膠	enwe
胒	enxn
臎	enyf
脏	eofg
毩	eoi
朥	eooe
毯	eooi
腅	eooy
膦	eoqg
臁	eouw
膅	eovk
毇	eowc
腑	eowf
臕	eoxo
膔	eoxx
脒	eoy
臗	epay
受	epcu
辤	epcu
迌	epd
爱	epdc
边	epe
脓	epey
腙	epfi
脘	epfq
腟	epgf
腚	epgh
臏	epgm
腪	eplh
愛	epnt
腕	epqb
舜	epqg
膑	eprw
胺	epvg
腔	epwa
膣	epwf
貁	epwy
胝	eqay
兒	eqb
郳	eqbh
脃	eqcn
脆	eqdb
膽	eqdy
氇	eqgj
朓	eqiy
毥	eqjd
朐	eqkg
豿	eqkg
脕	eqkq
褜	eqne
胞	eqnn
毱	eqoi
氌	eqoj
舄	eqou
鶂	eqqo
胸	eqrb
脗	eqrk
肳	eqrt
肷	eqwy
豹	eqyy
肑	eqyy
朡	erbt
胍	ercy
脪	erdh
脈	erey
腯	erfh
胉	erg
貃	erg
肵	erh
腺	eriy
貌	erqn
邈	erqp
學	errb
斅	errc
礐	errd
觷	erre
壆	errf
澩	erri
嚳	errk
嶨	errm
燢	erro
鱟	erro
鷽	erro
覺	errq
斆	errt
黌	errw
雤	erry
脎	ersy
脾	ertf
貏	ertf
毢	esd
彩	eset
膘	esfi
膊	esfy
腖	esjg
胢	eskg
脨	eskg
采	esu
腰	esvg
膝	eswi
脯	esy
胀	etay
胣	etbn
膖	etdp
鹞	etfg
繇	etfi
颻	etfj
臜	etfm
臢	etfm
鷂	etfo
遥	etfp
脡	etfp
毨	etfq
飖	etfr
腁	etgf
腄	etgf
腫	etgf
胜	etgg
胮	etgh
脌	etgh
毛	etgn
膴	etgo
臐	etgo
胻	etgs
胅	etgy
腶	ethc
胙	ethf
臼	ethg
脠	ethp
脷	etjh
膓	etjr
腹	etjt
胳	etkg
貉	etkg
貔	etlx
膍	etlx
爳	etnb
鄬	etnb
用	etnh
噕	etnk
肐	etnn
爲	etno
膇	etnp
胏	etnt
膰	etol
彡	ettt
貈	etuy
腇	etvg
脢	etxy
豸	etyt
爫	etyt
胼	euah
朕	eudy
朧	eued
腃	eugb
勝	euge
塍	eugf
腾	eugg
膶	eugg
䲢	eugg
胖	eugh
幐	eugh
膡	eugh
滕	eugi
縢	eugi
螣	eugj
賸	eugm
騰	eugo
鰧	eugo
黱	eugo
榺	eugs
媵	eugv
謄	eugy
羘	euh
朣	eujf
腤	eujg
臆	eujn
毰	eukd
脱	eukq
氆	euoj
胶	eury
膳	euuk
膁	euvw
膉	euwl
貖	euwl
妥	evf
墾	evff
肗	evg
貄	evgh
毽	evgp
腱	evgp
爭	evhj
貂	evkg
臘	evln
肍	evn
懇	evnu
腿	evpy
鵎	evqo
腦	evtr
貇	evy
肒	evyy
肕	evyy
股	ewcy
胗	ewet
脍	ewfc
肸	ewfh
胕	ewfy
腀	ewga
脸	ewgg
腧	ewgj
毺	ewgj
膾	ewgj
貐	ewgj
肹	ewgn
膯	ewgu
臉	ewgw
办	ewi
臾	ewi
脫	ewkq
肌	ewn
惥	ewnu
貅	ewsy
斞	ewuf
朌	ewvt
腳	ewwb
脞	ewwf
朎	ewyc
脽	ewyg
肣	ewyn
腍	ewyn
臇	ewyn
膲	ewyo
谿	exdk
鷄	exdo
奚	exdu
雞	exdy
腞	exey
乿	exin
脂	exjg
胇	exjh
膙	exkj
膷	extb
肶	exxn
豼	exxn
胟	exy
朜	eybg
脝	eybh
臍	eyjg
脐	eyjh
膻	eylg
氊	eylg
脉	eyni
胲	eynw
脑	eyrb
肞	eyry
肪	eyt
腣	eyuh
膱	eyuj
膪	eyuk
膀	eyuy
朖	eyvy
脺	eywf
肮	eywn
腋	eywy
膟	eyxf
臃	eyxy
胘	eyxy
霰	faet
卋	faf
鼖	fafc
霸	fafe
墸	fafj
壒	fafl
臷	fagf
墷	fagg
尭	fagq
韯	fahg
壏	fahl
卉	faj
塻	fajd
蛓	faji
堰	fajv
哉	fakd
域	fakg
墐	fakg
塸	fakk
壦	faky
载	fald
載	falk
戴	falw
霙	famd
翸	famn
贲	famu
賁	famu
墴	famw
歕	famw
胾	famw
堞	fans
烖	faoi
靀	fape
墆	faqh
酨	fasg
栽	fasi
枽	fasu
桒	fasu
塔	fawk
塂	fawn
塨	fawn
埖	fawx
截	fawy
垬	fawy
裁	faye
塃	fayk
邯	fbh
邗	fbh
壭	fbj
凷	fbk
地	fbn
逇	fbpv
垜	fbsy
霳	fbtg
壣	fbxg
坡	fby
雭	fbyu
圾	fbyy
弆	fcaj
叝	fcbc
却	fcbh
墋	fcce
頍	fcdm
叆	fcec
攰	fcee
埇	fceh
动	fcet
劫	fcet
刦	fcjh
朅	fcjn
坮	fckg
唟	fckx
盍	fclf
翅	fcnd
霧	fcne
霿	fcnh
霱	fcnk
雺	fcnt
霚	fcnt
运	fcpi
迲	fcpi
鳷	fcqo
魂	fcrc
埃	fctd
去	fcu
支	fcu
云	fcu
攳	fcvf
叇	fcvp
刧	fcvt
刼	fcvy
埈	fcwt
鼁	fcxf
堶	fdae
坺	fdcy
雳	fder
坜	fdet
雼	fdf
震	fdfe
堐	fdff
垮	fdfn
坧	fdg
堿	fdgk
坯	fdhg
墄	fdhi
坏	fdhy
埯	fdjn
壥	fdlf
堧	fdmd
需	fdmj
颥	fdmm
顬	fdmm
顸	fdmy
頇	fdmy
墭	fdnl
城	fdnn
垯	fdpy
塬	fdri
塽	fdrr
埼	fdsk
垹	fdtb
壢	fdth
靂	fdth
墈	fdwe
埲	fdwg
堾	fdwj
堪	fdwn
埉	fdww
垅	fdxy
雮	feb
垺	febg
協	feee
堋	feeg
塪	feeg
埒	fefy
埓	fefy
坥	fegg
霾	fejf
霓	feqb
堄	feqn
霢	fere
埰	fesy
协	fewy
霡	feyi
壩	ffae
墳	ffam
邽	ffbh
邿	ffbh
霴	ffci
靅	ffcm
霒	ffcn
霕	ffcn
霼	ffco
靆	ffcp
靉	ffct
雲	ffcu
坛	ffcy
壖	ffdj
劸	ffet
圭	fff
亖	fff
雸	fff
墵	fffc
土	ffff
垚	ffff
堼	ffff
壵	ffff
鞤	ffff
犎	fffg
幇	fffh
幫	fffh
顤	fffm
翹	fffn
遶	fffp
堯	fffq
墝	fffq
封	fffy
坩	ffg
埴	ffhg
填	ffhw
卦	ffhy
隷	ffii
款	ffiw
刲	ffjh
墘	ffjn
郌	ffkc
壊	ffle
雩	ffnb
鄠	ffnb
壔	ffnf
圬	ffnn
恚	ffnu
奊	ffny
霊	ffof
麉	ffox
坃	ffqn
堵	fftj
寺	ffu
墙	ffuk
墶	ffup
墻	ffwk
堎	ffwt
鼃	ffxf
坉	fgbn
垤	fgcf
埥	fgeg
埡	fgfg
圩	fgfh
二	fgg
干	fggh
未	fggy
十	fgh
士	fghg
甘	fghg
墕	fgho
雫	fghu
雨	fghy
寸	fghy
圷	fghy
塼	fgjf
垣	fgjg
埂	fgjr
塥	fgkh
堛	fgkl
壃	fglg
垭	fgog
坪	fguf
霋	fgvv
坘	fgxg
塐	fgxi
趞	fhaj
越	fhan
趪	fhaw
趣	fhbc
趉	fhbm
霏	fhdd
赲	fhee
趄	fheg
直	fhf
矗	fhfh
赶	fhfk
趌	fhfk
趬	fhfq
址	fhg
圵	fhg
壉	fhge
垰	fhgh
趔	fhgj
趰	fhgr
赴	fhhi
趠	fhhj
趈	fhhk
埗	fhht
埱	fhic
趙	fhie
趟	fhik
赻	fhit
趕	fhjf
趧	fhjh
坫	fhkg
趗	fhkh
趮	fhks
嗭	fhkx
盐	fhlf
壚	fhll
塷	fhlo
趩	fhlw
赸	fhmk
趐	fhnd
趘	fhne
垇	fhng
赳	fhnh
悳	fhnn
垆	fhnt
惪	fhnu
起	fhnv
赽	fhnw
趯	fhny
墟	fhog
趤	fhpd
赿	fhqa
趛	fhqd
趂	fhqi
趒	fhqi
垷	fhqn
趜	fhqo
趍	fhqq
趨	fhqt
赹	fhqu
趋	fhqv
赼	fhqw
趆	fhqy
赵	fhri
赾	fhrk
趚	fhsk
趏	fhtd
趎	fhtf
趃	fhtg
趫	fhtk
趱	fhtm
趲	fhtm
趀	fhtt
走	fhu
趇	fhud
﨣	fhuf
趥	fhug
趦	fhuk
趑	fhuw
趢	fhvi
超	fhvk
趁	fhwe
趖	fhwf
颠	fhwm
顛	fhwm
赺	fhwn
趝	fhwn
趭	fhwo
鷏	fhwo
趓	fhws
真	fhwu
埧	fhwy
趡	fhwy
圤	fhy
霟	fiaw
靋	fidh
霮	fidn
霄	fief
霪	fief
祘	fifi
霈	figh
垙	figq
霑	fihk
埫	fimk
霘	fimk
礼	finn
壋	fipl
霃	fipq
霂	fisu
示	fiu
垱	fivg
墚	fivs
霗	fiwc
塉	fiwe
霐	fixc
霔	fiyg
霶	fiyy
戟	fjay
朝	fjeg
壜	fjfc
坓	fjff
塒	fjff
埋	fjfg
韩	fjfh
垾	fjfh
亁	fjfn
埘	fjfy
坦	fjgg
堤	fjgh
場	fjgr
刊	fjh
刌	fjh
坤	fjhh
汬	fjiu
亓	fjj
霷	fjjr
井	fjk
墁	fjlc
塭	fjlg
堣	fjmy
電	fjnb
塌	fjng
韓	fjng
乹	fjnn
进	fjpk
堨	fjqn
埸	fjqr
堁	fjsy
乾	fjtn
刱	fjvw
斡	fjwf
幹	fjwf
螒	fjwj
翰	fjwn
鶾	fjwo
榦	fjws
倝	fjwy
雗	fjwy
堒	fjxx
丼	fjyi
郆	fkbh
霵	fkby
颉	fkdm
頡	fkdm
埍	fkeg
遠	fkep
劼	fket
袁	fkeu
吉	fkf
喆	fkfk
嚞	fkfk
埕	fkgg
圳	fkh
露	fkhk
墤	fkhm
壝	fkhp
酃	fkkb
龗	fkkd
喪	fkke
墠	fkkf
霝	fkkk
賷	fkkm
堮	fkkn
壧	fkkt
孁	fkkv
靈	fkkw
霣	fkmu
埚	fkmw
埙	fkmy
塤	fkmy
翓	fkng
迼	fkpd
臺	fkpf
鴶	fkqo
欯	fkqw
皷	fkub
鼓	fkuc
敼	fkuc
鼔	fkuc
彭	fkue
鼚	fkue
鼙	fkuf
壴	fkuf
尌	fkuf
鼞	fkuf
噽	fkug
鼘	fkug
瞽	fkuh
蟚	fkuj
鼜	fkuj
喜	fkuk
嘉	fkuk
嚭	fkuk
囍	fkuk
鼛	fkuk
壾	fkun
憙	fkun
熹	fkuo
鼕	fkuu
鼟	fkuu
歖	fkuw
甏	fkuy
霬	flaw
堌	fldg
雷	flf
墿	flff
靐	flfl
堽	flgh
夁	flld
靁	flll
皾	flmb
覿	flmq
賣	flmu
畞	flqy
塿	flvg
堺	flwj
塄	flyt
霻	fmau
堓	fmdf
雵	fmdu
靊	fmdu
坱	fmdy
塴	fmee
霌	fmfk
垌	fmgk
塏	fmgu
圸	fmh
坰	fmkg
堝	fmnk
垲	fmnn
献	fmud
南	fmuf
堈	fmum
遖	fmup
埛	fmwk
埁	fmwn
墔	fmwy
坝	fmy
垻	fmy
坍	fmyg
魗	fnac
壽	fnaf
垊	fnan
翿	fnan
燾	fnao
亏	fnb
堀	fnbm
逺	fnep
墛	fnff
霨	fnff
堩	fngg
霞	fnhc
韬	fnhe
壻	fnhe
堳	fnhg
韦	fnhk
韫	fnhl
违	fnhp
覟	fnhq
韧	fnhy
韨	fnhy
墀	fnig
夀	fnkf
霹	fnku
壀	fnku
圯	fnn
圮	fnn
圠	fnn
毐	fnnd
迃	fnpv
声	fnr
霫	fnrf
场	fnrt
志	fnu
忈	fnu
塀	fnua
卖	fnud
觌	fnuq
亐	fnv
罄	fnwb
聲	fnwb
殸	fnwc
磬	fnwd
漀	fnwi
馨	fnwj
韾	fnwj
毊	fnwk
鏧	fnwq
撀	fnwr
块	fnwy
謦	fnwy
坭	fnxn
专	fnyi
墌	foao
壙	foaw
赧	fobc
郝	fobh
垿	foch
頳	fodm
赭	fofj
赫	fofo
赪	fohm
赬	fohm
覝	fohq
赨	fojy
赮	fonc
赯	fook
埮	fooy
赩	foqc
赥	foqw
圹	fot
螫	fotj
赦	foty
赤	fou
灻	fou
墣	foug
墉	fovh
塘	fovk
塶	foxx
郣	fpbb
勃	fpbe
孛	fpbf
鹁	fpbg
愂	fpbn
鵓	fpbo
蠧	fpdj
槖	fpds
豰	fpfc
塜	fpfe
霥	fpfe
壺	fpfg
垸	fpfq
垨	fpfy
皼	fpgb
彀	fpgc
觳	fpgc
嗀	fpgc
榖	fpgc
殼	fpgc
瑴	fpgc
瞉	fpgc
穀	fpgc
糓	fpgc
縠	fpgc
轂	fpgc
鷇	fpgc
嗀	fpgc
塇	fpgg
壼	fpgg
埞	fpgh
螜	fpgj
靌	fpgm
懿	fpgn
亄	fpgn
愨	fpgn
壸	fpgo
鷧	fpgo
壹	fpgu
塚	fpgy
过	fpi
塓	fpju
辻	fpk
迀	fpk
壷	fpkg
毂	fplc
堚	fplh
疐	fplh
壶	fpof
埦	fpqb
売	fpqb
坾	fpsh
垞	fpta
垵	fpvg
埪	fpwa
壳	fpwb
殻	fpwc
堗	fpwd
塎	fpwk
悫	fpwn
坈	fpwn
慤	fpwn
靏	fpwo
堔	fpws
坹	fpwy
壱	fpxb
索	fpxi
坨	fpxn
坁	fqan
坻	fqay
元	fqb
圥	fqb
邧	fqbh
兘	fqck
垝	fqdb
顽	fqdm
頑	fqdm
埳	fqeg
埆	fqeh
坖	fqff
雿	fqiu
垗	fqiy
刓	fqjh
坸	fqkg
鼋	fqkn
堍	fqky
雹	fqnb
垉	fqnn
塢	fqoy
鳱	fqoy
远	fqpv
靎	fqqo
垑	fqqy
圽	fqrt
均	fqug
鋆	fquq
无	fqv
埩	fqvh
坎	fqwy
黿	fqxf
朮	fqyi
塯	fqyl
霤	fqyl
怷	fqyn
圴	fqyy
堫	frbt
坂	frcy
坬	frcy
坵	frg
堭	frgg
垢	frgk
圻	frh
塊	frqc
埤	frtf
墽	fryt
坼	fryy
耯	fsac
耢	fsae
耩	fsaf
耤	fsaj
耟	fsan
耔	fsbg
耚	fsby
耛	fsck
耙	fscn
耨	fsdf
頛	fsdm
耰	fsdt
耡	fsee
耝	fseg
耞	fsek
耗	fsen
耘	fsfc
堙	fsfg
墂	fsfi
耕	fsfj
博	fsfy
耫	fsgm
圢	fsh
霜	fshf
鹴	fshg
鸘	fsho
耒	fsi
耥	fsik
耖	fsit
埬	fsjg
墰	fsjh
耦	fsjy
坷	fskg
䎬	fslc
堜	fslg
耬	fslv
䎱	fslx
耜	fsng
耱	fsod
耮	fsoe
耧	fsov
霦	fsse
耓	fssh
霖	fssu
塛	fssy
某	fsu
雬	fsu
耣	fswa
耠	fswk
耭	fsxw
埔	fsy
耲	fsye
耪	fsyy
圫	ftan
孝	ftbf
教	ftbt
孷	ftdb
氂	ftde
釐	ftdf
犛	ftdg
甛	ftdg
埄	ftdh
漦	ftdi
墧	ftdk
塳	ftdp
嫠	ftdv
剺	ftdv
斄	ftdw
垁	ftdy
才	fte
耂	fte
雾	fter
圲	ftfh
霆	ftfp
埵	ftgf
堹	ftgf
耊	ftgf
考	ftgn
墲	ftgo
壎	ftgo
垳	ftgs
塅	fthc
垍	fthg
鼒	fthn
埏	fthp
都	ftjb
殾	ftjc
者	ftjf
翥	ftjn
乽	ftjn
煮	ftjo
煑	ftjo
覩	ftjq
塲	ftjr
斱	ftjr
垎	ftkg
塩	ftkl
墺	ftmd
塮	ftmf
垧	ftmk
霺	ftmt
埠	ftnf
坞	ftng
垖	ftng
圪	ftnn
塠	ftnp
墦	ftol
耇	ftqk
耉	fttk
垀	ftuf
雽	ftuf
塖	ftux
老	ftxb
耄	ftxe
耋	ftxf
耆	ftxj
耈	ftxk
霉	ftxu
坆	fty
攼	fty
圦	ftyy
壌	fuae
垪	fuah
壠	fued
靇	fued
丧	fueu
雴	fuf
報	fufc
褺	fufe
墊	fuff
漐	fufi
縶	fufi
幸	fufj
蟄	fufj
盩	fufl
贄	fufm
慹	fufn
騺	fufo
鷙	fufo
逹	fufp
摯	fufr
執	fufy
瓡	fufy
謺	fufy
垃	fug
埢	fugb
堘	fugf
坢	fugh
垟	fuh
垶	fuh
墥	fujf
堷	fujg
墹	fujg
墇	fujh
境	fujq
培	fukg
增	fulj
増	fulj
啬	fulk
達	fupk
壛	fuqe
墫	fusf
壿	fusf
墡	fuuk
霎	fuvf
塧	fuwl
霠	fuwn
赱	fuyu
雪	fvf
垏	fvgh
壗	fvhl
埭	fviy
埐	fvpc
埽	fvph
堖	fvtr
垠	fvy
塕	fwcn
坄	fwcy
垘	fwdy
勎	fwfe
勢	fwfe
坴	fwff
暬	fwfj
熱	fwfo
燅	fwfo
驇	fwfo
鵱	fwfo
逵	fwfp
摰	fwfr
槷	fwfs
坿	fwfy
埶	fwfy
埨	fwga
堬	fwgj
垥	fwgk
墖	fwgl
墱	fwgu
霯	fwgu
圿	fwjh
堢	fwks
堠	fwnd
垛	fwsy
堸	fwtj
夌	fwtu
雰	fwvr
坋	fwvt
嗇	fwwk
﨏	fwwk
赍	fwwm
賫	fwwm
墢	fwxc
鼀	fwxf
零	fwyc
坽	fwyc
霍	fwyf
堆	fwyg
埝	fwyn
坅	fwyn
靍	fwyo
鸖	fwyo
靃	fwyy
坳	fxet
堟	fxey
塡	fxhw
坲	fxjh
堦	fxxr
霛	fxxx
坶	fxy
墎	fybb
霩	fybb
埻	fybg
墩	fybt
堉	fyce
霅	fyf
圡	fyi
霽	fyjf
霁	fyjj
霭	fyjn
靄	fyjn
壤	fyke
壞	fyle
壇	fylg
壈	fylt
塙	fymk
垓	fynw
塆	fyox
壕	fype
雱	fyr
垴	fyrb
坊	fyt
雯	fyu
墑	fyud
墒	fyuk
塝	fyuy
埌	fyvy
埣	fywf
坑	fywn
壪	fyxx
坟	fyy
琖	gaay
邢	gabh
形	gaet
瓂	gafl
弐	gafy
玒	gag
璍	gagg
琊	gahb
鹉	gahg
璼	gahl
鵡	gaho
玡	gaht
虣	gahw
武	gahy
戋	gai
弄	gaj
型	gajf
刑	gajh
刬	gajh
开	gak
瑾	gakg
琙	gakg
瓘	gaky
盏	galf
瑛	gamd
璜	gamw
璊	gamy
貮	gamy
玴	gann
烎	gaou
鳽	gaqo
璥	gaqt
璓	gatb
瓁	gawc
瑹	gaws
珙	gawy
雃	gawy
瑘	gbbh
瓍	gbdp
珥	gbg
邞	gbh
击	gbk
邨	gbnb
旾	gbnj
顿	gbnm
頓	gbnm
迍	gbnp
屯	gbnv
玻	gby
戩	gcca
晉	gccj
郅	gcfb
臶	gcfb
至	gcff
臸	gcff
到	gcfj
臵	gcfk
臹	gcfn
鵄	gcfo
致	gcft
臻	gcft
玛	gcgg
珆	gckg
璚	gcnk
瑈	gcns
瑪	gcoy
玧	gcqn
丟	gcu
瑵	gcyj
瑚	gdeg
珛	gdeg
瓇	gdet
郉	gdfb
幵	gdfh
栞	gdfs
珬	gdgg
蝅	gdgj
蠺	gdgj
瑊	gdgk
珔	gdhb
玤	gdhh
环	gdhy
天	gdi
沗	gdiu
奣	gdje
昋	gdjf
蚕	gdju
吞	gdkf
瑌	gdmd
顼	gdmy
頊	gdmy
珹	gdnn
忝	gdnu
迗	gdpi
鴌	gdqo
琦	gdsk
瓑	gdth
璙	gdui
璂	gdwf
琫	gdwg
瑃	gdwj
瑧	gdwt
琪	gdwy
珑	gdxy
琈	gebg
郬	gebh
豝	gecn
豲	gedi
豯	geed
珕	geee
瑫	geeg
豠	geeg
靜	geeh
青	gef
豬	gefj
豮	gefm
豶	gefm
櫫	gefs
豷	gefu
玥	geg
豜	gega
瑗	gegc
豩	gege
豣	gegf
珇	gegg
豘	gegn
燹	gego
璵	gegw
靚	gehq
豕	gei
靗	geiq
蟸	gejj
豱	gejl
珈	gekg
靓	gemq
豭	genc
瑷	gepc
靛	geph
逐	gepi
璦	gept
靘	geqc
䴖	geqg
静	geqh
豞	geqk
鶄	geqo
豨	gerh
靔	gern
靝	gero
豧	gesy
玏	get
瑶	getb
甤	getg
豵	geth
表	geu
豤	gevy
豛	gewc
豴	geyd
豖	geyi
剢	geyj
豟	geyn
豥	geyw
邘	gfbh
珐	gfcy
瓀	gfdj
珪	gffg
玵	gfg
亞	gfgd
堊	gfgf
蝁	gfgj
惡	gfgn
鵶	gfgo
琧	gfgy
玕	gfh
瑱	gfhw
琎	gfjp
于	gfk
盂	gflf
瓄	gflm
璹	gfnf
玮	gfnh
瓙	gfno
迂	gfpk
玩	gfqn
琽	gftj
珯	gftx
珷	ggay
琶	ggcb
琢	ggey
玗	ggfh
玨	ggg
王	gggg
瓉	gggm
璱	gggt
夫	gggy
五	gghg
球	ggiy
替	ggjf
瑼	ggjf
璢	ggjl
璤	ggjn
珸	ggkg
鄻	gglb
辇	gglj
輦	gglj
一	ggll
鄼	ggmb
賛	ggmu
玙	ggng
瑟	ggnt
珁	ggny
瑨	ggoj
璈	ggqt
琹	ggsu
玶	gguf
琴	ggwn
珡	ggwu
琵	ggxx
瑇	ggxy
玞	ggy
珏	ggyy
正	ghd
琲	ghdd
頙	ghdm
鄢	ghgb
瓛	ghgd
璩	ghge
靕	ghge
焉	ghgo
下	ghi
琡	ghic
琸	ghjh
丅	ghk
玷	ghkg
瓐	ghll
乤	ghnb
亙	ghng
丏	ghnn
忑	ghnu
丐	ghnv
璿	ghph
鬹	ghqh
現	ghqn
規	ghqn
璨	ghqo
鴊	ghqo
槼	ghqs
嫢	ghqv
政	ghty
颪	ghwj
琥	ghwn
玼	ghxn
璖	gias
琑	gieg
琺	gifc
珖	gigq
琐	gimy
瑣	gimy
瑺	giph
璫	gipl
珰	givg
珱	givg
皳	giyb
裘	giye
求	giyi
盚	giyl
慦	giyn
逑	giyp
救	giyt
畱	gjal
丣	gjan
理	gjfg
亘	gjgf
瑅	gjgh
刯	gjgj
瑒	gjgr
鄟	gjhb
專	gjhf
瑁	gjhg
珅	gjhh
剸	gjhj
惠	gjhn
鷒	gjho
甎	gjhy
琩	gjjg
丌	gjk
瑥	gjlg
郠	gjrb
甦	gjrg
更	gjri
瑆	gjtg
琨	gjxx
璟	gjyi
琝	gjyy
郚	gkbh
琄	gkeg
吾	gkf
丗	gkgd
珵	gkgg
帯	gkgh
玔	gkh
叓	gkhc
囊	gkhe
嚢	gkhe
蠹	gkhj
蟗	gkhj
璐	gkhk
璝	gkhm
橐	gkhs
櫜	gkhs
栆	gkhu
珿	gkhy
亜	gkjg
悪	gkjn
卅	gkk
噩	gkkk
璪	gkks
畐	gklf
副	gklj
疈	gkll
鶝	gklo
逼	gklp
鞷	gkmf
鹝	gkmg
鬲	gkmh
融	gkmj
鬸	gkml
翮	gkmn
鷊	gkmo
鬺	gkmr
鬴	gkms
鬷	gkmt
逜	gkpd
带	gkph
吏	gkri
敔	gkty
豇	gkua
豌	gkub
郖	gkub
豉	gkuc
毭	gkue
豆	gkuf
豍	gkuf
剅	gkuj
頭	gkum
逗	gkup
豏	gkuw
事	gkvh
剚	gkvj
画	glbj
珚	gldy
環	glge
畺	glgg
玾	glh
卌	glk
瓃	glll
琏	glpy
璉	glpy
琾	glwj
曹	gmaj
遭	gmap
琠	gmaw
襾	gmbk
叀	gmcu
瑞	gmdj
勣	gmet
再	gmfd
珃	gmfg
琱	gmfk
専	gmfu
靑	gmhg
䴓	gmhg
巿	gmhk
帀	gmhk
鳾	gmho
迊	gmhp
兩	gmhy
曺	gmjf
珊	gmmg
両	gmmk
璎	gmmv
瓔	gmmv
恵	gmnu
鬶	gmqh
现	gmqn
规	gmqn
椝	gmqs
责	gmu
責	gmu
邴	gmwb
丙	gmwi
瓗	gmwk
琌	gmwn
两	gmww
璀	gmwy
珼	gmy
郦	gmyb
酈	gmyb
彨	gmye
彲	gmye
鹂	gmyg
玬	gmyg
鸝	gmyo
逦	gmyp
邐	gmyp
婯	gmyv
麗	gmyx
丽	gmyy
瑉	gnaj
珉	gnan
琚	gndg
珝	gng
与	gngd
欤	gngw
瑕	gnhc
瑂	gnhg
瑋	gnkg
玌	gnn
玘	gnn
邷	gnnb
瓪	gnnc
瓱	gnne
瓧	gnnf
瓩	gnnf
瓼	gnnf
甅	gnnf
瓸	gnnj
瓲	gnnn
瓰	gnnv
瓦	gnny
戸	gnr
玚	gnrt
珌	gntt
攷	gnty
忢	gnu
丂	gnv
璆	gnwe
玦	gnwy
璻	gnyf
亚	god
垩	goff
灭	goi
戬	goja
鄑	gojb
晋	gojf
恶	gonu
琰	gooy
璘	goqg
严	gote
璞	goug
瑭	govk
辷	gpd
迋	gpd
琮	gpfi
琓	gpfq
瑄	gpgg
琔	gpgh
璸	gpgm
璌	gpgw
珲	gplh
琿	gplh
璭	gplp
琯	gpng
琬	gpqb
瑸	gprw
瑢	gpwk
琛	gpws
瑏	gpwt
殘	gqaa
殣	gqag
殢	gqah
琘	gqaj
尶	gqal
殜	gqas
殛	gqbg
殆	gqck
麺	gqdf
殗	gqdn
殑	gqdq
殝	gqdt
殎	gqdw
万	gqe
殍	gqeb
殂	gqeg
劢	gqet
殱	gqfg
殖	gqfh
殰	gqfm
殪	gqfu
琻	gqg
残	gqga
殌	gqga
尫	gqgd
豗	gqge
殭	gqgg
麸	gqgy
殏	gqgy
殩	gqho
歹	gqi
珧	gqiy
珎	gqiy
裂	gqje
劽	gqje
珣	gqjg
䴕	gqjg
列	gqjh
虺	gqji
殟	gqjl
烈	gqjo
烮	gqjo
鮤	gqjo
鴷	gqjo
迾	gqjp
銐	gqjq
虿	gqju
姴	gqjv
殫	gqkf
玽	gqkg
趸	gqkh
殒	gqkm
殞	gqkm
殨	gqkm
㱮	gqkm
殬	gqlf
殃	gqmd
瑍	gqmd
瓊	gqmt
玸	gqnn
瑦	gqoy
鳺	gqoy
鳿	gqoy
迈	gqpe
殯	gqpm
殡	gqpw
殥	gqpw
卼	gqqb
歿	gqqc
殉	gqqj
殙	gqqj
殦	gqqo
麹	gqqo
歾	gqqr
歽	gqrh
殐	gqsk
聱	gqtb
珋	gqtb
瑤	gqtb
獒	gqtd
殀	gqtd
殠	gqtd
殊	gqtf
歼	gqtf
鳌	gqtg
骜	gqtg
殅	gqtg
螯	gqtj
嗸	gqtk
殈	gqtl
赘	gqtm
嶅	gqtm
贅	gqtm
熬	gqto
驁	gqto
鰲	gqto
鷔	gqto
遨	gqtp
鏊	gqtq
殇	gqtr
摮	gqtr
殤	gqtr
嫯	gqtv
鼇	gqtx
敖	gqty
謷	gqty
殚	gquf
殕	gquk
兀	gqv
兀	gqv
肂	gqvg
琤	gqvh
殔	gqvi
殁	gqwc
殄	gqwe
殓	gqwg
殲	gqwg
餮	gqwv
飱	gqwv
殮	gqww
死	gqxv
瑠	gqyl
玖	gqyy
殧	gqyy
玓	gqyy
碧	grdf
琋	grdh
珀	grg
瑝	grgg
瑔	griy
瑰	grqc
瓆	grrm
琕	grtf
瓅	grxs
璬	gryt
膥	gsdw
玎	gsh
末	gsi
亍	gsj
珂	gskg
瓎	gskm
唜	gskx
瑓	gslg
璴	gssh
琳	gssy
瑮	gssy
琜	gsww
璷	gsyt
琇	gtbt
琒	gtdh
珤	gtfb
玝	gtfh
瓒	gtfm
璳	gtfm
瓚	gtfm
珽	gtfp
珗	gtfq
珠	gtfy
珄	gtgg
璑	gtgo
珩	gtgs
瑖	gthc
琍	gtjh
珞	gtkg
瑀	gtky
璁	gtln
珦	gtmk
琁	gtnh
瑡	gtnh
璠	gtol
瓈	gtqi
珴	gtry
麦	gtu
珘	gtuy
瑽	gtwh
珻	gtxy
玫	gty
瑳	guag
郏	gudb
夹	gudi
刾	gudj
颊	gudm
頬	gudm
瓏	gued
瑐	guej
璲	guep
平	gufk
珜	guh
璋	gujh
璄	gujq
琣	gukg
璔	gulj
琷	gunn
珓	gury
来	gusi
瓓	gusl
赉	gusm
慭	gusn
亊	guvh
珶	guxt
勁	gvae
巠	gvaf
璕	gvaf
剄	gvaj
巰	gvak
頸	gvam
鵛	gvao
逕	gvap
坙	gvff
璛	gvfj
珒	gvgh
郪	gvhb
疌	gvhi
璶	gvhl
鶈	gvho
妻	gvhv
琭	gviy
璅	gvjs
玿	gvkg
珺	gvtk
瑙	gvtr
珢	gvy
玳	gway
玱	gwbn
玜	gwcy
珍	gwet
珮	gwgh
瑜	gwgj
璯	gwgj
珨	gwgk
珟	gwgq
璒	gwgu
玠	gwjh
壐	gwmf
蠒	gwmj
鸍	gwmo
邇	gwmp
覼	gwmq
爾	gwmr
璽	gwmy
玑	gwn
兲	gwu
玢	gwvt
玐	gwy
玲	gwyc
琟	gwyg
琀	gwyk
瑲	gwyk
玪	gwyn
璡	gwyp
互	gxd
瑑	gxey
纛	gxhi
繛	gxij
素	gxiu
瑻	gxmy
毒	gxu
夷	gxwi
鴺	gxwo
玭	gxxn
瑎	gxxr
璣	gxxw
璏	gxxx
琉	gyck
珫	gycq
珳	gyet
琂	gyg
斑	gygg
玣	gyhy
玉	gyi
乁	gyi
玊	gyi
琼	gyiy
璾	gyjg
瓖	gyke
瓌	gyle
璮	gylg
璃	gyrc
班	gytg
璇	gyth
瓋	gyup
瑯	gyvb
琅	gyvy
琗	gywf
玹	gyxy
玟	gyy
瞸	haas
睰	hadk
虐	hagd
眶	hagg
瞱	hagg
瞒	hagw
頥	hahm
瞙	hajd
瞘	hakk
矔	haky
瞄	halg
矒	halh
瞞	hamy
歫	hang
眓	hann
矇	hape
眍	hary
矆	hawc
齰	hbaj
齛	hban
齖	hbat
齱	hbbc
齝	hbck
齮	hbdk
齟	hbeg
齨	hbeg
齯	hbeq
齻	hbfw
眲	hbg
齬	hbgk
齜	hbhx
齒	hbj
齥	hbjt
齵	hbjy
齪	hbkh
齶	hbkn
齞	hbkw
齫	hbls
齷	hbnf
齓	hbnn
齳	hbpl
齣	hbqk
齙	hbqn
齺	hbqt
齗	hbrh
齭	hbrr
齼	hbsh
齽	hbsi
齚	hbtf
齕	hbtn
齲	hbty
齴	hbue
齸	hbul
齩	hbur
齠	hbvk
齦	hbvy
齡	hbwc
齘	hbwj
齔	hbxn
眙	hckg
瞲	hcnk
眸	hctg
攴	hcu
睃	hcwt
矋	hday
郹	hdbh
睚	hdff
睳	hdff
歲	hdgh
歳	hdgi
劌	hdgj
顪	hdgm
翽	hdgn
非	hdhd
奜	hdhd
猆	hdhd
裴	hdhe
靟	hdhe
韭	hdhg
盽	hdhh
蜚	hdhj
剕	hdhj
辈	hdhl
輩	hdhl
悲	hdhn
翡	hdhn
棐	hdhs
婓	hdhv
餥	hdhv
斐	hdhy
頉	hdmy
䴗	hdqg
鶪	hdqo
狊	hdu
瞭	hdui
睶	hdwj
眬	hdxy
虏	hee
肯	hef
眀	heg
皻	hegb
虘	hegd
覰	hegq
瞍	hehc
眊	hen
瞬	hepg
瞹	hept
睨	heqn
睬	hesy
睜	hevh
睵	hfak
瞌	hfcl
歧	hfcy
眃	hfcy
眭	hffg
歭	hffy
盰	hfh
瞋	hfhw
眎	hfiy
瞦	hfkk
盶	hfqn
睹	hftj
睦	hfwf
睖	hfwt
矐	hfwy
眛	hfy
盹	hgbn
眰	hgcf
丄	hgd
勮	hgee
睛	hgeg
豦	hgei
劇	hgej
遽	hgep
盱	hgfh
鬦	hggf
鬪	hggf
鬥	hggh
鬧	hggh
鬩	hggq
鬬	hggr
鬭	hggr
鬫	hggt
鬨	hggw
鬮	hggx
凸	hghg
芈	hghg
卝	hghg
眐	hghg
羋	hghg
茍	hghk
眄	hghn
瞡	hghq
羐	hghy
雈	hghy
戲	hgka
齾	hgkb
獻	hgkd
鬳	hgkh
覻	hgkq
甗	hgky
眪	hgmw
矖	hgmx
歵	hgmy
瞔	hgmy
眜	hgsy
睐	hgus
睫	hgvh
眱	hgxw
颦	hhdf
顰	hhdf
频	hhdm
頻	hhdm
瞁	hhdy
上	hhgg
止	hhgg
虍	hhgn
歮	hhhf
瞐	hhhf
目	hhhh
丨	hhll
亅	hhll
矑	hhll
鼑	hhnn
愳	hhnu
煛	hhou
瞾	hhpa
鷪	hhpo
睍	hhqn
步	hhr
卡	hhu
歨	hhu
戵	hhwa
矍	hhwc
氍	hhwe
鸜	hhwo
瞿	hhwy
眦	hhxn
卜	hhy
裻	hice
督	hich
惄	hicn
錖	hicq
叔	hicy
睄	hieg
敊	hihc
瞠	hipf
矘	hipo
縣	hiti
懸	hitn
歩	hitr
眇	hitt
尗	hiu
睅	hjfh
旧	hjg
睼	hjgh
眒	hjhh
卓	hjj
戱	hjna
虛	hjng
逴	hjpk
児	hjqb
鵫	hjqo
睗	hjqr
桌	hjsu
睲	hjtg
战	hkay
梷	hkcs
頕	hkdm
奌	hkdu
睊	hkeg
占	hkf
虞	hkgd
睈	hkgg
鸆	hkgo
敁	hkhc
瞆	hkhm
瞶	hkhm
覘	hkhq
瞣	hkkn
矂	hkks
觇	hkmq
乩	hknn
点	hkou
迠	hkpd
眖	hkqn
膚	hled
虜	hlee
盀	hlf
睤	hlgj
盧	hlld
顱	hllm
鸕	hllo
勴	hlne
卣	hlnf
慮	hlni
逌	hlnp
鹺	hloa
鹷	hloc
鹹	hlok
鹶	hlon
鹵	hlou
鹸	hlow
鹻	hlow
鹼	hlow
鹾	hlra
禼	hlrc
卤	hlru
卥	hlry
睏	hlsy
瞜	hlvg
欳	hmaw
睓	hmaw
眏	hmdy
睭	hmfk
眮	hmgk
卨	hmnk
遉	hmpi
贞	hmu
貞	hmu
眠	hnan
瞰	hnbt
颅	hndm
鼎	hndn
睱	hnhc
凹	hnhg
睸	hnhg
兕	hnhq
虑	hni
矚	hnij
県	hniu
鸬	hnqg
卢	hnr
虙	hnte
瞩	hnty
忐	hnu
郻	hnvb
矅	hnwy
眤	hnxn
矌	hoaw
戯	hoay
齢	hobc
歯	hobj
虚	hod
覷	hohq
觑	homq
睒	hooy
瞇	hopy
瞵	hoqg
歔	hoqw
瞨	houg
䁖	hovg
瞊	hovk
虡	howi
眯	hoy
瞎	hpdk
肻	hpef
睆	hpfq
叡	hpgc
壑	hpgf
壡	hpgf
睻	hpgg
睿	hpgh
矉	hpgm
瞚	hpgw
瞑	hpju
睴	hplh
矃	hpns
睕	hpqb
眈	hpqn
眝	hpsh
敹	hptt
睧	hqaj
眂	hqan
眡	hqay
見	hqb
覎	hqbd
韰	hqcg
粲	hqco
餐	hqcv
瞻	hqdy
䲣	hqgt
覞	hqhq
眺	hqiy
眴	hqjg
眗	hqkg
眳	hqkg
睌	hqkq
矎	hqmt
䱷	hqot
瞗	hqoy
鳪	hqoy
眵	hqqy
覐	hqrr
覹	hqtt
歺	hqu
盷	hqug
睁	hqvh
眅	hrcy
虗	hrd
睎	hrdh
眽	hrey
瞃	hrfh
盺	hrh
矈	hrpy
睥	hrtf
瞟	hsfi
盯	hsh
瞫	hsjh
虨	hsse
睞	hsww
睡	htgf
歱	htgf
瞴	htgo
矄	htgo
眣	htgy
矏	hthy
矀	htmt
盵	htnn
辪	htnu
矁	hton
瞅	htoy
眨	htpy
睋	htry
虖	htuf
歬	htuu
歑	htuw
瞛	htwh
處	htwv
眹	hudy
矓	hued
瞯	hueg
睠	hugb
瞤	hugg
眫	hugh
眻	huh
瞳	hujf
瞷	hujg
瞕	hujh
矙	hunt
睇	huxt
睷	hvgp
睩	hviy
眧	hvkg
眼	hvy
虥	hwaa
龄	hwbc
龌	hwbf
龃	hwbg
龊	hwbh
齿	hwbj
龉	hwbk
龆	hwbk
龅	hwbn
龁	hwbn
龂	hwbr
龈	hwbv
龇	hwbx
龀	hwbx
龋	hwby
瞈	hwcn
彪	hwee
眕	hwet
甝	hwfd
睔	hwga
睽	hwgd
睑	hwgg
睮	hwgj
瞺	hwgj
盻	hwgn
瞪	hwgu
瞼	hwgw
贙	hwhm
覤	hwhq
虤	hwhw
睺	hwnd
虝	hwqr
具	hwu
仧	hwu
虎	hwv
凣	hwv
盼	hwvt
睉	hwwf
虪	hwwo
雐	hwyd
睢	hwyg
虧	hwyn
瞧	hwyo
砦	hxdf
眑	hxet
些	hxff
祡	hxfi
眥	hxhf
歶	hxjy
呰	hxkf
啙	hxkk
赀	hxmu
貲	hxmu
胔	hxmw
此	hxn
觜	hxqe
鈭	hxqf
鮆	hxqo
鴜	hxqo
矊	hxrh
柴	hxsu
姕	hxvf
飺	hxwv
雌	hxwy
紫	hxxi
訾	hxyf
瞮	hyct
虔	hyi
瞓	hykh
睙	hynd
眿	hyni
盳	hynn
瞝	hyrc
眆	hyt
睟	hywf
眩	hyxy
盿	hyy
灆	iaal
淺	iaay
漭	iada
渃	iadk
澒	iadm
頮	iadm
颒	iadm
潵	iaet
濭	iafl
江	iag
洭	iagg
澕	iagg
懑	iagn
满	iagw
淽	iahg
洍	iahh
瀶	iahk
濫	iahl
灠	iahq
漠	iajd
濗	iajh
澫	iajy
淢	iakg
漌	iakg
漢	iakg
漚	iakk
灌	iaky
灘	iaky
渵	ialg
瀎	ialw
渶	iamd
溝	iamf
満	iamm
懣	iamn
潢	iamw
滿	iamy
汇	ian
洰	iang
泄	iann
泧	iann
渠	ians
渫	ians
瀳	iaoo
涝	iape
濛	iape
潆	iapi
溁	iaps
滢	iapy
鸿	iaqg
滯	iaqh
灊	iaqh
潛	iaqj
懘	iaqn
濍	iaqn
鴻	iaqo
沤	iary
渮	iask
柒	iasu
浇	iatq
灡	iaul
瀟	iavj
沏	iavt
潇	iavw
濩	iawc
溚	iawk
濸	iawk
港	iawn
鍙	iawq
洪	iawy
滙	iawy
浳	iaye
淓	iayt
灄	ibbb
滠	ibcc
溋	ibcl
碆	ibdf
瀡	ibdp
泐	ibet
洱	ibg
汓	ibg
滍	ibhj
涵	ibib
洆	ibig
凼	ibk
濻	ibkm
泏	ibmh
池	ibn
氾	ibn
錃	ibqf
漋	ibtg
婆	ibvf
滁	ibws
波	iby
汲	ibyy
泾	icag
涰	iccc
滲	icce
渗	icde
湧	icee
涌	iceh
慂	icen
泽	icgh
治	ickg
汿	icnh
沀	icnh
潏	icnk
滪	icnm
澦	icnm
渘	icns
溤	icoy
沇	icqn
涘	ictd
洠	ictg
浚	icwt
滩	icwy
汉	icy
溞	icyj
汊	icyy
濿	iday
汯	idcy
沷	idcy
湖	ideg
洧	ideg
沥	idet
瀀	idet
涱	idey
沯	idf
渀	idfa
浱	idfe
漘	idfe
涯	idff
溽	idff
滣	idfk
洿	idfn
沽	idg
沰	idg
減	idgk
澸	idgn
滅	idgo
洊	idhb
滟	idhc
湱	idhd
沣	idhh
潔	idhi
尜	idiu
湹	idjf
洦	idjg
淹	idjn
湎	idlf
渜	idmd
洏	idmj
湏	idmy
厳	idnt
沋	idny
浝	idny
洃	idoy
㳠	idpy
源	idri
漺	idrr
渏	idsk
涛	idtf
瀝	idth
尖	idu
潦	idui
湊	idwd
淎	idwg
溙	idwi
濝	idwi
湷	idwj
湛	idwn
澌	idwr
溱	idwt
浹	idww
淇	idwy
泷	idxy
汏	idy
汱	idy
汰	idyy
湼	ieag
濦	iean
浮	iebg
淝	iecn
滔	ieeg
淜	ieeg
肖	ief
浖	iefy
湲	iegc
沮	iegg
澙	iego
渓	iegy
溲	iehc
漞	iehq
削	iejh
揱	iejr
泇	iekg
灂	ielf
涭	iepc
逍	iepd
淣	ieqn
潟	ieqo
灚	ierq
氻	iet
滛	ietb
淫	ietf
潙	ieto
浽	ievg
淨	ievh
溪	iexd
鸂	iexo
灞	ifae
瀐	ifag
泋	ifah
渽	ifak
濆	ifam
溨	ifas
瀻	ifaw
溘	ifcl
法	ifcy
汥	ifcy
沄	ifcy
濡	ifdj
尘	iff
坔	iff
澐	iffc
湗	ifff
洼	iffg
澆	iffq
洔	iffy
泔	ifg
汢	ifg
汗	ifh
汁	ifh
淔	ifhg
滇	ifhw
沶	ifiy
潮	ifje
澣	ifjf
濣	ifjf
汫	ifjh
瀚	ifjn
漧	ifjn
澎	ifke
溒	ifke
澍	ifkf
洁	ifkg
瀆	iflm
湳	ifmf
渎	ifnd
濤	ifnf
污	ifnn
汚	ifnn
浾	ifoy
浡	ifpb
濲	ifpc
瀔	ifpc
瀫	ifpc
渤	ifpe
溹	ifpi
涜	ifpq
潱	ifpu
沅	ifqn
灀	ifsh
瀮	ifss
洡	ifsy
湈	ifsy
涍	iftb
渚	iftj
洘	iftn
漖	iftt
涬	ifuf
澾	ifup
澪	ifwc
淕	ifwf
濇	ifwk
淩	ifwt
瀖	ifwy
沬	ify
汧	igah
浅	igay
沌	igbn
洷	igcf
添	igdn
濪	igec
清	igeg
瀞	igeh
瀦	igej
涿	igey
汙	igfh
盓	igfl
汪	igg
潖	iggc
潜	iggj
濽	iggm
濏	iggt
泟	ighg
沔	ighn
漹	igho
浗	igiy
漙	igjf
洹	igjg
澑	igjl
潓	igjn
浭	igjr
灢	igke
浯	igkg
滞	igkh
滆	igkh
瀜	igkj
湢	igkl
浢	igku
洅	igmf
淸	igmg
沛	igmh
沞	igmh
漕	igmj
灑	igmx
渍	igmy
漬	igmy
汅	ignn
溍	igoj
光	igqb
韑	igqg
洌	igqj
辉	igql
輝	igql
滶	igqt
兤	igqw
黋	igqw
尡	igqx
耀	igqy
沫	igsy
浃	igud
泙	iguf
涞	igus
涇	igva
淒	igvv
举	igwg
挙	igwr
濔	igwr
兴	igwu
誉	igwy
溼	igxf
沍	igxg
溸	igxi
洟	igxw
渄	ihdd
濊	ihdh
湨	ihdy
泪	ihg
沚	ihg
澽	ihge
澁	ihhh
濒	ihhm
瀕	ihhm
涉	ihht
灈	ihhy
淑	ihic
渺	ihit
渉	ihit
渋	ihiy
淖	ihjh
澞	ihkd
沾	ihkg
惉	ihkn
瀘	ihll
濾	ihln
滷	ihlo
浈	ihmy
湞	ihmy
濎	ihnn
泸	ihnt
滤	ihny
濬	ihph
覍	ihqb
瀣	ihqg
涀	ihqn
澯	ihqo
滹	ihtf
小	ihty
滮	ihwe
淲	ihwn
濉	ihwy
泚	ihxn
氺	ihyy
濷	iiay
消	iieg
洸	iigq
水	iiii
淼	iiiu
尛	iiiu
渁	iiiy
涾	iijg
淌	iimk
溑	iimy
漟	iipf
澢	iipl
灙	iipo
硰	iitd
裟	iite
鲨	iitg
渻	iith
乷	iitn
鯊	iito
逤	iitp
挲	iitr
桬	iits
沙	iitt
娑	iitv
潎	iity
沝	iiy
渱	ijag
滭	ijag
瀑	ijai
沓	ijf
戦	ijfa
溡	ijff
濹	ijff
涅	ijfg
浬	ijfg
涆	ijfh
単	ijfj
濐	ijfj
汨	ijg
汩	ijg
鼝	ijgc
淏	ijgd
淂	ijgf
泹	ijgg
淵	ijgg
浉	ijgh
湜	ijgh
盪	ijgl
燙	ijgo
湯	ijgr
璗	ijgy
滉	ijiq
虩	ijiw
淐	ijjg
漫	ijlc
温	ijlg
澷	ijly
湡	ijmy
溻	ijng
洩	ijnt
湿	ijog
渴	ijqn
渇	ijqx
巣	ijsu
淉	ijsy
湦	ijtg
滥	ijtl
灦	ijxm
濕	ijxo
混	ijxx
浊	ijy
灗	ijyg
澋	ijyi
灏	ijym
灝	ijym
渂	ijyy
湒	ikbg
濈	ikby
浥	ikcn
涓	ikeg
呇	ikf
洖	ikgd
塣	ikgf
浧	ikgg
汌	ikh
沖	ikhh
潞	ikhk
溃	ikhm
潰	ikhm
瀢	ikhp
浞	ikhy
渑	ikjn
潬	ikkf
澏	ikkm
漶	ikkn
湂	ikkn
澡	ikks
涡	ikmw
涢	ikmy
溳	ikmy
況	ikqn
漍	ilag
潩	ilaw
涸	ildg
瀱	ildj
洇	ildy
渭	ileg
潈	iley
泴	ilf
畄	ilf
畓	ilf
澤	ilff
涠	ilfh
濖	ilfj
潶	ilfo
泗	ilg
沺	ilg
獣	ilgd
溷	ilge
渨	ilge
澴	ilge
淠	ilgj
洄	ilkg
灅	illf
潿	ilng
涟	ilpy
漣	ilpy
濁	ilqj
聻	ilrb
魙	ilrc
壍	ilrf
渐	ilrh
漸	ilrh
嬱	ilrv
涃	ilsy
溿	ilug
漊	ilvg
瀭	ilwj
溫	ilwl
溭	ilwt
泅	ilwy
潀	ilwy
漯	ilxi
濺	imaa
灔	imac
濃	imae
浀	imag
灎	imal
澧	imau
淟	imaw
灧	imdc
漄	imdf
湍	imdj
灩	imdl
湠	imdo
灃	imdu
泱	imdy
漰	imee
滑	imeg
淍	imfk
油	img
溅	imga
洞	imgk
涄	imgn
溦	imgt
澂	imgt
溰	imgu
汕	imh
测	imjh
測	imjh
瀃	imjr
潉	imjx
氅	imke
尚	imkf
尙	imkf
泂	imkg
幤	imkh
敞	imkt
瀴	immv
渦	imnk
濄	imnp
漴	impi
溄	imtg
潂	imuo
浻	imwk
涔	imwn
汭	imwy
漼	imwy
浿	imy
浵	imye
澱	inac
湣	inaj
泯	inan
尐	inb
潺	inbb
淈	inbm
澉	inbt
涺	indg
浘	inen
汛	infh
潳	infj
漏	infy
渥	ingf
汈	ingg
泀	ingk
溊	inhc
湑	inhe
湄	inhg
沑	inhg
漽	inig
灟	inij
湋	inkg
浺	inkh
澼	inku
瀷	inlw
涮	inmj
汜	inn
潠	innw
瀈	inpl
漝	inrg
烫	inro
汤	inrt
湉	intd
泌	intt
泼	inty
泦	invn
漻	inwe
濯	inwy
決	inwy
埿	inxf
泥	inxn
沁	iny
濢	inyf
瀥	inyk
浕	inyu
泤	inyw
沢	inyy
渡	ioac
瀇	ioaw
灋	iogc
瀍	iojf
瀵	iolw
澇	iooe
濴	iooi
瀠	iooi
瀯	iook
濙	iooo
灐	iooq
濚	ioos
淡	iooy
瀅	iooy
潾	ioqg
灖	iosd
灇	iouc
澲	iouf
濧	iouf
濂	iouw
溇	iovg
滽	iovh
漮	iovi
溏	iovk
瀌	ioxo
漉	ioxx
洣	ioy
瀽	ipah
黉	ipaw
学	ipbf
敩	ipbt
浤	ipdc
瀗	ipdn
涋	ipdy
瀉	ipeo
労	iper
浓	ipey
尝	ipfc
滱	ipfc
溕	ipfe
坣	ipff
淙	ipfi
浣	ipfq
泻	ipgg
渲	ipgg
淀	ipgh
濱	ipgm
演	ipgw
漃	iphc
覚	iphq
泶	ipiu
渖	ipjh
溟	ipju
蛍	ipju
裳	ipke
堂	ipkf
甞	ipkf
常	ipkh
劏	ipkj
嘗	ipkj
営	ipkk
當	ipkl
赏	ipkm
賞	ipkm
黨	ipko
党	ipkq
掌	ipkr
棠	ipks
牚	ipkt
瓽	ipky
浑	iplh
渾	iplh
峃	ipmj
觉	ipmq
澝	ipne
涫	ipng
滵	ipnm
濵	ipnm
濘	ipns
淧	ipnt
涴	ipqb
鲎	ipqg
鸴	ipqg
沈	ipqn
鴬	ipqo
滨	iprw
泞	ipsh
栄	ipsu
浨	ipsy
浶	iptg
喾	iptk
瀋	iptl
滓	ipuh
濅	ipvc
洝	ipvg
涳	ipwa
湥	ipwd
浫	ipwf
漥	ipwf
潌	ipwf
溶	ipwk
滘	ipwk
沉	ipwn
深	ipws
泬	ipwy
溛	ipwy
沱	ipxn
涽	iqaj
汦	iqan
泜	iqay
沟	iqcy
沒	iqcy
洈	iqdb
澹	iqdy
淊	iqeg
澥	iqeg
淦	iqg
渔	iqgg
澛	iqgj
滐	iqgs
洮	iqiy
沵	iqiy
洵	iqjg
潒	iqke
泃	iqkg
洺	iqkg
浼	iqkq
瀺	iqky
涣	iqmd
渙	iqmd
泡	iqnn
瀂	iqoj
淗	iqoy
溩	iqoy
漁	iqoy
濥	iqpw
洶	iqrb
淴	iqrn
沕	iqrt
淘	iqtb
泖	iqtb
潴	iqtj
漪	iqtk
汮	iqug
浄	iqvh
盜	iqwl
汐	iqy
渹	iqyg
瀏	iqyj
溜	iqyl
汋	iqyy
汣	iqyy
汹	irbh
汳	ircy
泒	ircy
淆	irde
湃	irdf
滜	irdf
浠	irdh
派	irey
垽	irff
泊	irg
湟	irgg
洉	irgk
沂	irh
沠	irhy
湶	iriy
淿	irmh
峾	irmj
汽	irn
滊	iroy
溾	irqc
浙	irrh
渒	irtf
澔	irtk
溵	irvc
湁	irwk
浜	irwy
漑	irxq
濼	irxs
激	iryt
泝	iryy
涁	iset
溎	isff
湮	isfg
漂	isfi
渿	isfi
溥	isfy
洒	isg
酒	isgg
泍	isgg
汀	ish
湘	ishg
渣	isjg
涷	isjg
潭	isjh
河	iskg
涑	iskg
溂	iskj
滒	iskk
濑	iskm
瀨	iskm
瀬	iskm
潄	iskt
漱	iskw
湅	islg
洓	ismn
潥	isoy
湐	isrg
淅	isrh
潸	isse
漜	issf
濋	issh
澿	issi
澘	issj
潹	isss
漤	issv
淋	issy
溧	issy
滼	issy
灪	iste
淞	iswc
漆	iswi
瀒	iswk
淶	isww
浦	isy
沐	isy
沭	isyy
弊	itaj
汑	itan
澨	itaw
沲	itbn
活	itdg
浲	itdh
潪	itdj
漨	itdp
鋈	itdq
獘	itdu
沃	itdy
少	ite
毟	iteb
滗	iten
劣	iter
汘	itfh
汻	itfh
濳	itfj
浩	itfk
灒	itfm
涏	itfp
洗	itfq
鍌	itfq
洙	itfy
涶	itgf
湩	itgf
泩	itgg
湰	itgg
洚	itgh
汼	itgh
淛	itgj
潕	itgo
洐	itgs
斃	itgx
泆	itgy
潅	itgy
溴	ithd
省	ithf
瞥	ithf
泎	ithf
洎	ithg
漇	ithh
濞	ithj
沜	ithn
涎	ithp
乑	ithy
潲	itie
暼	itjf
浰	itjh
漡	itjr
蟞	itju
鄨	itkc
洛	itkg
蹩	itkh
渪	itky
洫	itlg
潨	itli
漗	itln
澳	itmd
幣	itmh
澚	itmn
瀓	itmt
溮	itnh
泺	itni
汔	itnn
泲	itnt
憋	itnu
渊	itoh
潘	itol
湫	itoy
泛	itpy
鐅	itqf
鳖	itqg
鱉	itqo
鷩	itqo
撆	itrj
涐	itry
涤	itsy
潃	itte
澓	ittt
龞	ittx
泘	ituf
瀊	itul
溗	itux
泈	ituy
洀	ituy
瀄	itvb
嫳	itvf
涹	itvg
潷	itvg
漎	itwh
潻	itwi
瀩	itwm
彆	itxb
塰	itxf
鼈	itxf
瀿	itxi
湚	itxn
海	itxy
敝	ity
汷	ity
溠	iuag
洴	iuah
渆	iuaj
溯	iube
滚	iuce
渕	iudj
浂	iudy
瀧	iued
湇	iueg
湔	iuej
澻	iuep
泣	iug
淃	iugb
渼	iugd
润	iugg
潤	iugg
泮	iugh
漾	iugi
漛	iugi
潫	iugi
溔	iugo
瀁	iugv
湵	iugy
洋	iuh
潼	iujf
涧	iujg
湆	iujg
澗	iujg
漳	iujh
灨	iujm
滝	iujn
澺	iujn
滰	iujq
滾	iuke
灛	iukf
涪	iukg
涚	iukq
渷	iukq
潧	iulj
溬	iunc
湴	iuog
潽	iuoj
澬	iuqm
灁	iuri
滧	iurt
洨	iury
澊	iusf
湭	iusg
澜	iusl
瀾	iusl
瀙	iusq
澵	iusr
澖	iusy
濶	iutd
滻	iutg
渞	iuth
浐	iutt
濓	iutw
灍	iuuw
淁	iuvg
溓	iuvw
溢	iuwl
濨	iuxn
涕	iuxt
滋	iuxx
潣	iuyy
潯	ivaf
溉	ivaq
当	ivf
澅	ivfg
潚	ivfj
浔	ivfy
汝	ivg
堻	ivgf
津	ivgh
湽	ivgl
湕	ivgp
濜	ivhl
渌	iviy
漅	ivjs
沼	ivkg
洳	ivkg
灉	ivky
淄	ivlg
氿	ivn
浸	ivpc
染	ivsu
涒	ivtk
粱	ivwo
梁	ivws
泿	ivy
涩	ivyh
澀	ivyh
涊	ivyn
汍	ivyy
浌	iway
沧	iwbn
滃	iwcn
没	iwcy
洑	iwdy
脊	iwef
洕	iweg
鹡	iweg
鶺	iweo
沴	iwet
浍	iwfc
漈	iwfi
涻	iwfk
溌	iwfq
泭	iwfy
瀹	iwga
淪	iwga
渰	iwga
溆	iwgc
潊	iwgc
湀	iwgd
塗	iwgf
洤	iwgg
渝	iwgj
澮	iwgj
鼡	iwgj
洽	iwgk
潝	iwgn
洬	iwgq
涂	iwgs
潋	iwgt
漵	iwgt
瀲	iwgt
澄	iwgu
澰	iwgw
滫	iwhe
滺	iwhn
滌	iwhs
浟	iwht
沿	iwkg
涗	iwkq
湺	iwks
濮	iwog
滏	iwru
沨	iwry
渢	iwtj
氼	iwu
涖	iwug
湓	iwvl
汾	iwvt
洢	iwvt
溣	iwwa
瀸	iwwg
浴	iwwk
潑	iwxc
沦	iwxn
沎	iwxn
汃	iwy
汄	iwy
泠	iwyc
雀	iwyf
準	iwyf
淮	iwyg
蠽	iwyj
浛	iwyk
滄	iwyk
盕	iwyl
汵	iwyn
淰	iwyn
潐	iwyo
潗	iwys
湌	iwyv
汎	iwyy
渳	ixbg
泓	ixcy
漲	ixde
泑	ixet
湪	ixey
澠	ixg
瀰	ixgr
淥	ixiy
沸	ixjh
漒	ixkj
涨	ixty
溺	ixuu
潍	ixwy
濰	ixwy
沘	ixxn
湝	ixxr
漷	iybb
淳	iybg
涥	iybh
潡	iybt
淯	iyce
流	iyck
鎏	iycq
澈	iyct
瑬	iycy
瀛	iyey
沩	iyey
灜	iyey
注	iygg
乼	iygn
汴	iyhy
涼	iyiy
済	iyjg
湻	iyjg
濟	iyjg
济	iyjh
浏	iyjh
滖	iyke
瀼	iyke
瀤	iyle
澶	iylg
澟	iylt
滈	iymk
滬	iync
涙	iynd
淚	iynd
泳	iyni
汒	iynn
淭	iyns
沪	iynt
湙	iyod
滦	iyos
湾	iyox
洂	iyoy
濠	iype
渟	iyps
湸	iypw
漓	iyrc
灕	iyry
汸	iyt
游	iytb
湤	iytb
浒	iytf
滸	iytf
洲	iyth
漩	iyth
溈	iyto
滴	iyud
渧	iyuh
滳	iyuk
滂	iyuy
浪	iyvy
淬	iywf
沆	iywn
淤	iywu
液	iywy
滀	iyxl
灤	iyxs
灣	iyxx
泫	iyxy
澭	iyxy
汶	iyy
氵	iyyg
暱	jaak
蠂	jaas
昻	jabj
蟒	jada
蠎	jada
昮	jaer
虹	jag
曄	jagg
曅	jagg
畢	jagk
鷝	jago
螨	jagw
蚜	jaht
蟆	jajd
暯	jajd
蜡	jajg
蝘	jajv
蠇	jajy
蜮	jakg
暵	jakg
螼	jakg
曣	jako
蠸	jaky
蠴	jalj
蠛	jalw
暎	jamd
蝧	jamd
蟥	jamw
曂	jamw
蜹	jamw
暪	jamy
蟎	jamy
昛	jang
蚷	jang
煚	jano
蝶	jans
蠓	jape
曚	jape
蝾	japs
螮	jaqh
曔	jaqt
蠮	jatn
晓	jatq
蛲	jatq
蠨	javj
蟏	javw
蠖	jawc
暴	jawi
晎	jawy
謈	jawy
最	jbcu
朂	jber
虸	jbg
蜬	jbib
蟶	jbkg
蜢	jblg
曓	jbmf
昢	jbmh
虵	jbn
蚾	jby
昅	jbyy
昪	jcaj
蝃	jccc
肾	jcef
蛹	jceh
坚	jcff
蛏	jcfg
蚂	jcgg
贤	jcmu
蚆	jcn
蝚	jcns
螞	jcoy
蛑	jctg
竖	jcuf
晙	jcwt
紧	jcxi
曞	jday
蠣	jday
蚅	jdbn
蛂	jdcy
蝴	jdeg
蛕	jdeg
晨	jdfe
蜄	jdfe
蝰	jdff
晇	jdfn
鷐	jdfo
蛄	jdg
蟵	jdgf
蛎	jdgq
蝛	jdgv
蚽	jdhg
蚌	jdhh
暳	jdhv
蛨	jdjg
昦	jdjj
晻	jdjn
蝒	jdlf
蝡	jdmd
暊	jdmy
蝢	jdmy
晟	jdnb
晠	jdnn
蚘	jdny
蛖	jdny
螈	jdri
旲	jdu
暸	jdui
蟟	jdui
蟩	jduw
蜯	jdwg
蝽	jdwj
暙	jdwj
蟖	jdwr
螓	jdwt
昃	jdwu
蛺	jdww
蜞	jdwy
昽	jdxy
蜉	jebg
猒	jedy
蛠	jeee
冐	jef
蛶	jefy
明	jeg
蚏	jeg
暖	jegc
蝯	jegc
勗	jege
蛆	jegg
琞	jegy
螋	jehc
盟	jelf
蚝	jen
焽	jeou
曌	jepa
暧	jepc
曖	jept
晲	jeqn
蜺	jeqn
暚	jetb
蟡	jeto
螇	jexd
蟦	jfam
暁	jfaq
蠘	jfay
蜐	jfce
墅	jfcf
野	jfch
昙	jfcu
蚑	jfcy
里	jfd
蠕	jfdj
曘	jfdj
黙	jfdo
圼	jff
曇	jffc
蛙	jffg
晆	jffg
曉	jffq
蟯	jffq
時	jffy
蚶	jfg
旰	jfh
旪	jfh
虷	jfh
旱	jfj
蟛	jfke
蛣	jfkg
暿	jfkk
蟢	jfkk
蝻	jfmf
暔	jfmf
黒	jfou
曀	jfpu
蚖	jfqn
暑	jftj
暏	jftj
蝫	jftj
螧	jftj
蛯	jftx
蟽	jfup
曤	jfwy
时	jfy
昧	jfy
蚈	jgah
旽	jgbn
蛭	jgcf
晊	jgcf
昊	jgdu
晴	jgeg
蜻	jgeg
旦	jgf
旴	jgfh
虶	jgfh
旺	jgg
蚟	jgg
昰	jghf
韙	jghg
韪	jghh
题	jghm
題	jghm
鶗	jgho
遈	jghp
尟	jght
晸	jght
是	jghu
匙	jghx
虾	jghy
蛷	jgiy
量	jgjf
暷	jgjf
晅	jgjg
蟪	jgjn
晤	jgkg
螎	jgkh
曧	jgkj
蝠	jgkl
鼌	jgkn
师	jgmh
昁	jgmh
螬	jgmj
昞	jgmw
昺	jgmw
蛃	jgmw
曬	jgmx
蜽	jgmy
蛚	jgqj
鴠	jgqo
逿	jgqp
昜	jgqr
敭	jgqt
昩	jgsy
蛱	jgud
蚲	jguf
蛵	jgva
蜨	jgvh
鼂	jgxf
螦	jgxi
蛦	jgxw
蝳	jgxy
蚨	jgy
暃	jhdd
毷	jhen
勖	jhet
冒	jhf
蝆	jhgf
刂	jhh
蠼	jhhc
蠷	jhhy
晫	jhjh
暢	jhjr
申	jhk
蛅	jhkg
曥	jhll
蠦	jhll
曰	jhng
早	jhnh
畅	jhnr
虫	jhny
迧	jhpk
晛	jhqn
蜆	jhqn
畃	jhqy
朄	jhsl
蟕	jhxe
虲	jhy
蟝	jias
蛸	jieg
晃	jigq
晄	jigq
螳	jipf
蟐	jiph
蟷	jipl
曭	jipo
蝋	jiwg
曝	jjai
昌	jjf
晘	jjfh
昍	jjg
蚎	jjg
蜵	jjgg
蛳	jjgh
蝭	jjgh
暘	jjgr
蝪	jjgr
蝐	jjhg
曑	jjje
曟	jjje
晶	jjjf
晿	jjjg
曐	jjjg
曡	jjjg
日	jjjj
蠱	jjjl
蝿	jjjn
蟲	jjju
蟃	jjlc
蝹	jjlg
焸	jjou
暥	jjpv
蝎	jjqn
暍	jjqn
蜴	jjqr
晹	jjqr
蠍	jjqw
蜾	jjsy
暒	jjtg
蜫	jjxx
暻	jjyi
蜎	jkeg
蜈	jkgd
冔	jkgf
蚛	jkhh
蝇	jkjn
暺	jkkf
蟬	jkkf
曮	jkkt
蜗	jkmw
蟈	jlag
鄤	jlcb
曼	jlcu
蝟	jleg
蛊	jlf
昷	jlf
曎	jlff
蠌	jlff
曙	jlfj
蟔	jlfo
蠉	jlge
蝈	jlgy
蛼	jlh
蜖	jljf
蛔	jlkg
蠝	jlll
蠋	jlqj
螹	jlrh
蜠	jlty
螻	jlvg
螺	jlxi
曪	jlxy
蛐	jmag
晪	jmaw
映	jmdy
螖	jmeg
蚺	jmfg
蚦	jmfg
蜩	jmfk
晭	jmfk
蚰	jmg
晍	jmgk
暟	jmgu
螘	jmgu
帅	jmhh
顒	jmhm
颙	jmhm
愚	jmhn
遇	jmhp
禺	jmhy
旵	jmj
蠳	jmmv
蝸	jmnk
蚬	jmqn
蛧	jmrr
蝄	jmun
蠵	jmwk
蚋	jmwy
蛽	jmy
蚒	jmyg
蜛	jndg
毾	jnen
蛡	jng
暅	jngg
暇	jnhc
蝦	jnhc
蝑	jnhe
丱	jnhg
蝞	jnhg
虯	jnhh
曯	jnij
蠾	jnij
暐	jnkg
虬	jnn
蟤	jnnw
遢	jnpd
旸	jnrt
曳	jnte
曵	jnty
电	jnv
蟉	jnwe
曜	jnwy
蚗	jnwy
蠗	jnwy
昵	jnxn
蚭	jnxn
蚇	jnyy
蟅	joao
曠	joaw
昿	jocy
顕	jodm
显	jof
蟧	jooe
蠑	joos
晱	jooy
暽	joqg
旷	jot
炅	jou
曗	jouf
蝷	jout
蠊	jouw
蝼	jovg
螗	jovk
螰	joxx
炚	joy
曢	jpdi
螛	jpdk
晥	jpfq
暄	jpgg
蝖	jpgg
蝊	jpgh
蠙	jpgm
螾	jpgw
螟	jpju
暝	jpju
晖	jplh
暉	jplh
晕	jplj
暈	jplj
蜿	jpqb
晼	jpqb
晏	jpvf
鷃	jpvo
螲	jpwf
蛇	jpxn
蚔	jqan
蚳	jqay
昂	jqbj
蛫	jqdb
蟾	jqdy
曕	jqdy
蜭	jqeg
蠏	jqeg
曻	jqgj
晁	jqiu
晀	jqiy
蟓	jqke
昫	jqkg
蚼	jqkg
煦	jqko
晚	jqkq
冕	jqkq
晩	jqkq
蜔	jqlg
蝜	jqmy
蚫	jqnn
螐	jqoy
蛥	jqqy
敡	jqrc
剔	jqrj
惖	jqrn
鶍	jqro
逷	jqrp
易	jqrr
昒	jqrt
蟂	jqsy
昴	jqtb
蜪	jqtb
昀	jqug
蚐	jqug
毼	jqwe
鹖	jqwg
曷	jqwn
鶡	jqwo
遏	jqwp
歇	jqww
欥	jqwy
旳	jqyy
虳	jqyy
蝬	jrbt
昄	jrcy
蛌	jrcy
暤	jrdf
晞	jrdh
蚯	jrg
蝗	jrgg
昕	jrh
蚚	jrh
螔	jrhw
暭	jrif
暣	jroy
螝	jrqc
晣	jrrh
蜱	jrtf
曒	jryt
蚸	jryy
颗	jsdm
顆	jsdm
褁	jseu
螵	jsfi
晒	jsg
虰	jsh
敤	jshc
果	jsi
蝀	jsjg
曋	jsjh
蟫	jsjh
蚵	jskg
蝲	jskj
暕	jslg
夥	jsqq
晰	jsrh
蜥	jsrh
晽	jssy
杲	jsu
蜙	jswc
晡	jsy
蚞	jsy
蜅	jsy
昇	jtaj
虴	jtan
蜏	jtbt
蛞	jtdg
蜂	jtdh
蜘	jtdk
蟜	jtdk
旿	jtfh
晧	jtfk
蜓	jtfp
蛛	jtfy
戥	jtga
星	jtgf
蝩	jtgf
甠	jtgg
﨡	jtgg
曛	jtgo
蟱	jtgo
昳	jtgy
蛈	jtgy
蝂	jthc
螑	jthd
昨	jthf
蚱	jthf
曍	jthf
晷	jthk
螅	jthn
蜒	jthp
暞	jths
蜊	jtjh
蟍	jtjs
蝮	jtjt
蛒	jtkg
蝺	jtky
蟌	jtln
螕	jtlx
晌	jtmk
晑	jtmk
蜁	jtnh
螄	jtnh
虼	jtnn
蟠	jtol
蟋	jton
蛾	jtry
蝌	jtuf
昸	jtuy
蜲	jtvg
暰	jtwh
晦	jtxy
暀	jtyg
临	jtyj
监	jtyl
鉴	jtyq
览	jtyq
暛	juag
蛢	juah
曨	jued
蠬	jued
昱	juf
蚪	jufh
蜷	jugb
曦	jugy
蟻	jugy
蛘	juh
蝉	jujf
曈	jujf
暗	jujg
蟑	jujh
暲	jujh
蜕	jukq
蜣	junn
蠀	juqm
蛟	jury
晈	jury
蝤	jusg
螏	jutd
昗	juu
蟮	juuk
螊	juvw
螠	juwl
晜	juxt
螆	juxx
蟳	jvaf
旯	jvb
蝍	jvbh
妟	jvf
蟰	jvfj
归	jvg
曃	jvip
昭	jvkg
蛁	jvkg
照	jvko
蠟	jvln
螁	jvpy
旫	jvt
虭	jvt
蛝	jvy
蟘	jwam
蚮	jway
暡	jwcn
螉	jwcn
蚣	jwcy
昖	jwcy
昣	jwet
暩	jwfi
蚹	jwfy
蜦	jwga
暌	jwgd
蝓	jwgj
蛤	jwgk
蜍	jwgs
螩	jwhs
蚧	jwjh
蛻	jwkq
虮	jwn
蚥	jwry
昐	jwvt
蚡	jwvt
蛜	jwvt
晔	jwxf
蛉	jwyc
昤	jwyc
蠄	jwyc
蜼	jwyg
晗	jwyk
蛿	jwyk
螥	jwyk
昑	jwyn
蚙	jwyn
蟭	jwyo
暹	jwyp
蚴	jxet
蝝	jxey
蠅	jxg
蚓	jxhh
昲	jxjh
曊	jxjm
曏	jxtb
昆	jxxb
蜌	jxxf
鹍	jxxg
顯	jxxm
蚍	jxxn
鵾	jxxo
蝔	jxxr
歞	jxxw
蟣	jxxw
蜳	jybg
暾	jybt
蜟	jyce
蠩	jyfj
蛀	jygg
影	jyie
颢	jyim
顥	jyim
景	jyiu
晾	jyiy
蠐	jyjg
蛴	jyjh
曩	jyke
蠰	jyke
蟺	jylg
暠	jymk
蝙	jyna
蜧	jynd
昹	jyni
虻	jynn
昈	jynt
晐	jynw
蠔	jype
蝏	jyps
昘	jyr
螭	jyrc
蚁	jyry
昉	jyt
蚄	jyt
蝣	jytb
暆	jytb
暶	jyth
旻	jyu
蟙	jyuj
螪	jyuk
螃	jyuy
螂	jyvb
蜋	jyvy
晬	jywf
蜶	jywf
蚢	jywn
蟀	jyxf
昡	jyxy
蚿	jyxy
蚊	jyy
旼	jyy
喏	kadk
囈	kafc
嘞	kafe
嚡	kaff
叿	kag
哐	kagg
嘩	kagg
嚂	kahl
囕	kahq
呀	kaht
嗼	kajd
唶	kajg
囆	kajj
噶	kajn
噧	kajy
嘆	kakg
嘔	kakk
嚥	kako
嚾	kaky
喵	kalg
咂	kamh
唝	kamy
嗊	kamy
呓	kann
呭	kann
喋	kans
唠	kape
噆	kaqj
囌	kaqt
哎	kary
呕	kary
哓	katq
囒	kaul
嚄	kawc
嚿	kawe
嗬	kawk
嗒	kawk
嗏	kaws
哄	kawy
嚆	kayk
囁	kbbb
嗫	kbcc
唨	kbeg
咠	kbf
吇	kbg
咡	kbg
叩	kbh
嗤	kbhj
咄	kbmh
吔	kbn
吼	kbnn
戢	kbny
啊	kbsk
吸	kbyy
邑	kcb
啜	kccc
嘇	kcce
嗓	kccs
嗵	kcep
吗	kcgg
咍	kckg
吧	kcn
噊	kcnk
嗎	kcoy
吮	kcqn
唉	kctd
哞	kctg
唆	kcwt
叹	kcy
咗	kdag
呃	kdbn
吰	kdcy
嘠	kdea
喐	kdeb
哊	kdeg
呖	kdet
嚘	kdet
喯	kdfa
喹	kdff
啀	kdff
嗕	kdff
咵	kdfn
咕	kdg
喊	kdgk
喴	kdgv
嘎	kdha
囓	kdhb
喫	kdhd
呸	kdhg
嘁	kdhi
噄	kdhi
嚖	kdhn
嗄	kdht
嘒	kdhv
吥	kdhy
嚈	kdjd
喱	kdjf
咟	kdjg
唵	kdjn
喕	kdlf
咘	kdmh
顺	kdmy
順	kdmy
哤	kdny
咴	kdoy
哒	kdpy
嚦	kdth
嘹	kdui
噘	kduw
唪	kdwg
啿	kdwn
嘶	kdwr
嗪	kdwt
唊	kdww
唭	kdwy
咙	kdxy
吠	kdy
呔	kdyy
哹	kebg
啂	kebn
嗋	keee
肙	kef
哷	kefy
喛	kegc
咀	kegg
瓹	kegy
嗖	kehc
别	kejh
剈	kejh
咖	kekg
嚼	kelf
嗳	kepc
噯	kept
鹃	keqg
唲	keqn
鵑	keqo
另	ker
啋	kesy
叻	ket
嗂	ketb
噅	keto
哸	kevg
嗘	kexd
喷	kfam
噴	kfam
哋	kfbn
嗑	kfcl
吱	kfcy
呍	kfcy
呿	kfcy
嚅	kfdj
哇	kffg
啩	kffh
嘵	kffq
吐	kfg
咁	kfg
叶	kfh
嗔	kfhw
唗	kfhy
呩	kfiy
嘲	kfje
嘭	kfke
咭	kfkg
嘻	kfkk
鄙	kflb
啚	kflk
喃	kfmf
嚋	kfnf
嚇	kfoo
哧	kfoy
哱	kfpb
嚏	kfph
嚔	kfph
嗦	kfpi
噎	kfpu
呒	kfqn
嘟	kftb
哮	kftb
嗜	kftj
啫	kftj
嘋	kftt
咾	kftx
啈	kfuf
噠	kfup
嚯	kfwy
味	kfy
吋	kfy
咞	kgah
哢	kgah
郢	kgbh
噸	kgbm
吨	kgbn
咥	kgcf
吴	kgdu
啨	kgeg
啄	kgey
呈	kgf
啞	kgfg
吁	kgfh
噁	kgfn
噖	kggn
嘕	kgho
吓	kghy
咺	kgjg
哽	kgjr
囔	kgke
唔	kgkg
唖	kgkg
嗝	kgkh
哣	kgku
嘈	kgmj
唡	kgmw
囇	kgmx
啧	kgmy
啢	kgmy
嘖	kgmy
号	kgnb
鸮	kgng
鴞	kgno
饕	kgnv
飸	kgnv
號	kgnw
咓	kgny
哑	kgog
逞	kgpd
咧	kgqj
嚽	kgqm
嗷	kgqt
唛	kgty
呯	kguf
啑	kgvh
啛	kgvv
嗉	kgxi
咦	kgxw
呋	kgy
踐	khaa
蹛	khah
躇	khaj
踖	khaj
躤	khaj
蹃	khak
距	khan
跇	khan
跷	khaq
蹀	khas
蹒	khaw
躏	khay
蹣	khay
躪	khay
躡	khbb
蹑	khbc
踙	khbc
嚙	khbh
踂	khbn
跥	khbs
趿	khby
跛	khby
踊	khce
踴	khce
跆	khck
蹫	khck
跁	khcn
蹂	khcs
踆	khct
啡	khdd
蹖	khde
踌	khdf
蹰	khdf
跖	khdg
跍	khdg
噦	khdh
蹽	khdi
踳	khdj
踎	khdk
踦	khdk
跨	khdn
踸	khdn
跶	khdp
蹶	khdw
踑	khdw
跋	khdy
蹊	khed
蹈	khee
啃	kheg
跀	kheg
跙	kheg
跏	khek
踩	khes
踋	khfb
踍	khfb
跂	khfc
跬	khff
跱	khff
踛	khff
躊	khff
跿	khfh
踷	khfj
躂	khfp
蹺	khfq
踜	khft
蹎	khfw
跊	khfy
践	khga
趼	khga
嚱	khga
踁	khga
囐	khgd
噱	khge
哶	khgf
趶	khgf
跮	khgf
踕	khgh
蹧	khgj
踾	khgl
贵	khgm
貴	khgm
蹟	khgm
遗	khgp
遣	khgp
遺	khgp
躎	khgr
跠	khgw
躧	khgx
趺	khgy
踧	khhc
躩	khhc
躆	khhe
趾	khhg
踄	khhh
踔	khhj
跕	khhk
嚬	khhm
跐	khhx
咔	khhy
躣	khhy
踃	khie
蹐	khie
蹚	khif
踏	khij
噓	khjg
蹕	khjg
啅	khjh
踶	khjh
蹋	khjn
踢	khjr
踼	khjr
踝	khjs
跩	khjt
中	khk
噳	khkd
呫	khkg
踀	khkh
蹪	khkm
躁	khks
盅	khlf
躅	khlj
嚧	khll
蹥	khlp
蹦	khme
跚	khmg
踹	khmj
踻	khmk
踞	khnd
蹍	khne
蹘	khne
跼	khnk
跽	khnn
忠	khnu
躃	khnu
趹	khnw
跜	khnx
躍	khny
噛	khob
踱	khoc
躔	khof
躕	khof
嘘	khog
蹼	khog
蹸	khog
踮	khok
蹠	khoo
蹗	khox
踠	khpb
蹿	khph
踪	khpi
蹜	khpj
迚	khpk
躥	khpn
跎	khpx
跪	khqb
踭	khqh
跳	khqi
跔	khqk
蹓	khql
跑	khqn
哯	khqn
踘	khqo
蹨	khqo
跢	khqq
趵	khqy
踲	khrh
踬	khrm
躓	khrm
躒	khrs
躈	khrt
蹏	khrw
跅	khry
跴	khsg
蹅	khsg
跒	khsk
踈	khsk
蹮	khsn
躚	khsp
跃	khtd
踵	khtf
嘑	khtf
跦	khtf
跌	khtg
鹭	khtg
跭	khtg
躌	khtg
蹝	khth
蹤	khth
跞	khti
路	khtk
踟	khtk
蹻	khtk
蹯	khtl
躜	khtm
躦	khtm
趷	khtn
踿	khto
鷺	khto
跹	khtp
跣	khtq
踒	khtv
踇	khtx
踽	khty
足	khu
蹉	khua
跰	khua
踯	khub
踡	khub
躑	khub
躘	khud
蹲	khuf
蹡	khuf
蹱	khuf
跘	khug
蹭	khuj
踣	khuk
躝	khul
躢	khun
踫	khuo
跤	khur
躨	khut
踥	khuv
躙	khuy
躐	khvn
踺	khvp
蹆	khvp
跟	khvy
踚	khwa
啮	khwb
跄	khwb
跉	khwc
蹳	khwc
跈	khwe
跗	khwf
跧	khwg
踨	khwh
踰	khwj
跲	khwk
蹌	khwk
唬	khwn
趻	khwn
踗	khwn
蹹	khwn
跺	khws
蹬	khwu
趴	khwy
踓	khwy
嘴	khxe
跸	khxf
躖	khxh
蹞	khxm
躀	khxm
呲	khxn
喍	khxs
卟	khy
蹁	khya
躞	khyc
蹢	khyd
躟	khye
踤	khyf
跓	khyg
蹄	khyh
跻	khyj
躋	khyj
跡	khyo
趽	khyt
蹾	khyt
踉	khyv
蹴	khyy
嘙	kibv
啵	kiby
哨	kieg
咣	kigq
唦	kiit
唢	kimy
嗩	kimy
嘡	kipf
嚐	kipj
噹	kipl
吵	kitt
嗨	kitx
嗶	kjag
嚗	kjai
嘬	kjbc
哩	kjfg
哻	kjfh
嘢	kjfh
呾	kjgg
啺	kjgr
呻	kjhh
唱	kjjg
嗢	kjlg
喁	kjmy
黾	kjnb
喝	kjqn
嗮	kjsg
虽	kju
喅	kjug
雖	kjwy
噐	kkak
嚚	kkak
郘	kkbh
骂	kkcg
唈	kkcn
駡	kkco
器	kkdk
嚣	kkdk
嚻	kkdk
囂	kkdk
嚴	kkdt
哭	kkdu
哵	kkej
吕	kkf
鄂	kkfb
卾	kkfb
鹗	kkfg
颚	kkfm
顎	kkfm
咢	kkfn
鶚	kkfo
遌	kkfp
覨	kkfq
吅	kkg
呺	kkgn
串	kkhk
嘳	kkhm
患	kkhn
哫	kkhy
戰	kkja
鄲	kkjb
囅	kkje
辴	kkje
單	kkjf
丳	kkjk
鷤	kkjo
鄵	kkkb
碞	kkkd
氉	kkke
品	kkkf
嘽	kkkf
劋	kkkj
口	kkkk
喦	kkkm
嵒	kkkm
噪	kkks
喿	kkks
獸	kkld
嘼	kklk
鼍	kkln
鼉	kklx
㖞	kkmw
嘂	kknk
斝	kkpf
呪	kkqn
遻	kkup
咒	kkwb
呮	kkwy
喌	kkyh
嘓	klag
嗯	kldn
咽	kldy
喟	kleg
嚜	klff
嚸	klfk
嘿	klfo
啭	klfy
呬	klg
喂	klge
噮	klge
囀	klgf
啯	klgy
呷	klh
唓	klh
嚃	klip
嘪	klmy
嗹	klpy
噣	klqj
啰	klqy
嚺	klup
嘍	klvg
囉	klxy
噥	kmae
嗣	kmak
翤	kman
唺	kmaw
郧	kmbh
鄖	kmbh
嘊	kmdf
啱	kmdg
喘	kmdj
咉	kmdy
嘣	kmee
嗗	kmeg
勋	kmet
勛	kmet
呥	kmfg
啁	kmfk
哃	kmgk
吊	kmhj
嘤	kmmv
嚶	kmmv
喎	kmnk
鶰	kmqo
哕	kmqy
吶	kmty
员	kmu
員	kmu
囎	kmuj
剐	kmwj
呙	kmwu
呐	kmwy
嗺	kmwy
呗	kmy
唄	kmy
呡	knan
啒	knbm
噉	knbt
啹	kndg
吳	kndu
哪	kngb
喔	kngf
叼	kngg
呞	kngk
呉	kngw
吜	knhg
叫	knhh
囑	knij
喡	knkg
噼	knku
唰	knmj
噀	knnw
咇	kntt
嘱	knty
嘐	knwe
吷	knwy
嚁	knwy
呢	knxn
吣	kny
噿	knyf
呎	knyy
喥	koac
嗻	koao
嚝	koaw
嘮	kooe
啖	kooy
噒	koqg
嚰	kosd
嚤	kosr
嘛	koss
嚒	kosx
嚉	kouf
噗	koug
喽	kovg
嘃	kovh
咪	koy
吙	koy
噻	kpaf
嗐	kpdk
哝	kpey
唍	kpfq
喧	kpgg
啶	kpgh
喗	kplh
嘧	kpnm
嚀	kpns
啘	kpqb
咛	kpsh
咤	kpta
哰	kptg
喀	kptk
咹	kpvg
啌	kpwa
嚓	kpwi
噾	kpwj
咜	kpxn
呧	kqay
兄	kqb
嘫	kqdo
噡	kqdy
嘝	kqef
啗	kqeg
唃	kqeh
唫	kqg
鸣	kqgg
噜	kqgj
咷	kqiy
咰	kqjg
別	kqjh
呴	kqkg
喣	kqko
嚵	kqky
唤	kqmd
喚	kqmd
咆	kqnn
嚕	kqoj
嗚	kqoy
鳴	kqoy
哆	kqqy
哅	kqrb
唿	kqrn
吻	kqrt
嘄	kqsy
啕	kqtb
唙	kqto
呁	kqug
喼	kqvn
焁	kqwo
吹	kqwy
嚠	kqyj
唣	kran
呱	krcy
嗥	krdf
唏	krdh
哌	krey
唕	krfh
喤	krgg
听	krh
嗁	krhw
史	kri
噑	krif
啲	krqy
啪	krrg
哳	krrh
咑	krsh
啤	krtf
唞	kruf
啦	krug
喞	krxb
嚛	krxs
噭	kryt
喖	ksdg
嘌	ksfi
哂	ksg
呠	ksgg
唒	ksgg
叮	ksh
喳	ksjg
嘾	ksjh
呵	kskg
喇	kskj
槑	ksks
嗽	kskw
唽	ksrh
噤	kssi
啉	kssy
呆	ksu
喓	ksvg
嘜	kswq
唻	ksww
哺	ksy
呏	ktah
吒	ktan
噬	ktaw
唀	ktbt
咶	ktdg
嘺	ktdk
喢	ktfe
嚹	ktff
吀	ktfh
吘	ktfh
哠	ktfk
囋	ktfm
咮	ktfy
啣	ktgb
唾	ktgf
喠	ktgf
吽	ktgh
哖	ktgh
嘸	ktgo
嚑	ktgo
哘	ktgs
呹	ktgy
嗅	kthd
咋	kthf
嘷	kthf
咱	kthg
川	kthh
嘥	kthh
喒	kthj
嚊	kthj
唌	kthp
嘚	ktjf
唎	ktjh
呂	ktkf
咯	ktkg
啝	ktkg
囖	ktly
噢	ktmd
响	ktmk
呜	ktng
吃	ktnn
噃	ktol
啾	ktoy
嚟	ktqi
哦	ktry
呼	ktuf
咚	ktuy
唩	ktvg
呚	kty
咊	kty
叺	ktyy
嗟	kuag
嗍	kube
咲	kudy
嚨	kued
呌	kufh
啳	kugb
咩	kuh
吖	kuhh
啴	kujf
噇	kujf
喑	kujg
噫	kujn
噷	kujw
哾	kukq
噌	kulj
嗴	kunc
唴	kunn
㘚	kunt
㘎	kunt
嚪	kuqe
咬	kury
噂	kusf
嚫	kusq
噺	kusr
喭	kute
唼	kuvg
嗛	kuvw
唥	kuwc
嗌	kuwl
嗞	kuxx
噚	kvaf
嘅	kvaq
唧	kvbh
呶	kvcy
嘯	kvfj
嚍	kvhl
啸	kvhw
嗈	kvkc
嘨	kvoj
唚	kvpc
叧	kvr
叨	kvt
吚	kvtt
哏	kvy
呛	kwbn
咃	kwbn
嗡	kwcn
吺	kwcy
哙	kwfc
啥	kwfk
咐	kwfy
啽	kwga
喩	kwgb
喻	kwgj
噲	kwgj
哈	kwgk
噏	kwgn
嗱	kwgr
唋	kwgs
噔	kwgu
噞	kwgw
吤	kwjh
嗰	kwld
叽	kwn
喉	kwnd
嗲	kwrq
哬	kwsk
嘦	kwsv
咻	kwsy
哚	kwsy
喺	kwti
只	kwu
吩	kwvt
咿	kwvt
唑	kwwf
唂	kwwk
哗	kwxf
吪	kwxn
叭	kwy
噙	kwyc
呤	kwyc
唯	kwyg
唅	kwyk
嗆	kwyk
嗿	kwym
吟	kwyn
唸	kwyn
噍	kwyo
鷕	kwyo
喰	kwyv
呦	kxet
喙	kxey
吲	kxhh
咈	kxjh
叱	kxn
哟	kxqy
喲	kxqy
嚩	kxsf
哛	kxwv
哔	kxxf
咝	kxxg
噝	kxxi
吡	kxxn
喈	kxxr
嘰	kxxw
吆	kxy
呣	kxy
啍	kybg
哼	kybh
噋	kybt
唷	kyce
唁	kyg
噈	kyiy
嚌	kyjg
哜	kyjh
嚷	kyke
嗃	kymk
唳	kynd
咏	kyni
呝	kynn
咳	kynw
嚎	kype
喨	kypw
囄	kyry
嗾	kytd
嘀	kyud
啼	kyuh
嗙	kyuy
啷	kyvb
哴	kyvy
啐	kywf
吭	kywn
唹	kywu
囃	kywy
呟	kyxy
噰	kyxy
呅	kyy
轼	laay
軾	laay
輚	laay
羁	lafg
羇	lafk
羈	lafo
軭	lagg
轞	lahl
羃	lajh
轕	lajn
國	lakg
罭	lakg
爴	laky
轥	lauy
異	lawu
輁	lawy
輙	lbcy
囝	lbd
辄	lbnn
輒	lbnn
罊	lbwb
礊	lbwd
墼	lbwf
繫	lbwi
蟿	lbwj
轚	lbwl
擊	lbwr
檕	lbws
轻	lcag
辍	lccc
畷	lccc
罬	lccc
輟	lccc
轰	lccu
輽	lcdl
羆	lceo
罷	lcex
圗	lcff
軽	lcfg
囜	lci
囼	lckd
軩	lckg
圎	lcmi
輮	lcns
罞	lcnt
罵	lcou
畯	lcwt
轭	ldbn
軛	ldbn
軷	ldcy
固	ldd
囿	lded
罟	ldf
轱	ldg
軲	ldg
輱	ldgk
轗	ldgn
囨	ldhi
罘	ldhu
轊	ldhv
因	ldi
罨	ldjn
盢	ldlf
輭	ldmd
輀	ldmj
恩	ldnu
罽	ldoj
欭	ldqw
畸	ldsk
輢	ldsk
畴	ldtf
轣	ldth
轑	ldui
辏	ldwd
輳	ldwd
轃	ldwt
畎	ldy
軑	ldy
轪	ldy
軚	ldyy
罦	lebf
輣	leeg
轁	leeg
胃	lef
罝	legf
軞	len
輗	leqn
男	ler
嬲	leve
轒	lfam
囩	lfci
圔	lfcl
罴	lfco
罢	lfcu
転	lfcy
轜	lfdj
罣	lfff
畦	lffg
罫	lffh
畤	lffy
轩	lfh
軒	lfh
置	lfhf
団	lfi
畊	lfjh
囲	lfjk
辕	lfke
園	lfke
瞏	lfke
轅	lfke
罱	lfmf
疇	lfnf
围	lfnh
转	lfny
黭	lfoa
黦	lfob
默	lfod
黩	lfod
黝	lfoe
黪	lfoe
黲	lfoe
墨	lfof
黚	lfof
黫	lfof
黥	lfoi
黯	lfoj
黠	lfok
點	lfok
黬	lfok
黸	lfol
黜	lfom
黷	lfom
黔	lfon
黗	lfon
黤	lfon
黮	lfon
黟	lfoq
黕	lfoq
黖	lfoq
黢	lfot
黑	lfou
黰	lfow
黣	lfox
黓	lfoy
黵	lfoy
园	lfqv
团	lfte
署	lftj
圉	lfuf
睪	lfuf
鸅	lfuo
斁	lfut
歝	lfuw
轌	lfvg
轖	lfwk
輘	lfwt
囤	lgbn
軘	lgbn
轾	lgcf
輊	lgcf
囯	lgd
圊	lged
輤	lgeg
圂	lgei
慁	lgen
畏	lgeu
軖	lgg
囸	lghd
罡	lghf
車	lghh
團	lgjf
轉	lgjf
畀	lgjj
圄	lgkd
睘	lgke
鹮	lgkg
辐	lgkl
輻	lgkl
翾	lgkn
還	lgkp
疅	lglg
輌	lgmm
辆	lgmw
輛	lgmy
车	lgnh
軏	lgqn
軯	lguf
輕	lgva
鑋	lgvq
畉	lgy
国	lgyi
軙	lhcy
罪	lhdd
輫	lhdd
罩	lhjj
轤	lhll
四	lhng
皿	lhng
囗	lhng
罒	lhng
甲	lhnh
轳	lhnt
輎	lieg
塁	liff
輄	ligq
囦	lii
疂	lipg
遝	lipi
眔	liu
軣	liu
罼	ljag
囬	ljfd
廽	ljfp
逥	ljfp
畼	ljgr
輰	ljgr
輼	ljlg
辒	ljlg
輵	ljqn
輠	ljsy
辊	ljxx
輥	ljxx
辑	lkbg
輯	lkbg
回	lkd
罥	lkef
軎	lkf
圖	lkfk
甽	lkh
圚	lkhm
圆	lkmi
圓	lkmi
廻	lkpd
迴	lkpd
軦	lkqn
毄	lkwc
轵	lkwy
軹	lkwy
畕	llf
圛	llff
圜	llge
轘	llge
罍	lllb
奰	llld
礨	llld
氎	llle
壘	lllf
壨	lllf
畾	lllf
疊	lllg
纍	llli
轟	lllj
田	llll
轠	llll
鸓	lllo
櫐	llls
疉	lllx
罳	llnu
轋	llpy
轀	llwl
圐	llye
圌	lmdj
輲	lmdj
軮	lmdy
畘	lmfg
輖	lmfk
轴	lmg
軸	lmg
軕	lmh
鷶	lmqo
買	lmu
辋	lmun
輞	lmun
軜	lmwy
罠	lnab
辗	lnae
輾	lnae
囻	lnav
轏	lnbb
囙	lnd
顋	lndm
罻	lnff
軐	lnfh
翈	lng
圍	lnkg
轧	lnn
軋	lnn
思	lnu
疁	lnwe
轇	lnwe
罹	lnwy
辚	loqg
疄	loqg
轔	loqg
轛	louf
轐	loug
辘	loxx
轆	loxx
辖	lpdk
轄	lpdk
畳	lpeg
輐	lpfq
连	lpk
連	lpk
輨	lpng
畹	lpqb
軝	lqan
軧	lqay
輡	lqeg
鸭	lqgg
斀	lqjc
斣	lqjf
劅	lqjj
鸀	lqjo
蜀	lqju
歜	lqjw
軥	lqkg
輓	lqkq
軳	lqnn
鴨	lqoy
鴫	lqoy
逻	lqpi
囫	lqre
罗	lqu
畇	lqug
软	lqwy
軟	lqwy
輷	lqyg
罶	lqyl
畂	lqyy
畈	lrcy
畖	lrcy
罛	lrcy
軱	lrcy
磛	lrdf
堑	lrff
塹	lrff
輴	lrfh
斩	lrh
斬	lrh
覱	lrhq
暂	lrjf
暫	lrjf
蹔	lrkh
慙	lrnu
錾	lrqf
鏨	lrqf
椠	lrsu
槧	lrsu
轢	lrxs
圑	lsfi
輏	lsgg
町	lsh
困	lsi
圃	lsi
甼	lsj
轲	lskg
軻	lskg
罧	lssu
辅	lsy
輔	lsy
轿	ltdj
轎	ltdk
軠	ltfg
畽	ltgf
輧	ltgf
轶	ltgy
軼	ltgy
囷	lti
輹	ltjt
畧	ltkf
略	ltkg
辂	ltkg
輅	ltkg
轹	ltni
轓	ltol
轷	ltuf
軤	ltuf
图	ltui
輈	ltuy
辀	ltuy
畮	ltxy
畋	lty
軿	luah
圈	lugb
畻	lugf
畔	lugh
圏	lugn
轙	lugy
疃	lujf
罯	lujf
罿	lujf
罾	lulj
図	luri
较	lury
較	lury
輶	lusg
罤	luxt
囡	lvd
氀	lven
婁	lvf
圕	lvfj
輺	lvgl
甊	lvgy
罺	lvjs
轈	lvjs
轺	lvkg
軺	lvkg
辎	lvlg
輜	lvlg
轨	lvn
軌	lvn
遱	lvpd
鷜	lvqo
輑	lvtk
數	lvty
轫	lvyy
軔	lvyy
繋	lwci
撃	lwcr
軗	lwcy
圙	lwdf
轸	lwet
畛	lwet
軫	lwet
囶	lwfd
軵	lwfy
圇	lwga
輪	lwga
辁	lwgg
輇	lwgg
输	lwgj
輸	lwgj
畭	lwgs
囚	lwi
畍	lwjh
界	lwjj
朙	lwme
囧	lwmv
畟	lwtu
輍	lwwk
眾	lwww
轮	lwxn
囵	lwxv
囮	lwxv
囹	lwyc
軨	lwyc
圀	lwye
軡	lwyn
罖	lwyu
軓	lwyy
軪	lxet
羄	lxhj
累	lxiu
羂	lxke
邏	lxwp
羅	lxwy
毘	lxxb
辔	lxxk
毗	lxxn
辙	lyct
轍	lyct
圁	lyd
畩	lyey
詈	lyf
罸	lyfu
罜	lygf
軴	lygg
輬	lyiy
辌	lyiy
罚	lyjj
罰	lyjj
甿	lynn
軶	lynn
畡	lynw
輆	lynw
囥	lywv
羉	lyxi
圞	lyxs
圝	lyxx
贜	maah
賤	maay
曲	mad
農	made
蠈	madj
贼	madt
賊	madt
巈	mafo
屸	mag
鄷	magb
艶	magc
豑	magt
豊	magu
峫	mahb
岈	maht
岽	maiu
刪	majh
嶱	majn
贎	majy
冊	mak
嶇	makk
巏	maky
購	mamf
岠	mang
崂	mape
嵘	maps
嵽	maqh
嶜	maqj
岖	mary
峣	matq
贓	mauh
覥	mawq
觍	mawq
敟	mawt
典	mawu
戝	may
邮	mbh
邖	mbh
郥	mbh
崡	mbib
貤	mbn
屷	mbt
嶐	mbtg
岥	mby
貱	mby
岌	mbyu
岋	mbyy
峅	mcah
岜	mcb
嵾	mcce
贂	mcce
峄	mcgh
禸	mci
贻	mckg
貽	mckg
峻	mcwt
賐	mcwt
巁	mday
贆	mddd
峟	mdef
贿	mdeg
賄	mdeg
賬	mdey
岩	mdf
赈	mdfe
賑	mdfe
崖	mdff
峚	mdff
崕	mdff
岸	mdfj
岵	mdg
嵗	mdgh
嵅	mdgk
崴	mdgv
酆	mdhb
艷	mdhc
岯	mdhg
豓	mdhl
豔	mdhl
巎	mdht
豒	mdht
豐	mdhu
央	mdi
崦	mdjn
盎	mdlf
輋	mdlj
剬	mdmj
峏	mdmj
耑	mdmj
颛	mdmm
顓	mdmm
遄	mdmp
歂	mdmw
崸	mdmy
頔	mdmy
峸	mdnn
炭	mdou
鸯	mdqg
鴦	mdqo
屵	mdr
崎	mdsk
嶏	mdsn
嶚	mdui
嶛	mdui
嶡	mduw
嶥	mduw
賰	mdwj
嵁	mdwn
峽	mdww
嵟	mdwy
髒	meaa
嶾	mean
骮	meay
骳	meby
骷	medg
顝	medm
骻	medn
髓	medp
髄	medp
崩	meef
剻	meej
骽	meev
骨	mef
胄	mef
冑	mef
骭	mefh
髐	mefq
岄	meg
嵈	megc
骬	megf
岨	megg
骾	megr
嶼	megw
髗	mehl
骴	mehx
髁	mejs
髃	mejy
髑	melj
髏	melv
體	memu
髎	mene
髍	meos
髅	meov
髂	mepk
髕	mepm
髋	mepq
髌	mepw
髉	mepy
髖	mepy
鹘	meqg
骲	meqn
鶻	meqo
骶	meqy
屴	mer
髀	merf
骺	merk
髆	mesf
骵	mesg
骼	metk
骿	meua
髊	meua
骹	meur
崢	mevh
骩	mevn
骫	mevy
骰	mewc
骱	mewj
骪	mewy
嵠	mexd
髇	meyk
骸	meyw
骯	meyw
髈	meyy
賳	mfak
嶻	mfay
賎	mfay
岐	mfcy
冉	mfd
冃	mfd
冄	mfd
嶿	mfdj
亗	mff
崶	mfff
嶀	mffn
嶢	mffq
嶤	mffq
峙	mffy
屽	mfh
巅	mfhm
巔	mfhm
嵮	mfhw
曱	mfk
郮	mfkb
周	mfkd
彫	mfke
翢	mfkn
鵰	mfko
週	mfkp
雕	mfky
贖	mflm
赎	mfnd
嶹	mfnf
岏	mfqn
貦	mfqn
嵌	mfqw
崁	mfqw
赌	mftj
賭	mftj
财	mftt
財	mftt
峔	mftx
崚	mfwt
崋	mgag
岍	mgah
赋	mgay
贱	mgay
賦	mgay
峌	mgcf
豳	mgee
嶳	mgef
崝	mgeg
䝼	mgeg
䞍	mgeg
赇	mgiy
賕	mgiy
峘	mgjg
畁	mgjj
峺	mgjr
戙	mgka
敱	mgkc
同	mgkd
獃	mgkd
峿	mgkg
剴	mgkj
颽	mgkj
顗	mgkm
迵	mgkp
覬	mgkq
敳	mgkt
豈	mgku
凱	mgkw
嶆	mgmj
甹	mgnb
屿	mgng
峛	mgqj
峢	mgqj
屼	mgqn
峡	mgud
岼	mguf
崃	mgus
崨	mgvh
峓	mgxw
帴	mhaa
幙	mhad
幪	mhae
幊	mham
幉	mhas
幭	mhaw
帔	mhby
幓	mhce
帊	mhcn
帪	mhde
帳	mhde
帱	mhdf
帞	mhdj
幁	mhdm
帺	mhdw
帗	mhdy
幍	mhee
甴	mhfd
幬	mhff
帏	mhfh
帾	mhfj
幩	mhfm
巇	mhga
円	mhgd
巘	mhgd
巚	mhgd
峠	mhgh
幅	mhgl
帻	mhgm
幘	mhgm
帓	mhgs
帖	mhhk
帧	mhhm
幀	mhhm
帩	mhie
幥	mhir
幔	mhjc
帽	mhjh
幜	mhji
幆	mhjn
幌	mhjq
巾	mhk
幝	mhkf
贴	mhkg
岾	mhkg
貼	mhkg
幧	mhks
帜	mhkw
幗	mhlg
帼	mhly
冂	mhn
幈	mhna
幄	mhnf
由	mhng
幃	mhng
贝	mhny
貝	mhny
幮	mhof
幞	mhog
帵	mhpb
幏	mhpe
幰	mhpn
帎	mhpq
幎	mhpu
峴	mhqn
幨	mhqy
帕	mhrg
帄	mhsh
幖	mhsi
幯	mhtb
帲	mhtf
帙	mhtg
幡	mhtl
幒	mhtn
幠	mhto
帐	mhty
帡	mhua
幢	mhuf
幛	mhuj
幱	mhul
帨	mhuq
帹	mhuv
帿	mhwd
帢	mhwk
帉	mhwv
帆	mhwy
帷	mhwy
幟	mhyj
巌	midt
峭	mieg
埊	miff
崉	mijg
贘	mipm
汖	miu
巀	miwa
嵴	miwe
嵵	mjff
崼	mjgh
崵	mjgr
则	mjh
則	mjh
賵	mjhg
赗	mjhg
嵎	mjmy
嵑	mjqn
赐	mjqr
賜	mjqr
岿	mjvf
崐	mjxx
崑	mjxx
嶯	mkby
冋	mkd
賗	mkkh
嵓	mkkk
崿	mkkn
贃	mkkn
巖	mkkt
巗	mkkt
迥	mkpd
贶	mkqn
岲	mkqn
貺	mkqn
嶉	mkwy
崮	mldf
崓	mldg
嶧	mlff
嵔	mlge
岬	mlh
嶵	mlhd
崽	mlnu
嶃	mlrh
崭	mlrj
嶄	mlrj
嶁	mlvg
嶩	mmae
賟	mmaw
岟	mmdy
峀	mmf
賙	mmfk
赒	mmfk
岫	mmg
册	mmgd
删	mmgj
峒	mmgk
峝	mmgk
嵦	mmgu
甖	mmgy
屾	mmh
崱	mmjj
山	mmmm
贔	mmmu
赑	mmmu
巊	mmmv
鑍	mmqf
岘	mmqn
鸎	mmqo
岗	mmru
罂	mmtb
罌	mmtb
贁	mmty
崗	mmum
婴	mmvf
嬰	mmvf
鹦	mmvg
鸚	mmvo
賏	mmy
譻	mmyf
岷	mnan
岂	mnb
崛	mnbm
崫	mnbm
崌	mndg
嶎	mnff
嵋	mnhg
剀	mnjh
冎	mnmb
剮	mnmj
咼	mnmk
過	mnmp
觊	mnmq
旤	mnmq
歄	mnmw
屺	mnn
乢	mnn
嶍	mnrg
囘	mnv
嵺	mnwe
賿	mnwe
凯	mnwn
赆	mnyu
赃	mofg
賍	mofg
賘	mofy
嶗	mooe
巆	mook
嶸	moos
赕	mooy
賧	mooy
嶙	moqg
嶪	mouf
嶫	mouf
贌	moug
嵝	movg
嵻	movi
嵣	movk
迪	mpd
廸	mpd
峵	mpdc
崇	mpfi
賩	mpfi
贮	mpgg
辿	mpk
賱	mplh
貯	mpsh
峖	mpvg
崆	mpwa
嵱	mpwk
賝	mpws
岤	mpwy
岮	mpxn
崏	mqaj
岻	mqay
貾	mqay
见	mqb
觃	mqbd
岇	mqbj
购	mqcy
峗	mqdb
峞	mqdb
赡	mqdy
嶦	mqdy
贍	mqdy
嶰	mqeg
崅	mqeh
崟	mqf
崯	mqg
嵥	mqgs
賯	mqjb
峋	mqjg
刿	mqjh
嶑	mqke
岣	mqkg
巉	mqky
翙	mqng
嶌	mqou
嵨	mqoy
嶋	mqoy
鵙	mqoy
嵚	mqqw
嶔	mqqw
岉	mqrt
峁	mqtb
嶽	mqtd
岁	mqu
峥	mqvh
嵧	mqyl
嵏	mrbt
嵕	mrbt
贩	mrcy
岅	mrcy
販	mrcy
崤	mrde
岴	mrg
岶	mrg
崲	mrgg
岓	mrh
冈	mri
罓	mri
刚	mrjh
嵬	mrqc
网	mrri
羀	mrrl
崥	mrtf
嶊	mrwy
嶘	msaa
嵿	msdm
赙	msfy
賻	msfy
崬	msjf
崠	msjg
嵖	msjg
贉	msjh
岢	mskf
崊	mssy
崾	msvg
崧	mswc
崍	msww
峬	msy
嵀	msyg
账	mtay
峰	mtdh
峯	mtdh
峤	mtdj
嶠	mtdk
岆	mtdy
崻	mtff
峼	mtfk
巑	mtfm
崜	mtgf
貹	mtgg
岝	mthf
岞	mthf
嵲	mths
峲	mtjj
峉	mtkf
赂	mtkg
峈	mtkg
賂	mtkg
賉	mtlg
嶶	mtmt
巋	mtnh
屹	mtnn
嶭	mtnu
嶓	mtol
贬	mtpy
貶	mtpy
峨	mtry
峩	mtry
嵙	mtuf
嵊	mtux
峂	mtuy
巍	mtvc
崣	mtvf
嵂	mtvg
嵷	mtwh
嵸	mtwh
败	mty
敗	mty
內	mtyi
嵳	muaf
嵯	muag
賆	muah
胐	mubm
脧	muct
巃	mued
巄	mued
贚	mued
岦	muf
嵄	mugd
嶬	mugy
峷	muj
嶂	mujh
赔	mukg
賠	mukg
嵜	mukh
﨑	mukh
赠	mulj
嶒	mulj
贈	mulj
剛	mumj
岡	mumk
嶈	muqf
脁	muqi
胊	muqk
峧	mury
賋	mury
嶟	musf
崷	musg
嵃	mute
嵼	mutg
巙	mutt
巕	mutv
膧	muuf
赚	muvw
嵰	muvw
賺	muvw
賹	muwl
肦	muwv
嵫	muxx
罔	muyn
峍	mvgh
贐	mvhl
岧	mvkf
岹	mvkg
崰	mvlg
屶	mvr
峮	mvtk
峎	mvu
岃	mvyu
屻	mvyy
嵡	mwcn
赊	mwfi
賒	mwfi
崘	mwga
崙	mwga
峑	mwgf
崄	mwgg
嵛	mwgj
崳	mwgj
峆	mwgk
峇	mwgk
嶖	mwgn
賖	mwgs
嶝	mwgu
嶮	mwgw
峜	mwhf
峳	mwht
内	mwi
岕	mwjj
冏	mwkd
岚	mwru
嵐	mwtj
岎	mwvt
肉	mwwi
峪	mwwk
酅	mwyb
岭	mwyc
岺	mwyc
崔	mwyf
嵢	mwyk
巂	mwyk
賶	mwyk
嶺	mwym
岑	mwyn
岒	mwyn
嶲	mwyn
嶕	mwyo
嶣	mwyo
岰	mxet
巓	mxhm
岪	mxjj
嵹	mxkj
嶷	mxth
嵶	mxuu
幽	mxxi
雘	myac
崞	mybg
丹	myd
彤	myet
訔	myf
峕	myjf
刐	myjh
巐	myma
嵩	mymk
嵪	mymk
赅	mynw
峐	mynw
賅	mynw
嵉	myps
鴅	myqo
崺	mytb
崹	myuh
嵭	myuy
崀	myvu
崒	mywf
崪	mywf
賥	mywf
貥	mywn
悈	naah
恜	naay
愜	nadw
展	naei
愅	nafh
羾	nag
惬	nagd
恇	nagg
戼	nagn
慳	nahf
懢	nahl
异	naj
羿	naj
敯	najc
慔	najd
昬	najf
惜	najg
刡	najh
愺	najh
蟁	najj
愝	najv
懄	nake
惐	nakg
慬	nakg
慪	nakk
懽	naky
懵	nalh
懜	nalq
懱	nalw
愥	namd
愩	namy
慲	namy
怇	nang
怈	nann
怴	nann
屟	nans
惵	nans
屉	nanv
懞	nape
憯	naqj
憽	naqn
鴖	naqo
怄	nary
懂	natf
睯	nath
暋	natj
愍	natn
敃	naty
民	nav
殿	nawc
臀	nawe
壂	nawf
臋	naww
慌	nayk
恾	nayn
孱	nbbb
懾	nbbb
慑	nbcc
憜	nbde
聼	nbfn
邔	nbh
屈	nbmk
鶌	nbmo
忚	nbn
屙	nbsk
憨	nbtn
饏	nbtv
敢	nbty
怶	nby
翍	nby
忣	nbyy
惙	nccc
慘	ncce
惨	ncde
愑	ncee
悀	nceh
怪	ncfg
怿	ncgh
怡	nckg
忬	ncnh
憰	ncnk
恈	nctg
悛	ncwt
慅	ncyj
惰	ndae
墯	ndaf
翇	ndcy
居	ndd
恹	nddy
懮	ndet
悵	ndey
屒	ndfe
恗	ndfn
怙	ndg
憾	ndgn
恠	ndhf
怌	ndhg
慽	ndhi
懳	ndhn
怀	ndhy
懨	ndjd
剧	ndjh
愐	ndlf
愞	ndmd
怖	ndmh
頨	ndmy
忧	ndny
恢	ndoy
鶋	ndqo
慡	ndrr
憭	ndui
愖	ndwn
悏	ndww
翜	ndww
忕	ndy
忲	ndyy
懚	nean
毣	neb
屘	nebd
恊	neee
愶	neee
慆	neeg
屗	nefi
愋	negc
怚	negg
懙	negw
懓	nept
忇	net
愮	netb
尾	nev
慀	nexd
懴	nfag
愤	nfam
憤	nfam
屆	nfbk
恸	nfce
层	nfci
厾	nfci
怯	nfcy
忮	nfcy
忶	nfcy
翄	nfcy
懦	nfdj
憢	nffq
恃	nffy
忓	nfh
慎	nfhw
屚	nfi
叞	nfic
褽	nfie
尉	nfif
犚	nfig
螱	nfij
慰	nfin
熨	nfio
蝨	nfjj
卂	nfk
憉	nfke
懛	nfkf
恄	nfkg
憘	nfkk
懤	nfnf
懗	nfoo
悖	nfpb
懥	nfph
迅	nfpk
怃	nfqn
忨	nfqn
鳵	nfqo
屠	nftj
愭	nftj
鷵	nfto
恅	nftx
导	nfu
悻	nfuf
懎	nfwk
忖	nfy
怽	nfy
那	ngbh
忳	ngbn
屋	ngcf
恎	ngcf
剭	ngcj
刁	ngd
悿	ngdn
情	ngeg
忹	ngg
怔	nghg
卐	nghg
恆	nghg
慱	ngjf
恒	ngjg
憓	ngjn
丮	ngk
孠	ngkb
司	ngkd
悟	ngkg
愊	ngkl
覗	ngkq
慒	ngmj
怲	ngmw
慠	ngqt
屍	ngqx
怦	nguf
悽	ngvv
愫	ngxi
恞	ngxw
夨	ngyi
臦	nhah
臩	nhaj
燛	nhao
郿	nhbh
叏	nhcu
収	nhcy
眉	nhd
悱	nhdd
屝	nhdd
胥	nhef
叚	nhfc
遐	nhfp
懅	nhge
丑	nhgg
卍	nhgh
戄	nhhc
懼	nhhy
疋	nhi
疍	nhjg
悼	nhjh
蛋	nhju
丩	nhk
怗	nhkg
憈	nhog
鹛	nhqg
悓	nhqn
鶥	nhqo
疎	nhsk
收	nhty
惧	nhwy
疏	nhyk
屑	nied
悄	nieg
恍	nigq
尿	nii
氹	nii
劚	nilj
屬	nilj
斸	nilr
惝	nimk
憆	nipf
戃	nipo
悩	nirb
犀	nitg
遲	nitp
懪	njai
悭	njcf
悝	njfg
悍	njfh
怛	njgg
惿	njgh
翨	njgh
愓	njgr
愰	njiq
慢	njlc
愠	njlg
愒	njqn
惕	njqr
惈	njsy
惺	njtg
惃	njxx
憬	njyi
悒	nkcn
悁	nkeg
吢	nkf
郼	nkgb
韕	nkgb
悮	nkgd
韒	nkge
韔	nkge
韛	nkge
韜	nkge
韚	nkgf
韝	nkgf
韟	nkgf
悜	nkgg
韠	nkgg
韡	nkgg
韋	nkgj
韣	nkgj
韐	nkgk
韗	nkgl
韞	nkgl
韥	nkgm
韢	nkgn
違	nkgp
韎	nkgs
韖	nkgs
韘	nkgs
韤	nkgw
韌	nkgy
韍	nkgy
忡	nkhh
翀	nkhh
愦	nkhm
憒	nkhm
憚	nkkf
愕	nkkn
懆	nkks
屌	nkmh
愪	nkmy
悞	nknd
怳	nkqn
孹	nkub
礕	nkud
臂	nkue
襞	nkue
壁	nkuf
䴙	nkug
辟	nkuh
幦	nkuh
躄	nkuh
繴	nkui
憵	nkun
糪	nkuo
鷿	nkuo
鸊	nkuo
避	nkup
鐾	nkuq
擘	nkur
檗	nkus
劈	nkuv
嬖	nkuv
鼊	nkux
譬	nkuy
璧	nkuy
甓	nkuy
怾	nkwy
慖	nlag
翼	nlaw
乪	nld
屇	nld
懌	nlff
怬	nlg
愄	nlge
懁	nlge
恛	nlkg
愢	nlny
慩	nlpy
翴	nlpy
惭	nlrh
慚	nlrh
悃	nlsy
屢	nlvd
慺	nlvg
慍	nlwl
愣	nlyt
憹	nmae
届	nmd
惴	nmdj
怏	nmdy
愲	nmeg
惆	nmfk
怞	nmg
恫	nmgk
愷	nmgu
刷	nmhj
屃	nmi
屓	nmi
恻	nmjh
惻	nmjh
屭	nmmm
恺	nmnn
惘	nmun
慛	nmwy
惽	nnaj
怋	nnan
選	nnap
巽	nnaw
毋	nnde
己	nngn
巳	nngn
尸	nngt
巺	nngw
忸	nnhg
书	nnhy
局	nnkd
愇	nnkg
乙	nnll
乚	nnll
乛	nnll
⺄	nnll
忆	nnn
忋	nnn
繠	nnni
已	nnnn
橤	nnns
惢	nnnu
鵋	nnqo
慴	nnrg
怭	nntt
忌	nnu
乜	nnv
憀	nnwe
快	nnwy
怩	nnxn
羽	nnyg
懭	noaw
惦	nohk
屎	noi
憦	nooe
惔	nooy
憐	noqg
懡	nosc
戂	nosd
屡	novd
慵	novh
慷	novi
屪	npdi
迉	npe
悰	npfi
愃	npgg
慏	npju
恽	nplh
惲	nplh
翚	nplj
翬	nplj
悺	npng
懧	npns
惋	npqb
忱	npqn
愘	nptk
悾	npwa
屄	npwi
愹	npwk
惛	nqaj
忯	nqan
怟	nqay
㥮	nqbt
恑	nqdb
憺	nqdy
懈	nqeg
惂	nqeg
惍	nqg
鸤	nqgg
恌	nqiy
惸	nqjb
恂	nqjg
怐	nqkg
翑	nqkg
悗	nqkq
愌	nqmd
怉	nqnn
翵	nqoy
鳲	nqoy
恀	nqqy
恟	nqrb
惚	nqrn
愡	nqrn
㤘	nqvg
忺	nqwy
懰	nqyj
忷	nrbh
惾	nrbt
翪	nrbt
恡	nrdc
悕	nrdh
習	nrf
翫	nrfq
怕	nrg
惶	nrgg
忻	nrh
忾	nrn
愾	nroy
愧	nrqc
惞	nrqw
懫	nrrm
飁	nrwj
憿	nryt
慓	nsfi
愽	nsfy
恓	nsg
忊	nsh
杘	nsi
憛	nsjh
悚	nskg
懒	nskm
懶	nskm
憟	nsoy
憷	nssh
惏	nssy
慄	nssy
悑	nsy
怵	nsyy
屜	ntan
屧	ntas
怅	ntay
悸	ntbg
邲	ntbh
发	ntcy
恬	ntdg
憍	ntdk
必	nte
屐	ntfc
忏	ntfh
忤	ntfh
悎	ntfk
慥	ntfp
慟	ntge
屛	ntgf
性	ntgg
憮	ntgo
怢	ntgy
翐	ntgy
怍	nthf
屣	nthh
覕	nthq
悧	ntjh
虱	ntji
慯	ntjr
愎	ntjt
恪	ntkg
属	ntky
恤	ntlg
憁	ntln
屨	ntlv
懊	ntmd
恦	ntmk
忔	ntnn
憣	ntol
屦	ntov
愀	ntoy
鴓	ntqo
憡	ntsm
屩	nttk
履	nttt
悔	ntxy
改	nty
攺	nty
恲	nuah
屏	nuak
习	nud
买	nudu
憪	nueg
翌	nuf
翋	nug
惓	nugb
怑	nugh
慻	nugh
懩	nugv
飞	nui
憧	nujf
惮	nujf
愔	nujg
慞	nujh
憶	nujn
屖	nuk
悦	nukq
憎	nulj
層	nulj
遅	nupk
遟	nupk
飛	nurh
飝	nurh
恔	nury
愱	nutd
屫	nutk
羼	nuuu
翣	nuvf
慊	nuvw
悌	nuxt
懻	nuxw
悯	nuyy
憫	nuyy
憳	nvaf
慨	nvaq
怓	nvcy
忰	nvfh
翆	nvfj
妀	nvg
怊	nvkg
舝	nvpg
忉	nvt
惱	nvtr
尻	nvv
恨	nvy
怆	nwbn
慃	nwcn
恱	nwcq
忪	nwcy
戮	nwea
鄝	nweb
勠	nwee
鹨	nweg
剹	nwej
顟	nwem
鷚	nweo
翏	nwer
雡	nwey
憏	nwfi
惀	nwga
恮	nwgg
愉	nwgj
懀	nwgj
恰	nwgk
悇	nwgs
憕	nwgu
憸	nwgw
乆	nwi
夬	nwi
刔	nwjh
忦	nwjh
悅	nwkq
翭	nwnd
鴂	nwqo
恘	nwsy
凥	nwv
翂	nwvt
懺	nwwg
戳	nwya
怜	nwyc
愯	nwyc
翟	nwyf
惟	nwyg
愴	nwyk
忴	nwyn
惗	nwyn
懏	nwyn
憔	nwyo
鸐	nwyo
忛	nwyy
怮	nxet
憴	nxg
愼	nxhw
恉	nxjg
怫	nxjh
惯	nxmy
慣	nxmy
迡	nxpv
懝	nxth
愵	nxuu
尼	nxv
悂	nxxf
蠿	nxxj
屁	nxxv
惤	nxyx
惇	nybg
悙	nybh
憞	nybt
忄	nyhy
忭	nyhy
尺	nyi
乄	nyi
㣺	nyi
惊	nyiy
憱	nyiy
翞	nyiy
昼	nyjg
懠	nyjg
懹	nyke
悋	nykg
咫	nykw
懐	nyle
懷	nyle
憻	nylg
懔	nyli
懍	nylt
翯	nymk
惼	nyna
悷	nynd
怺	nyni
忙	nynn
心	nyny
迟	nypi
恼	nyrb
尽	nyuu
悢	nyvy
翠	nywf
悴	nywf
忼	nywn
以	nywy
慉	nyxl
怰	nyxy
忟	nyy
烒	oaay
度	oaci
剫	oacj
糤	oaet
煂	oafh
灴	oag
燁	oagg
熞	oahf
烥	oahh
爁	oahl
糮	oahl
爦	oahq
庌	oaht
灷	oaj
庴	oajd
糢	oajd
焟	oajg
爡	oajj
燤	oajy
廑	oakg
熯	oakg
熰	oakk
爟	oaky
庿	oald
鄺	oamb
煐	oamd
煹	oamf
席	oamh
懬	oamn
廣	oamw
焫	oamw
熿	oamw
熕	oamy
炬	oang
粔	oang
煠	oans
炼	oanw
庹	oany
鹧	oaog
庶	oaoi
鷓	oaoo
遮	oaop
廗	oaqh
熸	oaqj
糣	oaqj
燪	oaqn
烵	oaqy
糒	oate
烧	oatq
糚	oauf
爤	oaul
糷	oaul
爑	oawo
粪	oawu
烡	oawu
庻	oaww
糀	oawx
烘	oawy
粠	oawy
廰	obfn
籽	obg
廳	obgn
邝	obh
邺	obh
邩	obh
炪	obmh
灺	obn
廕	obwc
鬯	obxb
烃	ocag
糝	occe
糁	ocde
熥	ocep
広	oci
炲	ockg
粑	ocn
序	ocnh
燏	ocnk
糅	ocns
煣	ocns
焌	ocwt
糔	ocyj
爄	oday
糲	oday
炦	odcy
類	oddm
糊	odeg
煳	odeg
烠	odeg
粻	odey
煃	odff
炻	odg
煘	odgk
粝	odgq
炐	odhh
緳	odhi
廈	odht
炋	odhy
庆	odi
糎	odjf
粨	odjg
庵	odjn
糆	odlf
煗	odmd
粫	odmj
糥	odmj
烦	odmy
煩	odmy
頪	odmy
庬	odny
烣	odoy
爏	odth
类	odu
燎	odui
煁	odwn
糂	odwn
廝	odwr
燍	odwr
粸	odwy
庞	odxy
粀	odyy
粏	odyy
燬	oeac
烰	oebg
粰	oebg
熁	oeee
焩	oeeg
熖	oeeg
燲	oeem
煖	oegc
粗	oegg
廋	oehc
爝	oelf
粍	oen
廫	oene
燰	oept
熎	oetb
庾	oewi
燌	ofam
焼	ofaq
庋	ofci
廅	ofcl
熆	ofcl
庄	ofd
糯	ofdj
燸	ofdj
烓	offg
庤	offi
燒	offq
灶	ofg
粓	ofg
籵	ofh
廟	ofje
廚	ofkf
熺	ofkk
糦	ofkk
爧	ofkw
煵	ofmf
燽	ofnf
炜	ofnh
爀	ofoo
焃	ofoy
庑	ofqv
煤	ofsy
庨	oftb
烤	oftn
粩	oftx
燵	ofup
燯	ofwc
廧	ofwk
庱	ofwt
籿	ofy
庒	ofyi
炖	ogbn
庉	ogbn
庢	ogcf
精	ogeg
烼	ogey
炡	oghg
烜	ogjg
粳	ogjr
焐	ogkg
煏	ogkl
糟	ogmj
炳	ogmw
廲	ogmx
廌	ogno
煭	ogqo
廒	ogqt
粖	ogsy
烴	ogva
业	ohhg
爠	ohhy
焯	ohjh
店	ohkd
粘	ohkg
炶	ohkg
廬	ohll
爐	ohll
爈	ohln
粯	ohqn
燦	ohqo
爘	ohqv
庛	ohxv
黻	oidy
焇	oieg
应	oigd
廠	oimt
糛	oipf
爣	oipo
黼	oisy
炒	oitt
粆	oitt
黹	oiu
黺	oiwv
熦	oiwy
熚	ojag
爗	ojag
爆	ojai
熶	ojbc
焨	ojeg
鄽	ojfb
廛	ojff
粴	ojfg
焊	ojfh
糧	ojgf
炟	ojgg
煶	ojgh
煬	ojgr
糃	ojgr
灲	ojh
熀	ojiq
焻	ojjg
爞	ojjj
熳	ojlc
煴	ojlg
庽	ojmy
焬	ojqr
粿	ojsy
焺	ojta
煋	ojtg
煜	ojug
燳	ojvo
焜	ojxx
烛	ojy
燝	ojyi
焆	okeg
燀	okkf
焒	okkg
煰	okkk
燥	okks
熉	okmy
炾	okqn
炽	okwy
廙	olaw
熼	olaw
糞	olaw
煾	oldn
烟	oldy
煟	oleg
畨	olf
燡	olff
爅	olff
糬	olfj
畑	olg
煨	olge
糫	olge
糰	olgf
炠	olh
库	olk
庘	olk
庫	olk
廤	olkx
燭	olqj
焑	olsy
廔	olvd
熡	olvg
熅	olwl
燶	omae
粬	omag
庙	omd
煓	omdj
炴	omdy
粙	omg
烔	omgk
粡	omgk
灿	omh
籼	omh
廁	omjk
熴	omjx
炯	omkg
粣	ommg
廮	ommv
煱	omnk
焵	omum
焹	omun
烱	omwk
熣	omwy
烿	omye
煀	onbm
籸	onfh
廜	onfj
煆	onhc
糈	onhe
炄	onhg
煝	onhg
粈	onhg
応	oni
糏	onie
爥	onij
煒	onkg
廦	onku
焗	onnk
慶	onnt
熠	onrg
断	onrh
炀	onrt
废	onty
熤	onug
廖	onwe
熮	onwe
炔	onwy
燿	onwy
烬	onyu
粎	onyy
熫	ooao
爌	ooaw
郯	oobh
糭	oobt
顃	oodm
烾	ooff
粧	oofg
敥	oohc
煔	oohk
覢	oohq
剡	oojh
飊	oooj
火	oooo
燚	oooo
燊	ooos
爃	ooos
焱	ooou
歘	ooow
罃	oopb
勞	oope
膋	oope
褮	oope
塋	oopf
煢	oopf
犖	oopg
醟	oopg
滎	oopi
禜	oopi
縈	oopi
螢	oopj
營	oopk
嵤	oopm
憥	oopn
熒	oopo
鶯	oopo
覮	oopq
鎣	oopq
榮	oops
檾	oops
嫈	oopv
焭	oopw
瑩	oopy
甇	oopy
謍	oopy
燐	ooqg
鶑	ooqo
欻	ooqw
炎	oou
爜	oouc
燫	oouw
糠	oovi
糖	oovk
煻	oovk
焿	oovw
爊	ooxo
廘	ooxx
熝	ooxx
麊	ooxx
炏	ooy
顲	ooym
爎	opdi
粽	opfi
烷	opfq
糘	opge
煊	opgg
迷	opi
熐	opju
熍	opkk
煇	oplh
廀	opoc
焥	opqb
烢	opta
焢	opwa
熔	opwk
焪	opwx
炨	opxn
焝	oqaj
底	oqay
灮	oqb
煼	oqbt
燃	oqdo
焰	oqeg
廨	oqeg
粼	oqgb
鄰	oqgb
粦	oqgj
亃	oqgn
翷	oqgn
遴	oqgp
斴	oqgr
甐	oqgy
焔	oqhj
庣	oqii
烑	oqiy
焕	oqmd
煥	oqmd
炮	oqnn
庖	oqnv
廯	oqou
熓	oqoy
粷	oqoy
廞	oqqw
粅	oqrt
炊	oqwy
熘	oqyl
廇	oqyl
灼	oqyy
糉	orbt
炍	orcy
粄	orcy
烯	ordh
庪	orfc
粕	org
煌	orgg
炘	orh
庍	ork
熂	oroy
廆	orqc
焮	orqw
庳	ortf
焷	ortf
粺	ortf
螷	ortj
蠯	ortj
廏	orxc
廐	orxq
爍	orxs
燩	oryt
煙	osfg
熛	osfi
煿	osfy
糐	osfy
粞	osg
庮	osgd
灯	osh
廂	oshd
烞	oshy
床	osi
庯	osi
燂	osjh
庁	osk
炣	oskg
煉	oslg
魔	ossc
麽	ossc
黀	ossc
磨	ossd
靡	ossd
麾	osse
塺	ossf
犘	ossg
麻	ossi
縻	ossi
劘	ossj
黁	ossj
麿	ossk
黂	ossm
糜	osso
爢	osso
摩	ossr
穈	osst
麼	ossx
爩	oste
庲	osww
炑	osy
烳	osy
炢	osyy
灹	otan
籷	otan
炧	otbn
粚	otbn
庅	otci
烽	otdh
燆	otdk
熢	otdp
粁	otfh
焅	otfk
庭	otfp
糙	otfp
烶	otfp
烍	otfq
爋	otge
煄	otgf
廭	otgm
廡	otgo
燻	otgo
烆	otgs
煅	othc
糗	othd
炸	othf
糌	othj
熄	othn
烻	othp
烙	otkg
烅	otlg
熜	otln
燠	otmd
炿	otmy
烁	otni
籺	otnn
燔	otol
煍	otoy
熪	otqq
烀	otuf
庝	otui
炵	otuy
烐	otuy
烸	otxy
敉	oty
炇	oty
秌	oty
庰	ouak
烂	oudg
烪	oudy
爖	oued
龐	oued
燗	oueg
糋	ouej
燧	ouep
煫	ouey
凿	oufb
鄴	oufb
叢	oufc
料	oufh
炓	oufh
丵	oufj
糳	oufo
鸈	oufo
鑿	oufq
業	oufu
粒	oug
對	ougf
懟	ougn
糕	ougo
菐	ougu
燨	ougy
爔	ougy
烊	ouh
燑	oujf
燱	oujn
糡	oujq
庠	ouk
廍	oukb
焙	oukg
熷	oulj
焖	ouny
燜	ouny
爓	ouqe
烄	oury
燇	ousf
煪	ousg
爛	ousl
劆	ouvj
廉	ouvw
熑	ouvw
熌	ouwy
焍	ouxt
糍	ouxx
燘	ouyy
燖	ovaf
鄘	oveb
庸	oveh
鷛	oveo
娄	ovf
粋	ovfh
熽	ovfj
籹	ovg
煡	ovgp
鄌	ovhb
唐	ovhk
燼	ovhl
鶶	ovho
康	ovii
粶	oviy
炤	ovkg
廱	ovky
爉	ovln
煺	ovpy
灱	ovt
数	ovty
廄	ovwc
鹒	ovwg
庚	ovwi
赓	ovwm
賡	ovwm
鶊	ovwo
籾	ovyy
炝	owbn
焧	owcn
庺	owcs
炂	owcy
炈	owcy
烩	owfc
府	owfi
焤	owfo
廃	owfq
腐	owfw
爚	owga
烇	owgg
廥	owgj
燴	owgj
糩	owgj
烚	owgk
粭	owgk
熻	owgn
庩	owgs
燈	owgu
庂	owi
炌	owjh
庎	owjk
籶	own
糇	ownd
庥	owsi
烌	owsy
煈	owtj
粉	owvt
膺	owwe
座	owwf
鹰	owwg
噟	owwk
焀	owwk
應	owwn
鷹	owwo
譍	owwy
炛	owxb
廢	owxc
烨	owxf
炩	owyc
焳	owyg
焓	owyk
熗	owyk
庈	owyn
焾	owyn
燋	owyo
庼	oxdm
廎	oxdm
粌	oxhh
纇	oxim
颣	oxim
炥	oxjh
糨	oxkj
彂	oxtd
糑	oxuu
庀	oxv
鄜	oxxb
麛	oxxb
麚	oxxc
麌	oxxd
麎	oxxe
麝	oxxf
塵	oxxf
麟	oxxg
麈	oxxg
麆	oxxg
麠	oxxg
麖	oxxi
麘	oxxj
麞	oxxj
麡	oxxj
麍	oxxk
麏	oxxk
麐	oxxk
麔	oxxk
麙	oxxk
麢	oxxk
粃	oxxn
麅	oxxn
麋	oxxo
麃	oxxo
鏖	oxxq
麑	oxxq
煯	oxxr
麜	oxxs
麇	oxxt
麕	oxxt
麣	oxxt
鹿	oxxv
庇	oxxv
麂	oxxw
麒	oxxw
麀	oxxx
麤	oxxx
廓	oybb
焞	oybg
燉	oybt
焴	oyce
庡	oyei
炷	oygg
广	oygt
炞	oyhy
爙	oyke
廪	oyli
燷	oyli
廩	oylt
燣	oylt
熇	oymk
燺	oyms
煸	oyna
糄	oyna
熩	oync
庐	oyne
煽	oynn
炉	oynt
粐	oynt
烗	oynw
煷	oypw
米	oyty
熾	oyuj
熵	oyuk
廊	oyvb
粮	oyvy
烺	oyvy
粹	oywf
焠	oywf
炕	oywn
粇	oywn
焲	oywy
炫	oyxy
炆	oyy
灬	oyyy
宦	pahh
宧	pahh
寛	pahq
寬	pahy
寞	pajd
冪	pajh
宽	pamq
寋	pawb
褰	pawe
塞	pawf
骞	pawg
蹇	pawh
赛	pawm
賽	pawm
騫	pawo
鶱	pawo
搴	pawr
寨	paws
寒	pawu
弿	pawx
謇	pawy
冣	pbcu
字	pbf
宻	pcum
翝	pdcn
宏	pdcu
宥	pdef
寡	pdev
宕	pdf
宸	pdfe
割	pdhj
害	pdhk
豁	pdhk
鶷	pdho
寕	pdls
宬	pdnb
寄	pdsk
宊	pdu
寮	pdui
実	pdwu
宠	pdxy
宒	peb
肎	pef
宜	pegf
冝	pegf
农	pei
冩	peqo
寫	peqo
寀	pesu
寪	peto
冡	pfeu
寘	pfhw
崈	pfim
賨	pfim
鶎	pfio
宗	pfiu
宑	pfjj
完	pfqb
寇	pfqc
冦	pfqc
冠	pfqf
鵍	pfqo
宼	pfqv
宯	pftb
守	pfu
室	pgcf
寈	pgef
家	pgeu
冢	pgey
宇	pgfj
賓	pghm
顁	pghm
顮	pghm
定	pghu
宣	pgjg
寭	pgjn
翧	pgjn
富	pgkl
冨	pgkl
憲	pgln
戭	pgma
寅	pgmw
写	pgng
寳	pgqm
寚	pgtb
寶	pgtm
寁	pgvh
宝	pgyu
寂	phic
寊	phmu
宐	phng
鼏	phnn
宵	pief
寖	pivc
幂	pjdh
寔	pjgh
审	pjhj
寓	pjmy
鄍	pjub
覭	pjuq
冥	pjuu
鼆	pjux
宴	pjvf
宺	pkgk
宫	pkkf
宲	pksu
宮	pktk
郓	plbh
鄆	plbh
皲	plby
皸	plby
顐	pldm
寰	plge
军	plj
軍	plj
運	plpk
鶤	plqo
寠	plvf
寷	pmdu
宙	pmf
冚	pmj
甯	pnej
官	pnf
寍	pnlf
寜	pnlh
鸋	pnlo
寧	pnls
賔	pnmu
悹	pnnu
逭	pnpd
寗	pntf
蜜	pntj
密	pntm
宓	pntr
寥	pnwe
廴	pny
叜	pocu
灾	pou
冞	pou
宩	pou
之	pppp
宛	pqbb
鹓	pqbg
邥	pqbh
剜	pqbj
惌	pqbn
鵷	pqbo
瓭	pqgy
沊	pqii
宨	pqiu
冤	pqky
寃	pqky
寏	pqmd
鸩	pqqg
鴆	pqqo
冘	pqv
寙	prcy
宾	prwu
冟	prxb
宁	psj
冧	pssu
宋	psu
宅	ptab
宎	ptdu
宪	ptfq
牢	ptgj
客	ptkf
额	ptkm
額	ptkm
愙	ptkn
審	ptol
覾	ptoq
宷	ptou
裓	puaa
襼	puac
褠	puaf
襺	puaj
褡	puak
襤	pual
襽	pual
袣	puan
褋	puas
褗	puav
襪	puaw
襔	puay
襵	pubb
袦	pubm
衪	pubn
被	puby
衱	puby
裰	pucc
襂	puce
褬	pucs
褦	pucx
衩	pucy
袏	puda
袸	pudb
褉	pudd
裖	pude
褥	pudf
袥	pudg
袹	pudj
袻	pudj
襫	pudj
裿	pudk
袴	pudn
裺	pudn
实	pudu
裌	pudw
褀	pudw
袚	pudy
褑	puec
寵	pued
袓	pueg
襷	puer
衫	puet
衼	pufc
袪	pufc
褤	pufe
袿	puff
褂	pufh
衦	pufh
袆	pufh
褚	pufj
襦	pufj
袺	pufk
襩	pufm
襭	pufm
襓	pufq
裬	puft
寐	pufu
襶	pufw
衬	pufy
褹	pufy
裱	puge
衧	pugf
褿	pugj
寤	pugk
褔	pugl
襀	pugm
襧	pugr
袜	pugs
裋	pugu
褄	pugv
寎	pugw
襹	pugx
衭	pugy
裲	pugy
裶	puhd
褃	puhe
裃	puhh
袩	puhk
裭	puhw
补	puhy
褝	puif
襠	puil
襒	puit
裆	puiv
宰	puj
襊	pujc
裡	pujf
袒	pujg
衵	pujg
裫	pujg
襅	pujg
褆	pujh
襮	puji
裮	pujj
褴	pujl
褞	pujl
褐	pujn
褟	pujn
裼	pujr
裸	pujs
裩	pujx
裐	puke
襌	pukf
裎	pukg
衶	pukh
䙡	pukm
䙌	pukm
襙	puks
裀	puld
襗	pulf
襡	pulj
裢	pulp
褳	pulp
裍	puls
褸	pulv
襬	pulx
襛	pume
衻	pumf
袡	pumf
袖	pumg
褍	pumj
裯	pumk
衲	pumw
袇	pumy
裾	pund
褘	pung
褶	punr
袐	punt
袂	punw
襈	punw
袯	puny
襨	puof
襆	puog
褯	puoh
裤	puol
褲	puol
裧	puoo
褛	puov
褣	pupk
裈	pupl
褌	pupl
衴	pupq
袕	pupw
袉	pupx
衹	puqa
裪	puqb
襐	puqe
袧	puqk
袍	puqn
袳	puqq
袀	puqu
袛	puqy
襜	puqy
裨	purf
袙	purg
褫	purw
襟	pusi
褾	pusi
袔	pusk
襋	pusm
襰	pusm
褼	pusn
寴	pusq
襻	pusr
補	pusy
袘	putb
袄	putd
襖	putd
衽	putf
袾	putf
褈	putf
袟	putg
袶	putg
褷	puth
袮	puti
襣	putj
袼	putk
裇	putl
襎	putl
襸	putm
寱	puts
裄	puts
裑	putt
複	putt
宍	puu
褨	puua
裷	puub
襱	puud
褙	puue
襉	puue
袢	puug
裥	puuj
襇	puuj
襕	puul
襴	puul
襚	puup
裞	puuq
襯	puuq
寝	puvc
寢	puvc
襑	puvf
裙	puvk
袑	puvk
袽	puvk
褪	puvp
初	puvt
裉	puvy
衳	puwc
袊	puwc
襏	puwc
袱	puwd
袗	puwe
袝	puwf
袵	puwf
裣	puwg
襥	puwg
襳	puwg
衸	puwj
褕	puwj
襘	puwj
裕	puwk
袷	puwk
衿	puwn
褓	puws
襍	puws
衯	puwv
襝	puww
袎	puxe
褖	puxe
襁	puxj
褊	puya
褵	puyc
寣	puyf
襢	puyg
褅	puyh
裗	puyk
袨	puyx
衤	puyy
鞌	pvaf
宄	pvb
頞	pvdm
安	pvf
鴳	pvqo
案	pvsu
宭	pvtk
空	pwaf
窢	pwag
窍	pwan
鵼	pwao
穿	pwat
窃	pwav
冗	pwb
宂	pwb
窷	pwbb
窿	pwbg
窋	pwbm
窡	pwcc
窓	pwcn
梥	pwcs
窫	pwdd
竂	pwdi
宿	pwdj
窚	pwdn
鶟	pwdo
突	pwdu
窰	pweb
竁	pwee
竄	pwen
穷	pwer
窙	pwfb
窦	pwfd
窐	pwff
察	pwfi
罕	pwfj
穽	pwfj
竇	pwfm
竃	pwfn
窛	pwfv
窴	pwfw
窾	pwfw
竈	pwfx
窒	pwgf
穻	pwgf
窀	pwgn
窥	pwgq
窺	pwgq
竀	pwgq
窉	pwgw
窅	pwhf
窧	pwhj
窏	pwif
窪	pwif
窠	pwjs
窤	pwjx
窜	pwkh
窝	pwkw
窶	pwlv
帘	pwmh
窩	pwmk
穵	pwnb
窟	pwnm
窲	pwof
窭	pwov
窌	pwqb
窞	pwqe
窎	pwqg
窕	pwqi
窇	pwqn
窵	pwqo
鴧	pwqo
鴪	pwqo
穸	pwqu
竅	pwrt
窳	pwry
窊	pwry
穼	pwsu
罙	pwsu
窑	pwtb
竊	pwtc
穾	pwtd
窄	pwtf
宱	pwtf
窂	pwtg
窖	pwtk
竆	pwtk
窸	pwtn
窻	pwtn
窆	pwtp
窗	pwtq
窮	pwtx
穴	pwu
㓁	pwu
竉	pwud
窨	pwuj
窹	pwuk
窯	pwuo
邃	pwup
窔	pwur
究	pwvb
寑	pwvc
窘	pwvk
窼	pwvs
彮	pwwe
窬	pwwj
容	pwwk
窱	pwws
穹	pwxb
窈	pwxe
窽	pwxw
隺	pwyd
寉	pwyf
窣	pwyf
鹤	pwyg
寯	pwyn
鶴	pwyo
它	pxb
宆	pxb
宖	pxcu
實	pxmu
迱	pxpv
寲	pxth
祴	pyaa
祁	pybh
祂	pybn
礽	pybt
祃	pycg
禡	pyco
禊	pydd
祳	pyde
祷	pydf
禥	pydf
祜	pydg
祏	pydg
祐	pydk
祺	pydw
祓	pydy
禲	pydy
禐	pyec
祖	pyeg
祛	pyfc
禱	pyff
社	pyfg
祎	pyfh
禃	pyfh
禇	pyfj
禧	pyfk
祮	pyfk
禖	pyfs
祾	pyft
禛	pyfw
祙	pyfy
祆	pygd
宔	pygf
祬	pygf
福	pygl
禰	pygr
祉	pyhg
祯	pyhm
禎	pyhm
視	pyhq
神	pyjh
禔	pyjh
禵	pyjm
禢	pyjn
禓	pyjr
祼	pyjs
禑	pyjy
祦	pykd
禪	pykf
祌	pykh
祝	pykq
祸	pykw
祻	pyld
禗	pyln
禤	pyln
祵	pyls
禝	pylt
禩	pylw
禯	pyme
禂	pymk
禍	pymk
视	pymq
禮	pymu
冖	pyn
祤	pyng
禕	pyng
祠	pynk
礼	pynn
祀	pynn
祕	pynt
辶	pyny
禟	pyok
禷	pyom
禈	pypl
祇	pyqa
祪	pyqb
祹	pyqb
祧	pyqi
祢	pyqi
祗	pyqy
礿	pyqy
禆	pyrf
祈	pyrh
禠	pyrw
禋	pysf
禣	pysf
禫	pysj
祅	pytd
祣	pyte
祚	pytf
祍	pytf
祩	pytf
祑	pytg
祰	pytk
禶	pytm
禙	pyue
禅	pyuf
禉	pyug
祥	pyuh
禚	pyuo
禭	pyup
祱	pyuq
祶	pyut
禌	pyux
祲	pyvc
禄	pyvi
祒	pyvk
禴	pywa
祋	pywc
祔	pywf
祄	pywj
禬	pywj
祫	pywk
禒	pyxe
祿	pyxi
禨	pyxw
禳	pyye
祽	pyyf
禘	pyyh
禞	pyyk
宀	pyyn
祊	pyyt
礻	pyyy
鑶	qaah
鐷	qaas
鉽	qaay
錢	qaay
锘	qadk
鍩	qadk
頯	qadm
鏾	qaet
氒	qafj
鐯	qafj
䦃	qafj
鑉	qafl
釭	qag
鏵	qagg
铘	qahb
鋣	qahb
鏗	qahf
鑑	qahl
鑦	qahm
鑬	qahq
釾	qaht
䥺	qaht
鑮	qaif
銾	qaiy
镆	qajd
鏌	qajd
昏	qajf
错	qajg
錯	qajg
钷	qakg
鉕	qakg
鏂	qakk
鑎	qakm
鑵	qaky
锚	qalg
錨	qalg
鑖	qalw
鍈	qamd
锳	qamd
帋	qamh
鉔	qamh
鐄	qamw
鏋	qamy
钜	qang
鉅	qang
钺	qann
鉞	qann
鉪	qann
鍱	qans
铽	qany
鋱	qany
铹	qape
鐕	qaqj
銰	qary
鑝	qatp
铙	qatq
钄	qaul
氏	qav
鍣	qavk
镬	qawc
鑊	qawc
匒	qawk
鎝	qawk
錵	qawx
鉷	qawy
鈛	qay
邸	qayb
鸱	qayg
氐	qayi
鋩	qayn
铓	qayn
鴟	qayo
錺	qayt
釴	qayy
鑷	qbbb
鎁	qbbh
镊	qbcc
駌	qbco
鋷	qbcy
铒	qbg
釨	qbg
鉺	qbg
钌	qbh
卬	qbh
夘	qbh
邜	qbh
釕	qbh
眢	qbhf
鐊	qbjr
盌	qblf
锰	qblg
錳	qblg
鈯	qbmh
夗	qbn
釶	qbn
銸	qbnn
怨	qbnu
迎	qbpk
鸳	qbqg
鴛	qbqo
锕	qbsk
錒	qbsk
釢	qbt
皺	qbtb
鄒	qbtb
鶵	qbto
芻	qbtt
雛	qbty
妴	qbvf
铍	qby
鈹	qby
鈒	qbyy
钑	qbyy
色	qcb
錣	qccc
鏒	qcce
鎟	qccs
銿	qceh
铎	qcgh
勾	qci
鈶	qckg
钯	qcn
鈀	qcn
鐍	qcnk
鍒	qcns
鎷	qcoy
鈗	qcqn
鉾	qctg
鋑	qcwt
钗	qcyy
釵	qcyy
危	qdbb
頠	qdbm
鈪	qdbn
钹	qdcy
鈜	qdcy
鈸	qdcy
铕	qdeg
銪	qdeg
鍸	qdeg
鋹	qdey
锛	qdfa
錛	qdfa
鋠	qdfe
鍷	qdff
鎒	qdff
錼	qdfi
銙	qdfn
钴	qdg
鈷	qdg
鉐	qdg
銊	qdgg
鍼	qdgk
銌	qdhb
锲	qdhd
鍥	qdhd
銔	qdhf
鉟	qdhg
鏚	qdhi
鏏	qdhv
钚	qdhy
鈈	qdhy
銆	qdjg
匎	qdjn
钸	qdmh
鈽	qdmh
顉	qdmy
铖	qdnn
鋮	qdnn
然	qdou
鋴	qdqn
厃	qdr
鏯	qdrr
錡	qdsk
锜	qdsk
矦	qdtd
铸	qdtf
鋳	qdtf
镣	qdui
鐐	qdui
镢	qduw
鐝	qduw
鍖	qdwn
鐁	qdwr
鋏	qdww
詹	qdwy
甔	qdwy
錤	qdwy
釱	qdy
钛	qdyy
鈦	qdyy
觨	qeai
觾	qeao
觵	qeaw
鋢	qebg
觙	qeby
觭	qedk
錋	qeeg
觬	qeeq
觔	qeet
臽	qef
觟	qeff
觰	qefj
锊	qefy
鋝	qefy
钥	qeg
鈅	qeg
锾	qegc
鍰	qegc
锄	qege
鋤	qege
鉏	qegg
觩	qegy
锼	qehc
鎪	qehc
觥	qeiq
觘	qeit
角	qej
觛	qejg
触	qejy
觶	qekf
鉫	qekg
觸	qelj
觿	qemk
觽	qemn
觓	qenh
觖	qenw
燄	qeoo
鑀	qept
觗	qeqa
觤	qeqb
鹐	qeqg
鵤	qeqo
鵮	qeqo
觼	qeqt
欿	qeqw
觝	qeqy
觻	qers
觚	qery
觫	qesk
钐	qet
釛	qet
釤	qet
鎐	qetb
觡	qetk
觞	qetr
觴	qetr
斛	qeuf
觯	qeuf
觲	qeug
觧	qeuh
觪	qeuh
解	qevg
鋖	qevg
觮	qevi
蟹	qevj
邂	qevp
觹	qewn
鐵	qfag
鐼	qfam
鐡	qfau
銭	qfay
鎑	qfcl
鈘	qfcy
鉣	qfcy
勻	qfd
鑐	qfdj
銈	qffg
鐃	qffq
钳	qfg
钍	qfg
釷	qfg
鉗	qfg
针	qfh
針	qfh
釬	qfh
镇	qfhw
鎮	qfhw
銢	qfiy
鎱	qfke
銡	qfkg
镭	qflg
鐳	qflg
鑟	qflm
鑄	qfnf
釫	qfnn
鋕	qfny
鋍	qfpb
鎍	qfpi
鈨	qfqn
銇	qfsy
﨧	qftb
锗	qftj
鍺	qftj
铐	qftn
銬	qftn
釮	qftt
铑	qftx
銠	qftx
﨨	qfuf
鐽	qfup
錴	qfwf
錂	qfwt
鹱	qgac
鳠	qgac
鳓	qgae
鈃	qgah
钘	qgah
鉶	qgaj
铏	qgaj
鲽	qgas
钱	qgay
錻	qgay
鲰	qgbc
印	qgbh
钝	qgbn
鈍	qgbn
鲏	qgby
鲬	qgce
鲹	qgce
銍	qgcf
铚	qgcf
鳋	qgcj
鲐	qgck
鲃	qgcn
鸟	qgd
鲔	qgde
銒	qgdf
鲕	qgdj
䲠	qgdj
鳡	qgdn
鳜	qgdw
鲯	qgdw
鱿	qgdy
鲅	qgdy
鳐	qgeb
锖	qgeg
錆	qgeg
鲵	qgeq
錶	qgey
鱼	qgf
鲑	qgff
錏	qgfg
釪	qgfh
鳍	qgfj
鲒	qgfk
鲼	qgfm
鐚	qgfn
鲓	qgfn
鲮	qgft
鳕	qgfv
鲭	qgge
鲆	qggf
錱	qggf
鐟	qggj
鲾	qggl
鑚	qggm
鲀	qggn
鲠	qggr
鲡	qggy
舛	qgh
鲱	qghd
钲	qghg
鉦	qghg
鲇	qghk
钙	qghn
鲈	qghn
鈣	qghn
鲿	qgic
銶	qgiy
鳗	qgjc
鲁	qgjf
鲤	qgjf
鲥	qgjf
鲣	qgjf
鏄	qgjf
鳀	qgjh
鲳	qgjj
鐂	qgjl
鳁	qgjl
鳎	qgjn
鏸	qgjn
鲲	qgjx
鋙	qgkg
铻	qgkg
镉	qgkh
鎘	qgkh
鑩	qgkk
匐	qgkl
鍢	qgkl
鳄	qgkn
鋀	qgku
鲴	qgld
鳂	qgle
鳏	qgli
鳃	qgln
鲢	qglp
鲉	qgmg
鏪	qgmj
鲗	qgmj
鲷	qgmk
鲖	qgmk
鳢	qgmu
鈵	qgmw
鳚	qgnf
鲺	qgnj
鱾	qgnn
鳛	qgnr
鋄	qgoc
鳞	qgog
铔	qgog
鳙	qgoh
錽	qgot
鲩	qgpq
鸵	qgpx
䲟	qgqb
鲍	qgqn
鳇	qgrg
鲌	qgrg
鳈	qgri
鲘	qgrk
鳔	qgsi
鲄	qgsk
桀	qgsu
鲊	qgtf
鲧	qgti
鳤	qgtn
鳅	qgto
鲦	qgts
鳆	qgtt
稣	qgty
铗	qgud
鳟	qguf
匉	qguf
鳉	qguf
䲡	qgug
鲜	qguh
鳝	qguk
鲛	qgur
铼	qgus
鳒	qguw
鋞	qgva
鲫	qgvb
鲟	qgvf
鲪	qgvk
鲻	qgvl
鱽	qgvt
鲙	qgwc
鲋	qgwf
鲶	qgwn
鑈	qgwr
銕	qgxw
鈇	qgy
鳊	qgya
鳣	qgyg
鲸	qgyi
鲚	qgyj
鲂	qgyt
钰	qgyy
鈺	qgyy
鳑	qgyy
鑡	qhbh
鈙	qhcy
鐬	qhdh
錹	qheg
钼	qhg
鉬	qhg
钀	qhgd
鐻	qhge
钁	qhhc
䦆	qhhc
鉲	qhhy
鑺	qhhy
亇	qhj
鋽	qhjh
钻	qhkg
鉆	qhkg
夞	qhkx
鐪	qhle
鑪	qhll
鑢	qhln
鏀	qhlo
鍞	qhmy
鐤	qhnn
迯	qhpi
鋧	qhqn
鎼	qhrh
鏬	qhtf
錿	qhwn
外	qhy
钋	qhy
釙	qhy
頫	qidm
销	qieg
銷	qieg
鼗	qifc
鍅	qifc
銧	qigq
玺	qigy
覙	qihq
覜	qihq
兆	qii
錔	qijg
鐋	qijr
鋿	qimk
锁	qimy
鎖	qimy
铴	qinr
镗	qipf
鏜	qipf
鏛	qiph
逃	qipi
迩	qipi
鐺	qipl
鑜	qipm
钂	qipo
鎲	qipq
镋	qipq
鐣	qipr
鏿	qips
鴵	qiqo
鎃	qire
钞	qitt
鈔	qitt
尔	qiu
淾	qiu
铛	qivg
釥	qiy
鏎	qjag
鑤	qjai
郇	qjbh
铿	qjcf
旬	qjd
锂	qjfg
鋰	qjfg
銲	qjfh
鈤	qjg
锝	qjgf
鍀	qjgf
钽	qjgg
鉭	qjgg
鍉	qjgh
鍚	qjgr
钊	qjh
釗	qjh
鉮	qjhh
鎤	qjiq
錩	qjjg
锠	qjjg
亀	qjjn
镘	qjlc
鏝	qjlc
鎾	qjlg
鍝	qjmy
龟	qjnb
鎉	qjng
迿	qjpd
銞	qjqf
鍻	qjqn
锡	qjqr
錫	qjqr
锞	qjsy
錁	qjsy
鍟	qjtg
锟	qjxx
錕	qjxx
鉵	qjy
鐛	qjyi
鍓	qkbg
邭	qkbh
句	qkd
勨	qkee
鋗	qkeg
劬	qket
象	qkeu
名	qkf
釦	qkg
鋘	qkgd
锃	qkgg
鋥	qkgg
钏	qkh
釧	qkh
钟	qkhh
鈡	qkhh
鏴	qkhk
鐀	qkhm
鑓	qkhp
鋜	qkhy
铝	qkkg
鋁	qkkg
鋛	qkkh
锷	qkkn
鍔	qkkn
鐰	qkks
铞	qkmh
銱	qkmh
锅	qkmw
免	qkqb
勉	qkqe
鸲	qkqg
鴝	qkqo
鵵	qkqo
逸	qkqp
够	qkqq
欨	qkqw
兔	qkqy
斪	qkrh
鉂	qkry
敂	qkty
鉙	qkwy
雊	qkwy
酁	qkxb
劖	qkxj
毚	qkxy
甸	qld
锢	qldg
錮	qldg
铟	qldy
銦	qldy
鐸	qlff
钿	qlg
鈿	qlg
鍡	qlge
鐶	qlge
镮	qlge
鎠	qlgh
钾	qlh
鉀	qlh
鑸	qllf
鑘	qlll
錷	qlnn
锶	qlny
鍶	qlny
链	qlpy
鏈	qlpy
镯	qlqj
鐲	qlqj
锣	qlqy
鏩	qlrh
鏤	qlvg
鎅	qlwj
镙	qlxi
鏍	qlxi
鑼	qlxy
錪	qmaw
錌	qmdf
鍴	qmdj
奂	qmdu
鉠	qmdy
鏰	qmee
镚	qmee
錭	qmfk
铀	qmg
鈾	qmg
铜	qmgk
銅	qmgk
鎧	qmgu
铡	qmjh
鍘	qmjh
岛	qmk
島	qmk
銏	qmmg
銟	qmmh
鍋	qmnk
铠	qmnn
鐹	qmnp
钢	qmry
鎽	qmth
负	qmu
負	qmu
鋼	qmum
奐	qmwd
鑴	qmwk
烉	qmwo
夐	qmwt
敻	qmwt
钠	qmwy
鈉	qmwy
鏙	qmwy
钡	qmy
鋇	qmy
馍	qnad
馑	qnag
鍲	qnaj
鈱	qnan
饶	qnaq
馓	qnat
饣	qnb
饵	qnbg
饳	qnbm
饴	qnck
馂	qnct
锯	qndg
鋸	qndg
馊	qnec
馁	qnev
饽	qnfb
馌	qnfl
鈻	qng
饯	qnga
馕	qnge
鉰	qngk
饨	qngn
饾	qngu
鍜	qnhc
钮	qnhg
镅	qnhg
鈕	qnhg
鎇	qnhg
钃	qnij
馒	qnjc
刨	qnjh
馃	qnjs
馄	qnjx
蚀	qnjy
鍏	qnkg
馈	qnkm
鐴	qnku
馉	qnme
钇	qnn
钆	qnn
釓	qnn
釔	qnn
釲	qnn
饲	qnnk
锔	qnnk
鋦	qnnk
饧	qnnr
馔	qnnw
鐉	qnnw
炰	qnou
馆	qnpn
馅	qnqe
馏	qnql
饱	qnqn
馋	qnqu
饮	qnqw
饭	qnrc
饩	qnrn
钖	qnrt
馎	qnsf
馇	qnsg
饤	qnsh
饦	qnta
饫	qntd
饬	qnte
饪	qntf
饰	qnth
饷	qntk
饹	qntk
铋	qntt
鉍	qntt
饿	qnty
䥽	qnty
饼	qnua
馐	qnug
饺	qnur
包	qnv
鏐	qnwe
镠	qnwe
饸	qnwk
饥	qnwn
馀	qnws
鈌	qnwy
鑃	qnwy
铌	qnxn
鈮	qnxn
鈊	qny
饻	qnye
鉯	qnyw
鈬	qnyy
镀	qoac
鍍	qoac
鱯	qoac
鸌	qoac
鰳	qoae
鰹	qoaf
魟	qoag
鰙	qoak
鰸	qoak
鮔	qoan
鏣	qoao
鰈	qoas
鰋	qoav
鑛	qoaw
鱑	qoaw
鱴	qoaw
鱹	qoay
鯫	qobc
鄔	qobh
鄥	qobh
鯭	qobl
鮿	qobn
鑁	qobt
魥	qoby
鮍	qoby
鯒	qoce
鯵	qoce
鰺	qoce
魣	qoch
鰠	qocj
鮐	qock
鱊	qock
鰢	qoco
鷌	qoco
鰇	qocs
鮻	qoct
鵔	qoct
鉱	qocy
鮪	qode
鰖	qode
鰗	qode
魾	qodg
鮕	qodg
鮖	qodg
爒	qodi
鮞	qodj
鰆	qodj
鰔	qodk
鮬	qodn
鯎	qodn
鱤	qodn
鰄	qodv
鯕	qodw
鱖	qodw
鶀	qodw
魷	qody
鮁	qody
鱱	qody
鰩	qoeb
鰀	qoec
魹	qoen
鯢	qoeq
鶃	qoeq
鱫	qoet
鳨	qoet
鮾	qoev
鱮	qoew
魼	qofc
鮭	qoff
鯥	qoff
魽	qofg
鯐	qofh
鯺	qofj
鰭	qofj
鱬	qofj
鮚	qofk
鱚	qofk
鰪	qofl
鱩	qofl
鱝	qofm
鮳	qofn
魭	qofq
鱙	qofq
鯪	qoft
鱈	qofv
鮱	qofx
鮇	qofy
鯖	qoge
鮃	qogf
鱄	qogf
魳	qogh
鰽	qogj
鯃	qogk
鱷	qogk
鰏	qogl
鰿	qogm
魨	qogn
鱁	qogp
鯁	qogr
鮧	qogw
魱	qogx
鱺	qogx
鯄	qogy
鯡	qohd
鱥	qohh
鮛	qohi
鮎	qohk
鱸	qohl
鱋	qoho
鯱	qohw
鰬	qohy
匊	qoi
灳	qoi
烏	qoi
鳥	qoi
鮹	qoie
鱨	qoij
魦	qoit
鯋	qoit
鵿	qoja
鰻	qojc
魯	qojf
鯉	qojf
鰣	qojf
鯹	qojg
魝	qojh
鯷	qojh
鸔	qoji
鯧	qojj
鱪	qojj
鰛	qojl
鰨	qojn
鯣	qojr
鰑	qojr
鯤	qojx
鰅	qojy
鱓	qokf
鰐	qokn
鱢	qoks
鯝	qold
鰃	qole
鱞	qole
魻	qolh
鰥	qoli
鱰	qolj
鮰	qolk
鰮	qoll
鰓	qoln
鰱	qolp
鮂	qolw
鱡	qomd
鮋	qomg
鰂	qomj
鮦	qomk
鯛	qomk
鱧	qomu
魶	qomw
鰕	qonc
鮙	qong
鯴	qonj
魢	qonn
鳦	qonn
鰼	qonr
鮅	qont
鴃	qonw
鐒	qooe
鱗	qoog
鱅	qooh
鱇	qooi
鑅	qoos
锬	qooy
錟	qooy
鯳	qooy
鰘	qopf
鰚	qopg
鰰	qoph
鯮	qopi
鰫	qopk
鯶	qopl
魫	qopq
鯇	qopq
鮟	qopv
鴥	qopw
鮀	qopx
鴕	qopx
鮠	qoqb
鮣	qoqb
鱌	qoqe
鏻	qoqg
鮡	qoqi
鮈	qoqk
鰡	qoql
鮑	qoqn
鰞	qoqo
鱻	qoqo
鵴	qoqo
鷠	qoqo
鮸	qoqq
魩	qoqr
歍	qoqw
魡	qoqy
魬	qorc
鮊	qorg
鰉	qorg
鯑	qorh
鰁	qori
鮜	qork
鱳	qors
鯼	qort
鷈	qorw
鯂	qosg
鰾	qosi
鯟	qosj
鯻	qosj
鱏	qosj
魺	qosk
鴚	qosk
鰊	qosl
鯠	qosw
鯆	qosy
魠	qota
鯚	qotb
鮓	qotf
鮢	qotf
鮏	qotg
鰤	qoth
鶳	qoth
鯀	qoti
鯏	qotj
鯯	qotj
鮥	qotk
鯌	qotk
鯦	qotk
鱎	qotk
鱵	qotk
鴼	qotk
鱕	qotl
魸	qotn
鰍	qoto
鯅	qotp
鯓	qott
鰒	qott
鮗	qotu
鴤	qotu
鯘	qotv
穌	qoty
魞	qoty
炙	qou
魚	qou
鮩	qoua
鑆	qouf
鱂	qouf
鱒	qouf
镤	qoug
鏷	qoug
鰌	qoug
鱃	qoug
鮮	qouh
鱆	qouj
鱛	qouj
鱔	qouk
鮵	qouq
鮫	qour
鮷	qout
鯜	qouv
鱶	qouv
镰	qouw
鐮	qouw
鰜	qouw
鰦	qoux
鸃	qouy
鯽	qovb
鮼	qovc
鱘	qovf
镂	qovg
镛	qovh
鏞	qovh
鯞	qovh
鏮	qovi
鵦	qovi
鱐	qovj
鎕	qovk
鮉	qovk
鮶	qovk
鯔	qovl
鱲	qovn
鰎	qovp
魛	qovt
鯩	qowa
鳧	qowb
魿	qowc
鱍	qowc
鮲	qowd
鯸	qowd
鮒	qowf
鰶	qowi
魪	qowj
鱠	qowj
鮯	qowk
鯰	qown
鯾	qowr
鮴	qows
鮽	qows
鰷	qows
鵌	qows
魵	qowv
魤	qowx
魜	qowy
鮘	qowy
鴏	qowy
鵻	qowy
鱜	qoxb
鱦	qoxg
鮄	qoxj
鮨	qoxj
镳	qoxo
鑣	qoxo
鰯	qoxu
鏕	qoxx
魮	qoxx
麁	qoxx
钬	qoy
鈥	qoy
銤	qoy
鯿	qoya
鯙	qoyb
鱣	qoyg
鯨	qoyi
鱭	qoyj
鯍	qoyk
鰝	qoyk
魲	qoyn
魴	qoyt
鷻	qoyt
鯲	qoyu
魧	qoyw
鮌	qoyx
魰	qoyy
鰟	qoyy
鑳	qpah
鑧	qpay
鋐	qpdc
鎋	qpdk
錝	qpfi
鋎	qpfq
镓	qpge
鎵	qpge
鍹	qpgg
锭	qpgh
錠	qpgh
鑌	qpgm
夤	qpgw
鏔	qpgw
鍕	qplh
錧	qpng
鑏	qpns
鋺	qpqb
鈂	qpqn
镔	qprw
铵	qpvg
銨	qpvg
镩	qpwh
镲	qpwi
鑔	qpwi
鏥	qpwj
鎔	qpwk
镕	qpwk
鑹	qpwn
铊	qpxn
鉈	qpxn
鎺	qpyg
錉	qqaj
銽	qqak
卶	qqbh
铯	qqcn
銫	qqcn
钩	qqcy
鈎	qqcy
錎	qqeg
夡	qqfk
鍂	qqg
镥	qqgj
匇	qqi
铫	qqiy
鉨	qqiy
銚	qqiy
銁	qqjg
鐌	qqke
铭	qqkg
鉤	qqkg
銘	qqkg
鋔	qqkq
鑱	qqky
镵	qqky
翗	qqng
鉋	qqnn
铇	qqnn
鑥	qqoj
鎢	qqoy
鵭	qqoy
迻	qqpi
鑫	qqqf
夠	qqqk
金	qqqq
鉹	qqqy
锪	qqrn
鍃	qqrn
鍯	qqrn
铆	qqtb
鉚	qqtb
鋾	qqtb
多	qqu
钧	qqug
鈞	qqug
憌	qqun
郺	qqvc
铮	qqvh
錚	qqvh
钦	qqwy
欽	qqwy
釸	qqy
鍧	qqyg
镏	qqyl
鎦	qqyl
钓	qqyy
釣	qqyy
胷	qrbe
匈	qrbk
鍐	qrbt
钣	qrcy
鈑	qrcy
鈲	qrcy
勿	qre
甮	qrej
鍎	qrfh
锧	qrfm
铂	qrg
鉑	qrg
鍠	qrgg
锽	qrgg
銗	qrgk
釿	qrh
釽	qrhy
匁	qri
曶	qrjf
刎	qrjh
锦	qrmh
錦	qrmh
忽	qrnu
鎎	qroy
锨	qrqw
鍁	qrqw
鑕	qrrm
鎩	qrsc
铩	qrsy
錍	qrtf
鋲	qrwy
鑠	qrxs
匆	qryi
怱	qryn
鄡	qsbh
镖	qsfi
鏢	qsfi
鎛	qsfy
镈	qsfy
钵	qsgg
鉢	qsgg
钉	qsh
釘	qsh
匍	qsi
錬	qsjg
镡	qsjh
鐔	qsjh
钶	qskg
鈳	qskg
鋉	qskg
鎶	qskk
鏉	qskw
鍊	qslg
錰	qsoy
鑻	qsrr
枭	qsu
梟	qsu
錸	qsww
铺	qsy
鈢	qsy
鋪	qsy
鉥	qsyy
獲	qtac
狨	qtad
獏	qtad
獴	qtae
猎	qtaj
猫	qtal
狘	qtan
獦	qtan
玂	qtar
犽	qtat
獚	qtaw
獾	qtay
卯	qtbh
狲	qtbi
猻	qtbi
猛	qtbl
犯	qtbn
乮	qtbn
犼	qtbn
鉇	qtbn
锈	qtbt
銹	qtbt
狓	qtby
犸	qtcg
獝	qtck
獁	qtco
狁	qtcq
猱	qtcs
狻	qtct
猰	qtdd
猢	qtde
狉	qtdg
狜	qtdg
銛	qtdg
铦	qtdg
锋	qtdh
鋒	qtdh
獠	qtdi
獂	qtdi
鑙	qtdj
猗	qtdk
鐈	qtdk
懖	qtdn
鏠	qtdp
獉	qtdt
獶	qtdt
獿	qtdt
獗	qtdw
狹	qtdw
猉	qtdw
犹	qtdy
犾	qtdy
狵	qtdy
鉃	qtdy
猺	qteb
猨	qtec
獀	qtec
狙	qteg
猙	qteh
獡	qteo
猊	qteq
匋	qtfb
铥	qtfc
銩	qtfc
猿	qtfe
锸	qtfe
鍤	qtfe
鈓	qtfg
钎	qtfh
犴	qtfh
釺	qtfh
狋	qtfi
猪	qtfj
獳	qtfj
锆	qtfk
狤	qtfk
鋯	qtfk
獖	qtfm
鑽	qtfm
铤	qtfp
遙	qtfp
鋌	qtfp
铣	qtfq
獟	qtfq
銑	qtfq
橥	qtfs
犲	qtft
狫	qtfx
铢	qtfy
銖	qtfy
狭	qtgd
猜	qtge
锤	qtgf
锺	qtgf
錘	qtgf
鍾	qtgf
狂	qtgg
夝	qtgg
狟	qtgg
鉎	qtgg
犻	qtgh
鈝	qtgh
钅	qtgn
鑂	qtgo
鵟	qtgo
逛	qtgp
獮	qtgr
獓	qtgt
铁	qtgy
鉄	qtgy
锻	qthc
玃	qthc
鍛	qthc
猅	qthd
鈼	qthf
獩	qthh
獹	qthl
鎴	qthn
鋋	qthp
镍	qths
鎳	qths
猇	qthw
猟	qtig
猀	qtit
獙	qtit
獌	qtjc
狸	qtjf
猂	qtjf
猩	qtjg
狚	qtjg
狮	qtjh
鋓	qtjh
猖	qtjj
猲	qtjn
猓	qtjs
鏫	qtjs
鍑	qtjt
猑	qtjx
独	qtjy
狷	qtke
铬	qtkg
鉻	qtkg
狆	qtkh
玁	qtkt
猥	qtle
猬	qtle
獧	qtle
狎	qtlh
獨	qtlj
鏓	qtln
猡	qtlq
獑	qtlr
鎞	qtlx
玀	qtly
鐭	qtmd
猾	qtme
鉓	qtmh
狦	qtmj
猯	qtmj
匔	qtmk
狪	qtmk
猧	qtmk
銄	qtmk
銵	qtmt
鎫	qtmt
猠	qtmw
匑	qtmx
狈	qtmy
狽	qtmy
獕	qtmy
儿	qtn
勹	qtn
猳	qtnc
钨	qtng
狃	qtng
猸	qtnh
铄	qtni
峱	qtnm
釳	qtnn
鎚	qtnp
狔	qtnx
夕	qtny
獛	qtog
獜	qtog
鐇	qtol
悐	qton
鏭	qton
逖	qtop
犷	qtot
獷	qtow
狄	qtoy
锹	qtoy
鍬	qtoy
狩	qtpf
猔	qtpi
獱	qtpm
狞	qtps
獰	qtps
猽	qtpu
狖	qtpw
獬	qtqg
狰	qtqh
狝	qtqi
狣	qtqi
鑗	qtqi
狥	qtqj
狗	qtqk
狍	qtqn
犳	qtqy
猈	qtrf
獆	qtrf
獔	qtrf
狛	qtrg
狶	qtrh
狾	qtrr
猣	qtrt
獥	qtrt
狐	qtry
锇	qtry
鋨	qtry
猼	qtsf
猹	qtsg
獭	qtsm
獺	qtsm
鏼	qtsm
猍	qtsw
狇	qtsy
狏	qttb
狧	qttd
狅	qttf
獋	qttf
狌	qttg
獅	qtth
猁	qttj
猘	qttj
狢	qttk
獢	qttk
犵	qttn
獯	qtto
狿	qttp
犭	qttt
獇	qtuc
獞	qtuf
猶	qtug
獐	qtuj
獈	qtul
猐	qtun
獍	qtuq
狡	qtur
鉖	qtuy
卿	qtvb
錗	qtvg
犰	qtvn
獵	qtvn
狠	qtvy
犱	qtvy
狯	qtwc
狑	qtwc
猴	qtwd
猤	qtwd
猃	qtwg
鏦	qtwh
猦	qtwj
獪	qtwj
猞	qtwk
獊	qtwk
鋵	qtwn
狳	qtws
獫	qtww
猚	qtwy
狕	qtxe
猭	qtxe
狴	qtxf
猕	qtxi
狒	qtxj
獼	qtxr
鋂	qtxy
鉌	qty
猵	qtya
狱	qtyd
獄	qtyd
猏	qtye
獽	qtye
猝	qtyf
狺	qtyg
釒	qtyg
犿	qtyh
猄	qtyi
鸑	qtyo
獤	qtyt
狼	qtyv
犺	qtyw
釞	qtyy
鎈	quag
鉼	quah
鎙	qube
匀	qud
鎹	qudp
鑨	qued
鐗	queg
鎆	quej
鐩	quep
钭	qufh
斘	qufh
鈄	qufh
鉝	qug
鍆	qug
锎	quga
鐦	quga
锩	qugb
錈	qugb
镁	qugd
鎂	qugd
鉡	qugh
锌	quh
鋅	quh
鐘	qujf
锏	qujg
鐧	qujg
鏱	qujh
镱	qujn
鐿	qujn
镜	qujq
鏡	qujq
锫	qukg
錇	qukg
锐	qukq
鋭	qukq
鏳	qulj
钔	qun
錓	qunn
镨	quoj
鐠	quoj
锵	quqf
鏘	quqf
铰	qury
鉸	qury
鐏	qusf
镧	qusl
鑭	qusl
鏟	qutg
铲	qutt
鐥	quuk
䦅	quuk
鎌	quvw
镒	quwl
鎰	quwl
鉳	quxn
锑	quxt
銻	quxt
鎡	quxx
镃	quxx
鐞	qvaf
邹	qvbh
皱	qvby
刍	qvf
鏽	qvfj
钕	qvg
釹	qvg
銉	qvgh
鍿	qvgl
键	qvgp
鍵	qvgp
争	qvhj
録	qviy
鏁	qvjs
铷	qvkg
鉊	qvkg
銣	qvkg
锱	qvlg
錙	qvlg
鑞	qvln
镴	qvln
鎻	qvmy
釚	qvn
急	qvnu
锓	qvpc
鋟	qvpc
釖	qvt
煞	qvto
勼	qvv
匓	qvwc
雏	qvwy
银	qvy
銀	qvy
釰	qvyy
釻	qvyy
釼	qvyy
凫	qwb
鳬	qwb
鎓	qwcn
鈆	qwcy
鈠	qwcy
鉁	qwet
鉜	qwfy
錀	qwga
鑰	qwga
鍨	qwgd
铨	qwgg
銓	qwgg
鍮	qwgj
铪	qwgk
匌	qwgk
鉿	qwgk
镎	qwgr
鎿	qwgr
镫	qwgu
鐙	qwgu
鐱	qwgw
鎀	qwhe
鏅	qwhe
勽	qwi
鉩	qwiy
铅	qwkg
鉛	qwkg
銳	qwkq
釠	qwn
鍭	qwnd
匃	qwnv
銝	qwsy
銋	qwtf
欠	qwu
鈖	qwvt
锉	qwwf
銼	qwwf
鑯	qwwg
鋊	qwwk
鏺	qwxc
铧	qwxf
鈋	qwxn
釟	qwy
镌	qwyb
鎸	qwyb
铃	qwyc
鈴	qwyc
鎨	qwyf
锥	qwyg
錐	qwyg
鋡	qwyk
鎗	qwyk
钤	qwyn
鈐	qwyn
錜	qwyn
鐫	qwyn
鐎	qwyo
鏶	qwys
飧	qwyv
钒	qwyy
釩	qwyy
鐑	qxfk
鈏	qxhh
鈟	qxhh
鎭	qxhw
銯	qxiy
錄	qxiy
鉘	qxjh
镄	qxjm
鐨	qxjm
镪	qxkj
鏹	qxkj
鏆	qxmy
匂	qxv
鈚	qxxn
锴	qxxr
鍇	qxxr
鐖	qxxw
鉧	qxy
錞	qybg
镦	qybt
鐓	qybt
錥	qyce
锍	qyck
鋶	qyck
铳	qycq
銃	qycq
訇	qyd
袅	qyeu
裊	qyeu
铱	qyey
锿	qyey
銥	qyey
鎄	qyey
鉒	qygg
久	qyi
勺	qyi
夊	qyi
鍄	qyiy
鑇	qyjg
镶	qyke
鑲	qyke
铈	qymh
鈰	qymh
镐	qymk
鎬	qymk
鍽	qyna
錑	qynd
釯	qynn
䥇	qynn
䦂	qynn
鈩	qynt
匄	qynv
灸	qyou
粂	qyou
钫	qyt
鈁	qyt
孵	qytb
鍦	qytb
毈	qytc
镞	qytd
鏃	qytd
镟	qyth
銂	qyth
鏇	qyth
贕	qytm
邎	qytp
卵	qyty
镝	qyud
鏑	qyud
鍗	qyuh
镑	qyuy
鎊	qyuy
鄮	qyvb
鎯	qyvb
鹠	qyvg
劉	qyvj
留	qyvl
贸	qyvm
貿	qyvm
鶹	qyvo
遛	qyvp
斵	qyvr
锒	qyvy
鋃	qyvy
錊	qywf
钪	qywn
鈧	qywn
鏲	qyxg
铉	qyxy
鉉	qyxy
鈫	qyy
擛	raas
拭	raay
皂	rab
搑	rabg
掿	radk
撒	raet
擆	rafj
扛	rag
撶	ragg
皣	ragg
捓	rahb
摼	rahf
挋	rahh
攬	rahq
擓	raiy
摸	rajd
措	rajg
擖	rajn
揠	rajv
掝	rakg
摳	rakk
擹	rakw
攤	raky
描	ralg
搆	ramf
撗	ramw
摃	ramy
拒	rang
抴	rann
揲	rans
拣	ranw
捞	rape
摕	raqh
撍	raqj
擏	raqt
抠	rary
挠	ratq
擭	rawc
攃	rawi
搭	rawk
搽	raws
拱	rawy
找	ray
攝	rbbb
揶	rbbh
摄	rbcc
报	rbcy
掫	rbcy
撱	rbde
氖	rbe
挕	rbg
邱	rbh
邤	rbh
拯	rbig
摂	rbiy
凶	rbk
掹	rblg
拙	rbmh
扡	rbn
兇	rbqb
挅	rbsy
扔	rbt
搎	rbti
披	rby
扱	rbyy
氢	rcad
拚	rcah
掇	rccc
摻	rcce
撡	rccn
搡	rccs
㧐	rccy
掺	rcde
撪	rcdl
捅	rceh
择	rcgh
反	rci
掻	rcjy
抬	rckg
把	rcn
皅	rcn
抒	rcnh
揉	rcns
返	rcpi
抁	rcqn
挨	rctd
捘	rcwt
摊	rcwy
払	rcy
瓞	rcyg
瓜	rcyi
搔	rcyj
瓥	rcyj
瓟	rcyn
扠	rcyy
瓝	rcyy
扼	rdbn
敎	rdbt
郄	rdcb
拔	rdcy
抜	rdcy
郩	rdeb
殽	rdec
肴	rdef
擾	rdet
掁	rdey
捹	rdfa
振	rdfe
捱	rdff
搙	rdff
拜	rdfh
拝	rdfh
捺	rdfi
皋	rdfj
撦	rdfj
挎	rdfn
翱	rdfn
鷎	rdfo
摦	rdfy
拓	rdg
撼	rdgn
搣	rdgo
揻	rdgv
拵	rdhb
揳	rdhd
抷	rdhg
摵	rdhi
抔	rdhy
揼	rdiy
擫	rdjd
掩	rdjn
郗	rdmb
希	rdmh
抪	rdmh
鵗	rdmo
欷	rdmw
颀	rdmy
瓻	rdmy
頎	rdmy
拋	rdne
扰	rdny
拻	rdoy
挞	rdpy
氪	rdqv
摤	rdrr
掎	rdsk
挷	rdtb
攊	rdth
撩	rdui
撅	rduw
揍	rdwd
摏	rdwe
捧	rdwg
揕	rdwn
撕	rdwr
搸	rdwt
挾	rdww
掑	rdwy
拢	rdxy
扙	rdyy
揑	reag
捊	rebg
撬	reee
拹	reee
搚	reee
掤	reeg
搯	reeg
揺	refb
捋	refy
抈	reg
援	regc
抯	regg
攑	regg
拥	reh
搜	rehc
覛	rehq
拁	rekg
皭	relf
授	repc
皧	rept
掜	reqn
攪	rerq
採	resy
劤	ret
劧	ret
劰	ret
扐	ret
摇	retb
撝	reto
挼	revg
掙	revh
擮	rfay
搕	rfcl
技	rfcy
抎	rfcy
抾	rfcy
擩	rfdj
挂	rffg
掛	rffh
摴	rffn
撓	rffq
皢	rffq
持	rffy
扗	rfg
拑	rfg
扞	rfh
盾	rfhd
攧	rfhm
鶞	rfho
遁	rfhp
搷	rfhw
瞂	rfhy
皁	rfj
撠	rfja
擀	rfjf
擡	rfkf
拮	rfkg
撷	rfkm
擷	rfkm
擂	rflg
擜	rfmd
揇	rfmf
乕	rfmh
质	rfmi
貭	rfmi
逓	rfmp
擣	rfnf
扝	rfnn
抟	rfny
捇	rfoy
挬	rfpb
撎	rfpu
挝	rfpy
抚	rfqn
抏	rfqn
搘	rftj
拷	rftn
撻	rfup
掕	rfwt
攉	rfwy
皬	rfwy
抺	rfy
挵	rgah
扽	rgbn
卮	rgbv
挃	rgcf
捯	rgcj
巵	rgcv
掭	rgdn
氰	rged
掅	rgeg
皘	rgeg
皇	rgf
掗	rgfg
氬	rgfg
扜	rgfh
抂	rgg
撵	rggl
攆	rggl
攅	rggm
扌	rghg
摫	rghq
皝	rgiq
捄	rgiy
摶	rgjf
皩	rgjq
挭	rgjr
郈	rgkb
后	rgkd
攮	rgke
劶	rgke
垕	rgkf
捂	rgkg
搹	rgkh
揊	rgkl
逅	rgkp
抦	rgmw
氞	rgmw
攦	rgmx
掚	rgmy
皟	rgmy
氩	rgod
挜	rgog
搢	rgoj
遑	rgpd
挒	rgqj
扤	rgqn
抹	rgsy
皌	rgsy
挟	rgud
抨	rguf
挳	rgva
氫	rgva
捷	rgvh
捿	rgvv
擟	rgwr
挗	rgxw
扶	rgy
排	rhdd
掯	rheg
摣	rheg
掳	rhet
看	rhf
扯	rhg
據	rhge
挊	rhgh
攫	rhhc
捗	rhht
拤	rhhy
掓	rhic
掉	rhjh
拈	rhkg
擄	rhle
攎	rhll
攄	rhln
揁	rhmy
摅	rhny
挸	rhqn
摢	rhtf
䴘	rhwg
鷉	rhwo
遞	rhwp
虒	rhwv
歋	rhww
皉	rhxn
扑	rhy
爬	rhyc
坕	rhyf
爪	rhyi
爮	rhyn
㧟	rian
捎	rieg
皐	rifj
翶	rifn
挄	rigq
挱	riit
摚	ripf
擋	ripl
攩	ripo
搅	ripq
撹	ripq
撑	ripr
撐	ript
灥	riri
楽	risu
挘	rite
毮	rite
抄	ritt
撇	rity
泉	riu
挡	rivg
撮	rjbc
氜	rjd
擝	rjel
捏	rjfg
捚	rjfg
捍	rjfh
皔	rjfh
抇	rjg
担	rjgg
提	rjgh
揚	rjgr
氱	rjgr
刈	rjh
刏	rjh
捜	rjhc
抻	rjhh
氠	rjhk
氘	rjk
摱	rjlc
氲	rjld
揾	rjlg
搨	rjng
拽	rjnt
捑	rjny
揭	rjqn
掦	rjqr
掲	rjqx
捰	rjsy
揽	rjtq
掍	rjxx
撔	rjyi
揖	rkbg
擑	rkby
挹	rkcn
捐	rkeg
捌	rkej
拐	rket
扣	rkg
挰	rkgg
撌	rkhm
捉	rkhy
氚	rkk
撣	rkkf
捛	rkkg
操	rkks
损	rkmy
損	rkmy
拀	rkqn
抧	rkwy
摑	rlag
擺	rlcx
氤	rldi
摁	rldn
畠	rlf
摆	rlfc
擇	rlff
搟	rlfh
擐	rlge
揋	rlge
掴	rlgy
押	rlh
捙	rlh
攌	rlle
攂	rlll
揌	rlny
摙	rlpy
擉	rlqj
斶	rlqj
摲	rlrh
捆	rlsy
撂	rltk
摟	rlvg
擻	rlvt
搵	rlwl
氳	rlwl
摞	rlxi
攞	rlxy
擃	rmae
捵	rmaw
揣	rmdj
抰	rmdy
搰	rmeg
抩	rmfg
皗	rmfk
抽	rmg
挏	rmgk
皚	rmgu
緜	rmhi
帛	rmhj
岳	rmj
氙	rmk
撄	rmmv
攖	rmmv
皑	rmnn
撾	rmnp
㧏	rmry
掆	rmum
氝	rmwi
攜	rmwk
摧	rmwy
抐	rmwy
皠	rmwy
搌	rnae
抿	rnan
掘	rnbm
撖	rnbt
据	rndg
捤	rnen
扟	rnfh
挧	rng
挪	rngb
握	rngf
揯	rngg
搄	rngg
揟	rnhe
扭	rnhg
忥	rni
摨	rnig
擗	rnku
扎	rnn
癿	rnn
挶	rnnk
撰	rnnw
摺	rnrg
所	rnrh
乺	rnrn
扬	rnrt
拨	rnty
摒	rnua
搱	rnuh
摎	rnwe
抉	rnwy
擢	rnwy
紥	rnxi
屔	rnxn
抳	rnxn
抋	rny
拟	rnyw
択	rnyy
摭	roao
擴	roaw
拡	rocy
掂	rohk
氣	roi
撈	rooe
氮	rooi
攚	rook
掞	rooy
撛	roqg
掋	roqy
攠	rosd
擵	rosr
扩	rot
擈	rouf
撲	roug
搂	rovg
搪	rovk
擞	rovt
掶	rovw
捬	rowf
攗	roxo
皫	roxo
攈	roxt
攟	roxt
摝	roxx
攐	rpae
攓	rpah
迫	rpd
廹	rpd
搳	rpdk
攇	rpdn
皖	rpfq
捖	rpfq
揎	rpgg
掟	rpgh
擯	rpgm
近	rpk
挥	rplh
揮	rplh
捾	rpng
擰	rpns
捥	rpqb
抌	rpqn
摈	rprw
拧	rpsh
挓	rpta
揢	rptk
氨	rpvd
按	rpvg
控	rpwa
揬	rpwd
搾	rpwf
撺	rpwh
擦	rpwi
摍	rpwj
搈	rpwk
挖	rpwn
抭	rpwn
攛	rpwn
摉	rpwq
探	rpws
搉	rpwy
搲	rpwy
攨	rpwy
拕	rpxn
捪	rqaj
扺	rqan
抵	rqay
皃	rqb
抑	rqbh
搊	rqbt
魑	rqcc
鬾	rqcc
魈	rqce
鬽	rqce
魁	rqcf
魅	rqcf
魊	rqcg
魓	rqcg
鬼	rqci
魒	rqci
魀	rqcj
魍	rqcn
魆	rqcn
魖	rqco
鬿	rqcr
魉	rqcw
魌	rqcw
魐	rqcw
魕	rqcw
魃	rqcy
抅	rqcy
魋	rqcy
魎	rqcy
撚	rqdo
擔	rqdy
掐	rqeg
捔	rqeh
捦	rqg
撸	rqgj
搩	rqgs
挑	rqiy
拘	rqkg
挽	rqkq
搀	rqku
攙	rqky
换	rqmd
換	rqmd
捣	rqmh
搗	rqmh
抱	rqnn
兜	rqnq
擼	rqoj
掬	rqoy
摀	rqoy
揿	rqqw
撳	rqqw
拸	rqqy
揔	rqrn
掏	rqtb
搖	rqtb
抣	rqug
挣	rqvh
欣	rqwy
扻	rqwy
揈	rqyg
的	rqyy
扚	rqyy
鋬	rrcq
扳	rrcy
皈	rrcy
皞	rrdf
硩	rrdf
爼	rreg
挀	rrey
埑	rrff
揗	rrfh
拍	rrg
拞	rrg
揘	rrgg
折	rrh
抙	rrh
斦	rrh
搋	rrhw
擨	rrhw
抓	rrhy
気	rri
皡	rrif
晢	rrjf
蜇	rrju
哲	rrkf
啠	rrkf
踅	rrkh
捳	rrmh
劕	rrmj
質	rrmu
乴	rrnb
悊	rrnu
烲	rrou
焎	rrou
逝	rrpk
魄	rrqc
銴	rrqf
掀	rrqw
皛	rrrf
皨	rrrf
掱	rrrj
白	rrrr
摋	rrsc
梊	rrsu
捭	rrtf
爻	rru
娎	rrvf
捠	rrwy
擽	rrxs
皪	rrxs
裚	rrye
誓	rryf
撽	rryt
皦	rryt
拆	rryy
弑	rsay
氥	rsd
摽	rsfi
搏	rsfy
拪	rsg
打	rsh
氭	rsjd
揸	rsjg
刹	rsjh
撢	rsjh
抲	rskg
捒	rskg
揦	rskj
攋	rskm
摗	rskw
揀	rslg
拺	rsmn
搮	rssy
杀	rsu
閷	rsuw
殺	rswc
捕	rsy
剎	rsyj
弒	rsyy
抍	rtah
托	rtan
扥	rtan
拖	rtbn
逰	rtbp
括	rtdg
捀	rtdh
挢	rtdj
撟	rtdk
摓	rtdp
擌	rtdw
扷	rtdy
氕	rte
郫	rtfb
插	rtfe
鹎	rtfg
扦	rtfh
卑	rtfj
皓	rtfk
捁	rtfk
攒	rtfm
攢	rtfm
鵯	rtfo
挺	rtfp
捶	rtgf
揰	rtgf
手	rtgh
挿	rtgh
揷	rtgh
气	rtgn
撫	rtgo
抶	rtgy
搝	rthd
拃	rthf
皥	rthf
丘	rthg
攥	rthi
擤	rthj
揝	rthj
扸	rthn
挻	rthp
摥	rtjr
挌	rtkg
摠	rtln
擙	rtmd
扢	rtnn
搥	rtnp
播	rtol
皤	rtol
揪	rtoy
抸	rtpy
乒	rtr
皒	rtry
斤	rtth
搬	rtuc
氡	rtui
擶	rtuj
擳	rtvb
捼	rtvg
摐	rtwh
撘	rtwk
拠	rtwn
挴	rtxy
乂	rty
敀	rty
扖	rtyy
搓	ruag
拼	ruah
皏	ruah
搠	rube
掷	rudb
拦	rudg
攏	rued
撊	rueg
揃	ruej
抖	rufh
拉	rug
捫	rug
捲	rugb
撋	rugg
拌	rugh
搼	rugr
攁	rugv
撯	ruhg
撞	rujf
掸	rujf
揞	rujg
摬	rujq
氧	ruk
掊	rukg
搃	rukn
捝	rukq
扪	run
掽	ruog
摪	ruqf
皎	rury
挍	rury
擲	rusb
撙	rusf
揂	rusg
攔	rusl
摌	rutg
搁	rutk
擱	rutk
接	ruvg
搛	ruvw
搤	ruwl
揹	ruxe
兠	ruxq
挮	ruxt
撏	rvaf
摡	rvaq
揤	rvbh
抛	rvet
挦	rvfy
扫	rvg
揵	rvgp
氯	rvii
捸	rviy
摷	rvjs
招	rvkg
擸	rvln
扏	rvn
殷	rvnc
慇	rvnn
掃	rvph
拶	rvqy
捃	rvtk
拫	rvy
势	rvye
垫	rvyf
鸷	rvyg
絷	rvyi
蛰	rvyj
贽	rvym
热	rvyo
挚	rvyr
执	rvyy
扨	rvyy
抢	rwbn
捴	rwcn
投	rwcy
抮	rwet
摖	rwfi
捨	rwfk
拊	rwfy
掄	rwga
揜	rwga
掵	rwgb
揆	rwgd
拴	rwgg
捡	rwgg
揄	rwgj
拾	rwgk
搿	rwgr
捈	rwgs
撜	rwgu
撿	rwgw
扴	rwjh
挩	rwkq
挆	rwsy
拰	rwtf
兵	rwu
摿	rwuj
扵	rwuy
氛	rwve
掰	rwvr
扮	rwvt
挫	rwwf
攕	rwwg
撥	rwxc
抡	rwxn
扒	rwy
携	rwyb
擒	rwyc
拎	rwyc
皊	rwyc
㩳	rwyc
搇	rwye
推	rwyg
搶	rwyk
捻	rwyn
扲	rwyn
擕	rwyn
撨	rwyo
墍	rxaf
曁	rxag
旣	rxaq
槩	rxas
皀	rxb
卽	rxbh
皍	rxbj
攭	rxej
拗	rxet
掾	rxey
指	rxjg
拂	rxjh
氟	rxjk
摾	rxkj
掼	rxmy
摜	rxmy
抝	rxnn
撧	rxqc
擬	rxth
搦	rxuu
批	rxxn
揩	rxxr
樂	rxxs
拇	rxy
撴	rybt
撤	ryct
挔	ryey
攍	ryey
拄	rygg
抃	ryhy
斥	ryi
掠	ryiy
擠	ryjg
挤	ryjh
攘	ryke
擅	rylg
搞	rymk
皜	rymk
揙	ryna
捩	rynd
掮	ryne
搧	rynn
护	rynt
氦	rynw
揨	ryps
摛	ryrc
攡	ryry
揓	rytb
鸄	ryto
邀	rytp
敫	ryty
譥	ryty
乓	ryu
摘	ryud
揥	ryuh
擿	ryup
搒	ryuy
捽	rywf
抗	rywn
掖	rywy
摔	ryxf
撁	ryxg
搐	ryxl
擁	ryxy
抆	ryy
械	saah
欌	saah
櫙	saak
栻	saay
棧	saay
榵	sabg
栉	sabh
桏	sabh
楛	sadg
楉	sadk
橵	saet
杢	saf
覇	safe
覉	safk
覊	safo
樲	safy
杠	sag
框	sagg
樺	sagg
橫	sagw
榧	sahd
樫	sahf
栕	sahh
檻	sahl
欖	sahq
枒	saht
欂	saif
栋	saiy
模	sajd
橗	saje
棤	sajg
椻	sajv
槿	sakg
棫	sakg
樞	sakk
櫃	sakm
欟	sakq
權	saky
櫣	salp
櫗	salw
楧	samd
構	samf
横	samw
槓	samy
樠	samy
柜	sang
枻	sann
楪	sans
檬	sape
槆	saqj
橬	saqj
檧	saqn
柩	saqy
枢	sary
樥	sath
桡	satq
欗	saul
櫹	savj
檴	sawc
欍	sawe
﨓	sawf
櫒	sawi
榙	sawk
檋	sawl
櫵	sawo
椛	sawx
栱	sawy
杙	sayy
欇	sbbb
椰	sbbh
楹	sbcl
棷	sbcy
椭	sbde
橢	sbde
櫇	sbdm
李	sbf
杍	sbg
栮	sbg
邒	sbh
郙	sbh
極	sbkg
檉	sbkg
柮	sbmh
杝	sbn
樄	sbsj
桗	sbsy
槂	sbti
柀	sby
极	sbyy
棳	sccc
槮	scce
槡	sccs
椮	scde
桳	scdf
桶	sceh
樋	scep
柽	scfg
树	scfy
杩	scgg
枱	sckg
杷	scn
櫲	scne
壄	scnf
杼	scnh
橘	scnk
懋	scnn
楙	scns
楺	scns
柕	scnt
榪	scoy
桙	sctg
梭	scwt
权	scy
杈	scyy
楕	sdae
檶	sdak
櫔	sday
枙	sdbn
柭	sdcy
栯	sdeg
楜	sdeg
枥	sdet
櫌	sdet
棖	sdey
桭	sdfe
楏	sdff
槈	sdff
櫉	sdff
桍	sdfn
槬	sdfy
枯	sdg
柘	sdg
橱	sdgf
椷	sdgk
楲	sdgv
栫	sdhb
楔	sdhd
柸	sdhg
槭	sdhi
桮	sdhk
櫘	sdhn
榎	sdht
槥	sdhv
杯	sdhy
栢	sdjg
槗	sdkk
柨	sdmh
栭	sdmj
顶	sdmy
頂	sdmy
遷	sdnp
榞	sdri
樉	sdrr
椅	sdsk
梆	sdtb
梼	sdtf
櫪	sdth
橭	sduh
橑	sdui
橛	sduw
楱	sdwd
樁	sdwe
樭	sdwf
棒	sdwg
櫀	sdwi
椿	sdwj
椹	sdwn
榛	sdwt
梜	sdww
棋	sdwy
栊	sdxy
杕	sdy
枤	sdy
杖	sdyy
檓	seac
檼	sean
棴	sebc
桴	sebg
橇	seee
栛	seee
棚	seeg
槄	seeg
桕	seg
枂	seg
楥	segc
査	segf
柤	segg
櫸	segg
欅	segr
枷	sekg
枆	sen
橓	sepg
棿	seqn
棌	sesy
杉	set
朸	set
榣	setb
櫾	seti
橳	seue
桵	sevg
楰	sewy
榽	sexd
欛	sfae
枿	sfah
橨	sfam
桟	sfay
鄄	sfbh
榼	sfcl
枝	sfcy
枟	sfcy
檽	sfdj
垔	sff
橒	sffc
桂	sffg
樗	sffn
橈	sffq
杜	sfg
柑	sfg
甄	sfgy
杆	sfh
植	sfhg
樾	sfhn
槙	sfhw
勡	sfie
彯	sfie
隸	sfii
剽	sfij
飄	sfij
顠	sfim
翲	sfin
飘	sfir
票	sfiu
柰	sfiu
歀	sfiw
标	sfiy
瓢	sfiy
柡	sfiy
橶	sfja
榸	sfjf
檊	sfjf
枾	sfjg
榬	sfke
樹	sfkf
檯	sfkf
桔	sfkg
橲	sfkk
櫺	sfkk
欞	sfkw
檑	sflg
櫝	sflm
楠	sfmf
椟	sfnd
檮	sfnf
杇	sfnn
梽	sfny
桲	sfpb
杬	sfqn
歅	sfqw
楳	sfsy
楮	sftj
榰	sftj
栲	sftn
材	sftt
栳	sftx
尃	sfu
樯	sfuk
橽	sfup
樰	sfvg
檣	sfwk
棱	sfwt
槸	sfwy
村	sfy
醆	sgaa
醛	sgag
枅	sgah
梇	sgah
醋	sgaj
醧	sgak
醼	sgao
栈	sgay
酏	sgbn
杶	sgbn
醊	sgcc
醦	sgce
桎	sgcf
椡	sgcj
酸	sgct
本	sgd
酉	sgd
醐	sgde
酭	sgde
酤	sgdg
醎	sgdk
醢	sgdl
醃	sgdn
酞	sgdy
酻	sgeb
醙	sgec
酹	sgef
釂	sgef
棈	sgeg
酕	sgen
椓	sgey
酵	sgfb
酝	sgfc
醻	sgff
酣	sgfg
椏	sgfg
酐	sgfh
杅	sgfh
醏	sgfj
醹	sgfj
醽	sgfk
醘	sgfl
酛	sgfq
酎	sgfy
枉	sgg
酑	sggf
醩	sggj
櫕	sggm
酽	sggt
釃	sggx
酾	sggy
酜	sggy
丁	sgh
醵	sghe
西	sghg
柾	sghg
覀	sghg
酟	sghk
槻	sghq
甫	sghy
朩	sghy
梂	sgiy
槫	sgjf
醒	sgjg
桓	sgjg
醍	sgjh
橊	sgjl
醖	sgjl
桺	sgjn
橞	sgjn
梗	sgjr
醌	sgjx
欜	sgke
梧	sgkg
酲	sgkg
槅	sgkh
櫮	sgkk
楅	sgkl
釅	sgkt
梪	sgku
醳	sglf
橿	sglg
醞	sgll
醲	sgme
杮	sgmh
槽	sgmj
酮	sgmk
醠	sgml
醴	sgmu
柄	sgmw
欐	sgmx
樍	sgmy
醪	sgne
醑	sgne
翉	sgng
配	sgnn
朽	sgnn
酦	sgny
釄	sgod
桠	sgog
醭	sgog
醿	sgoi
榗	sgoj
醣	sgok
醈	sgoo
醾	sgoo
醚	sgop
逎	sgpd
酧	sgpf
醡	sgpf
醓	sgpl
酖	sgpq
酡	sgpx
醄	sgqb
栵	sgqj
酩	sgqk
杌	sgqn
杤	sgqt
酌	sgqy
酗	sgrb
醜	sgrc
酊	sgsh
醥	sgsi
醰	sgsj
酠	sgsk
醂	sgss
枺	sgsy
酺	sgsy
酢	sgtf
酷	sgtk
酪	sgtk
醺	sgto
酰	sgtq
酶	sgtx
酥	sgty
醝	sgua
醸	sgue
枰	sguf
酙	sguf
醅	sguk
醷	sgun
梾	sgus
桱	sgva
酔	sgvf
醁	sgvi
棲	sgvv
酘	sgwc
醱	sgwc
酫	sgwg
醮	sgwo
醗	sgwq
檷	sgwr
酴	sgws
酚	sgwv
醶	sgww
醀	sgwy
酳	sgxe
枑	sgxg
榡	sgxi
酯	sgxj
桋	sgxw
枎	sgy
醇	sgyb
醨	sgyc
釀	sgye
醉	sgyf
酬	sgyh
醕	sgyj
酼	sgyk
醯	sgyl
酿	sgyv
棑	shdd
檅	shdh
樝	sheg
相	shg
杫	shg
桛	shgh
欔	shhc
欋	shhy
椒	shic
棹	shjh
槕	shjs
枮	shkg
櫨	shll
櫖	shln
樐	shlo
桢	shmy
楨	shmy
檙	shnn
栌	shnt
想	shnu
梘	shqn
椃	shwn
椇	shwy
橴	shxi
朴	shy
榩	shyy
梢	sieg
榉	sigg
桄	sigq
﨔	sigr
桫	siit
樘	sipf
檔	sipl
欓	sipo
橖	sips
橕	sipt
杪	sitt
档	sivg
桜	sivg
樑	sivs
樶	sjbc
東	sjd
杳	sjf
榯	sjff
梩	sjfg
桿	sjfh
皶	sjgb
查	sjgf
棏	sjgf
柦	sjgg
棩	sjgg
鸉	sjgo
楊	sjgr
柛	sjhh
榥	sjiq
覃	sjj
椙	sjjg
橸	sjjj
螙	sjju
槾	sjlc
榅	sjlg
榻	sjng
栧	sjnt
楬	sjqn
鶇	sjqo
鷣	sjqo
棵	sjsy
槛	sjtl
榄	sjtq
棍	sjxx
楫	skbg
檝	skby
可	skd
束	skd
頼	skdm
梋	skeg
鶒	skeo
勅	sket
柺	sket
杏	skf
桯	skgg
枵	skgn
杊	skh
樻	skhm
剌	skjh
揧	skjr
樿	skkf
梠	skkg
梙	skkh
榀	skkk
楍	skkk
槵	skkn
橾	skks
欕	skkt
速	skpd
赖	skqm
賴	skqm
柷	skqn
鵣	skqo
遬	skqp
欶	skqw
戨	sksa
哥	sksk
歌	sksw
整	skth
慗	sktn
鷘	skto
遫	sktp
敕	skty
辢	skuh
枴	skvt
枳	skwy
喸	skxb
槶	slag
柬	sld
棝	sldg
栶	sldy
盙	slf
檡	slff
柶	slg
椳	slge
檈	slge
檲	slgf
椢	slgy
柙	slh
檌	slhd
欙	slli
櫑	slll
楒	slny
梿	slpy
槤	slpy
鶫	slqo
椤	slqy
梱	slsy
棞	slty
樓	slvg
櫢	slvt
楐	slwj
榲	slwl
樏	slxi
欏	slxy
楞	slyt
檂	smae
柵	smah
欁	smas
椣	smaw
椯	smdj
柍	smdy
榾	smeg
枏	smfg
柟	smfg
椆	smfk
柚	smg
桐	smgk
梬	smgn
榿	smgu
杣	smh
刺	smjh
栅	smmg
樱	smmv
櫻	smmv
楇	smnk
桤	smnn
檛	smnp
枧	smqn
㭎	smry
棘	smsm
棗	smsm
僰	smsw
敇	smty
贾	smu
賈	smu
棡	smum
棢	smun
枣	smuu
朿	smv
欈	smwk
梣	smwn
梤	smwv
枘	smwy
槯	smwy
梖	smy
枬	smyg
榐	snae
乶	snb
朰	snb
樼	snbb
橄	snbt
椐	sndg
梶	snen
栩	sng
梛	sngb
楃	sngf
柌	sngk
椵	snhc
楈	snhe
楣	snhg
杻	snhg
橻	snhg
朻	snhh
榍	snie
樨	snig
欘	snij
蚻	snju
椲	snkg
檘	snku
札	snn
杞	snn
梮	snnk
梞	snny
槢	snrg
杨	snrt
榓	sntl
柲	sntt
榌	snuh
樛	snwe
櫂	snwy
紮	snxi
柅	snxn
杺	sny
樜	soao
櫎	soaw
櫥	soff
桩	sofg
櫦	sont
橯	sooe
檆	sook
櫿	sook
橩	soow
棪	sooy
橉	soqg
榳	sotp
杰	sou
粟	sou
欉	souc
檏	souf
樸	soug
楼	sovg
槦	sovh
槺	sovi
榶	sovk
椩	sovw
櫠	sowc
椨	sowf
樚	soxx
廼	spd
迺	spd
槣	spdk
櫶	spdn
椬	speg
棕	spfi
梡	spfq
榢	spge
榁	spgf
楦	spgg
椗	spgh
檳	spgm
逋	spi
榠	spju
楎	splh
橣	spne
棺	spng
櫁	spnj
樒	spnm
檸	spns
椀	spqb
枕	spqn
槟	sprw
柠	spsh
楁	sptk
榟	spuh
桉	spvg
椌	spwa
榨	spwf
檫	spwi
樎	spwj
榕	spwk
棎	spws
榷	spwy
柼	spwy
柁	spxn
榊	spyh
棔	sqaj
桰	sqak
柢	sqay
枊	sqbh
栁	sqbh
桞	sqbh
栬	sqcn
构	sqcy
桅	sqdb
橪	sqdo
檐	sqdy
槲	sqef
檞	sqeg
桷	sqeh
桝	sqgh
橹	sqgj
榤	sqgs
桃	sqiy
栒	sqjg
橡	sqke
枸	sqkg
梚	sqkq
欃	sqky
槝	sqmh
枹	sqnn
櫓	sqoj
櫯	sqot
椈	sqoy
樢	sqoy
鵏	sqoy
栘	sqqy
楤	sqrn
柳	sqtb
梑	sqto
枃	squg
棦	sqvh
檭	sqvy
杴	sqwy
榴	sqyl
橮	sqym
杓	sqyy
杦	sqyy
梍	sran
椶	srbt
板	srcy
柧	srcy
槔	srdf
桸	srdh
楯	srfh
柏	srg
栀	srgb
梔	srgc
楻	srgg
栃	srgq
析	srh
杽	srh
榹	srhw
枛	srhy
槹	srif
檪	sris
楾	sriy
晳	srjf
蜤	srju
棉	srmh
惁	srnu
槐	srqc
櫆	srqf
樊	srrd
礬	srrd
鬰	srre
皙	srrf
欎	srrf
欝	srrf
蠜	srrj
櫍	srrm
燓	srro
鐢	srrq
攀	srrr
棥	srrs
榝	srsc
樧	srsc
椞	srsu
椑	srtf
橷	sruq
梹	srwy
梎	srxn
槪	srxq
櫟	srxs
檄	sryt
覈	sryt
柝	sryy
樷	ssbc
郴	ssbh
辳	ssde
櫏	ssdp
彬	sset
埜	ssff
禁	ssfi
標	ssfi
檦	ssfj
榑	ssfy
栖	ssg
梄	ssgg
梺	ssgh
槱	ssgo
朾	ssh
楂	ssjg
棟	ssjg
橝	ssjh
柯	sskg
梀	sskg
楋	sskj
櫴	sskm
樕	sskw
榃	sslf
楝	sslg
栜	ssmn
槚	ssmy
檟	ssmy
楚	ssnh
焚	ssou
麓	ssox
樮	ssoy
椘	sspu
棾	sspw
鷅	ssqo
梦	ssqu
檚	sssh
木	ssss
森	sssu
栗	ssu
婪	ssvf
楆	ssvg
檒	sswj
棽	sswn
棼	sswv
棶	ssww
梵	sswy
林	ssy
枡	stah
杔	stan
枨	stay
柂	stbn
栝	stdg
桻	stdh
桥	stdj
椥	stdk
橋	stdk
槰	stdp
檱	stdw
枖	stdy
鬱	stfe
杵	stfh
杄	stfh
櫡	stfj
梏	stfk
欑	stfm
梃	stfp
株	stfy
棰	stgf
栍	stgg
栙	stgh
橅	stgo
櫄	stgo
桁	stgs
柣	stgy
権	stgy
椴	sthc
柞	sthf
橰	sthf
梴	sthp
櫋	sthy
椼	stis
楿	stjg
梸	stjh
椱	stjt
格	stkg
楀	stky
桖	stlg
樬	stln
榭	stmf
栴	stmy
桘	stng
栎	stni
杚	stnn
槌	stnp
柹	stnt
橎	stol
楸	stoy
覂	stpu
柉	stpy
橁	stqj
覆	sttt
櫤	stuj
柊	stuy
櫛	stvb
棅	stvg
樅	stwh
櫷	stxg
梅	stxy
枚	sty
柇	sty
樦	styg
杁	styy
槎	suag
栟	suah
栏	sudg
栚	sudy
櫳	sued
橌	sueg
椾	suej
檖	suep
梉	sufg
枓	sufh
柆	sug
椚	sug
棬	sugb
椦	suge
橍	sugg
柈	sugh
様	sugi
樣	sugi
榚	sugo
檨	sugw
檥	sugy
样	suh
梓	suh
栤	suiy
椫	sujf
橦	sujf
橺	sujg
樟	sujh
槞	sujn
檍	sujn
樈	sujq
棓	sukg
榈	sukk
櫚	sukk
棁	sukq
橧	sulj
椪	suog
櫩	suqe
栨	suqw
校	sury
橂	susd
樽	susf
楢	susg
欄	susl
櫬	susq
榇	susy
槉	sutd
楌	sute
櫊	sutk
檤	sutp
橏	suuk
椄	suvg
槏	suvw
榏	suwl
梯	suxt
樳	svaf
櫭	svag
概	svaq
楖	svbh
要	svf
枠	svfh
橚	svfj
桪	svfy
楗	svgp
棣	sviy
椂	sviy
樔	svjs
柖	svkg
椔	svlg
朹	svn
棂	svoy
梫	svpc
覅	svqr
桚	svqy
朷	svt
桾	svtk
榋	svvv
根	svy
梕	svyn
杒	svyy
栰	sway
枪	swbn
棇	swcn
枩	swcu
松	swcy
杸	swcy
覄	swdu
栿	swdy
桧	swfc
柎	swfy
棆	swga
椧	swgb
楡	swgb
楑	swgd
检	swgg
栓	swgg
榆	swgj
檜	swgj
枍	swgn
楩	swgr
梌	swgs
橙	swgu
検	swgw
檢	swgw
櫈	swgw
樇	swhe
樤	swhs
厀	swib
桼	swiu
柗	swkg
梲	swkq
椺	swks
机	swn
枫	swry
栣	swtf
楓	swtj
椕	swvs
枌	swvt
麯	swwa
郲	swwb
麬	swwb
麮	swwc
麶	swwc
猌	swwd
勑	swwe
桽	swwf
麵	swwf
櫼	swwg
麩	swwg
麰	swwg
來	swwi
賚	swwm
顂	swwm
愸	swwn
憖	swwn
憗	swwn
麧	swwn
麪	swwn
麫	swwn
麭	swwn
麴	swwo
鶆	swwo
逨	swwp
麥	swwq
麲	swwq
麱	swws
麨	swwt
麷	swwu
麳	swww
枞	swwy
橃	swxc
桦	swxf
梻	swxj
杹	swxn
朲	swy
朳	swy
槜	swyb
柃	swyc
檎	swyc
欆	swyc
榫	swyf
椎	swyg
梒	swyk
槍	swyk
枔	swyn
棯	swyn
檇	swyn
樵	swyo
杋	swyy
欚	sxej
柪	sxet
椽	sxey
槇	sxhw
栺	sxjg
柫	sxjh
樌	sxmy
朼	sxn
杛	sxn
檰	sxrh
榒	sxuu
橼	sxxe
櫞	sxxe
梐	sxxf
枇	sxxn
檵	sxxn
楷	sxxr
機	sxxw
栂	sxy
槨	sybb
椁	sybg
梈	sybh
橔	sybt
棛	syce
梳	syck
橀	sycl
堏	syff
槠	syfj
櫧	syfj
柱	sygg
术	syi
椋	syiy
櫅	syjg
榱	syke
欀	syke
櫰	syle
檀	sylg
檩	syli
檁	sylt
柿	symh
槁	symk
楄	syna
槴	sync
棙	synd
栐	syni
杧	synn
枦	synt
怸	synu
核	synw
椖	syny
檺	sype
述	sypi
鶐	sypo
楟	syps
橠	syqe
旉	syr
樆	syrc
枋	syt
椸	sytb
栦	syth
檹	sytk
懯	sytn
敷	syty
樀	syud
楴	syuh
樴	syuj
榜	syuy
榔	syvb
樃	syve
桹	syvy
椊	sywf
杭	sywn
棜	sywu
棭	sywy
槒	syxl
箋	taau
穁	tabg
筇	tabj
笻	tabj
箬	tadk
篋	tadw
笁	taf
簕	tafe
箧	tagd
筐	tagf
筺	tagy
篚	tahd
籃	tahl
熈	taho
笌	taht
徣	tajg
稓	tajg
升	tak
笸	takf
稢	takg
籄	takm
稶	takr
筪	talj
篝	tamf
篢	tamu
簧	tamw
穔	tamw
笹	tanb
秬	tang
衐	tans
徔	tapy
簪	taqj
乇	tav
彻	tavt
穫	tawc
籆	tawc
簭	tawk
遾	tawp
篫	tawr
築	taws
衖	taws
筮	taww
筑	tawy
长	tayi
竾	tbb
箃	tbcu
頺	tbdm
季	tbf
秄	tbg
篜	tbio
笜	tbmj
彵	tbn
透	tbpe
迤	tbpv
秀	tbr
箛	tbry
篨	tbws
彼	tby
秛	tby
笈	tbyu
彶	tbyy
径	tcag
笲	tcaj
笆	tcb
穇	tcce
篸	tcce
䅟	tcde
筩	tcej
笃	tcgf
笞	tckf
秮	tckg
篤	tcou
么	tcu
稄	tcwt
私	tcy
矱	tdac
矩	tdan
榘	tdas
叐	tdci
秡	tdcy
舌	tdd
頢	tddm
箶	tdef
衚	tdes
甜	tdfg
圱	tdfg
憇	tdfn
秙	tdg
箴	tdgk
舔	tdgn
短	tdgu
稧	tdhd
秠	tdhg
夆	tdhj
蠭	tdhj
逢	tdhp
篲	tdhv
夭	tdi
刮	tdjh
刋	tdjh
乔	tdjj
舓	tdjr
聟	tdkb
敽	tdkc
勪	tdke
呑	tdkf
知	tdkg
智	tdkj
喬	tdkk
鷮	tdko
敿	tdkt
鼅	tdkx
矲	tdlx
稬	tdmd
舑	tdmf
岙	tdmj
筬	tdnb
舏	tdnh
稽	tdnj
嵇	tdnm
嵆	tdnm
乱	tdnn
諬	tdny
舕	tdoo
适	tdpd
舐	tdqa
鸹	tdqg
鴁	tdqo
鴙	tdqo
鴰	tdqo
舚	tdqy
徛	tdsk
矨	tdtd
舙	tdtd
筹	tdtf
矫	tdtj
矯	tdtk
憩	tdtn
矪	tdtu
矮	tdtv
敌	tdty
矢	tdu
辞	tduh
簝	tdui
矰	tduj
簸	tdwb
矬	tdwf
簊	tdwf
箺	tdwj
谸	tdwk
簛	tdwr
箕	tdwu
筴	tdww
雉	tdwy
稘	tdwy
矧	tdxh
笼	tdxy
穩	tean
笔	teb
箙	tebc
筟	tebf
稃	tebg
稻	teeg
稝	teeg
筋	teer
筯	tege
笡	tegf
租	tegg
徂	tegg
穥	tegw
籅	tegw
稲	tehj
甪	tek
笳	tekf
穱	telf
稱	temf
秏	ten
笾	tepu
务	ter
竻	ter
簲	terf
徭	tetb
籐	teui
籘	teui
箏	tevh
穏	tevn
徯	texd
籖	tfag
缸	tfba
缾	tfba
缷	tfbb
罎	tfbc
罅	tfbf
罇	tfbf
缽	tfbg
邾	tfbh
罀	tfbi
罈	tfbj
缶	tfbk
缿	tfbk
罏	tfbl
罁	tfbm
罆	tfbm
缹	tfbo
罉	tfbr
缺	tfbw
缼	tfbw
罐	tfby
缻	tfby
篕	tfcl
丢	tfcu
秐	tfcy
秓	tfcy
壬	tfd
穤	tfdj
敮	tfec
臿	tfed
歃	tfew
竺	tff
玍	tff
筀	tfff
篈	tfff
徍	tffg
徺	tffq
穘	tffq
街	tffs
等	tffu
待	tffy
秲	tffy
啎	tfgk
衎	tfgs
秆	tfh
徝	tfhg
稙	tfhg
憄	tfhn
衠	tfhs
稹	tfhw
徒	tfhy
朱	tfi
午	tfj
竿	tfj
簳	tfjf
千	tfk
郜	tfkb
靠	tfkd
勂	tfke
告	tfkf
籉	tfkf
秸	tfkg
鹄	tfkg
穯	tfkk
頶	tfkm
鵠	tfko
造	tfkp
德	tfln
徳	tfln
籌	tfnf
忎	tfnu
廷	tfpd
迁	tfpk
迕	tfpk
頲	tfpm
颋	tfpm
先	tfqb
笎	tfqb
酂	tfqb
酇	tfqb
劗	tfqj
赞	tfqm
贊	tfqm
鴸	tfqo
选	tfqp
兟	tfqq
衏	tfqs
筠	tfqu
篏	tfqw
簙	tfsf
籍	tfsj
筙	tfsu
箸	tftj
穑	tfuk
乖	tfux
稑	tfwf
穡	tfwk
稜	tfwt
籗	tfwy
籱	tfwy
鼄	tfxf
郵	tgab
垂	tgaf
笄	tgaj
剰	tgaj
筭	tgaj
乗	tgas
笺	tgau
甀	tgay
秷	tgcf
犇	tgcg
箌	tgcj
生	tgd
幷	tgdf
筓	tgdf
逬	tgdp
甁	tgdy
箐	tgef
篴	tgep
劮	tget
稏	tgfg
竽	tgfj
彺	tgg
簮	tggj
卸	tghb
眚	tghf
征	tghg
徰	tghh
惩	tghn
篶	tgho
欫	tghw
失	tgi
年	tgj
夅	tgj
動	tgje
重	tgjf
篿	tgjf
濌	tgjj
穗	tgjn
憅	tgjn
勲	tgjo
筻	tgjr
稉	tgjr
牛	tgk
吿	tgkf
稫	tgkl
衙	tgks
鄦	tglb
甥	tgle
勳	tgle
舞	tglg
熏	tglo
無	tglo
鷡	tglo
橆	tgls
甒	tgly
製	tgme
制	tgmj
穂	tgmn
掣	tgmr
箦	tgmu
簀	tgmu
穲	tgmx
籭	tgmx
積	tgmy
怣	tgnu
迭	tgpi
逄	tgpk
鴩	tgqo
鵇	tgqo
鸻	tgsg
行	tgsh
鴴	tgso
秣	tgsy
甧	tgte
甡	tgtg
秤	tguf
埀	tguf
徕	tgus
徑	tgva
徢	tgvh
箑	tgvh
勧	tgwe
観	tgwq
穪	tgwr
籋	tgwr
歓	tgww
算	thaj
郋	thbh
自	thd
篹	thdb
鄓	thdb
段	thdc
篡	thdc
簒	thdc
徘	thdd
穢	thdh
纂	thdi
臭	thdu
籑	thdv
乍	thff
怎	thfn
迮	thfp
牋	thga
牑	thga
版	thgc
牍	thgd
牐	thge
牌	thgf
牔	thgf
牉	thgg
牗	thgh
牏	thgj
牊	thgk
牘	thgm
片	thgn
牎	thgn
牕	thgn
籧	thgp
覑	thgq
牒	thgs
牖	thgs
臰	thgx
牓	thgy
籰	thhc
衢	thhs
徏	thht
徙	thhy
忂	thhy
处	thi
臯	thif
翺	thin
鷱	thio
篎	thit
昝	thjf
咎	thkf
笘	thkf
秥	thkg
齆	thlc
齅	thld
齈	thle
齉	thle
鼾	thlf
齄	thlg
齇	thlg
鼼	thlh
齂	thli
鼻	thlj
劓	thlj
齁	thlk
籚	thll
齃	thln
鼿	thlq
鼽	thlv
齀	thly
郔	thnb
鄎	thnb
蜑	thnj
臫	thnn
延	thnp
息	thnu
簴	thow
邉	thpp
邊	thpp
臱	thpy
筧	thqb
臲	thsb
鷍	thso
臬	thsu
甈	thsy
竹	thth
辠	thuj
箎	thwb
臮	thwy
篊	tiaw
笵	tibb
筂	tibb
箥	tibu
箈	tick
筲	tief
稍	tieg
箾	tiej
愆	tign
衍	tigs
篞	tijf
簜	tijr
徜	timk
簹	tipl
箔	tirf
簿	tisf
箵	tith
籓	titl
箲	titq
秒	titt
徶	tity
尓	tiu
筜	tivf
簗	tivs
馢	tjaa
篳	tjag
穝	tjbc
忁	tjbi
馣	tjdn
馛	tjdy
馟	tjeb
香	tjf
馞	tjfb
稈	tjfh
筸	tjfj
馩	tjfm
得	tjgf
笪	tjgf
筛	tjgh
徥	tjgh
利	tjh
馡	tjhd
馧	tjjl
馤	tjjn
馝	tjnt
悡	tjnu
馜	tjnx
馪	tjpm
鋫	tjqf
梨	tjsu
稞	tjsy
犁	tjtg
篂	tjtg
馫	tjtj
篮	tjtl
馥	tjtt
复	tjtu
馦	tjuw
馠	tjwk
馚	tjwv
箟	tjxx
箿	tkbf
頟	tkdm
各	tkf
和	tkg
筽	tkgd
程	tkgg
徎	tkgg
种	tkhh
簬	tkhk
篑	tkhm
簣	tkhm
洜	tkiu
筥	tkkf
簞	tkkf
稆	tkkg
鄅	tkmb
筼	tkmu
篔	tkmu
禹	tkmy
惒	tknu
鵅	tkqo
兎	tkqy
敋	tkty
积	tkwy
雒	tkwy
簂	tlag
簚	tlah
篾	tlaw
穓	tlaw
衊	tlaw
範	tlbb
衈	tlbg
卹	tlbh
笝	tlcu
血	tld
甶	tld
箇	tldf
稒	tldg
衃	tldh
筃	tldu
秵	tldy
稩	tleg
备	tlf
盉	tlf
笽	tlf
睾	tlff
箅	tlgj
衆	tliu
笚	tlj
徊	tlkg
簤	tlmu
衄	tlng
惫	tlnu
粤	tlon
囱	tlqi
悤	tlqn
箩	tlqu
欰	tlqw
簐	tlqw
衇	tlre
囟	tlri
顖	tlrm
恖	tlrn
囪	tlry
稇	tlsy
簵	tltk
衉	tltk
箘	tltu
稛	tlty
衅	tlug
簍	tlvf
邍	tlvp
籔	tlvt
衂	tlvy
稷	tlwt
籮	tlxy
穠	tmae
筁	tmaf
躻	tmda
躾	tmdd
躼	tmde
軂	tmde
射	tmdf
軃	tmdf
軇	tmdf
躰	tmdg
躿	tmdi
篅	tmdj
軄	tmdj
躺	tmdk
躳	tmdk
躸	tmdk
軀	tmdk
軉	tmdm
躵	tmdn
軈	tmdn
躹	tmdo
鵢	tmdo
躭	tmdq
躯	tmdr
躲	tmds
躱	tmds
躶	tmds
身	tmdt
軆	tmdu
躮	tmdv
躴	tmdv
躷	tmdv
躽	tmdv
軁	tmdv
躬	tmdx
秧	tmdy
軅	tmdy
笛	tmf
簓	tmfe
稠	tmfk
徟	tmfk
秞	tmg
筒	tmgk
秱	tmgk
懲	tmgn
衕	tmgs
微	tmgt
徽	tmgt
徵	tmgt
徴	tmgt
鰴	tmgt
黴	tmgt
秈	tmh
币	tmhk
屲	tmj
向	tmkd
逈	tmkp
笧	tmmg
簻	tmnp
奥	tmod
嶴	tmom
笕	tmqb
秽	tmqy
奧	tmtd
粵	tmtn
幑	tmtt
筫	tmu
笍	tmwu
箆	tmwx
徾	tmyt
笢	tnab
乞	tnb
頧	tndm
戶	tne
阜	tnfj
顊	tnfm
箼	tngf
師	tngh
笥	tngk
徦	tnhc
稰	tnhe
篃	tnhf
歸	tnhh
徲	tnig
穉	tnig
乐	tnii
刉	tnjh
蛗	tnju
徫	tnkg
稦	tnkg
躗	tnkh
躛	tnkh
衛	tnks
衞	tnks
讆	tnky
讏	tnky
帥	tnmh
峊	tnmj
邬	tnnb
毎	tnnf
乌	tnng
筷	tnnw
簨	tnnw
追	tnpd
迄	tnpv
鴭	tnqo
簈	tntf
秘	tntt
箳	tnua
稺	tnuh
穋	tnwe
籊	tnwy
秜	tnxn
笖	tnyw
穬	toaw
释	tocg
甃	togy
釆	toi
湬	toiu
稥	tojf
蝵	toju
鄱	tolb
勫	tole
番	tolf
釋	tolf
飜	tolh
翻	toln
鷭	tolo
釉	tomg
簖	tonr
悉	tonu
愁	tonu
釈	tony
簩	tooe
鍫	toqf
鹙	toqg
鶖	toqo
揫	torj
醔	tosg
夈	tou
穙	toug
簾	touw
篓	tovf
媝	tovf
穅	tovi
篖	tovk
穮	toxo
簏	toxx
秋	toy
簺	tpaf
秾	tpey
徖	tpfi
筦	tpfq
簆	tpft
稼	tpge
箮	tpgg
穦	tpgm
管	tpnf
箢	tpqb
鴔	tpqo
筞	tpsu
秺	tpta
乏	tpu
箜	tpwa
穃	tpwk
篧	tpwy
簶	tpyi
籛	tqaa
秖	tqan
彽	tqay
秪	tqay
禿	tqb
篘	tqbt
頹	tqdm
衡	tqds
簷	tqdy
篯	tqga
穞	tqgj
衔	tqgs
銜	tqgs
筄	tqiu
称	tqiy
箰	tqjb
筍	tqjf
徇	tqjg
穐	tqjn
笱	tqkf
笣	tqnb
穭	tqoj
鵆	tqos
穒	tqou
移	tqqy
笏	tqrr
笷	tqtb
籦	tqtf
犂	tqtg
睝	tqth
黎	tqti
黧	tqto
鯬	tqto
鵹	tqto
邌	tqtp
錅	tqtq
棃	tqts
剓	tqtv
笉	tquf
筝	tqvh
籙	tqvi
稳	tqvn
彴	tqyy
簼	traf
箍	trah
簎	traj
稯	trbt
筢	trcb
箨	trcg
笟	trcy
稀	trdh
箝	trff
循	trfh
篁	trgf
徨	trgg
籒	trgl
篪	trhw
笊	trhy
穆	trie
箉	trke
筘	trkf
籜	trlf
鹅	trng
鵝	trno
鵞	trno
我	trny
籀	trql
篼	trqq
篺	trrf
笅	trru
稗	trtf
箄	trtf
籡	trww
徼	tryt
篐	tsah
簯	tsdw
徱	tsfi
篻	tsfi
籈	tsfy
徆	tsg
笨	tsgf
箱	tshf
簟	tsjj
笴	tskf
籁	tskm
籟	tskm
簌	tskw
簠	tslf
徚	tslg
策	tsmb
箣	tsmj
籕	tsql
篥	tssu
箖	tssu
条	tsu
徠	tsww
箂	tsww
秿	tsy
術	tsys
秫	tsyy
秅	ttan
筈	ttdf
秳	ttdg
穚	ttdk
簥	ttdk
篷	ttdp
笑	ttdu
笶	ttdu
秗	ttdy
秊	ttfj
秊	ttfj
筶	ttfk
穳	ttfm
籫	ttfm
筳	ttfp
簉	ttfp
筅	ttfq
秼	ttfy
御	ttgb
笙	ttgf
種	ttgf
箠	ttgf
箽	ttgf
徃	ttgg
禦	ttgi
筕	ttgs
衘	ttgs
衝	ttgs
秩	ttgy
攵	ttgy
笮	tthf
秨	tthf
簰	tthf
簁	tthh
筵	tthp
籩	tthp
筣	ttjj
復	ttjt
稪	ttjt
笿	ttkf
丿	ttll
篦	ttlx
篩	ttnh
秭	ttnt
笫	ttnt
夂	ttny
篍	ttou
簃	ttqq
筿	ttsu
篽	tttb
彳	ttth
籞	ttti
禾	tttt
笗	ttuu
箻	ttvg
篵	ttwh
龝	ttxg
秝	tty
艧	tuac
艨	tuae
穣	tuae
舡	tuag
艜	tuah
艦	tual
艓	tuas
舼	tuaw
郍	tubh
艋	tubl
舥	tucn
舿	tudn
舦	tudy
乊	tue
艀	tueb
艘	tuec
徿	tued
籠	tued
箭	tuej
穟	tuep
笠	tuf
科	tufh
乎	tufk
艢	tufk
乯	tufn
艝	tufv
箞	tugb
秚	tugh
艚	tugj
徉	tuh
艣	tuhe
艫	tuhl
舻	tuhn
従	tuhy
舟	tui
艄	tuie
艡	tuil
简	tujf
箪	tujf
徸	tujf
穜	tujf
簡	tujf
艃	tujf
艒	tujh
螽	tujj
篭	tujn
篰	tukb
箁	tukf
稖	tukg
舯	tukh
税	tukq
艥	tuky
盘	tulf
舺	tulh
艛	tulv
舳	tumg
舢	tumh
舰	tumq
乥	tunb
艍	tund
艉	tune
艔	tuoc
舵	tupx
鸼	tuqg
艪	tuqj
鵃	tuqo
鷑	tuqo
艬	tuqy
舨	turc
舶	turg
艎	turg
艊	turh
艐	turt
筊	turu
舾	tusg
舸	tusk
籣	tusl
舴	tutf
簅	tutg
舽	tutg
艂	tuth
艞	tuti
艁	tutk
艇	tutp
衜	tuts
舧	tuty
冬	tuu
艖	tuua
艟	tuuf
艏	tuuh
艗	tuul
艤	tuuy
舠	tuvt
稴	tuvw
舱	tuwb
般	tuwc
舩	tuwc
舲	tuwc
艭	tuwc
磐	tuwd
褩	tuwe
鞶	tuwf
幋	tuwh
縏	tuwi
螌	tuwj
船	tuwk
艙	tuwk
盤	tuwl
艌	tuwn
鎜	tuwq
搫	tuwr
槃	tuws
艅	tuws
艠	tuwu
媻	tuwv
舤	tuwy
剩	tuxj
稊	tuxt
乘	tuxv
舭	tuxx
稵	tuxx
艑	tuya
艩	tuyj
艈	tuyk
舮	tuyn
舣	tuyr
舫	tuyt
簢	tuyu
艆	tuyv
航	tuyw
舷	tuyx
艕	tuyy
穊	tvaq
節	tvbj
蠞	tvbj
笯	tvcu
秉	tvd
衟	tvds
委	tvf
簫	tvfj
律	tvgh
筆	tvgj
徤	tvgp
瓾	tvgy
覣	tvhq
箫	tvhw
箓	tviu
笤	tvkf
筎	tvkf
簋	tvlf
簘	tvoj
逶	tvpd
箒	tvph
魏	tvrc
犩	tvrg
笋	tvtr
很	tvy
笂	tvyu
秇	tvyy
筏	twau
笩	tway
秃	twb
垼	twcf
役	twcy
彸	twcy
颓	twdm
頽	twdm
穄	twfi
符	twfu
稐	twga
籥	twga
篟	twge
筌	twgf
签	twgg
劄	twgj
徻	twgj
箚	twgj
答	twgk
秴	twgk
籲	twgm
箯	twgr
徐	twgs
稌	twgs
筡	twgs
籢	twgt
簦	twgu
簽	twgw
籨	twgw
篠	twhs
筱	twht
黐	twic
黏	twik
黍	twiu
筗	twkh
穨	twkm
稅	twkq
篌	twnd
鵚	twqo
秹	twtf
筰	twtf
秂	twu
凢	twv
処	twv
籂	twvh
秎	twvt
聳	twwb
籤	twwg
從	twwh
慫	twwn
熧	twwo
彾	twyc
秢	twyc
笭	twyc
篗	twyc
稚	twyg
筨	twyk
篬	twyk
稔	twyn
笒	twyn
穛	twyo
穕	twys
衑	twys
竼	twyu
篒	twyv
龜	txd
胤	txen
勄	txet
篆	txeu
第	txht
系	txiu
彿	txjh
笰	txjj
箹	txqy
鳘	txtg
籎	txth
繁	txti
瀪	txti
緐	txti
慜	txtn
鰵	txto
敏	txty
後	txty
每	txu
篛	txuu
笓	txxb
筚	txxf
秕	txxn
稭	txxr
籪	txxr
穖	txxw
毓	txyk
稕	tybg
勶	tyce
徹	tyct
簱	tydw
籝	tyey
籯	tyey
簔	tyge
往	tygg
笇	tyhu
入	tyi
乀	tyi
汆	tyiu
稤	tyiy
穧	tyjg
穰	tyke
忀	tyke
簑	tyke
屳	tymj
稿	tymk
篙	tymk
肏	tymw
篇	tyna
徧	tyna
稨	tyna
笀	tynb
簄	tync
兦	tynv
籴	tyou
糴	tyoy
籇	type
込	typi
鳰	tyqo
篱	tyrc
籬	tyry
彷	tyt
箷	tytb
簇	tytd
籏	tytw
徬	tyuy
篣	tyuy
筤	tyvu
稂	tyvy
笐	tywb
稡	tywf
箤	tywf
秔	tywn
箊	tywu
稸	tyxl
衒	tyxs
郱	uabh
疘	uad
瘔	uadd
頩	uadm
羢	uadt
差	uaf
冮	uag
疟	uagd
瓶	uagy
齹	uahb
冴	uaht
疨	uaht
閕	uaht
冻	uaiy
并	uaj
竎	uaj
瘼	uajd
瘄	uajd
癘	uajy
阈	uakg
瘽	uakg
閾	uakg
癱	uaky
癀	uamw
牃	uans
疶	uanv
痨	uape
迸	uapk
艵	uaqc
鵧	uaqo
剙	uavw
剏	uavy
閧	uawi
瘩	uawk
闀	uawn
戕	uay
闻	ubd
聞	ubd
疓	ube
癮	uben
疲	ubi
兯	ubj
疗	ubk
疖	ubk
瘾	ubqn
痾	ubsk
朔	ubte
塑	ubtf
癃	ubtg
愬	ubtn
逆	ubtp
遡	ubtp
屰	ubtr
槊	ubts
欮	ubtw
癊	ubwc
痉	ucad
羟	ucag
閞	ucak
慿	ucan
瘮	ucce
瘆	ucde
痛	ucek
衮	uceu
闯	ucgd
冯	ucgg
冶	uckg
羓	ucn
闖	ucoi
憑	ucon
凴	ucow
馮	ucoy
兖	ucqb
竢	uctd
疤	ucv
竣	ucwt
羧	ucwt
痠	ucwt
瘫	ucwy
瘙	ucyj
郑	udbh
闳	udci
閎	udci
冹	udcy
竑	udcy
闫	udd
閆	udd
痏	uded
疬	udee
痮	udei
兰	udf
减	udgk
羬	udgk
瘈	udhd
痞	udhk
瘛	udhn
头	udi
竰	udjf
竡	udjg
阉	udjn
痷	udjn
閹	udjn
疣	udny
痝	udny
送	udpi
闼	udpi
羱	udri
癧	udth
关	udu
療	udui
凑	udwd
瘞	udwf
瘎	udwn
瘱	udwn
凘	udwr
状	udy
狀	udy
閒	ued
閰	ued
顡	uedm
痭	ueed
奨	uefd
醤	uefg
龏	uega
聾	uegb
疽	uegd
礱	uegd
龍	uegd
龑	uegd
龖	uegd
龘	uegd
襲	uege
壟	uegf
龒	uegi
蠪	uegj
驡	uego
鸗	uego
龔	uegw
讋	uegy
瘦	uehc
覵	uehq
前	uejj
翦	uejn
煎	uejo
剪	uejv
痈	uek
痂	uekd
瘸	uekw
竓	uen
癙	uenn
阌	uepc
閿	uepc
遂	uepi
鷳	ueqo
阋	ueqv
劷	uet
羏	uet
豙	ueu
辦	ueuh
閐	uev
凈	uevh
毅	uewc
瘐	uewi
弉	ufaj
羵	ufam
阖	ufcl
闔	ufcl
攱	ufcy
疳	ufd
羺	ufdj
奘	ufdu
闺	uffd
閨	uffd
痔	uffi
壮	ufg
壯	ufg
竍	ufh
癫	ufhm
癲	ufhm
阗	ufhw
瘨	ufhw
闐	ufhw
疛	ufi
斗	ufk
閈	ufk
闬	ufk
闧	ufkp
癗	ufld
凟	uflm
乧	ufnb
闱	ufnh
痣	ufni
疞	ufnv
焋	ufou
銺	ufqf
痲	ufqq
痚	uftb
闭	ufte
閉	ufte
瘏	uftj
闍	uftj
阇	uftj
闥	ufup
娤	ufvf
牆	ufwk
凌	ufwt
癨	ufwy
装	ufye
裝	ufye
開	ugak
卷	ugbb
勌	ugbe
痓	ugcf
駦	ugco
闰	ugd
闩	ugd
閂	ugd
閏	ugd
頖	ugdm
美	ugdu
靖	ugeg
凊	ugeg
劵	uger
瘃	ugey
瘂	ugfg
閸	ugfg
癋	ugfn
豢	ugge
齤	ughb
症	ughd
眷	ughf
疜	ughi
閇	ughi
闚	ughq
羨	ugiw
竱	ugjf
判	ugjh
养	ugjj
奍	ugjj
癅	ugjl
鵥	ugjo
半	ugk
痦	ugkd
闘	ugkf
竵	ugkh
痘	ugku
盖	uglf
帣	ugmh
病	ugmw
巻	ugnb
韏	ugng
恙	ugnu
羹	ugod
痖	ugod
羮	ugog
羔	ugou
羙	ugou
疠	ugqe
觠	ugqe
鲞	ugqg
冽	ugqj
鮝	ugqo
鯗	ugqo
羑	ugqy
叛	ugrc
拳	ugrj
桊	ugsu
牶	ugtg
羲	ugty
義	ugty
瘗	uguf
閛	uguf
羡	uguw
痙	ugva
羥	ugva
姜	ugvf
券	ugvr
凄	ugvv
餋	ugwv
弮	ugxb
勬	ugxe
冱	ugxg
絭	ugxi
羛	ugxj
痍	ugxw
羠	ugxw
誊	ugyf
癍	ugyg
羕	ugyi
閠	ugyi
飬	ugyv
養	ugyv
瘧	uhag
痱	uhdd
阒	uhdi
闃	uhdi
着	uhf
闅	uhhc
癯	uhhy
竨	uhjh
丫	uhk
痁	uhkd
站	uhkg
門	uhng
疵	uhxv
痟	uied
閖	uii
痧	uiit
閯	uiit
闛	uipf
闣	uipl
阔	uitd
闊	uitd
竗	uitt
瘠	uiwe
冰	uiy
頀	ujac
韺	ujad
贑	ujam
戅	ujan
鄣	ujbh
韷	ujbm
间	ujd
間	ujd
彰	ujet
音	ujf
郸	ujfb
冁	ujfe
勭	ujfe
氃	ujfe
童	ujff
单	ujfj
疸	ujgd
韴	ujgh
瘍	ujgr
痩	ujhc
覸	ujhq
闽	uji
痋	uji
閩	uji
章	ujj
阊	ujjd
閶	ujjd
韻	ujkm
瘟	ujld
竜	ujnb
闒	ujnd
阘	ujnd
鷾	ujno
意	ujnu
遧	ujpk
竟	ujqb
竭	ujqn
羯	ujqn
鶕	ujqo
鷼	ujqo
竸	ujqq
痬	ujqr
韵	ujqu
嬜	ujqv
歆	ujqw
韹	ujrg
韸	ujth
赣	ujtm
贛	ujtm
戆	ujtn
戇	ujtn
韼	ujtp
竷	ujtt
韶	ujvk
閺	ujyi
部	ukbh
问	ukd
問	ukd
勏	uket
袞	ukeu
咅	ukf
瓿	ukgy
冲	ukhh
竒	ukhj
闠	ukhm
阓	ukhm
剖	ukjh
郶	ukkc
闾	ukkd
閭	ukkd
癉	ukkf
闡	ukkf
闆	ukkk
癌	ukkm
总	uknu
竞	ukqb
兑	ukqb
兗	ukqb
况	ukqn
競	ukqq
敚	ukqt
敨	ukty
疻	ukwi
兾	ulaw
痼	uldd
凅	uldg
凙	ulff
癦	ulff
癏	ulge
闤	ulge
阛	ulge
痹	ulgj
兽	ulgk
瘝	ulii
鄫	uljb
曾	uljf
曽	uljf
朆	uljr
甑	uljy
闸	ulk
閘	ulk
閳	ulk
痐	ulkd
癳	ulli
阃	ulsi
閫	ulsi
瘻	ulvd
瘰	ulxi
癑	umae
闦	umau
痶	umaw
端	umdj
羰	umdo
凋	umfk
痌	umgk
凒	umgu
闓	umgu
閴	umi
疝	umk
閊	umk
瘿	ummv
癭	ummv
瘑	umnk
闿	umnv
闝	umti
凗	umwy
癜	unac
冺	unan
阚	unbt
闞	unbt
羗	unci
瘺	unfi
翔	ung
翊	ung
瘕	unhc
羞	unhg
爿	unht
闷	uni
悶	uni
闈	unkg
癖	unku
闢	unku
乵	unn
疡	unre
閟	unte
竮	unua
羌	unv
瘳	unwe
疦	unwi
决	unwy
痆	unxv
並	uof
焛	uoi
疢	uoi
普	uojf
羻	uont
癆	uooe
痰	uooi
瘘	uovd
牅	uovh
竤	updc
竩	upeg
羦	upfq
凕	upju
瘒	uplk
痯	upnd
竚	upsh
羜	upsh
羫	upwa
阍	uqaj
痻	uqaj
閽	uqaj
疧	uqav
羝	uqay
疷	uqay
奖	uqdu
癚	uqdy
阎	uqed
閻	uqed
奬	uqfd
獎	uqfd
墏	uqff
醬	uqfg
漿	uqfi
螀	uqfj
螿	uqfj
槳	uqfs
将	uqfy
將	uqfy
凎	uqg
鲝	uqgf
癣	uqgu
浆	uqiu
阄	uqjn
痀	uqkd
竘	uqkg
凂	uqkq
痪	uqmd
瘓	uqmd
疱	uqnv
癬	uqou
鮺	uqou
鴗	uqoy
鴹	uqoy
痑	uqqi
瘹	uqqy
酱	uqsg
桨	uqsu
净	uqvh
竫	uqvh
䦛	uqvh
䦶	uqvh
垐	uqwf
咨	uqwk
盗	uqwl
资	uqwm
資	uqwm
恣	uqwn
乲	uqwn
粢	uqwo
栥	uqws
楶	uqws
秶	uqwt
姿	uqwv
餈	uqwv
次	uqwy
瓷	uqwy
疚	uqyi
瘤	uqyl
郊	urbh
瓣	urcu
頝	urdm
効	uret
斨	urh
虠	urhw
闎	urii
瘣	urqc
䴔	urqg
鵁	urqo
痺	urtf
效	urty
交	uru
兿	urvc
閪	usd
闉	usfd
凐	usfg
瘭	usfi
鄭	usgb
奠	usgd
猷	usgd
尊	usgf
酋	usgf
蠤	usgj
鷷	usgo
遵	usgp
遒	usgp
親	ushq
闲	usi
痡	usi
閑	usi
凍	usjg
疔	usk
閅	usk
疴	uskd
閜	uskd
辣	uskg
竦	uskg
凁	uskg
牁	uskg
瘌	uskj
癞	uskm
癩	uskm
瘷	uskt
瘶	uskw
阑	usld
闌	usld
鹇	usqg
鷴	usqo
新	usrh
凚	ussi
痳	ussi
凓	ussy
亲	usu
闄	usvd
凇	uswc
牀	usy
竔	utah
凞	utao
痵	utbd
疾	utdi
痴	utdk
产	ute
閁	ute
彦	utee
颜	utem
顔	utem
遃	utep
竏	utfh
閮	utfp
冼	utfq
瘇	utgf
痸	utgj
癪	utgm
癟	utha
首	uthf
痄	uthf
導	uthf
馘	uthg
噵	uthk
瘜	uthn
道	uthp
闑	uths
夔	utht
瘪	uthx
痢	utjk
阁	utkd
閣	utkd
竬	utky
癓	utmt
癥	utmt
竧	utmt
疙	utnv
羳	utol
疺	utpi
産	uttg
剷	uttj
癁	uttt
瘢	utuc
疼	utui
癤	utvb
痿	utvd
亷	utvw
瘲	utwh
痜	utwv
痗	utxi
瘥	uuad
阙	uubw
瘚	uubw
闕	uubw
閚	uud
闁	uud
関	uudi
癇	uued
閗	uufk
竝	uug
闂	uugb
冸	uugh
癢	uugv
牂	uuh
辡	uuh
瘖	uujd
癎	uujd
闇	uujd
阐	uujf
瘅	uujf
暜	uujf
瘴	uujk
癔	uujn
痒	uuk
鄯	uukb
善	uukf
阅	uukq
痥	uukq
閲	uukq
敾	uukt
歚	uukw
竲	uulj
竴	uusf
痫	uusi
羴	uuuj
立	uuuu
妾	uvf
疩	uvfk
妆	uvg
妝	uvg
冿	uvgh
痕	uvi
鹣	uvjg
鶼	uvjo
兼	uvjw
歉	uvjw
甉	uvjy
癰	uvky
辧	uvuh
阀	uwai
閥	uwai
疮	uwbv
疫	uwci
竐	uwcy
羖	uwcy
疹	uwee
瘵	uwfi
痊	uwgd
阕	uwgd
闋	uwgd
瘉	uwgj
癐	uwgj
羭	uwgj
冾	uwgk
閤	uwgk
癒	uwgn
闟	uwgn
凃	uwgs
竳	uwgu
羷	uwgw
闪	uwi
閃	uwi
疥	uwjk
閱	uwkq
益	uwlf
鹢	uwlg
蠲	uwlj
鷁	uwlo
竌	uwn
瘊	uwnd
疯	uwri
飒	uwry
瘋	uwtj
闏	uwtj
颯	uwtj
竕	uwvt
羒	uwvt
痤	uwwf
䦟	uwwf
䦷	uwwf
疭	uwwi
閦	uwww
癈	uwxc
閄	uwy
冷	uwyc
羚	uwyc
竛	uwyc
閝	uwyc
痽	uwyd
閵	uwyd
凖	uwyf
准	uwyg
凔	uwyk
牄	uwyk
瘡	uwyk
癄	uwyo
飡	uwyv
邶	uxbh
瘬	uxde
鄁	uxeb
背	uxef
丠	uxgf
鹈	uxhg
剃	uxhj
弚	uxhj
鵜	uxho
递	uxhp
弟	uxht
辮	uxiu
疿	uxjk
軰	uxlj
冀	uxlw
北	uxn
凝	uxth
癡	uxth
辫	uxuh
疕	uxv
孳	uxxb
鹚	uxxg
關	uxxg
慈	uxxn
闗	uxxo
鶿	uxxo
鷀	uxxo
兹	uxxu
疪	uxxv
甆	uxxy
訚	uyd
誾	uyd
閍	uye
冫	uyg
疰	uygd
疒	uygg
辛	uygh
丬	uygh
六	uygy
门	uyhn
闵	uyi
閔	uyi
凉	uyiy
凉	uyiy
癠	uyjd
羶	uylg
凛	uyli
癝	uyli
凜	uylt
癛	uylt
闹	uymh
閙	uymh
闙	uynt
阂	uynw
痎	uynw
閡	uynw
丷	uyt
瘯	uytd
羊	uyth
⺶	uytt
辨	uytu
辩	uyuh
辬	uyuh
辯	uyuh
阆	uyvi
閬	uyvi
羪	uyvy
瘁	uywf
瘀	uywu
阏	uywu
閼	uywu
闶	uywv
閌	uywv
痃	uyxi
癴	uyxr
癵	uyxw
癕	uyxy
譱	uyyd
嫟	vaak
嬺	vaan
媶	vabg
婼	vadk
娀	vadt
妅	vag
嬅	vagg
姬	vahh
姫	vahh
嫫	vajd
鄩	vakb
彠	vakc
尋	vakf
嫤	vakg
嫨	vakg
嫗	vakk
嬿	vako
孉	vaky
媌	valg
媖	vamd
媾	vamf
嫹	vamw
姖	vang
媟	vans
塈	vaqf
暨	vaqg
既	vaqn
鱀	vaqo
妪	vary
嬞	vatf
嫕	vatn
娆	vatq
孏	vaul
嬳	vawc
婲	vawx
娂	vawy
娵	vbcy
嫷	vbde
堲	vbff
好	vbg
即	vbh
邚	vbh
媸	vbhj
她	vbn
恏	vbnu
婀	vbsk
奶	vbt
孥	vcbf
娺	vccc
驽	vccg
駑	vcco
砮	vcdf
姢	vceg
努	vcer
妈	vcgg
始	vckg
帑	vcmh
胬	vcmw
妑	vcn
妤	vcnh
媃	vcns
怒	vcnu
媽	vcoy
鴑	vcqo
拏	vcrj
娭	vctd
厹	vcu
弩	vcxb
奴	vcy
媠	vdae
妭	vdcy
姷	vdeg
媩	vdeg
娠	vdfe
娾	vdff
媷	vdff
姱	vdfn
姑	vdg
妬	vdg
媙	vdgv
妦	vdhh
娝	vdhk
妚	vdhy
媔	vdlf
媆	vdmd
頄	vdmy
娍	vdnn
娏	vdny
娔	vdqn
嫄	vdri
婍	vdsk
嫴	vduh
嫽	vdui
媋	vdwj
媅	vdwn
嫀	vdwt
娸	vdwy
娐	vebg
嫍	veeg
媛	vegc
姐	vegg
嬩	vegw
嫂	vehc
嬹	vemw
嫒	vepc
嬡	vept
婗	veqn
婇	vesy
媱	vetb
婬	vetf
嬀	veto
娞	vevg
彟	vfac
妓	vfcy
妘	vfcy
嬬	vfdj
垦	vff
娃	vffg
嫮	vffn
嬈	vffq
姏	vfg
奸	vfh
嫃	vfhw
卆	vfj
書	vfjf
晝	vfjg
妌	vfjh
肅	vfjk
鷫	vfjo
歗	vfjw
媴	vfke
嬯	vfkf
姞	vfkg
嬉	vfkk
畵	vflb
畫	vflg
劃	vflj
嬻	vflm
婻	vfmf
嬦	vfnf
娡	vfny
嬄	vfpu
妩	vfqn
妧	vfqn
孀	vfsh
媒	vfsy
媎	vftj
姥	vftx
寻	vfu
婞	vfuf
嫱	vfuk
嬙	vfwk
婈	vfwt
妹	vfy
妍	vgah
娬	vgay
姪	vgcf
姸	vgdf
衋	vgdl
婖	vgdn
婧	vgeg
婊	vgey
婭	vgfg
姃	vghg
嫣	vgho
嫥	vgjf
姮	vgjg
聿	vgk
娪	vgkg
婳	vglb
姉	vgmh
孋	vgmx
嫧	vgmy
娅	vgog
建	vgpk
妺	vgsy
娙	vgva
婕	vgvh
嬭	vgwr
嫊	vgxi
姨	vgxw
妋	vgy
婔	vhdd
⺻	vhgd
盡	vhgl
賮	vhgm
婌	vhic
鹔	vhjg
婥	vhjh
肃	vhjw
肀	vhk
媜	vhmy
娊	vhqn
嫭	vhtf
媫	vhvh
婋	vhwn
虓	vhwn
娋	vieg
姯	vigq
隶	vii
剥	vijh
盝	vilf
嫦	viph
逮	vipi
逯	vipi
妙	vitt
录	viu
媣	vivs
旭	vjd
旮	vjf
娌	vjfg
娨	vjfh
妲	vjgg
婣	vjgg
媞	vjgh
婸	vjgr
媢	vjhg
妽	vjhh
娼	vjjg
嫚	vjlc
媪	vjlg
媀	vjmy
鄛	vjsb
勦	vjse
剿	vjsj
巢	vjsu
婐	vjsy
婫	vjxx
邵	vkbh
卲	vkbh
綤	vkbi
邕	vkcb
雝	vkcy
娟	vkeg
劭	vket
召	vkf
叴	vkf
如	vkg
娱	vkgd
妕	vkhh
嬇	vkhm
娖	vkhy
刟	vkjh
嬋	vkkf
嬠	vkks
孍	vkkt
帤	vkmh
娲	vkmw
娛	vknd
巶	vknn
恕	vknu
娯	vknw
迢	vkpd
鴽	vkqo
欩	vkqw
挐	vkrj
桇	vksu
絮	vkxi
婟	vldg
姻	vldy
媦	vleg
娚	vlet
嫐	vlev
甾	vlf
嬕	vlff
嫼	vlfo
嬛	vlge
疀	vlgh
嬽	vlhd
媤	vlny
鶅	vlqo
巤	vlrn
邋	vlrp
媼	vlwl
嫘	vlxi
姍	vmah
婰	vmaw
婩	vmdf
媏	vmdj
姎	vmdy
姌	vmfg
婤	vmfk
妯	vmg
姛	vmgk
娉	vmgn
媺	vmgt
嬍	vmgt
奾	vmh
帇	vmhk
姗	vmmg
孆	vmmv
媧	vmnk
孈	vmwk
妠	vmwy
姄	vnan
婮	vndg
娓	vnen
娜	vngb
媉	vngf
彐	vngg
艮	vngy
婽	vnhc
婿	vnhe
媚	vnhg
妞	vnhg
孎	vnij
媁	vnkg
妃	vnn
巛	vnnn
刀	vnt
妼	vntt
恳	vnu
嫪	vnwe
妜	vnwy
嬥	vnwy
妮	vnxn
姒	vnyw
嫬	voao
粛	vojk
嬫	voos
婒	vooy
嫾	voqg
嬷	vosc
孊	vosd
嫲	voss
嬤	vosx
灵	vou
災	vou
嬚	vouw
嫞	vovh
嫝	vovi
彛	vowa
彞	voxa
辺	vpe
婃	vpfi
嫁	vpge
媗	vpgg
婝	vpgh
嬪	vpgm
退	vpi
婶	vpjh
彚	vpjs
嫇	vpju
媈	vplh
帚	vpmh
婠	vpng
嬣	vpns
婉	vpqb
妉	vpqn
嫔	vprw
姹	vpta
嬸	vptl
巡	vpv
廵	vpv
姲	vpvg
嫆	vpwk
婚	vqaj
媰	vqbt
姽	vqdb
鸠	vqgg
姚	vqiy
妳	vqiy
姰	vqjg
姁	vqkg
姳	vqkg
嬎	vqkg
嬔	vqkg
娩	vqkq
婏	vqky
嫓	vqmx
媍	vqmy
婅	vqoy
鳩	vqoy
鳭	vqoy
鵖	vqoy
姼	vqqy
夛	vqu
婙	vqvh
嬝	vqye
嬼	vqyj
媹	vqyl
妁	vqyy
奺	vqyy
媓	vrgg
姤	vrgk
妡	vrh
婂	vrmh
媿	vrqc
婢	vrtf
娦	vrwy
嬓	vryt
嫖	vsfi
奵	vsh
娻	vsjg
妸	vskg
娕	vskg
嬾	vskm
嫩	vskt
嫰	vskw
媡	vslg
杂	vsu
婹	vsvg
婡	vsww
雑	vswy
奼	vtan
姡	vtdg
娇	vtdj
嬌	vtdk
妖	vtdy
尹	vte
妊	vtfg
奷	vtfh
娗	vtfp
姺	vtfq
姝	vtfy
娷	vtgf
媑	vtgf
姓	vtgg
姩	vtgh
嫵	vtgo
妷	vtgy
妰	vthf
嬶	vthj
媳	vthn
娫	vthp
娳	vtjh
郡	vtkb
裠	vtke
君	vtkf
帬	vtkh
頵	vtkm
焄	vtko
鵘	vtko
覠	vtkq
群	vtku
羣	vtku
媲	vtlx
姠	vtmk
九	vtn
姊	vtnt
嬏	vtol
姂	vtpy
娥	vtry
婑	vtvg
孂	vtvl
娒	vtxy
姀	vty
嬢	vuae
嫅	vuag
姘	vuah
嫺	vueg
媊	vuej
嬘	vuep
婘	vugb
媄	vugd
姅	vugh
嬟	vugy
婵	vujf
嫜	vujh
嬑	vujn
婄	vukg
娧	vukq
姣	vury
媨	vusg
孄	vusl
娴	vusy
媇	vusy
嫻	vusy
嫉	vutd
馗	vuth
嫸	vuuk
嫌	vuvw
嬨	vuxn
娣	vuxt
嫿	vvfg
姧	vvfh
妇	vvg
奻	vvg
嬧	vvhl
娽	vviy
妱	vvkg
婦	vvph
脋	vvve
姦	vvvf
刕	vvvr
女	vvvv
妐	vwcy
婨	vwga
媕	vwga
婾	vwgb
姾	vwgg
姵	vwgh
媮	vwgj
嬒	vwgj
姶	vwgk
嬆	vwgn
嬁	vwgu
嬐	vwgw
刅	vwi
妎	vwjh
媬	vwks
娰	vwnw
姙	vwtf
妢	vwvt
孅	vwwg
姈	vwyc
孇	vwyc
婎	vwyg
娢	vwyk
妗	vwyn
嫶	vwyo
嬵	vxrh
嫋	vxuu
妣	vxxn
媘	vxxr
姆	vxy
娹	vxyx
訄	vyd
妫	vyey
娮	vyg
丒	vygf
妵	vygg
刃	vyi
丸	vyi
刄	vyi
婛	vyiy
孃	vyke
嬗	vylg
媥	vyna
妒	vynt
忍	vynu
姟	vynw
婷	vyps
妨	vyt
嫙	vyth
媯	vyto
嫡	vyud
媂	vyuh
嬂	vyuj
嫎	vyuy
嫏	vyvb
奿	vyvd
歰	vyvh
娘	vyvy
妔	vywn
妶	vyxy
妏	vyy
僷	waas
侙	waay
俴	waay
傇	wabg
偌	wadk
儰	waeo
仝	waf
垡	waff
仜	wag
仺	wagf
儖	wahl
伢	waht
借	wajg
偃	wajv
傼	wakg
僅	wakg
傴	wakk
儺	waky
儚	walq
偀	wamd
傋	wamf
僙	wamw
佢	wang
伳	wann
偞	wans
僃	waqe
僀	waqh
僭	waqj
儆	waqt
伛	wary
備	wate
憊	watn
侥	watq
供	wawy
伐	way
袋	waye
垈	wayf
牮	wayg
帒	wayh
贷	waym
岱	waym
貸	waym
黛	wayo
柋	ways
代	wayy
戗	wbay
仓	wbb
倻	wbbh
仔	wbg
佴	wbg
创	wbjh
他	wbn
怹	wbnu
鸧	wbqg
仍	wbt
佊	wby
伋	wbyy
傪	wcce
颂	wcdm
頌	wcdm
俑	wceh
瓮	wcgy
凤	wci
佁	wckg
勜	wcne
翁	wcnf
鹟	wcng
伃	wcnh
僪	wcnk
鶲	wcno
忩	wcnu
傌	wcoy
兊	wcqb
毤	wcqe
枀	wcsu
俟	wctd
侔	wctg
公	wcu
殳	wcu
俊	wcwt
傩	wcwy
仅	wcy
仏	wcy
佐	wdag
伌	wdbn
伖	wdcy
侑	wdeg
優	wdet
倀	wdey
倴	wdfa
侲	wdfe
傉	wdff
倷	wdfi
侉	wdfn
估	wdg
仨	wdg
佦	wdg
侟	wdhb
偰	wdhd
伾	wdhg
仹	wdhh
傶	wdhi
俖	wdhk
伓	wdhy
凮	wdjd
佰	wdjg
俺	wdjn
佑	wdkg
偭	wdlf
偄	wdmd
佈	wdmh
侕	wdmj
优	wdny
偧	wdqq
傆	wdri
傸	wdrr
倚	wdsk
俦	wdtf
儮	wdth
做	wdty
傄	wduh
僚	wdui
俸	wdwg
傣	wdwi
偆	wdwj
偡	wdwn
俠	wdww
僛	wdww
倛	wdwy
伏	wdy
仗	wdyy
俘	webg
俷	wecn
倗	weeg
仴	weg
伹	wegg
佣	weh
傁	wehc
伽	wekg
偁	wemf
僢	wepg
僾	wept
倪	weqn
倸	wesy
仂	wet
傜	wetb
僞	weto
俀	wevg
傒	wexd
傤	wfal
儎	wfal
偾	wfam
僨	wfam
郐	wfcb
凨	wfci
刽	wfcj
会	wfcu
伎	wfcy
伝	wfcy
佉	wfcy
儒	wfdj
佳	wffg
僥	wffq
侍	wffy
仁	wfg
仕	wfg
佄	wfg
什	wfh
仠	wfh
佱	wfhf
值	wfhg
値	wfhn
傎	wfhw
畲	wfil
祭	wfiu
佘	wfiu
仐	wfj
癷	wfj
舍	wfkf
儓	wfkf
舎	wfkf
佶	wfkg
舒	wfkh
僖	wfkk
舘	wfkn
鵨	wfko
舖	wfks
舗	wfks
儥	wflm
儔	wfnf
伟	wfnh
怤	wfnu
传	wfny
俧	wfny
侼	wfpb
発	wfqb
侾	wftb
偖	wftj
侤	wftn
佬	wftx
倖	wfuf
姇	wfvf
佞	wfvg
倰	wfwt
付	wfy
佅	wfy
侀	wgaj
倵	wgay
伅	wgbn
侄	wgcf
倒	wgcj
戣	wgda
鄈	wgdb
癸	wgdu
兪	wgeb
鄃	wgeb
毹	wgee
倩	wgeg
俞	wgej
愈	wgen
逾	wgep
觎	wgeq
儬	wgeq
覦	wgeq
歈	wgew
俵	wgey
全	wgf
亼	wgf
俹	wgfg
僫	wgfn
伍	wgg
仼	wgg
僣	wggj
儧	wggm
佂	wghg
傿	wgho
佥	wgig
剑	wgij
敛	wgit
俅	wgiy
凬	wgjd
傳	wgjf
僡	wgjn
便	wgjr
龠	wgka
弇	wgka
命	wgkb
郃	wgkb
鄧	wgkb
敆	wgkc
龕	wgkd
儾	wgke
合	wgkf
鸽	wgkg
俉	wgkg
倳	wgkh
龣	wgki
剣	wgkj
劍	wgkj
樖	wgkk
盒	wgkl
偪	wgkl
畣	wgkl
盫	wgkl
颌	wgkm
頜	wgkm
顩	wgkm
龥	wgkm
翕	wgkn
翖	wgkn
鴿	wgko
鸙	wgko
邆	wgkp
覴	wgkq
使	wgkr
拿	wgkr
搻	wgkr
龤	wgkr
斂	wgkt
龢	wgkt
登	wgku
侸	wgku
豋	wgku
劎	wgkv
凳	wgkw
歙	wgkw
僉	wgkw
欱	wgkw
歛	wgkw
龡	wgkw
龛	wgky
剱	wgky
劒	wgky
劔	wgky
鄶	wglb
朇	wglf
僵	wglg
劊	wglj
會	wglj
侖	wgma
侢	wgmf
伂	wgmh
傮	wgmj
俩	wgmw
儷	wgmx
债	wgmy
俪	wgmy
倆	wgmy
債	wgmy
兮	wgnb
侴	wgnj
佤	wgny
俨	wgot
夙	wgqi
例	wgqj
鳳	wgqo
傲	wgqt
厁	wgsb
叙	wgsc
敍	wgsc
斜	wgsf
畬	wgsl
峹	wgsm
嵞	wgsm
悆	wgsn
途	wgsp
敘	wgst
余	wgsu
雓	wgsy
侠	wgud
伻	wguf
俫	wgus
俓	wgva
倢	wgvh
儞	wgwr
仾	wgxg
傃	wgxi
侇	wgxw
伕	wgy
凪	whd
俳	whdd
企	whf
仩	whg
倶	whgw
佧	whhy
俶	whic
个	whj
倬	whjh
佔	whkg
儢	whln
侦	whmy
偵	whmy
候	whnd
俔	whqn
儏	whqo
倏	whtd
修	whte
脩	whte
鞗	whtf
跾	whth
絛	whti
偹	whtl
悠	whtn
翛	whtn
倐	whto
儵	whto
焂	whto
鯈	whto
鋚	whtq
鎥	whtq
條	whts
攸	whty
偼	whvh
俿	whwn
俱	whwy
佌	whxn
偨	whxs
仆	why
俏	wieg
侊	wigq
倘	wimk
僘	wimt
偿	wipc
儅	wipl
償	wipm
儻	wipo
傥	wipq
偗	with
仯	witt
氽	wiu
尒	wiu
仦	wiy
儤	wjai
俚	wjfg
但	wjgg
偍	wjgh
偒	wjgr
伸	wjhh
敒	wjht
介	wjj
倡	wjjg
僈	wjlc
偶	wjmy
傝	wjng
偈	wjqn
倮	wjsy
儑	wjxo
倱	wjxx
偮	wkbg
俋	wkcn
俣	wkgd
侱	wkgg
仲	wkhh
僓	wkhm
儙	wkhp
促	wkhy
僤	wkkf
侣	wkkg
偘	wkkk
侃	wkkn
偔	wkkn
僺	wkks
儼	wkkt
諐	wkky
傊	wkmy
俁	wknd
兌	wkqb
敓	wkqt
堡	wksf
賲	wksm
煲	wkso
保	wksy
侶	wktk
伿	wkwy
個	wldg
侽	wlet
佃	wlg
伵	wlg
偎	wlge
儇	wlge
伡	wlh
俥	wlh
佪	wlkg
儽	wlli
儡	wlll
偲	wlny
僆	wlpy
僌	wlty
僂	wlvg
傫	wlxi
儸	wlxy
儂	wmae
僼	wmau
倎	wmaw
偳	wmdj
佒	wmdy
傰	wmee
傦	wmeg
倜	wmfk
伷	wmg
侗	wmgk
俜	wmgn
仙	wmh
凧	wmhk
仚	wmj
侧	wmjh
側	wmjh
儩	wmjr
伣	wmqn
儶	wmwk
侺	wmwn
催	wmwy
僝	wnbb
倔	wnbm
倨	wndg
佀	wng
偓	wngf
伺	wngk
假	wnhc
偦	wnhe
偉	wnkg
僻	wnku
亿	wnn
侷	wnnk
僎	wnnw
鄇	wntb
侯	wntd
佖	wntt
偋	wnua
亾	wnv
僇	wnwe
伲	wnxn
伈	wny
侭	wnyu
似	wnyw
伬	wnyy
癶	wnyy
儣	woaw
儍	wobt
僗	wooe
儝	woos
倓	wooy
僯	woqg
侂	wota
僕	woug
偻	wovg
傭	wovh
傏	wovk
俯	wowf
儦	woxo
伙	woy
侎	woy
僿	wpaf
侬	wpey
倧	wpfi
俒	wpfq
傢	wpge
伫	wpgg
儐	wpgm
倌	wpng
儜	wpns
倇	wpqb
傧	wprw
佇	wpsh
俕	wpsy
侘	wpta
侒	wpvg
倥	wpwa
傛	wpwk
僒	wpwk
伔	wpwn
傕	wpwy
佗	wpxn
低	wqay
尣	wqb
仰	wqbh
㑳	wqbt
佹	wqdb
儋	wqdy
釡	wqf
尩	wqgd
傑	wqgs
您	wqin
你	wqiy
佻	wqiy
侚	wqjg
像	wqke
佝	wqkg
佲	wqkg
俛	wqkq
儳	wqky
偩	wqmy
佨	wqnn
鳯	wqoi
侈	wqqy
尦	wqqy
偬	wqrn
伆	wqrt
俇	wqtg
伨	wqug
㑇	wqvg
仢	wqyy
爺	wrbb
爷	wrbj
爸	wrcb
仮	wrcy
倄	wrde
俙	wrdh
飕	wrec
偱	wrfh
釜	wrfu
伯	wrg
凰	wrgd
偟	wrgg
伒	wrh
飐	wrhk
飓	wrhw
傂	wrhw
风	wri
飔	wrln
飏	wrnr
飚	wroo
傀	wrqc
飗	wrql
飑	wrqn
爹	wrqq
俽	wrqw
斧	wrrj
儨	wrrm
俾	wrtf
父	wru
儌	wryt
僊	wsdn
僄	wsfi
傅	wsfy
価	wsg
体	wsgg
仃	wsh
凩	wsi
倲	wsjg
剁	wsjh
何	wskg
價	wsmy
恷	wsnu
烋	wsou
僳	wsoy
鸺	wsqg
僲	wsqg
鵂	wsqo
儊	wssh
僸	wssi
傈	wssy
朵	wsu
偠	wsvg
倯	wswc
倈	wsww
休	wsy
俌	wsy
仛	wtan
伥	wtay
仫	wtcy
俬	wtcy
佸	wtdg
侨	wtdj
倁	wtdk
僑	wtdk
仸	wtdy
伤	wtet
俢	wtet
偛	wtfe
偫	wtff
任	wtfg
仟	wtfh
仵	wtfh
俈	wtfk
赁	wtfm
儹	wtfm
賃	wtfm
恁	wtfn
鵀	wtfo
侹	wtfp
侁	wtfq
栠	wtfs
凭	wtfw
侏	wtfy
働	wtge
倂	wtgf
倕	wtgf
偅	wtgf
儛	wtgg
件	wtgh
佭	wtgh
佚	wtgy
亻	wth
作	wthf
偺	wthj
倃	wthk
颼	wtjc
颳	wtjd
飇	wtjd
颩	wtje
颵	wtje
飂	wtje
颫	wtjg
颹	wtjg
俐	wtjh
颴	wtjh
風	wtji
飃	wtji
飉	wtji
颲	wtjj
颾	wtjj
飍	wtjj
颭	wtjk
颱	wtjk
飀	wtjl
飅	wtjl
颮	wtjn
颸	wtjn
颷	wtjo
飈	wtjo
傷	wtjr
颺	wtjr
颬	wtjt
飋	wtjt
颶	wtjw
颰	wtjy
佫	wtkg
俰	wtkg
偊	wtky
侐	wtlg
俻	wtlg
傯	wtln
傻	wtlt
几	wtn
仡	wtnn
僠	wtol
僁	wton
僽	wton
偢	wtoy
俄	wtry
佟	wtuy
侜	wtuy
倭	wtvg
傱	wtwh
係	wtxi
侮	wtxy
八	wty
傞	wuag
併	wuah
儱	wued
僩	wueg
偂	wuej
伞	wufj
位	wug
們	wug
倦	wugb
伴	wugh
儯	wugo
儀	wugy
佯	wuh
僮	wujf
偣	wujg
僴	wujg
傽	wujh
億	wujn
傹	wujq
倍	wukg
侻	wukq
僧	wulj
们	wun
佽	wuqw
俲	wure
傚	wurt
佼	wury
僔	wusf
偤	wusg
儭	wusq
偐	wute
仒	wuu
傡	wuug
僐	wuuk
倿	wuvg
傔	wuvw
凲	wuvw
偝	wuxe
俤	wuxt
餞	wvaa
饃	wvad
饛	wvae
饉	wvag
弅	wvaj
饇	wvak
饚	wval
餀	wvar
饊	wvat
餝	wvay
餌	wvbg
邠	wvbh
飿	wvbm
餟	wvcc
飴	wvck
餕	wvct
伮	wvcy
餴	wvda
餪	wvdd
餦	wvde
餬	wvde
颁	wvdm
頒	wvdm
餣	wvdn
餿	wvec
饀	wvee
飷	wveg
餒	wvev
餑	wvfb
坌	wvff
伜	wvfh
飦	wvfh
饎	wvfk
饁	wvfl
饙	wvfm
饒	wvfq
饐	wvfu
饢	wvge
侓	wvgh
飩	wvgn
健	wvgp
餖	wvgu
瓫	wvgy
饖	wvhh
儘	wvhl
饄	wvif
饓	wvis
饅	wvjc
饆	wvjg
饂	wvjl
餲	wvjn
餳	wvjr
餜	wvjs
蚠	wvju
餛	wvjx
蝕	wvjy
佋	wvkg
侞	wvkg
饋	wvkm
兺	wvkx
餵	wvle
盆	wvlf
儠	wvln
饠	wvly
餶	wvme
岔	wvmj
餇	wvmk
贫	wvmu
貧	wvmu
仇	wvn
飼	wvnk
飶	wvnt
忿	wvnu
饌	wvnw
饝	wvod
餹	wvok
餤	wvoo
炃	wvou
麄	wvox
侵	wvpc
餫	wvpl
館	wvpn
飹	wvqb
餡	wvqe
餆	wvqi
餾	wvql
飽	wvqn
鳻	wvqo
飲	wvqw
饞	wvqy
分	wvr
飯	wvrc
餽	wvrc
餚	wvre
餭	wvrg
餙	wvrh
餼	wvro
餺	wvsf
餷	wvsg
飣	wvsh
餗	wvsk
餔	wvsy
飥	wvta
飫	wvtd
餂	wvtd
飭	wvte
飪	wvtf
飵	wvtf
餠	wvtf
飾	wvth
侰	wvtk
餉	wvtk
餎	wvtk
饡	wvtm
餰	wvts
伊	wvtt
餧	wvtv
攽	wvty
飠	wvty
餓	wvty
餅	wvua
饈	wvug
餢	wvuk
饍	wvuk
餻	wvuo
餸	wvup
餃	wvur
餱	wvwd
飻	wvwe
餁	wvwf
餄	wvwk
飢	wvwn
餘	wvws
餩	wvww
飤	wvwy
餯	wvxe
饑	wvxw
佷	wvy
餏	wvye
饟	wvye
飳	wvyg
饘	wvyg
飰	wvyh
仞	wvyy
仭	wvyy
韱	wwag
耸	wwbf
伧	wwbn
倊	wwcn
傟	wwcn
癹	wwcu
伀	wwcy
伇	wwcy
俎	wweg
佾	wweg
侩	wwfc
坐	wwfd
傺	wwfi
剉	wwfj
倽	wwfk
夎	wwft
倫	wwga
偸	wwgb
丛	wwgf
俭	wwgg
佺	wwgg
佩	wwgh
偷	wwgj
儈	wwgj
佮	wwgk
俆	wwgs
僜	wwgu
倹	wwgw
儉	wwgw
睂	wwhh
伱	wwiy
价	wwjh
谾	wwka
卻	wwkb
郤	wwkb
谹	wwkc
豀	wwkd
豅	wwkd
豂	wwke
谷	wwkf
鹆	wwkg
谻	wwkg
螸	wwkj
谽	wwkk
豄	wwkm
慾	wwkn
鵒	wwko
逧	wwkp
谺	wwkt
豃	wwkt
欲	wwkw
谼	wwkw
佡	wwmh
仉	wwn
怂	wwnu
偑	wwtj
仌	wwu
份	wwvt
侳	wwwf
傘	wwwf
俗	wwwk
众	wwwu
人	wwww
伦	wwxn
从	wwy
仈	wwy
伶	wwyc
倠	wwyg
傖	wwyk
僋	wwym
仱	wwyn
儁	wwyn
僬	wwyo
仑	wxb
倾	wxdm
傾	wxdm
华	wxfj
僶	wxg
伄	wxhh
佛	wxjh
货	wxmu
貨	wxmu
化	wxn
儗	wxth
發	wxwc
仳	wxxn
偕	wxxr
僟	wxxw
隽	wybr
邻	wycb
俼	wyce
鸰	wycg
刢	wycj
领	wycm
領	wycm
翎	wycn
鴒	wyco
令	wycu
隻	wycu
瓴	wycy
顀	wydm
依	wyey
伪	wyey
偯	wyey
詧	wyf
储	wyfj
隼	wyfj
儲	wyfj
鶽	wyfo
傠	wyfy
信	wyg
隹	wyg
住	wygg
雋	wyhn
凡	wyi
僦	wyiy
倞	wyiy
儕	wyjg
侪	wyjh
儴	wyke
售	wykf
儃	wylg
傐	wymk
偏	wyna
今	wynb
侌	wync
衾	wyne
酓	wyng
韽	wynj
含	wynk
盦	wynl
贪	wynm
颔	wynm
貪	wynm
頷	wynm
念	wynn
傓	wynn
鳹	wyno
敜	wynt
侫	wynv
侅	wynw
欦	wynw
僱	wyny
雂	wyny
鹪	wyog
劁	wyoj
顦	wyom
鷦	wyoo
焦	wyou
進	wypd
儫	wype
停	wyps
燞	wyqo
禽	wyrc
仪	wyry
集	wysu
仿	wyt
偽	wyto
倣	wyty
亽	wyu
偙	wyuh
傍	wyuy
戧	wyva
創	wyvj
倉	wyvk
鶬	wyvo
食	wyvu
飮	wyvw
俍	wyvy
雙	wywc
倅	wywf
犨	wywg
伉	wywn
雧	wyws
讐	wywy
雔	wywy
雥	wywy
雦	wywy
傗	wyxl
伭	wyxy
伩	wyy
犫	wyyg
雠	wyyy
讎	wyyy
綫	xaay
縙	xabg
绒	xadt
絨	xadt
繖	xaet
缂	xafh
緙	xafh
红	xag
紅	xag
弫	xahh
弬	xahh
繿	xahl
纜	xahq
縸	xajd
緎	xakg
彄	xakk
緢	xalg
緓	xamd
绬	xamd
彉	xamw
弡	xang
绁	xann
紲	xann
弽	xans
緤	xans
练	xanw
繱	xaqn
纄	xatp
绕	xatq
緅	xbcy
弭	xbg
鄳	xbh
弢	xbhc
绌	xbmh
絀	xbmh
弛	xbn
毑	xbn
紴	xby
级	xbyy
級	xbyy
经	xcag
弪	xcag
缀	xccc
綴	xccc
縿	xcce
縔	xccs
経	xcfg
绎	xcgh
強	xcjy
绐	xckg
紿	xckg
緿	xckn
弝	xcn
紦	xcn
纾	xcnh
紓	xcnh
繘	xcnk
弘	xcy
紁	xcyy
绂	xdcy
紘	xdcy
紱	xdcy
纮	xdcy
絠	xdeg
纋	xdet
張	xdey
缛	xdff
縟	xdff
绔	xdfn
絝	xdfn
缄	xdgk
緘	xdgk
縅	xdgv
縬	xdhi
紑	xdhy
緾	xdjf
絔	xdjg
弼	xdjx
缅	xdlf
緬	xdlf
緛	xdmd
顷	xdmy
頃	xdmy
絾	xdnn
紌	xdny
縓	xdri
绮	xdsk
綺	xdsk
绑	xdtb
綁	xdtb
缭	xdui
繚	xdui
縥	xdwt
綊	xdww
綨	xdwy
紎	xdy
孧	xebf
綒	xebg
绷	xeeg
弸	xeeg
綳	xeeg
縚	xeeg
缓	xegc
緩	xegc
组	xegg
組	xegg
剶	xejh
蠡	xejj
劙	xejj
盠	xelf
绶	xepc
綬	xepc
鴢	xeqo
鶨	xeqo
綵	xesy
幼	xet
糼	xet
絼	xet
彖	xeu
绥	xevg
綏	xevg
縘	xexd
纎	xfag
繊	xfao
駂	xfco
纭	xfcy
紜	xfcy
紶	xfcy
繻	xfdj
繧	xffc
絓	xffg
繞	xffq
绀	xfg
紺	xfg
疆	xfgg
缜	xfhw
縝	xfhw
頴	xfim
颕	xfim
结	xfkg
結	xfkg
繥	xfkk
缬	xfkm
纈	xfkm
續	xflm
续	xfnd
纬	xfnh
綕	xfny
綍	xfpb
続	xfpq
鸨	xfqg
鴇	xfqo
绪	xftj
緒	xftj
緖	xftj
緈	xfuf
盭	xful
繨	xfup
繬	xfwk
绫	xfwt
綾	xfwt
纣	xfy
紂	xfy
线	xgay
纯	xgbn
純	xgbn
絰	xgcf
绖	xgcf
緻	xgct
綪	xgeg
弖	xgf
纡	xgfh
弙	xgfh
紆	xgfh
纉	xggm
絚	xghg
絿	xgiy
縳	xgjf
絙	xgjg
繐	xgjn
绠	xgjr
綆	xgjr
缰	xglg
彊	xglg
繮	xglg
弻	xglx
纚	xgmx
绩	xgmy
緉	xgmy
績	xgmy
缙	xgoj
縉	xgoj
弳	xgva
經	xgva
緁	xgvh
緀	xgvv
彌	xgwr
瓕	xgwy
縤	xgxi
绯	xhdd
緋	xhdd
引	xhh
彏	xhhc
缈	xhit
緲	xhit
绰	xhjh
綽	xhjh
弔	xhk
盄	xhlf
纑	xhll
緽	xhmy
顚	xhnm
鷆	xhno
眞	xhnw
繉	xhqi
絸	xhqn
紪	xhxn
颍	xidm
潁	xidm
绡	xieg
弰	xieg
綃	xieg
絖	xigq
弾	xijf
剝	xijh
绱	ximk
緔	ximk
纱	xitt
紗	xitt
糸	xiu
彔	xiu
彃	xjag
縪	xjag
繓	xjbc
旨	xjf
缇	xjgh
緹	xjgh
绅	xjhh
紳	xjhh
縨	xjiq
刜	xjjh
縄	xjjn
弗	xjk
缦	xjlc
縵	xjlc
緼	xjlg
缊	xjlg
鄪	xjmb
费	xjmu
費	xjmu
絏	xjnt
艴	xjqc
鴲	xjqo
緆	xjqr
綶	xjsy
缆	xjtq
绲	xjxx
緄	xjxx
缉	xkbg
緝	xkbg
绢	xkeg
弲	xkeg
絹	xkeg
紃	xkh
缋	xkhm
繢	xkhm
缱	xkhp
繾	xkhp
勥	xkje
犟	xkjg
绳	xkjn
强	xkjy
謽	xkjy
彈	xkkf
繟	xkkf
絽	xkkg
缲	xkks
繰	xkks
縜	xkmy
织	xkwy
絪	xldy
緭	xleg
繹	xlff
纆	xlff
细	xlg
細	xlg
缳	xlge
彋	xlge
繯	xlge
綥	xlgj
絗	xlkg
纝	xlli
缌	xlny
緦	xlny
縺	xlpy
綑	xlsy
縷	xlvg
縕	xlwl
缧	xlxi
縲	xlxi
轡	xlxk
纙	xlxy
繷	xmae
紻	xmdy
繃	xmee
縎	xmeg
绸	xmfk
綢	xmfk
紬	xmg
䌷	xmg
絧	xmgk
絅	xmkg
缨	xmmv
纓	xmmv
緺	xmnk
遦	xmpi
纲	xmry
贯	xmu
貫	xmu
綱	xmum
網	xmun
綗	xmwk
纗	xmwk
纳	xmwy
納	xmwy
繀	xmwy
缗	xnaj
緡	xnaj
緪	xngg
縆	xngg
弓	xngn
縀	xnhc
縃	xnhe
纽	xnhg
紐	xnhg
纠	xnhh
糾	xnhh
緯	xnkg
纪	xnn
幻	xnn
乣	xnn
糺	xnn
紀	xnn
纟	xnng
彑	xnng
黽	xnng
毌	xnnh
繏	xnnw
母	xnny
糹	xnny
缪	xnwe
繆	xnwe
彍	xoaw
纊	xoaw
絋	xocy
熲	xodm
颎	xodm
缠	xojf
纏	xojf
纒	xojf
继	xonn
継	xonn
緂	xooy
繗	xoqg
纩	xot
缕	xovg
彜	xowa
彝	xoxa
鬻	xoxh
粥	xoxn
綋	xpdc
縖	xpdk
综	xpfi
綜	xpfi
綄	xpfq
縇	xpgg
纻	xpgg
绽	xpgh
綻	xpgh
繽	xpgm
縯	xpgw
彙	xpjs
緷	xplh
绾	xpng
綰	xpng
綩	xpqb
紞	xpqn
缤	xprw
紵	xpsh
縡	xpuh
缩	xpwj
縮	xpwj
紽	xpxn
緍	xqaj
纸	xqan
紙	xqan
弤	xqay
縐	xqbt
绝	xqcn
絶	xqcn
繎	xqdo
繲	xqeg
弥	xqiy
絩	xqiy
绚	xqjg
絢	xqjg
絇	xqkg
絻	xqkq
纔	xqky
緫	xqrn
綯	xqtb
绹	xqtb
绉	xqvg
繺	xqvo
弞	xqwy
约	xqyy
約	xqyy
緵	xrbt
弧	xrcy
絺	xrdh
絈	xrg
紤	xrh
線	xriy
缐	xriy
绵	xrmh
綿	xrmh
綼	xrtf
纅	xrxs
缴	xryt
繳	xryt
緸	xsfg
缥	xsfi
縹	xsfi
缚	xsfy
縛	xsfy
絤	xsg
絊	xsgg
綇	xsgg
糽	xsh
缃	xshg
緗	xshg
綀	xskg
彁	xskk
練	xslg
綝	xssy
絉	xsyy
张	xtay
鄊	xtbb
絁	xtbn
绣	xtbt
綉	xtbt
觺	xtde
肄	xtdg
絬	xtdg
疑	xtdh
綘	xtdh
繑	xtdk
颖	xtdm
穎	xtdm
缝	xtdp
縫	xtdp
欵	xtdw
矤	xtdy
乡	xte
紝	xtfg
纴	xtfg
纤	xtfh
缵	xtfm
纘	xtfm
綎	xtfp
絑	xtfy
缍	xtgf
綞	xtgf
緟	xtgf
绛	xtgh
絳	xtgh
纁	xtgo
绗	xtgs
絎	xtgs
紩	xtgy
缎	xthc
緞	xthc
縰	xthh
绺	xthk
綹	xthk
綖	xthp
緮	xtjt
蚃	xtju
络	xtkg
絡	xtkg
總	xtln
繌	xtlt
匕	xtn
纥	xtnn
紇	xtnn
缒	xtnp
縋	xtnp
繙	xtol
鄕	xtrb
绦	xtsy
縦	xtuh
终	xtuy
終	xtuy
郷	xtvb
緌	xtvg
縱	xtwh
飨	xtwv
鄉	xtyb
蠁	xtyj
響	xtyj
嚮	xtyk
饗	xtyv
縒	xuag
絣	xuah
縌	xubp
繝	xueg
繸	xuep
彅	xuev
紏	xufh
绻	xugb
綣	xugb
绊	xugh
絆	xugh
絴	xuh
弹	xujf
繶	xujn
縂	xukn
綐	xukq
缯	xulj
繒	xulj
絘	xuqw
纐	xurm
绞	xury
絞	xury
繜	xusf
緧	xusg
缮	xuuk
繕	xuuk
缣	xuvw
縑	xuvw
缢	xuwl
縊	xuwl
鶸	xuxo
绨	xuxt
綈	xuxt
弱	xuxu
絕	xvcn
縁	xvey
繣	xvfg
紣	xvfh
彇	xvfj
繡	xvfj
绿	xviy
緑	xviy
缫	xvjs
繅	xvjs
绍	xvkg
弨	xvkg
紹	xvkg
缁	xvlg
緇	xvlg
繍	xvoj
綅	xvpc
糿	xvt
匘	xvtr
綛	xvyn
纫	xvyy
纨	xvyy
紈	xvyy
紉	xvyy
総	xwcn
絥	xwdy
紾	xwet
绘	xwfc
絵	xwfc
縩	xwfi
弣	xwfy
紨	xwfy
綸	xwga
絟	xwgg
緰	xwgj
繪	xwgj
给	xwgk
給	xwgk
缏	xwgr
緶	xwgr
縧	xwhs
紒	xwjh
緥	xwks
缑	xwnd
緱	xwnd
纀	xwog
絍	xwtf
纷	xwvt
紛	xwvt
纖	xwwg
緃	xwwh
綌	xwwk
绤	xwwk
纵	xwwy
纶	xwxn
紷	xwyc
维	xwyg
維	xwyg
紟	xwyn
畿	xxal
幾	xxaw
繈	xxcj
紭	xxcy
毞	xxeb
缘	xxey
緣	xxey
坒	xxff
毕	xxfj
繩	xxg
丝	xxgf
鸶	xxgg
斷	xxgr
毙	xxgx
紖	xxhh
纼	xxhh
顈	xxim
鷥	xxio
絲	xxiy
綠	xxiy
绋	xxjh
紼	xxjh
繦	xxkj
比	xxn
弜	xxn
毖	xxnt
粊	xxou
勓	xxre
皆	xxrf
鶛	xxro
枈	xxsu
彘	xxtx
纰	xxxn
紕	xxxn
繼	xxxn
幺	xxxx
弴	xybg
綧	xybg
统	xycq
統	xycq
袰	xyeu
紸	xygg
弶	xyiy
綡	xyiy
緕	xyjg
纃	xyjg
縗	xyke
纕	xyke
缞	xyke
繵	xylg
缟	xymk
縞	xymk
编	xyna
編	xyna
綟	xynd
絯	xynw
綂	xyqn
鶭	xyqo
缡	xyrc
縭	xyrc
纺	xyt
紡	xyt
絒	xyth
縼	xyth
缔	xyuh
締	xyuh
織	xyuj
縍	xyuy
綷	xywf
繂	xyxf
縴	xyxg
纞	xyxn
婱	xyxv
弦	xyxy
絃	xyxy
纹	xyy
紋	xyy
诫	yaah
誡	yaah
试	yaay
試	yaay
諓	yaay
诺	yadk
諾	yadk
讛	yafc
諽	yafh
讧	yag
訌	yag
诓	yagg
誆	yagg
譁	yagg
衺	yahe
讶	yaht
訝	yaht
谟	yajd
謨	yajd
諎	yajg
譪	yajn
谨	yakg
謹	yakg
謳	yakk
讌	yako
䜩	yako
讙	yaky
講	yamf
讵	yang
詎	yang
詍	yann
谍	yans
諜	yans
谮	yaqj
譖	yaqj
讴	yary
護	yawc
诬	yaww
誣	yaww
誮	yawx
谎	yayk
謊	yayk
讘	ybbb
郭	ybbh
诹	ybcy
諏	ybcy
讔	yben
享	ybf
斈	ybf
斊	ybf
誀	ybg
邡	ybh
詜	ybhc
亨	ybj
嚲	ybkf
诎	ybmh
詘	ybmh
訑	ybn
烹	ybou
鹑	ybqg
鶉	ybqo
墪	ybtf
憝	ybtn
鐜	ybtq
撉	ybtr
敦	ybty
亸	ybuf
塾	ybvf
熟	ybvo
孰	ybvy
詖	yby
诐	yby
訯	ybyy
弃	ycaj
棄	ycas
諁	yccc
謲	ycce
育	ycef
诵	yceh
誦	yceh
逳	ycep
裛	yceu
译	ycgh
旀	yciy
袬	ycke
诒	yckg
詒	yckg
夣	yclq
袤	ycne
谲	ycnk
譎	ycnk
褭	ycoe
充	ycqb
诶	yctd
誒	yctd
誜	ycwt
訍	ycyy
詙	ydcy
詴	ydeg
顏	ydem
彥	yder
誫	ydfe
譇	ydfj
誇	ydfn
诂	ydg
詁	ydg
諴	ydgk
譿	ydhn
斋	ydmj
诚	ydnn
誠	ydnn
訧	ydny
诙	ydoy
詼	ydoy
謜	ydri
旑	ydsk
诪	ydtf
產	ydtg
讈	ydth
谌	ydwn
諶	ydwn
諆	ydwy
譭	yeac
驘	yecy
彣	yee
謟	yeeg
裒	yeeu
谖	yegc
諼	yegc
诅	yegg
詛	yegg
謏	yehc
蠃	yejy
臝	yejy
亹	yemg
斖	yemg
裔	yemk
赢	yemy
贏	yemy
誽	yeqn
鸁	yeqy
谣	yetb
謡	yetb
譌	yeto
衣	yeu
哀	yeu
羸	yeuy
嬴	yevy
谀	yewy
諛	yewy
謑	yexd
为	yeyi
詓	yfcy
譳	yfdj
诖	yffg
詿	yffg
謣	yffn
譊	yffq
诗	yffy
詩	yffy
詌	yfg
计	yfh
讦	yfh
計	yfh
訐	yfh
謓	yfhw
謿	yfje
讲	yfjh
诘	yfkg
詰	yfkg
譆	yfkk
讀	yflm
讟	yfly
谳	yfmd
諵	yfmf
读	yfnd
譸	yfnf
讳	yfnh
誌	yfny
誖	yfpb
読	yfpq
谋	yfsy
诔	yfsy
誄	yfsy
謀	yfsy
誟	yftb
诸	yftj
諸	yftj
褻	yfwe
讨	yfy
対	yfy
討	yfy
訮	ygah
贇	ygam
赟	ygam
斌	ygay
訰	ygbn
誈	ygcf
主	ygd
詽	ygdf
请	ygeg
請	ygeg
诼	ygey
諑	ygey
諘	ygey
訏	ygfh
譛	yggj
讃	yggm
证	yghg
証	yghg
譓	ygjn
语	ygkg
語	ygkg
讍	ygkk
諨	ygkl
謮	ygmy
瓬	ygny
迬	ygpd
謸	ygqt
评	yguf
評	yguf
誙	ygva
誱	ygvh
殶	ygwc
谑	yhag
謔	yhag
诽	yhdd
誹	yhdd
裵	yhde
韲	yhdg
謯	yheg
让	yhg
訨	yhg
讞	yhgd
諔	yhic
詀	yhkg
譃	yhog
斍	yhqb
誢	yhqn
謼	yhtf
卞	yhu
諕	yhwn
訿	yhxn
讣	yhy
訃	yhy
鹫	yidg
蹵	yidh
鷲	yido
就	yidy
诮	yieg
誚	yieg
勍	yiet
氷	yii
誻	yijg
剠	yijh
譡	yipl
讜	yipo
谠	yipq
鶁	yiqo
訬	yitt
京	yiu
斔	yjew
亯	yjf
斉	yjf
齊	yjf
裏	yjfe
裏	yjfe
髙	yjfk
詚	yjgg
諟	yjgh
諹	yjgr
刘	yjh
齑	yjhg
齏	yjhg
訷	yjhh
亰	yjiu
斎	yjiu
齋	yjiu
齐	yjj
亣	yjj
誯	yjjg
剂	yjjh
剤	yjjh
劑	yjjh
螡	yjju
螤	yjjw
谩	yjlc
謾	yjlc
齍	yjlf
齎	yjmu
恴	yjnu
齌	yjou
谒	yjqn
謁	yjqn
裹	yjse
课	yjsy
課	yjsy
謃	yjtg
蚉	yju
諿	ykbg
吝	ykf
误	ykgd
誤	ykgd
衰	ykge
训	ykh
訓	ykh
衷	ykhe
訲	ykhh
谴	ykhp
譴	ykhp
讉	ykhp
襄	ykke
勷	ykke
譂	ykkf
谔	ykkn
諤	ykkn
譟	ykks
讝	ykkt
瓤	ykky
詋	ykqn
识	ykwy
畆	ylcy
谓	yleg
謂	yleg
亩	ylf
畗	ylf
譯	ylff
訵	ylg
譞	ylge
褱	ylie
皽	ylkb
勯	ylke
氈	ylke
亶	ylkg
鹯	ylkg
禀	ylki
颤	ylkm
顫	ylkm
鸇	ylko
邅	ylkp
稟	ylkt
讄	ylll
諰	ylny
謰	ylpy
畝	ylqy
謱	ylvg
谡	ylwt
謖	ylwt
畒	ylwy
譨	ymae
諯	ymdj
詇	ymdy
调	ymfk
調	ymfk
詷	ymgk
讪	ymh
訕	ymh
市	ymhj
髜	ymka
鄗	ymkb
敲	ymkc
毃	ymkc
髝	ymke
高	ymkf
詗	ymkg
诇	ymkg
鶮	ymko
槀	ymks
髞	ymks
稾	ymkt
髛	ymkv
歊	ymkw
髚	ymkw
諣	ymnk
誷	ymun
讗	ymwk
讷	ymwy
訥	ymwy
肈	ynag
啔	ynak
邙	ynbh
誳	ynbm
譀	ynbt
戾	yndi
戻	yndi
户	yne
肩	yned
肓	ynef
望	yneg
顅	ynem
鵳	yneo
讯	ynfh
訊	ynfh
诩	yng
詡	yng
词	yngk
詞	yngk
扉	ynhd
諝	ynhe
谞	ynhe
盲	ynhf
訆	ynhh
扂	ynhk
永	ynii
昶	ynij
朚	ynje
蝱	ynjj
巟	ynkb
扈	ynkc
启	ynkd
吂	ynkf
諱	ynkg
啟	ynkt
扁	ynma
帍	ynmh
扃	ynmk
翩	ynmn
騗	ynmo
鶣	ynmo
遍	ynmp
甂	ynmy
记	ynn
記	ynn
氓	ynna
扇	ynnd
戺	ynnn
焈	ynno
忘	ynnu
戹	ynnv
譔	ynnw
誋	ynny
扊	ynoo
鳸	ynqo
扅	ynqq
謵	ynrg
杗	ynsu
郂	yntb
劾	ynte
肇	yntg
綮	ynti
刻	yntj
晵	yntj
啓	yntk
扄	yntk
谧	yntl
衁	yntl
謐	yntl
颏	yntm
賌	yntm
頦	yntm
棨	ynts
亥	yntw
欬	yntw
忞	ynu
悥	ynu
戽	ynuf
謘	ynuh
亡	ynv
妄	ynvf
肁	ynvg
谬	ynwe
謬	ynwe
顧	ynwm
雇	ynwy
诀	ynwy
訣	ynwy
訫	yny
房	ynye
扆	ynye
訳	ynyy
弈	yoaj
謶	yoao
孪	yobf
变	yocu
奕	yodu
亪	yogy
蛮	yoju
帟	yomh
峦	yomj
脔	yomw
恋	yonu
燮	yooc
爕	yooo
夑	yoot
谈	yooy
談	yooy
迹	yopi
谜	yopy
謎	yopy
銮	yoqf
鸾	yoqg
鵉	yoqo
挛	yorj
栾	yosu
変	yotu
亦	you
譵	youf
譧	youw
娈	yovf
弯	yoxb
詸	yoy
這	ypd
毫	ypeb
谊	ypeg
誼	ypeg
誴	ypfi
亴	ypfv
豪	ypge
諠	ypgg
諚	ypgh
这	ypi
谉	ypjh
膏	ypke
诨	yplh
諢	yplh
訦	ypqn
詝	ypsh
亭	ypsj
诧	ypta
亳	ypta
詫	ypta
讅	yptl
稁	yptu
亮	ypwb
詑	ypxn
諙	yqaj
诋	yqay
詆	yqay
謅	yqbt
诡	yqdb
詭	yqdb
谵	yqdy
譫	yqdy
谄	yqeg
諂	yqeg
椉	yqgs
謋	yqgs
誂	yqiy
询	yqjg
詢	yqjg
訽	yqkg
詺	yqkg
谗	yqku
讒	yqky
讂	yqmt
袌	yqne
鴍	yqou
諊	yqoy
鳼	yqoy
鴋	yqoy
袲	yqqe
誃	yqqy
詾	yqrb
謠	yqtb
诳	yqtg
誑	yqtg
诌	yqvg
诤	yqvh
諍	yqvh
訋	yqyy
离	yrbc
訩	yrbh
讻	yrbh
離	yrby
誵	yrde
諻	yrgg
诟	yrgk
詬	yrgk
訢	yrh
䜣	yrh
謕	yrhw
义	yri
謉	yrqc
褢	yrqe
訤	yrry
諀	yrtf
亵	yrve
譤	yryt
诉	yryy
訴	yryy
諲	ysfg
謤	ysfi
订	ysh
訂	ysh
諌	ysjg
谭	ysjh
譚	ysjh
诃	yskg
訶	yskg
誎	yskg
謌	yskk
谏	yslg
諫	yslg
諃	yssy
誺	ysww
誧	ysy
訹	ysyy
託	ytan
讬	ytan
斿	ytbg
施	ytbn
遊	ytbp
诱	ytbt
誘	ytbt
旇	ytby
话	ytdg
話	ytdg
旖	ytdk
譑	ytdk
旗	ytdw
訞	ytdy
膂	ytee
旄	yten
旟	ytew
膐	ytew
旅	ytey
许	ytfh
許	ytfh
诰	ytfk
誥	ytfk
讚	ytfm
誔	ytfp
诜	ytfq
詵	ytfq
诛	ytfy
誅	ytfy
袠	ytge
諈	ytgf
諥	ytgf
旆	ytgh
譕	ytgo
旊	ytgy
詄	ytgy
诈	ythf
詐	ythf
詯	ythg
诞	ythp
誕	ythp
旓	ytie
誗	ytjh
詻	ytkg
謥	ytln
谢	ytmf
謝	ytmf
斾	ytmh
旃	ytmy
旋	ytnh
讫	ytnn
訖	ytnn
為	ytno
旎	ytnx
旙	ytol
譒	ytol
旐	ytqi
謻	ytqq
旂	ytrh
誐	ytry
旚	ytsi
族	yttd
旌	yttg
旛	yttl
鷟	ytto
旞	ytup
诿	ytvg
諉	ytvg
帰	ytvh
旍	ytwc
旝	ytwj
譗	ytwk
斻	ytwn
诲	ytxy
誨	ytxy
放	yty
訸	yty
旜	ytyg
州	ytyh
旒	ytyk
譲	yuae
誁	yuah
戠	yuaj
譋	yueg
譾	yuen
譢	yuep
谫	yuev
謭	yuev
詊	yugh
議	yugy
详	yuh
詳	yuh
谙	yujg
諳	yujg
譩	yujn
说	yukq
説	yukq
譄	yulj
啇	yumd
商	yumk
適	yump
敵	yumt
歒	yumw
甋	yumy
諩	yuog
谱	yuoj
譜	yuoj
帝	yuph
啻	yupk
鶙	yupo
遆	yupp
覫	yupq
旁	yupy
讇	yuqe
谘	yuqk
諮	yuqk
詨	yury
譐	yusf
谰	yusl
斓	yusl
斕	yusl
讕	yusl
谚	yute
諺	yute
谦	yuvw
謙	yuvw
谥	yuwl
謚	yuwl
郎	yvbh
郞	yvbh
郎	yvbh
詉	yvcy
塱	yvef
朗	yveg
勆	yvet
旔	yvgp
良	yvi
剆	yvjh
郒	yvkc
诏	yvkg
詔	yvkg
訅	yvn
誛	yvpc
欴	yvqw
詪	yvy
譅	yvyh
認	yvyn
訒	yvyy
訙	yvyy
讱	yvyy
亢	ywb
邟	ywbh
设	ywcy
讼	ywcy
訟	ywcy
設	ywcy
颃	ywdm
頏	ywdm
诊	ywet
劥	ywet
診	ywet
裦	ywfe
褎	ywfe
褏	ywfe
襃	ywfe
詂	ywfy
論	ywga
讑	ywga
诠	ywgg
詮	ywgg
谕	ywgj
諭	ywgj
譮	ywgj
詥	ywgk
諡	ywgl
證	ywgu
譣	ywgw
亱	ywjg
斺	ywjh
褒	ywke
說	ywkq
讥	ywn
詤	ywnk
迒	ywpv
讽	ywry
諷	ywtj
鵺	ywto
夜	ywty
乻	ywun
旕	ywux
於	ywuy
訜	ywvt
卒	ywwf
谶	ywwg
讖	ywwg
顇	ywwm
雜	ywwy
论	ywxn
讹	ywxn
訛	ywxn
认	ywy
詅	ywyc
謢	ywyc
﨎	ywyc
谁	ywyg
誰	ywyg
誝	ywyk
謒	ywyk
谂	ywyn
訡	ywyn
諗	ywyn
谯	ywyo
譙	ywyo
訉	ywyy
詏	yxet
譝	yxg
訠	yxhh
率	yxif
玅	yxit
紊	yxiu
诣	yxjg
詣	yxjg
鄐	yxlb
畜	yxlf
謴	yxmy
牽	yxpg
罋	yxtb
玈	yxte
壅	yxtf
譺	yxth
饔	yxtv
雍	yxty
甕	yxty
玄	yxu
孿	yxxb
奱	yxxd
卛	yxxf
矕	yxxh
灓	yxxi
曫	yxxj
蠻	yxxj
巒	yxxm
戀	yxxn
鸞	yxxo
鑾	yxxq
谐	yxxr
攣	yxxr
諧	yxxr
欒	yxxs
變	yxxt
孌	yxxv
臠	yxxw
譏	yxxw
彎	yxxx
䜌	yxxy
孶	yxyb
玆	yxyx
誸	yxyx
谆	yybg
諄	yybg
譈	yybt
旈	yyck
堃	yyff
亠	yyg
誩	yyg
訁	yygg
註	yygg
方	yygt
文	yygy
谅	yyiy
諒	yyiy
讓	yyke
譠	yylg
丶	yyll
謞	yymk
讠	yyn
谝	yyna
斒	yyna
諞	yyna
詠	yyni
謆	yynn
该	yynw
該	yynw
譹	yype
諪	yyps
謧	yyrc
议	yyry
访	yyt
訪	yyt
詶	yyth
谪	yyud
謫	yyud
谛	yyuh
諦	yyuh
旘	yyuj
識	yyuj
謪	yyuk
讁	yyup
谤	yyuy
謗	yyuy
斏	yyvy
誏	yyvy
谇	yywf
誶	yywf
詃	yyxy
譶	yyyf
言	yyyy
