〇	lgoo
一	ykvv
丁	dgvi
七	qkva
万	mlva
丏	mmvi
丐	ghvi
丕	pkvu
世	ekvi
丘	qqui
丙	bgvi
丝	skaa
丞	jrai
严	yfvi
丫	ysou
串	wtia
丽	lkvi
乇	tluv
义	ykou
乍	fsuv
乓	ppui
乙	ykaa
乜	mdaa
乜	ndaa
习	xkao
乳	rjuo
乸	nsai
乾	gfuo
乾	qmuo
予	ylao
井	jgvv
亘	gnvo
亚	ysvi
些	sliv
亟	qkai
亡	wpov
亢	kpov
亥	hhov
亨	hrov
享	xxov
京	jgov
亭	tgov
亮	lxov
亳	blov
人	rnii
亿	ykia
什	eniu
仃	dgiv
仄	zevu
仅	jbia
仆	pjii
仇	qqiu
仉	qpiu
今	jbio
介	jdiu
仑	lwiu
仔	zkia
仕	ekiv
仗	qpiv
仙	xmii
仝	tyiv
仞	rnia
仟	qmiu
仨	ssiv
仪	ykio
仰	ypiu
仲	fyii
仳	pkiv
件	jmiu
价	jsii
伉	kpio
伎	qkiu
伏	fjiv
伐	fsiv
优	ydiv
伙	hlio
伟	wwiv
传	ftiv
伢	ysiv
伤	epiu
伥	jpiu
伦	lwii
伧	jnii
伪	wwio
伯	bliu
估	gjiu
伴	bfio
伺	ckia
伽	qdia
佃	dmii
佃	tmii
佐	zliv
佘	eeiv
佛	flia
佝	gdiu
佞	ngiv
佣	yyiu
佤	wsiv
佯	ypio
佰	bhiv
佳	jsiv
佴	nhiv
佴	xjiv
佻	tciu
佼	jcio
佽	ckio
侈	wkiu
侉	kqiv
侗	dyii
侣	llio
侥	jciv
侥	yziv
侦	qnii
侧	fhia
侧	qhia
侨	qciu
侩	kgii
侮	wjiu
侯	hdia
侴	hziv
便	pmiv
俅	qqiv
俍	lxio
俏	qcii
俐	lkiu
俦	wdiv
俨	yfiv
俪	lkiv
俯	fjio
俱	jlii
俳	phii
俵	bciv
俶	jjii
俸	friv
俺	xfiv
俾	bkiu
倌	gtio
倍	bwio
倔	jhia
倘	tpii
倚	ykiv
倜	tkiu
借	jdiv
倥	kyio
倦	jtio
倧	zyio
倩	qgiv
倩	qmiv
倪	nkiu
倴	bniv
债	fhiv
债	qhiv
倻	yeiv
值	fkiu
偈	jdio
偕	xdiv
偡	qfiv
健	jmia
偭	mmiv
偲	chii
偶	xdii
偾	fniu
偿	jpii
傀	gbiu
傀	kbiu
傍	bpio
傒	xkiu
傧	bbio
傩	nlia
僇	ljia
僔	zwio
僦	jqio
僮	fmio
僮	fxio
僮	tyio
僰	blvi
僳	sjiv
僵	jxiv
僻	pkia
儴	rpio
兀	wjvu
兆	fzuo
兆	qzuo
兔	tjua
兢	jguo
兴	xgoo
具	jlia
典	dmia
兹	zkou
兼	jmou
兽	edou
冀	jkiv
冏	jyia
冕	mmia
冗	ryoa
冠	gtoa
冢	fyoa
冤	ytoa
冥	mgoa
冮	gpov
冯	frov
冯	pgov
冰	bgov
冱	hjov
冶	yeov
冻	dyov
冽	ldov
凋	dcov
凌	lgov
凛	lbov
凡	ffua
凰	hmua
凰	hxua
凶	xyuo
凸	tjiv
凹	xzia
击	jkvv
函	hfai
凿	zzii
刃	rnau
刊	kfvv
刎	wnua
制	fkuv
刹	esuo
刻	keov
刽	gbiv
剀	khia
剁	dlua
剃	tkou
削	xhio
剋	kwuo
剌	lsvi
剐	gqoi
剑	jmiv
剖	pdov
剟	dlao
剥	blav
剧	jlav
功	gyvi
务	wjua
劣	ldiu
助	qjia
努	njau
劫	jdvo
劬	qlua
劲	jbao
勃	bluo
勃	bwuo
勉	mmua
勒	lwvi
勔	mmvu
勖	xlia
勘	kfvi
勤	qbvi
勰	xdau
勺	ezua
勾	gdua
匈	xyua
匍	pjua
匕	bkua
匙	ekoi
匙	wkoi
匚	fpva
匝	zsvi
匡	kmvv
匡	kxvv
匣	xsvi
匮	kbvi
匾	bmvo
升	eruv
卉	hbuo
华	hqiu
卑	bwui
卒	cjov
卓	fliv
单	jfou
卜	bjio
卫	wwai
卬	ypua
危	wwua
卸	xduv
卺	jbai
厂	jpvu
厄	xevu
历	lkvu
厌	yfvu
厍	eevu
厖	mpvu
厝	clvu
厢	xxvu
厦	xsvu
厩	jqvu
厮	skvu
厶	skao
厾	djav
参	cnao
叉	wsao
及	jkua
友	ydvu
叙	xliv
叛	pfou
叟	sdui
叠	ddao
口	kdoo
叨	tzoa
叭	bsou
叭	psou
叮	dgov
叱	wkou
史	ekia
叵	plvo
叶	xdou
叶	yeou
叻	leoa
叼	dcoa
叽	jkou
吉	jkvo
吊	dcoi
吋	cwov
吓	xsov
吕	lloo
吖	xsoo
吖	ysoo
君	jwav
吟	yboi
吠	fwov
吣	qboo
启	qkoa
吱	fkou
吲	yboa
吴	wjov
吵	jzoi
吵	wzoi
吸	xkou
吻	wnou
吼	hdoa
吾	wjvi
呐	neoi
呐	nsoi
呔	dhov
呔	thov
呕	xdov
呙	gloi
呜	wjou
呤	lgoi
呱	gqou
呲	ckoi
呲	zkoi
呵	heov
呶	nzoa
呻	enoi
呼	hjou
咀	zboi
咂	zsov
咄	dloa
咆	pzou
咋	fsou
咏	yyoo
咐	fjoi
咒	fdoo
咔	ksoi
咕	gjou
咖	gsoa
咖	jsoa
咚	dyou
咛	ngoo
咣	gmoi
咣	gxoi
咤	fsoo
咩	mdoo
咯	geou
咯	ksou
咯	llou
咳	hhoo
咳	keoo
咸	xmvu
咻	xqoi
咽	yeoi
咽	yfoi
哂	enov
哃	tyoi
哄	hyov
哆	dlou
哇	wsov
哎	xhoi
哏	hnoa
哑	ysov
哒	dsov
哓	xcov
哝	nyoo
哞	mdoa
哥	gevo
哦	xeou
哧	wkov
哨	ezoi
哩	lkoi
哪	neoa
哮	xcou
哲	feiu
哲	qeiu
哺	bjov
哽	grov
哿	geau
唆	sloa
唇	jwvu
唉	xhoa
唔	xnov
唝	gyov
唠	lzoi
唢	sloi
唬	hjoi
售	edio
唯	wwoi
唳	lkoo
唼	esoo
啁	fdou
啁	tcou
啄	flov
啕	tzou
啜	wgoa
啡	fwoi
啤	pkou
啧	zeov
啫	feou
啫	qeou
啮	ndoi
啰	lloi
啴	tfoo
啵	bloa
啶	dgoo
啷	lpoo
啸	xcoa
啼	tkoo
啾	jqou
喀	ksoo
喆	fevo
喆	qevo
喏	nloi
喔	wloa
喔	xloa
喝	yeoo
喟	kboi
喧	xtoo
喰	cfoi
喳	fsov
喵	mcoi
喹	kbov
喻	yloi
喽	ldoo
嗄	esov
嗅	xqou
嗉	sjov
嗍	sloo
嗒	dsoi
嗔	jnou
嗜	ekou
嗝	geov
嗞	zkoo
嗟	jdoo
嗤	wkoa
嗥	hzou
嗨	hhoa
嗪	qbov
嗫	ndov
嗬	heoi
嗲	dsou
嗳	xhou
嗵	tyoa
嗷	xzov
嗼	mloi
嗽	sdov
嗾	sdoo
嘀	dkoo
嘈	czov
嘉	jsvo
嘘	xloi
嘟	djou
嘡	tpoi
嘣	broi
嘤	ygoa
嘬	wgoo
嘬	zloo
嘭	prov
嘲	jzou
嘲	wzou
嘶	skov
嘻	xkov
噂	zwoo
噌	croo
噔	droa
噘	jhov
噙	qboi
噜	ljou
噢	xlou
噤	jbov
器	qkoo
噩	xevi
噪	zzoo
噻	shoo
嚄	hloi
嚅	rjov
嚎	hzoo
嚓	wsoo
嚯	hlov
嚼	jcou
囡	nfia
囱	cyui
围	wwia
囵	lwia
圃	pjia
圆	ytia
圈	jtia
圜	htia
圩	wwvo
圭	gbvo
圲	qmvo
圹	kmvo
圹	kxvo
圻	qkvo
坂	bfvo
坉	twvo
坎	kfvo
坐	zlii
坚	jmii
坛	tfvo
坝	bsvo
坟	fnvo
坨	tlvo
坫	dmvo
坬	gqvo
坳	xzvo
坶	mjvo
坷	kevo
坻	dkvo
垅	lyvo
垆	ljvo
型	xgvv
垌	dyvo
垌	tyvo
垏	llvo
垒	lwao
垓	ghvo
垙	gmvo
垙	gxvo
垛	dlvo
垟	ypvo
垢	gdvo
垦	knav
垧	epvo
垫	dmiu
垭	ysvo
垯	dsvo
垱	dpvo
垲	khvo
垴	nzvo
垸	htvo
垾	hfvo
埂	grvo
埃	xhvo
埏	efvo
埔	pjvo
埕	jrvo
埙	xwvo
埝	nmvo
域	ylvo
埠	bjvo
埪	kyvo
埫	wyvo
埭	dhvo
基	jkvi
堀	kjvo
堃	kwov
堋	brvo
堍	tjvo
堑	qmva
堙	ybvo
堠	hdvo
堡	bzio
堨	xevo
堵	djvo
堽	gpvo
堾	wtvo
塄	lrvo
塅	dtvo
塌	tsvo
塍	jruo
塑	sjou
墁	mfvo
境	jgvo
墐	jbvo
墓	mjii
墙	qxvo
墟	xlvo
墦	ffvo
墩	dwvo
壁	bkav
士	ekvo
壮	fmov
壮	fxov
壳	qcvo
壶	hjvo
壸	kwvo
壹	ykvo
夔	kbou
夕	xkua
夙	sjua
夥	hlia
夫	fjvv
夭	yzuv
央	ypia
夯	hpvu
失	ekuv
夷	ykva
夹	gsvo
奇	qkvu
奈	nhvu
奉	frvv
奖	jxov
奘	zpai
奠	dmou
奡	xzvu
奸	jmau
妃	fwau
妍	yfau
妒	djau
妗	jbau
妥	tluo
妨	fpau
妩	wjau
妫	gbau
妭	bsau
妮	nkau
妯	fdau
妾	qdov
姆	mjau
姈	lgau
姊	zkau
姒	skau
姗	efau
姚	yzau
姜	jxou
姨	ykau
姿	zkov
娀	syau
威	wwvu
娄	ldou
娅	ysau
娇	jcau
娉	pgau
娌	lkau
娑	slai
娓	wwau
娜	nsau
娟	jtau
娥	xeau
娩	mmau
娲	wsau
娶	qlvi
婉	wfau
婕	jdau
婘	qtau
婚	hwau
婞	xgau
婢	bkau
婧	jgau
婪	lfvv
婳	hqau
婴	ygao
婵	jfau
婶	enau
婷	tgau
婼	rlau
婿	xlau
媆	rtau
媒	mwau
媖	ygau
媞	tkau
媪	xzau
媲	pkau
媵	yguo
媸	wkau
嫂	szau
嫌	xmau
嫒	xhau
嫔	pbau
嫖	pcau
嫘	lwau
嫚	mfau
嫜	qpau
嫦	jpau
嫪	lzau
嫱	qxau
嫽	lcau
嬛	xtau
嬢	nxau
嬥	tcau
嬬	rjau
嬲	ncia
孓	jhai
孕	ywau
孖	msai
孜	zkai
孝	xcuo
孢	bzai
孤	gjai
孩	hhai
孪	ltov
孰	ejov
孱	cfav
孱	jfav
孺	rjai
宄	gboo
守	edoo
宍	rdoo
宕	dpoo
宛	wfoo
宛	ytoo
宜	ykoo
宠	wyoo
室	ekoo
宥	ydoo
宦	htoo
宪	xmoo
宬	jroo
宰	zhoo
宴	yfoo
宵	xcoo
宿	sjoo
宿	xqoo
寁	zfoo
寄	jkoo
寅	yboo
富	fjoo
寐	mwoo
寒	hfoo
寓	yloo
寞	mloo
寥	lcoo
寸	cwvi
寺	skvo
导	dzav
封	frvo
射	yeui
射	ykui
尅	keuo
将	qxov
尔	xjua
尜	gsiu
尝	jpio
尧	yzva
尪	wpvu
尴	gfvu
尸	ekav
尹	ybav
尺	jeav
尺	weav
尺	wkav
尾	wwav
尿	sbav
屉	tkav
屌	dcav
屑	xdav
屙	xeav
属	ejav
属	qjav
屠	tjav
屡	llav
屮	czai
岂	qkia
岔	wsuo
岗	gpia
岘	xmia
岙	xzuv
岚	lfia
岞	zlia
岣	gdia
岫	xqia
岭	lgia
岳	yhui
岷	mbia
岸	xfia
峋	xwia
峏	xjia
峒	dyia
峭	qcia
峻	jwia
崀	lpia
崂	lzia
崆	kyia
崇	wyia
崒	zjia
崤	xcia
崽	zhia
崾	yzia
嵊	eria
嵘	ryia
嵩	syia
嵯	clia
嵲	ndia
嶓	blia
嶙	lbia
嶝	dria
嶟	zwia
川	wtui
巢	jzaa
巢	wzaa
差	jhou
巯	qqao
己	jkav
巳	skav
巷	hpvi
币	bkui
市	ekov
帆	ffia
师	ekiu
希	xkuo
帐	qpia
帑	tpau
帔	pwia
帖	tdia
帛	blui
帝	dkov
帡	pgia
帧	qnia
帨	ebia
帱	dzia
帻	zeia
帽	mzia
幅	fjia
幌	hmia
幌	hxia
幔	mfia
幖	bcia
幢	fmia
幢	fxia
幢	wmia
幢	wxia
幸	xgvo
幺	yzaa
幻	htaa
幼	ydaa
庆	qgov
庇	bkov
庋	gbov
序	xlov
庥	xqov
度	dlov
庳	bwov
庵	xfov
庸	yyov
庹	tlov
廉	lmov
廊	lpov
廓	klov
廛	jfov
廷	tguv
异	ykav
弃	qkov
弄	lyvv
弊	bkou
式	ekvv
弗	fjav
弟	dkou
弦	xmav
弧	hjav
弨	jzav
弨	wzav
弪	jgav
弭	mkav
弯	wfov
彐	xhav
录	ljav
彖	ttaa
彟	hlav
彤	tyua
彩	chuo
彭	prvo
彰	qpov
彳	wkuu
彷	ppuu
役	ykuu
彼	bkuu
征	qruu
徂	cjuu
徇	xwuu
徉	ypuu
徐	xluu
徕	lhuu
徘	phuu
徙	xkuu
徜	jpuu
御	yluu
徨	hmuu
徨	hxuu
徭	yzuu
微	wwuu
徼	jcuu
徽	hbuu
忏	jfoo
忐	tfiv
忑	tevi
志	fkvo
忝	tmvv
忞	mbov
忠	fyia
忪	fyoo
忪	syoo
忱	jnoo
忳	twoo
忻	xboo
忽	hjua
忾	khoo
忿	fnuo
怂	syii
怅	jpoo
怆	wmoo
怆	wxoo
怊	jzoo
怊	wzoo
怏	ypoo
怔	qroo
怖	bjoo
怛	dsoo
怜	lmoo
思	skia
怠	dhao
怦	proo
怩	nkoo
怯	qdoo
怵	jjoo
怼	dbao
恂	xwoo
恒	hroo
恕	ejau
恚	hbvo
恤	xloo
恫	dyoo
息	xkui
恸	tyoo
悃	kwoo
悔	hboo
悖	bwoo
悛	qtoo
悟	wjoo
悠	ydii
悢	lxoo
悦	yhoo
悯	mboo
悱	fwoo
悴	cboo
悼	dzoo
惆	wdoo
惇	dwoo
惊	jgoo
惑	hlvo
惘	wpoo
惙	wloo
惚	hjoo
惛	hwoo
惜	xkoo
惝	tpoo
惟	wwoo
惠	hbvi
惦	dmoo
惧	jloo
惩	jruu
惫	bwua
惭	cfoo
惮	dfoo
惯	gtoo
惰	dloo
惶	hmoo
惶	hxoo
愆	qmuu
愈	yliv
愍	mbav
愎	bkoo
愐	mmoo
愕	xeoo
愠	ywoo
愤	fnoo
愿	ytvu
慆	tzoo
慈	ckou
慎	enoo
慑	eeoo
慧	hbvv
慷	kpoo
憎	zroo
憝	dbov
憧	fmoo
憧	fxoo
憨	hfav
懈	xdoo
懊	xzoo
懋	mzva
懒	lfoo
懔	lboo
懦	nloo
懵	mroo
戈	geva
戉	yhva
戋	jmvv
戌	xlvu
戎	ryvv
戒	jdvv
戛	gsvu
戛	jsvu
戟	jkuo
戣	kbao
戤	ghau
截	jduo
戳	wlao
戴	dhuo
房	fpoa
扁	bmoa
扁	pmoa
扂	dmoa
扃	jyoa
扇	efoa
扈	hjoa
扎	fsiu
扒	bsiu
扒	psiu
扛	gpiu
扯	jeiu
扯	weiu
扳	bfiu
扶	fjiu
扼	xeiu
抃	bmiu
抑	ykiu
抒	ejiu
抔	pdiu
投	tdiu
抠	kdiu
抢	jriu
抨	priu
抱	bziu
抵	dkiu
抹	mliu
抻	jniu
抿	mbiu
拄	qjiu
拇	mjiu
拌	pfiu
拎	lbiu
拒	jliu
拓	tliu
拓	tsiu
拗	nqiu
拗	xziu
拙	fliu
拚	pbiu
拜	bhiu
拦	lfiu
拯	qriu
拱	gyiu
拳	qtou
拶	zfiu
拶	zsiu
挈	qdvv
挖	wsiu
挝	wliu
挟	jsiu
挡	dpiu
挤	jkiu
挥	hbiu
挨	xhiu
挫	cliu
挫	zliu
振	qniu
挲	ssai
挺	tgiu
挼	rliu
捃	jwiu
捅	tyiu
捋	lliu
捕	bjiu
捞	lziu
捣	dziu
捶	wbiu
捺	nsiu
掀	xmiu
掇	dliu
授	ediu
掐	qsiu
掖	yeiu
掘	jhiu
掠	lhiu
掣	jeuv
掣	weuv
掩	yfiu
掭	tmiu
掴	ggiu
掴	gliu
掸	dfiu
掺	cfiu
掺	efiu
掼	gtiu
揄	yliu
揎	xtiu
描	mciu
揞	xfiu
揠	ysiu
揣	fbiu
揣	ttiu
揩	khiu
揪	jqiu
揲	ddiu
援	ytiu
搀	jfiu
搁	geiu
搅	jciu
搌	qfiu
搐	jjiu
搒	bpiu
搠	eliu
搢	jbiu
搦	nliu
搪	tpiu
搭	dsiu
携	xdiu
摄	eeiu
摄	ndiu
摇	yziu
摊	tfiu
摏	wyiu
摧	cbiu
摹	mlii
摽	bciu
撄	ygiu
撕	skiu
撩	lciu
撵	nmiu
撸	ljiu
撺	ctiu
撼	hfiu
擎	qgii
擐	htiu
擒	qbiu
擗	pkiu
擞	sdiu
擤	xgiu
攥	ztiu
攰	gbuo
攴	pliv
政	qrvi
敌	dkuv
敛	lmiv
敦	dwov
敬	jgii
敲	qcov
斋	fhov
斋	qhov
斐	fwiv
斑	bfvv
斓	lfov
斝	jsoo
斟	qnvi
斤	jbuu
斫	flvu
斯	skvi
斶	jjuu
旄	mzov
旅	llov
旆	pwov
旋	xtov
旎	nkov
族	zjov
旐	fzov
旐	qzov
旞	sbov
无	mlvv
旦	dfoi
旨	fkua
旬	xwua
旭	xlua
旯	lsoi
旰	gfoi
旱	hfoi
旸	ypoi
旺	wpoi
昀	ywoi
昃	zeoi
昄	bfoi
昇	eroi
昉	fpoi
昊	hzoi
昌	jpoi
易	ykoi
昔	xkvi
昕	xboi
昙	tfoi
昝	zfua
星	xgoi
映	ygoi
昣	qnoi
昧	mwoi
昨	zloi
昪	bmoi
昭	fzoi
昭	qzoi
昴	mzoi
昵	nkoi
昶	jpoa
昺	bgoi
昽	lyoi
晃	hmoi
晃	hxoi
晋	jbvi
晌	epoi
晐	ghoi
晓	xcoi
晙	jwoi
晟	jroi
晡	bjoi
晤	wjoi
晦	hboi
景	jgoi
晰	xkoi
晴	qgoi
晾	lxoi
暄	xtoi
暇	xsoi
暑	ejoi
暗	xfoi
暝	mgoi
暲	qpoi
暴	bzoi
曛	xwoi
曜	yzoi
曩	npoi
更	jgvi
曼	mfoi
月	yhuu
朏	fwuo
朐	jwuu
朓	tcuu
朔	elou
期	qkvi
朦	mrui
木	mjvv
术	ejvo
朳	bsvu
朴	plvi
杄	qmvu
杆	gfvv
杉	efvu
李	lkva
杓	ezvu
杖	qpvv
杜	djvv
束	ejvi
杧	mpvo
杩	msva
杲	gzoi
杳	yzvo
杷	psva
杼	qjva
板	bfvu
极	jkvu
枉	wpvv
枋	fpvo
析	xkvu
枕	qnvo
枚	mwvu
果	glia
枝	fkvu
枞	cyvi
枢	ejvv
枣	zzvi
枫	frvu
枭	xcua
枯	kjvu
枰	pgvv
枷	jsva
枸	gdvu
枸	jlvu
枹	bzvu
柈	pfvo
柏	bhvu
柏	blvu
柖	ezva
柘	fevv
柘	qevv
柜	gbvv
柞	zlvu
柬	jmvi
柯	kevv
柰	nhvv
柱	qjvo
柴	jhiv
栅	cevu
栅	fsvu
栋	dyvv
栌	ljvi
栎	yhvu
栐	yyvo
栒	xwvu
栖	xkvv
栝	gqvu
栟	bnvo
校	jcvo
栩	xlva
株	qjvu
栳	lzvu
栴	qfvu
格	gevu
栽	zhuo
桀	jdua
桁	hrvu
桃	tzvu
桉	xfvo
桎	fkvv
桐	tyvi
桔	jlvv
桠	ysvv
桧	gbvi
桫	slva
桷	jhvu
梃	tgvu
梏	gjvu
梗	grvv
梢	szvi
梣	jnvi
梨	lkuv
梯	tkvo
械	xdvv
梴	jfvu
梾	lhvv
棁	flvo
棂	lgva
棋	qkvv
棒	bpvv
棠	tpio
棣	dkva
棣	tkva
棤	qhvv
棬	qtvo
棰	wbvu
棵	kevi
棹	flvi
棹	fzvi
棹	qzvi
椁	glvo
椆	wdvu
椋	lxvo
椎	fbvi
椎	wbvi
椒	jcvi
椟	djvu
椤	llvi
椰	yevv
椹	envv
楂	fsvv
楂	wsvv
楗	jmva
楚	jjvv
楞	lrvi
楣	mwva
楦	xtvo
楪	ddvv
楱	cdvv
楸	qqvu
榀	pbvo
榃	tfvv
榄	lfvi
榅	wnvo
榉	jlvo
榔	lpvo
榕	ryvo
榜	bpvo
榧	fwvv
榨	fsvo
榱	cbvo
榷	qhvo
槃	pfuu
槔	gzvu
槜	zbvi
槟	bbvo
槟	bgvo
槭	sevv
槱	ydvv
槲	hjvu
槽	czvv
樊	ffvu
樟	qpvo
模	mjvi
模	mlvi
樨	xkva
樯	qxvu
樱	ygva
橄	gfva
橇	qcvu
橐	tlvi
橑	lcvv
橘	jlva
橙	jrva
橛	jhvv
檞	jdvu
檫	wsvo
欠	qmua
欢	htao
欤	ylva
欲	yluo
欸	xhao
欸	xwao
歃	esuv
歇	xdoi
歉	qmou
止	fkiv
武	wjvv
歧	qkiv
歹	dhvu
歼	jmvu
殁	mlvu
殃	ypvu
殄	tmvu
殇	epvu
殊	ejvu
殍	pcvu
殒	ywvu
殓	lmvu
殡	bbvu
殣	jbvu
殳	ejua
殴	xdvu
殷	ybuu
毋	wjaa
毙	bkva
毡	qfuv
毫	hzov
毳	cbuv
毳	qcuv
毵	sfao
氆	pjuv
氇	ljuv
氓	mpov
氓	mrov
氙	xmuv
氚	wtuv
氢	qguv
氤	ybuv
氩	ysuv
氮	dfuv
氲	ywuv
水	ebaa
氽	twia
氾	ffaa
汁	fkau
汆	ctuo
汈	dcaa
汊	wsaa
汋	flau
汔	qkau
汕	efai
池	wkaa
污	wjav
汩	gjao
汰	thav
汶	mnao
汶	wnao
汾	fnau
沈	enao
沌	twav
沐	mjav
沓	dsao
沛	pwav
沟	gdau
沣	frav
沦	lwai
沨	frau
沩	wwao
沪	hjao
沫	mlav
沮	jlai
沱	tlao
沲	dlau
沲	tlau
沸	fwaa
油	ydai
沺	tmai
沼	fzaa
沼	qzaa
沽	gjau
沾	qfai
泃	jlau
泇	jsaa
泊	blau
泌	bkao
泌	mkao
泓	hyaa
泔	gfav
泖	mzau
泗	skai
泙	prav
泚	ckai
泣	qkao
泮	pfao
泰	thvv
泳	yyao
泵	brvu
泷	emav
泷	exav
泷	lyav
泸	ljai
泻	xdao
泼	plaa
泾	jgaa
洁	jdav
洄	hbai
洌	ldav
洓	seav
洗	xkau
洘	kzau
洚	jxau
洛	llau
洢	ykai
洨	xcao
洭	kmav
洭	kxav
洴	pgao
洵	xwau
洸	gmai
洸	gxai
洹	htav
洺	mgau
洼	wsav
浃	jsav
浅	qmav
浇	jcav
浈	qnai
浉	ekai
济	jkao
浏	lqao
浑	hwao
浒	xlao
浜	bpau
浞	flao
浭	grav
浮	fjau
浴	ylau
浸	jbaa
涄	pgai
涌	yyaa
涑	sjav
涓	jtao
涛	tzav
涝	lzai
涞	lhav
涟	lmav
涢	ywao
涣	htau
涤	dkau
涫	gtao
涴	wfao
涵	hfaa
涸	heai
涿	flav
淀	dmao
淄	zkaa
淆	xcau
淌	jpai
淌	tpai
淖	flai
淖	wlai
淠	pkai
淠	pwai
淡	dfao
淦	gfai
淫	ybau
淬	cbao
淳	jwao
淳	qwao
淴	hjau
淹	yfav
淼	mcaa
渊	ytau
渍	zkav
渐	jmav
渑	erao
渑	mmao
渗	enaa
渚	qjau
渟	tgao
渠	qlav
渣	fsav
渰	yfai
渴	heao
游	ydao
渺	mcai
渼	mwao
湃	phai
湄	mwaa
湉	tmao
湎	mmav
湘	xxav
湛	qfav
湟	hmau
湟	hxau
湫	qqau
湴	bfao
湿	ekao
溅	jmaa
溇	ldao
溉	ghaa
溍	jbav
溏	tpao
源	ytav
溘	keav
溚	dsai
溜	lqau
溠	fsao
溥	pjav
溯	sjao
溱	qbav
溱	qnav
溴	xqau
溷	hwai
溹	slau
溺	ncaa
溺	nkaa
溻	tsao
滆	geav
滇	dmau
滉	hmao
滉	hxao
滋	zkao
滔	tzau
滘	jcao
滞	fkav
滠	eeav
滢	ygai
滤	llai
滧	yzao
滩	tfaa
滫	xqai
滹	hjai
漆	qkav
漋	lyaa
漓	lkao
演	yfao
漤	lfav
漦	wkvv
漩	xtao
漯	tsai
漴	wyai
漶	htai
漷	hlao
漼	cbai
漾	ypao
潇	xcai
潋	lmai
潢	hmav
潢	hxav
潦	lcav
潦	lzav
潭	tfav
潵	sfav
潸	efav
潺	jfaa
潼	tyao
潾	lbao
澄	draa
澄	jraa
澛	ljau
澜	lfao
澧	lkai
澪	lgav
澶	jfao
澹	dfau
澹	tfau
激	jkau
濂	lmao
濋	jjav
濒	bbai
濛	mrai
濠	hzao
濡	rjav
濩	hlai
濮	pjai
濯	flaa
瀌	bcao
瀑	bzao
瀑	pjao
瀚	hfau
瀣	xdai
瀵	fnao
瀹	yhai
灈	qlai
灌	gtai
灞	bsav
灶	zzou
灸	jqua
灼	flou
灿	cfou
炅	jyoi
炌	khou
炔	gbou
炔	qhou
炖	dwou
炘	xbou
炣	keou
炫	xtou
炬	jlou
炭	tfia
炯	jyou
炳	bgou
炼	lmou
烃	tgou
烔	tyou
烘	hyou
烙	lzou
烛	qjou
烟	yfou
烩	hbou
烫	tpaa
烬	jbou
烷	wfou
烺	lpou
烽	frou
焊	hfou
焌	qlou
焕	htou
焖	mnou
焘	dzvv
焘	tzvv
焙	bwou
焚	fnvv
焜	kwou
焞	twou
煅	dtou
煋	xgou
煌	hmou
煌	hxou
煜	ylou
煞	esua
煤	mwou
煨	wwou
煮	qjuo
煴	ywou
煸	bmou
煺	tbou
煽	efou
熇	heou
熏	xwuv
熘	lqou
熛	bcou
熜	cyou
熨	ywav
熳	mfou
熵	epou
熹	xkvo
燎	lcou
燔	ffou
爆	bzou
爚	yhou
爟	gtou
爨	ctui
爪	fzuu
爪	qzuu
爰	ytuo
爵	jhuo
父	fjuo
爸	bsuo
爹	dduo
爿	pfai
牁	keai
牍	djui
牒	ddui
牖	ydui
牝	pbuv
牟	mjao
牥	fpuv
牦	mzuv
牻	mpuv
犀	xkav
犇	bnuv
犏	pmuv
犒	kzuv
犬	qtvu
犴	hfua
犴	xfua
犷	gmua
犷	gxua
狁	ywua
狄	dkua
狍	pzua
狎	xsua
狒	fwua
狙	jlua
狨	ryua
狩	edua
狮	ekua
狯	kgua
狰	qrua
狱	ylua
狲	swua
狸	lkua
猊	nkua
猕	mkua
猖	jpua
猜	chua
猝	cjua
猞	eeua
猡	llua
猩	xgua
猪	qjua
猫	mzua
献	xmuo
猰	ysua
猱	nzua
猷	ydou
猸	mwua
猹	fsua
猿	ytua
獐	qpua
獗	jhua
獴	mrua
獾	htua
玉	ylvv
玎	dgvv
玒	hyvv
玓	dkvv
玖	jqvv
玚	jpvv
玛	msvv
玟	wnvv
玢	bbvv
玥	yhvv
玩	wfvv
玫	mwvv
玭	pbvv
环	htvv
玱	qxvv
玲	lgvv
玳	dhvv
玷	dmvv
玼	ckvv
玿	ezvv
珀	plvv
珈	jsvv
珉	mbvv
珍	qnvv
珖	gmvv
珖	gxvv
珙	gyvv
珞	llvv
珠	qjvv
珢	ybvv
珣	xwvv
珦	xxvv
珧	yzvv
珩	hpvv
珫	wyvv
珰	dpvv
珲	hwvv
珽	tgvv
琇	xqvv
琉	lqvv
琏	lmvv
琐	slvv
琛	jnvv
琢	flvv
琢	zlvv
琤	jrvv
琨	kwvv
琫	brvv
琮	cyvv
琲	bwvv
琴	qbvv
琵	pkvv
瑁	mzvv
瑄	xtvv
瑅	tkvv
瑑	ftvv
瑔	qtvv
瑕	xsvv
瑖	dtvv
瑙	nzvv
瑚	hjvv
瑛	ygvv
瑭	tpvv
瑳	clvv
瑷	xhvv
瑾	jbvv
璃	lkvv
璆	qqvv
璒	drvv
璘	lbvv
璜	hmvv
璜	hxvv
璞	pjvv
璠	ffvv
璩	qlvv
璪	zzvv
璬	jcvv
璲	sbvv
璺	wnui
瓀	rtvv
瓒	zfvv
瓘	gtvv
瓜	gquu
瓞	dduu
瓢	pcvi
瓣	bfov
瓤	rpov
瓦	wsva
瓷	ckov
甑	zrou
甘	gfvi
甲	jsia
申	enia
甸	dmua
画	hqvi
畅	jpia
畋	tmia
界	jdia
畑	tmou
畔	pfia
畜	jjov
畸	jkia
疁	lqia
疃	ttia
疆	jxav
疏	ejai
疗	lcov
疚	jqov
疝	efov
疟	yzov
疢	jnov
疣	ydov
疤	bsov
疥	jdov
疭	zyov
疮	wmov
疮	wxov
疱	pzov
疳	gfov
疸	dfov
疹	qnov
疽	jlov
疾	jkov
痂	jsov
症	qrov
痊	qtov
痒	ypov
痔	fkov
痕	hnov
痘	ddov
痨	lzov
痪	htov
痫	xmov
痰	tfov
痼	gjov
痿	wwov
瘁	cbov
瘊	hdov
瘙	szov
瘤	lqov
瘥	clov
瘦	edov
瘪	bdov
瘭	bcov
瘳	wdov
瘾	ybov
癃	lyov
癌	xhov
癖	pkov
癫	dmov
癯	qlov
癿	qdui
皂	zzui
皆	jdva
皈	gbui
皎	jcui
皕	bkvu
皖	wfui
皞	hzui
皲	jwoa
盉	heuv
盏	qfvv
盐	yfvo
盒	heiv
盔	kbvu
盗	dzov
盛	ervu
盛	jrvu
盥	gtui
直	fkuo
盹	dwia
盾	dwuu
眈	dfia
眉	mwai
眍	kdia
眨	fsia
眩	xtia
眬	lyia
眺	tcia
着	fzou
着	qzou
睁	qria
睃	slia
睐	lhia
睛	jgia
睥	bkia
睦	mjia
睨	nkia
睬	chia
睹	djia
睽	kbia
睾	gzui
睿	rbiv
瞄	mcia
瞅	wdia
瞋	jnia
瞌	keia
瞍	sdia
瞑	mgia
瞠	jria
瞭	lcia
瞰	kfia
瞳	tyia
瞻	qfia
瞿	qlia
矗	jjuo
矜	qbao
矣	ykao
矧	enuv
矩	jluv
矮	xhuv
石	dfvu
石	ekvu
矼	gpvu
矿	kmvu
矿	kxvu
砀	dpvu
砂	esvu
砉	hqvv
砌	qdvu
砍	kfvu
砑	ysvu
砖	ftvu
砗	jevu
砗	wevu
砘	dwvu
砣	tlvu
砥	dkvu
砧	qnvu
砩	fjvu
砬	lsvu
砭	bmvu
砰	prvu
砳	levu
砷	envu
砼	tyvu
础	jjvu
硅	gbvu
硇	nzvu
硌	llvu
硎	xgvu
硐	dyvu
硝	xcvu
硪	wlvu
硫	lqvu
硿	kyvu
碃	qgvu
碇	dgvu
碈	mbvu
碌	ljvu
碍	xhvu
碏	qhvu
碑	bwvu
碓	dbvu
碗	wfvu
碟	ddvu
碡	fdvu
碧	bkvv
碳	tfvu
碴	wsvu
碹	xtvu
碾	nmvu
磁	ckvu
磅	bpvu
磊	lwvu
磔	fevu
磔	qevu
磕	kevu
磙	gwvu
磨	mlov
磲	qlvu
磷	lbvu
磹	dmvu
磻	pfvu
礁	jcvu
礓	jxvu
礞	mrvu
礵	emvu
礵	exvu
礼	lkoa
祂	tsoa
祃	msoa
祊	broa
祋	dboa
祖	zjoa
祚	zloa
祠	ckoa
祠	skoa
祧	tcoa
祭	qhua
祯	qnoa
祷	dzoa
祸	hloa
祾	lgoa
禄	ljoa
福	fjoa
禧	xkoa
禳	rpoa
离	lkov
秃	tjuv
秉	bguv
种	wyuv
秘	bkuv
秣	mluv
秧	ypuv
积	jkuv
秸	jduv
移	ykuv
秽	hbuv
秾	nyuv
稀	xkuv
稂	lpuv
程	jruv
稔	rnuv
稞	keuv
稻	dzuv
稼	jsuv
稿	gzuv
穆	mjuv
穑	seuv
穜	tyuv
穟	sbuv
穴	xhoo
窀	qwoo
突	tjoo
窄	fhoo
窄	qhoo
窆	bmoo
窍	qcoo
窎	dcoo
窑	yzoo
窒	fkoo
窕	tcoo
窟	kjoo
窥	kboo
窦	ddoo
窿	lyoo
竖	ejii
竣	jwov
童	tyov
竦	syov
端	dtov
竹	qjuv
竽	yluv
竿	gfuv
笆	bsuv
笊	fzuv
笊	qzuv
笞	wkuv
笥	skuv
符	fjuv
笪	dsuv
笫	zkuv
笮	zluv
笸	pluv
筋	jbuv
筌	qtuv
筐	kmuv
筐	kxuv
策	ceuv
筝	qruv
筠	jwuv
筢	psuv
筲	ezuv
筹	wduv
签	qmuv
箍	gjuv
箐	jguv
箖	lbuv
箢	ytuv
箩	lluv
箫	xcuv
箭	jmuv
箴	qnuv
篌	hduv
篑	kbuv
篓	lduv
篝	gduv
篷	pruv
簉	zzuv
簋	gbuv
簌	sjuv
簕	leuv
簖	dtuv
簝	lcuv
簟	dmuv
簧	hmuv
簧	hxuv
簪	zfuv
簰	phuv
籥	yhuv
籴	dkuo
粄	bfoo
粒	lkou
粕	plou
粘	qfou
粜	tcai
粟	sjvi
粥	fdav
粪	fnou
粮	lxou
粱	lxaa
粲	cfiv
粹	cbou
粼	lbou
粽	zyou
精	jgou
糁	enou
糅	rdou
糇	hdou
糌	zfou
糜	mwov
糠	kpou
糬	ejou
糯	nlou
糸	mkaa
紊	wnov
素	sjvv
紧	jbii
綮	qgoa
繁	ffuv
繇	fduo
纠	jqaa
红	gyaa
纤	qmaa
纤	xmaa
纥	geaa
纥	heaa
级	jkaa
纫	rnaa
纬	wwaa
纭	ywaa
纰	bkaa
纰	pkaa
纱	esaa
纲	gpaa
纶	lwaa
纸	fkaa
纹	wnaa
纺	fpaa
纽	nqaa
纾	ejaa
绀	gfaa
细	xkaa
绌	jjaa
绐	dhaa
绒	ryaa
结	jdaa
绖	ddaa
绗	hpaa
绘	hbaa
绚	xtaa
络	lzaa
统	tyaa
绠	graa
绥	sbaa
绦	tzaa
绪	xlaa
绫	lgaa
绰	wlaa
绱	epaa
绲	gwaa
绳	eraa
绸	wdaa
绺	lqaa
绻	qtaa
综	zyaa
绽	qfaa
绾	wfaa
绿	ljaa
缀	fbaa
缂	keaa
缅	mmaa
缆	lfaa
缇	tkaa
缑	gdaa
缔	dkaa
编	bmaa
缗	mbaa
缘	ytaa
缚	fjaa
缛	rjaa
缜	qnaa
缞	cbaa
缤	bbaa
缥	pcaa
缦	mfaa
缨	ygaa
缫	szaa
缬	xdaa
缭	lcaa
缮	efaa
缯	zraa
缰	jxaa
缵	ztaa
罄	qgvo
罅	xsuv
罐	gtuv
罔	wpia
罕	hfoa
罢	bsia
罩	fzia
罩	qzia
置	fkia
署	ejia
罹	lkia
罾	zria
羊	ypou
羌	qxou
羔	gzou
羚	lgou
羡	xmou
羧	slou
羯	jdou
羰	tpou
羱	ytou
羸	lwov
羹	grou
翀	wyao
翃	hyvu
翅	wkuo
翔	xxou
翕	xkiv
翘	qcva
翟	dkao
翰	hfuo
翳	ykvu
翻	ffuo
耀	yzio
耇	gduo
耑	dtia
耒	lwvv
耔	zkvv
耘	ywvv
耙	bsvv
耙	psvv
耜	skvv
耠	hlvv
耢	lzvv
耧	ldvv
耨	ndvv
耩	jxvv
耪	ppvv
耶	yevi
耷	dsvu
耻	wkvi
耿	grvi
聃	dfvi
聆	lgvi
聋	lyvu
职	fkvi
聍	ngvi
聚	jlvi
肌	jkuu
肏	czuo
肓	hmov
肓	hxov
肖	xcio
肘	fduv
肚	djuv
肛	gpuv
肟	wluv
股	gjuu
肩	jmoa
肪	fpuo
肭	nsui
肱	gyuv
育	ylov
肺	fwuv
肽	thuv
肾	enii
肿	fyui
胁	xdua
胂	enui
胆	dfuo
背	bwiv
胖	pfuo
胗	qnui
胜	eruu
胞	bzuu
胠	qluv
胥	xlai
胧	lyuv
胨	dyuv
胪	ljui
胭	yfui
胱	gmui
胱	gxui
胲	hhuo
胳	gsuu
胴	dyui
胶	jcuo
胺	xfuo
胼	pmuo
脉	mhuo
脍	kgui
脎	ssuu
脐	qkuo
脖	bluu
脚	jcuv
脞	clui
脟	lduu
脩	xqii
脬	pzuu
脲	ncua
脶	lluo
脿	bcuv
腆	tmui
腋	yeuo
腌	yfuv
腐	fjov
腓	fwui
腕	wfuo
腘	glui
腧	ejui
腩	nfuu
腭	xeuo
腯	tjuu
腹	fjuu
腺	xmuu
腼	mmuv
膀	ppuo
膈	geuv
膊	bluv
膏	gzov
膙	jxua
膛	tpui
膦	lbuo
膳	efuo
臁	lmuo
臂	bwav
臆	ykuo
臑	nzuv
臜	zsuo
臜	zsuu
臭	wdui
臭	xqui
致	fkva
臻	qnva
舅	jqui
舆	ylui
舌	eeuv
舒	ejiv
舔	tmuv
舛	wtua
舜	ewuo
舞	wjuv
舟	fduu
舠	dzuu
舡	wtuu
舢	efuu
舥	psuu
舫	fpuu
般	bfuu
舯	fyuu
舰	jmuu
舲	lguu
舳	qjuu
舵	dluu
舸	geuu
舻	ljuu
艄	ezuu
艏	eduu
艘	sduu
艟	wyuu
艨	mruu
良	lxoa
艰	jmao
色	ehua
艳	yfvv
艹	czii
艺	ykii
艽	qqii
艿	nhii
芄	wfii
芈	mkiv
芋	ylii
芏	djii
芗	xxii
芘	pkii
芙	fjii
芜	wjii
芝	fkii
芠	wnii
芥	ghii
芦	ljii
芪	qkii
芬	fnii
芭	bsii
花	hqii
芳	fpii
芸	ywii
芹	qbii
芽	ysii
苄	bmii
苍	cpii
苑	ytii
苒	rfii
苔	thii
苕	ezii
苕	tcii
苛	keii
苟	gdii
苠	mbii
苫	efii
苷	gfii
苹	pgii
茂	mzii
茈	zkii
茌	wkii
茏	lyii
茗	mgii
茜	qmii
茜	xkii
茨	ckii
茳	jxii
茶	wsii
茹	rjii
茺	wyii
茼	tyii
荀	xwii
荃	qtii
荑	tkii
荙	dsii
荛	rzii
荟	hbii
荡	dpii
荥	xgii
荪	swii
荫	ybii
荮	fdii
荷	heii
荼	tjii
荽	sbii
莉	lkii
莎	esii
莓	mwii
莝	clii
莞	gtii
莨	lpii
莨	lxii
莰	kfii
莱	lhii
莳	ekii
莴	wlii
莶	lmii
莽	mpii
菇	gjii
菌	jwii
菡	hfii
菱	lgii
菲	fwii
菸	yfii
菹	zjii
菼	tfii
萃	cbii
萄	tzii
萌	mrii
萎	wwii
萏	dfii
萑	htii
萚	tlii
萜	tdii
萝	llii
萣	dgii
营	ygii
萧	xcii
萱	xtii
萳	nfii
萼	xeii
落	lsii
落	lzii
葑	frii
著	flii
著	qjii
葜	qsii
葩	psii
葫	hjii
葱	cyii
葶	tgii
蒂	dkii
蒇	jfii
蒈	khii
蒉	kbii
蒌	ldii
蒐	sdii
蒛	qhii
蒡	bpii
蒴	elii
蒸	qrii
蒽	xnii
蓄	xlii
蓉	ryii
蓑	slii
蓓	bwii
蓖	bkii
蓬	prii
蓼	lcii
蔀	bjii
蔈	bcii
蔌	sjii
蔑	mdii
蔓	mfii
蔗	feii
蔗	qeii
蔟	cjii
蔫	nmii
蔷	qxii
蔸	ddii
蔺	lbii
蔻	kdii
蕃	ffii
蕉	jcii
蕊	rbii
蕖	qlii
蕞	zbii
蕨	jhii
蕹	wrii
薄	blii
薄	bzii
薅	hzii
薛	xhii
薨	hyii
薪	xbii
薸	pcii
薿	nkii
藁	gzii
藉	jdii
藉	jkii
藐	mcii
藿	hlii
蘖	ndii
蘘	rpii
蘸	qfii
蘼	mkii
虎	hjiv
虏	ljiv
虑	lliv
虒	skuu
虢	gluo
虱	ekau
虺	hbvu
虻	mria
虾	hsia
虾	xsia
虿	jhva
蚂	msia
蚄	fpia
蚋	rbia
蚌	bpia
蚌	bria
蚓	ybia
蚕	cfvv
蚝	hzia
蚣	gyia
蚤	zzao
蚩	wkai
蚯	qqia
蚶	hfia
蚺	rfia
蛃	bgia
蛇	eeia
蛋	dfai
蛔	hbia
蛙	wsia
蛞	klia
蛟	jcia
蛮	mfov
蛲	nzia
蛸	ezia
蛹	yyia
蛾	xeia
蜂	fria
蜈	wjia
蜒	yfia
蜓	tgia
蜗	wlia
蜜	mkoo
蜡	lsia
蜣	qxia
蜷	qtia
蜻	qgia
蜿	wfia
蝂	bfia
蝇	ygia
蝉	jfia
蝎	xdia
蝙	bmia
蝴	hjia
蝶	ddia
螅	xkia
螓	qbia
螣	truo
螬	czia
螭	wkia
螳	tpia
螵	pcia
螽	fyua
蟀	egia
蟊	mzao
蟒	mpia
蟓	xxia
蟛	pria
蟮	efia
蟷	dpia
蠊	lmia
蠕	rjia
蠛	mdia
蠡	lkaa
蠢	jwvv
蠹	djvi
血	xdui
血	xhui
衃	pwui
衅	xbui
衍	yfuu
街	jduu
衠	qwuu
衢	qluu
衣	ykov
衬	jnoa
衰	egov
衲	nsoa
衽	rnoa
袁	ytvo
袂	mwoa
袄	xzoa
袍	pzoa
袖	xqoa
袜	wsoa
袢	pfoa
袼	geoa
裂	ldvu
裈	kwoa
裉	knoa
裕	yloa
裘	qqvi
裙	qwoa
裢	lmoa
裤	kjoa
裨	bkoa
裨	pkoa
裴	pwiv
裸	lloa
裹	glov
裼	tkoa
褂	gqoa
褒	bzov
褓	bzoa
褙	bwoa
褚	jjoa
褡	dsoa
褪	twoa
褴	lfoa
褶	feoa
褶	qeoa
襁	qxoa
襟	jboa
襦	rjoa
覃	tfvi
覆	fjvi
觅	mkuo
觇	jfiv
览	lfii
觉	jcoo
觏	gdvv
角	jcua
觚	gjua
觜	zbiv
觟	hqua
觥	gyua
触	jjua
誊	trou
謇	jmoo
謦	qguo
计	jkoa
讧	hyoa
议	ykoa
讯	xwoa
讳	hboa
讵	jloa
讶	ysoa
讹	xeoa
讻	xyoa
讽	froa
诀	jhoa
诂	gjoa
评	pgoa
识	fkoa
诈	fsoa
诌	fdoa
诎	qloa
诏	fzoa
诏	qzoa
诒	dhoa
诔	lwoa
诗	ekoa
诚	jroa
诜	xmoa
诞	dfoa
诠	qtoa
诡	gboa
诤	qroa
详	xxoa
诨	hwoa
诫	jdoa
诬	wjoa
诮	qcoa
诰	gzoa
诱	ydoa
诳	kmoa
诳	kxoa
说	eboa
说	yhoa
诵	syoa
诸	qjoa
诼	floa
诽	fwoa
课	keoa
谄	jfoa
谇	sboa
谌	enoa
谍	ddoa
谎	hmoa
谎	hxoa
谒	yeoa
谓	wwoa
谖	xtoa
谘	zkoa
谙	xfoa
谚	yfoa
谛	dkoa
谜	mkoa
谟	mloa
谠	dpoa
谡	sjoa
谢	xdoa
谣	yzoa
谩	mfoa
谭	tfoa
谴	qmoa
谵	qfoa
谷	gjuo
谼	hyuo
豁	hloo
豇	jxvo
豉	wkvo
豌	wfvo
象	xxua
豮	fnvu
豳	bbiv
豹	bzuo
貂	dcuo
貅	xquo
貆	htuo
貉	heuo
貉	hzuo
貌	mzuo
貔	pkuo
貘	mluo
贞	qniv
负	fjua
贠	ytao
账	qpao
货	hliu
质	fkuu
贩	ffao
贪	tfio
贬	bmao
贮	qjao
贯	gtaa
贰	xjvv
贲	bkuo
贲	bnuo
贵	gbia
贶	kmao
贶	kxao
贷	dhiv
贺	heau
贾	gjvi
贾	jsvi
贿	hbao
赂	ljao
赅	ghao
赈	qnao
赉	lhvo
赊	eeao
赋	fjao
赌	djao
赎	ejao
赏	epio
赒	fdao
赔	pwao
赗	frao
赜	zevi
赡	efao
赢	ygov
赦	eevo
赧	nfvo
赫	hevo
赳	jqvo
赴	fjvo
赶	gfvo
趁	jnvo
趄	qdvo
趑	zkvo
趟	tpvo
趣	qlvo
趱	zfvo
趴	psoi
趸	dwva
趾	fkoi
跃	yhoi
跄	qxoi
跋	bsoi
跌	ddoi
跎	tloi
跏	jsoi
距	jloi
跤	jcoi
跳	tcoi
践	jmoi
跷	qcoi
跺	dloi
跻	jkoi
踊	yyoi
踏	tsoi
踔	wloi
踝	hgoi
踢	tkoi
踣	bloi
踪	zyoi
踮	dmoi
踵	fyoi
踶	dkoi
蹁	pmoi
蹅	wsoi
蹈	dzoi
蹉	cloi
蹊	qkoi
蹒	pfoi
蹙	cjvu
蹜	sjoi
蹬	droi
蹯	ffoi
蹲	cwoi
蹲	dwoi
蹲	zwoi
蹴	zjoi
蹶	jhoi
蹼	pjoi
蹽	lcoi
躁	zzoi
躅	floi
躅	qjoi
躇	jjoi
躏	lboi
躐	ldoi
躬	gyui
躲	dlui
軎	wwvi
轧	fsva
轧	gsva
轨	gbva
轩	xtva
轪	dhva
轫	rnva
轭	xeva
轱	gjva
轲	keva
轴	fdva
轷	hjva
轼	ekva
轿	jcva
辁	qtva
辄	feva
辄	qeva
辅	fjva
辇	nmvv
辉	hbio
辊	gwva
辋	wpva
辌	lxva
辍	wlva
辎	zkva
辑	jkva
辒	wnva
输	ejva
辔	pwaa
辕	ytva
辖	xsva
辗	nmva
辗	qfva
辘	ljva
辚	lbva
辛	xbov
辟	pkav
辣	lsov
辩	bmov
辰	jnvu
迄	qkuv
迅	xwav
迈	mhva
返	ffuu
迚	dsia
远	ytvv
违	wwvv
迪	dkia
迫	phui
迭	dduv
迮	zeuv
迷	mkou
迺	nhvi
逄	ppua
逅	hduu
逆	nkou
逊	xwai
逋	bjvi
逗	ddvo
逞	jrov
逢	frua
逵	kbvo
逸	ykua
逻	llia
逼	bkvo
遂	sbou
遇	ylia
遏	xeoi
遐	xsav
遑	hmui
遑	hxui
遒	qqou
遛	lqua
遣	qmia
遥	yzuo
遵	zwou
遽	jliv
邀	yzui
邃	sboo
邓	drao
邛	qyvi
邝	kmov
邝	kxov
邠	bbuo
邡	fpov
那	nlav
邨	cwva
邪	xdva
邪	yeva
邮	ydia
邯	hfvi
邰	thao
邵	ezau
邺	yeii
邻	lbio
郁	ylvu
郄	qduo
郊	jcov
郎	lpoa
郐	ggiv
郐	kgiv
郑	qrou
郝	hzvo
郧	ywoa
郫	pkui
郯	tfou
郸	dfou
都	djuo
鄀	rlii
鄌	tpov
鄞	ybvi
鄱	pluo
鄹	zdvi
酂	cluv
酃	lgvo
酉	ydvi
酎	fdvi
酗	xlvi
酚	fnvi
酝	ywvi
酞	thvi
酢	cjvi
酢	zlvi
酰	xmvi
酲	jrvi
酴	tjvi
酶	mwvi
酺	pjvi
醅	pwvi
醇	jwvi
醍	tkvi
醐	hjvi
醒	xgvi
醛	qtvi
醣	tpvi
醪	lzvi
醺	xwvi
醾	mkvi
釉	yduo
释	ekuo
重	fyuv
野	yeia
鋆	ywvo
錾	zfva
鍪	mdao
钆	gsio
针	qnio
钉	dgio
钊	fzio
钊	qzio
钍	tjio
钏	wtio
钐	efio
钒	ffio
钔	mnio
钕	nlio
钗	jhio
钛	thio
钞	jzio
钞	wzio
钟	fyio
钠	nsio
钦	qbio
钧	jwio
钨	wjio
钫	fpio
钭	ddio
钮	nqio
钯	bsio
钯	psio
钰	ylio
钵	blio
钷	plio
钺	yhio
钼	mjio
钾	jsio
钿	dmio
钿	tmio
铀	ydio
铁	tdio
铃	lgio
铅	qmio
铉	xtio
铊	tlio
铊	tsio
铋	bkio
铌	nkio
铍	pkio
铏	xgio
铐	kzio
铑	lzio
铖	jrio
铘	yeio
铙	nzio
铛	dpio
铞	dcio
铟	ybio
铠	khio
铡	fsio
铣	xkio
铤	tgio
铧	hqio
铨	qtio
铩	esio
铪	hsio
铬	geio
铭	mgio
铮	qrio
铲	jfio
铳	wyio
铵	xfio
铷	rjio
铸	qjio
铺	pjio
链	lmio
锂	lkio
锄	jjio
锅	glio
锈	xqio
锉	clio
锊	lhio
锋	frio
锌	xbio
锍	lqio
锑	tkio
锒	lpio
锕	xsio
锗	feio
锗	qeio
锚	mzio
锛	bnio
锜	qkio
锞	keio
锟	kwio
锢	gjio
锧	fkio
锨	xmio
锫	pwio
键	jmio
锯	jlio
锰	mrio
锱	zkio
锲	qdio
锳	ygio
锵	qxio
锷	xeio
锸	wsio
锹	qcio
锼	sdio
锽	hmio
锽	hxio
锾	htio
镀	djio
镁	mwio
镂	ldio
镄	fwio
镆	mlio
镊	ndio
镐	gzio
镐	hzio
镕	ryio
镖	bcio
镘	mfio
镚	brio
镛	yyio
镜	jgio
镝	dkio
镞	zjio
镣	lcio
镥	ljio
镦	dwio
镧	lfio
镩	ctio
镫	drio
镭	lwio
镯	flio
镴	lsio
镶	xxio
长	qpuv
闪	efoi
闭	bkoi
闯	wmoi
闯	wxoi
闲	xmoi
闳	hyoi
闵	mboi
闶	kpoi
闷	mnoi
闺	gboi
闻	wnoi
闿	khoi
阀	fsoi
阁	geoi
阃	kwoi
阄	jqoi
阆	lpoi
阇	djoi
阍	hwoi
阐	jfoi
阑	lfoi
阒	qloi
阗	tmoi
阙	qhoi
阜	fjui
阡	qmai
阢	wjai
阪	bfai
阱	jgai
阳	ypai
阴	ybai
阶	jdai
阽	dmai
陀	tlai
陂	bwai
陂	plai
附	fjai
际	jkai
陆	lqai
陇	lyai
陉	xgai
陋	ldai
陌	mlai
降	jxai
降	xxai
限	xmai
陑	xjai
陔	ghai
陛	bkai
陞	erai
陟	fkai
陧	ndai
陨	ywai
陬	zdai
陵	lgai
隅	ylai
隗	kbai
隙	xkai
障	qpai
隧	sbai
隩	xzai
隳	dlai
隶	lkav
隹	fbio
隼	swio
雀	qhiu
雅	ysva
集	jkio
雌	ckiv
雠	wdio
雨	ylvi
雱	ppvi
雳	lkvo
雷	lwvo
雾	wjvo
霄	xcvo
霆	tgvo
霈	pwvo
霉	mwvo
霎	esvo
霏	fwvo
霓	nkvo
霖	lbvo
霜	emvo
霜	exvo
霞	xsvo
霰	xmvo
露	ldvo
霹	pkvo
霾	mhvo
青	qgvv
靓	lxvv
靡	mkov
靥	yevu
革	gevi
靴	xhvi
靶	bsvi
靸	ssvi
靽	bfvi
鞅	ypvi
鞋	xdvi
鞑	dsvi
鞔	mfvi
鞘	ezvi
鞘	qcvi
鞨	hevi
鞲	gdvi
鞳	tsvi
鞴	bwvi
韂	jfvi
韭	jqiv
韵	ywov
韶	ezov
顷	qgva
顸	hfvv
项	xxvi
顼	xlvv
颀	qkuu
颁	bfuo
颃	hpov
颇	plau
颈	jgao
颉	xdvo
颐	ykvi
频	pbiv
颓	tbuv
颔	hfio
颖	ygua
颛	ftia
颜	yfov
颞	ndvi
颤	qfov
颥	rjvo
飕	sdua
飙	bcvu
飚	bcua
食	ekio
食	skio
飨	xxaa
飱	swvu
饕	tzov
饧	tpua
饨	twua
饪	rnua
饬	wkua
饮	ybua
饯	jmua
饱	bzua
饲	skua
饸	heua
饹	leua
饼	bgua
饽	blua
馃	glua
馄	hwua
馅	xmua
馆	gtua
馇	wsua
馈	kbua
馌	yeua
馍	mlua
馐	xqua
馑	jbua
馔	ftua
馘	glou
香	xxuv
马	msaa
驭	ylaa
驮	dlaa
驯	xwaa
驱	qlaa
驳	blaa
驴	llaa
驵	zpaa
驶	ekaa
驹	jlaa
驻	qjaa
驼	tlaa
驾	jsau
骀	thaa
骁	xcaa
骂	msoo
骃	ybaa
骄	jcaa
骅	hqaa
骇	hhaa
骈	pmaa
验	yfaa
骍	xgaa
骎	qbaa
骏	jwaa
骑	qkaa
骕	sjaa
骙	kbaa
骛	wjao
骞	qmoo
骠	bcaa
骢	cyaa
骤	fdaa
骦	emaa
骦	exaa
骨	gjia
骷	kjia
骼	geia
髂	qsia
髅	ldia
髌	bbia
髓	sbia
髟	bcvi
髡	kwvi
髢	dkvi
髭	zkvi
髹	xqvi
鬃	zyvi
鬏	jqvi
鬓	bbvi
鬟	htvi
鬣	ldvi
鬯	jpuo
鬷	zyvo
鬻	ylav
魃	bsui
魄	plui
魄	tlui
魆	xlui
魈	xcui
魋	tbui
魍	wpui
魏	wwuv
魑	wkui
鱽	dzua
鱿	ydua
鲂	fpua
鲅	bsua
鲆	pgua
鲇	nmua
鲈	ljua
鲎	hdoo
鲏	pkua
鲐	thua
鲗	zwua
鲘	hdua
鲢	lmua
鲦	tcua
鲨	esai
鲪	jwua
鲭	qgua
鲰	zdua
鲸	jgua
鲹	enua
鲻	zkua
鲼	fnua
鲽	ddua
鳀	tkua
鳃	shua
鳄	xeua
鳅	qqua
鳈	qtua
鳊	bmua
鳋	szua
鳌	xzvv
鳍	qkua
鳎	tsua
鳐	yzua
鳕	xhua
鳖	bdou
鳗	mfua
鳘	mbuv
鳙	yyua
鳝	efua
鳡	gfua
鳣	qfua
鸟	dcua
鸣	mgou
鸧	cpia
鸫	dyva
鸭	ysia
鸵	tlua
鸸	xjvu
鸹	gquv
鸺	xqiv
鸻	hruu
鸽	geiv
鸿	hyav
鹃	jtou
鹅	xeuv
鹊	qhvi
鹌	xfvu
鹏	pruu
鹕	hjuo
鹙	qquv
鹟	wruo
鹤	heoa
鹧	feov
鹧	qeov
鹩	lcvu
鹭	ljoi
鹾	cliv
鹿	ljov
麇	qwov
麈	qjov
麓	ljvv
麝	eeov
麦	mhvv
麻	msov
麾	hbov
黉	hyoo
黍	ejuv
默	mlia
黜	jjia
黪	cfia
黾	mroi
鼍	tloo
鼎	dgia
鼐	nhau
鼓	gjvo
鼗	tzuo
鼢	fnui
鼩	qlui
鼫	ekui
鼯	wjui
鼱	jgui
鼾	hfui
齁	hdui
齄	fsui
齉	npui
齿	wkiv
龀	jniv
龄	lgiv
龅	bziv
龆	tciv
龇	zkiv
龈	ybiv
龋	qliv
龌	wliv
龚	gyvu
龛	kfiv
龟	gbua
龠	yhiv
㑇	fdiu
㕮	fjou
㙂	dbvo
㛚	tyau
㛹	pmau
㠇	jqia
㧐	syiu
㧑	wwiu
㧟	kgiu
㨃	dbiu
㬊	htoi
㭎	gpvi
㴔	seau
㵐	jhav
㶲	yyou
㸆	kzou
㸌	hlou
㻬	tjvv
䌹	jyaa
䐃	jyui
䓖	qyii
䓬	fzii
䓬	qzii
䢺	jjai
䴘	tkuu
𠳐	bpov
𡎚	pmvo
𣗋	dpvi
𥕢	czvu
𥖨	zzvu
𥻗	wsou
𦰡	nlii
𦰡	nsii
𧿹	mjoi
𨐈	gmva
𨐈	gxva
𨱇	qqio
𨱏	dsio
𨺙	nkai
ㄓ	fkia
不	fdvu
个	geii
乂	ykuo
乃	nhau
么	mlua
乌	wjua
乐	yzua
乘	jruv
九	jqua
乞	qkuv
乩	jkiv
了	lcai
了	leai
二	xjvv
亍	jjvv
亟	jkai
亡	wjov
亲	qgov
亵	xdov
亶	dfov
亸	dlov
亹	wwov
仡	geiu
仫	mjiu
价	jdii
伈	xbio
伊	ykia
伋	jkiu
伎	jkiu
休	xqiv
伧	cpii
伫	qjio
伭	xmio
伯	bhiu
伲	nkia
伶	lgii
伺	skia
似	ekia
伽	jsia
伾	pkiv
佑	ydiv
佖	bkio
佗	tlio
佚	ddiu
佚	ykiu
佟	tyiu
佬	lziu
佶	jkiv
侁	eniu
侂	tlio
侄	fkiv
侍	ekiv
侏	qjiu
侔	mdia
侗	tyii
侹	tgiu
俑	yyia
俘	fjiu
俙	xkiu
俜	pgii
俞	yliv
俟	skia
俣	ylio
俤	dkio
俫	lhiv
倏	ejii
倕	wbiu
倞	lxio
倡	jpio
倨	jlia
倬	flii
倮	llii
偁	jriu
偃	yfiv
偈	jkio
偎	wwii
偓	wlia
偰	xdiv
偻	ldio
偻	llio
傃	sjiv
傅	fjiv
傈	lkiv
傕	jhio
傣	dhiv
傥	tpii
傺	wkiu
僎	ftia
僖	xkiv
僭	jmiv
儇	xtii
儋	dfiu
儡	lwii
儦	bcio
儳	jfio
儿	xjua
兕	skia
入	rjuo
八	bsuo
六	ljov
兮	xkuo
兹	ckou
冁	jfou
冈	gpia
冒	mlia
冔	xlia
冘	yboa
冘	ydoa
冼	xmov
净	jgov
凄	qkov
凇	syov
凉	lxov
凘	skov
凳	drao
凹	wsia
刀	dzau
刁	dcav
刈	ykuo
刍	jjua
刑	xgvv
刖	yhui
刨	bzua
刭	jgao
刳	kjvu
券	xtou
刿	gbia
剂	jkov
剅	ldvo
削	xcio
剔	tkoi
剜	wfoo
剞	jkvu
剡	yfou
剪	jmou
剽	pcvi
剿	jcaa
劁	qcio
劂	jhvu
劈	pkav
劐	hlii
劓	ykui
力	lkau
劢	mhva
劭	ezau
励	lkvu
劼	jduo
劾	heov
势	ekiu
勋	xwoa
勍	qgov
勐	mrai
募	mjii
勠	ljao
勹	bzua
勿	wjua
匐	fjua
匜	ykva
匦	gbvv
区	xdvu
匼	kevi
十	ekuo
午	wjuv
卒	zjov
单	efou
卜	blio
卞	bmov
卟	bjoi
卣	ydiv
卤	ljiv
卯	mzua
厉	lkvu
厘	lkvu
参	enao
参	sfao
叆	xhvv
叇	dhvv
又	ydao
叕	flao
叚	jsav
叡	rbiv
句	gdua
叨	dzoa
召	ezau
吁	xlov
吁	ylov
吅	xtoo
吆	yzoa
合	geiv
吏	lkvi
吒	fsou
吓	heov
吔	yeoa
吝	lbov
吡	pkov
否	pkvu
吩	fnou
吱	zkou
吽	hdou
吽	hyou
吽	xdou
呆	dhov
呇	qkaa
呋	fjov
呒	xmov
呓	ykoi
呦	ydoa
呯	pgov
呱	gjou
呷	xsoi
咁	gfov
咁	xmov
咇	bkoo
咉	ypoi
咍	hhoa
咎	jqua
咥	ddov
咦	ykov
咨	zkov
咪	mkoo
咫	fkav
咲	xcoo
咴	hbov
咿	ykoi
哉	zhuo
哐	kmov
哐	kxov
哔	bkov
哕	yhoi
哚	dlou
哜	jkoo
哟	yloa
哢	lyov
哱	plou
哳	fsoi
唁	yfoo
唏	xkou
唑	zloi
唔	wjov
唣	zzou
唪	frov
唵	xfov
唿	hjou
啁	fzou
啁	qzou
啉	lbov
啉	lfov
啖	dfoo
啜	wloa
啻	wkov
喀	keoo
喁	yloi
喁	yyoi
喂	wwoi
喇	lsov
喋	ddov
喋	fsov
喑	yboo
喔	wjoa
喙	hboa
喤	hmou
喤	hxou
喰	qkoi
喳	wsov
喾	kjoo
嗄	xsov
嗌	xhoo
嗌	ykoo
嗐	hhoo
嗑	keov
嗒	tsoi
嗨	hwoa
嘏	gjuo
嘘	ekoi
嘞	lwov
嘱	qjoa
嘲	fzou
嘲	qzou
嘹	lcov
噀	xwoa
噇	wmoo
噇	wxoo
噍	jcoi
噎	yeov
噗	pjoi
噫	ykoo
噬	ekou
噱	jhoi
噱	xhoi
噷	hmoo
噼	pkoa
嚆	hzoi
嚏	tkou
嚣	xcoo
嚼	jhou
囝	jmia
囟	xbui
囤	dwia
囿	ydia
圊	qgia
圌	wtia
圐	kjia
圕	ttia
圙	lhia
圜	ytia
土	tjvo
圢	tgvo
圩	xlvo
圪	gevo
圫	ylvo
圬	wjvo
圮	pkvo
圯	ykvo
圳	qnvo
圻	ybvo
圾	jkvo
址	fkvo
坋	bnvo
坌	bnuo
坍	tfvo
坏	pwvo
坒	bkva
坜	lkvo
坞	wjvo
坥	qlvo
坩	gfvo
坭	nkvo
坯	pkvo
坻	wkvo
坽	lgvo
垎	hevo
垕	hduu
垚	yzvo
垞	wsvo
垡	fsiv
垣	ytvo
垩	xevi
垵	xfvo
垸	ytvo
垿	xlvo
埆	qhvo
埇	yyvo
埌	lpvo
埏	yfvo
埒	ldvo
埔	bjvo
埗	bjvo
埚	glvo
埤	pkvo
埯	xfvo
埵	dlvo
埼	qkvo
堉	ylvo
堋	prvo
堎	lrvo
堐	ysvo
堞	ddvo
堡	pjio
堰	yfvo
堼	frvo
塆	wfvo
塝	bpvo
塥	gevo
塱	lpoa
塾	ejov
墀	wkvo
墅	ejia
墈	kfvo
墘	qmvo
墚	lxvo
墡	efvo
墣	pjvo
墨	mlia
壅	yyov
壑	heiv
壕	hzvo
売	mhvo
夐	xyua
夤	ybua
大	dhvu
夼	kmvu
夼	kxvu
奁	lmvu
奇	jkvu
奓	eevu
奚	xkuo
奭	ekvv
妄	wpov
妆	fmov
妆	fxov
妊	rnau
妓	jkau
妘	ywau
妣	bkau
妧	wfau
妪	ylau
妫	wwau
妼	bkau
姝	ejau
姣	jcau
姣	xcau
姤	gdau
姥	mjau
姬	jkau
姶	xeau
姹	wsau
姻	ybau
姽	gbau
娈	ltov
娠	enau
娱	ylau
娴	xmau
娵	jlau
婀	xeau
婌	ejau
婍	qkau
婠	wfau
婤	fdau
婫	hwau
婺	wjao
媄	mwau
媓	hmau
媓	hxau
媚	mwau
媛	ytau
媭	xluu
媱	yzau
媳	xkau
媾	gdau
嫁	jsau
嫄	ytau
嫉	jkau
嫕	ykau
嫠	lkvv
嫡	dkau
嫣	yfau
嫫	mlau
嫭	hjau
嬉	xkau
嬖	bkav
嬗	efau
嬛	htau
嬴	ygov
嬷	mlau
孑	jdai
孖	zkai
孚	fjuo
孛	bwuo
季	jkuv
孳	zkou
孵	fjua
宇	yloo
宓	fjoo
宓	mkoo
宙	fdoo
实	ekoo
宸	jnoo
寂	jkoo
寇	kdoo
寤	wjoo
寨	fhoo
寨	qhoo
寮	lcoo
寰	htoo
尉	wwav
尖	jmiu
尛	mliu
尤	ydvu
尨	lyvu
尾	ykav
屁	pkav
屃	xkav
届	jdav
屎	ekav
屐	jkav
履	llav
屦	jlav
屹	ykia
屺	qkia
屼	wjia
屾	enia
屿	ylia
岊	jdai
岌	jkia
岐	qkia
岖	qlia
岜	bsia
岢	keia
岬	jsia
岽	dyia
岿	kbia
峁	mzia
峂	tyia
峃	xhoo
峒	tyia
峘	htia
峙	ekia
峙	fkia
峡	xsia
峣	yzia
峤	jcia
峤	qcia
峥	qria
峧	jcia
峨	xeia
峪	ylia
峱	nzua
峸	jria
崁	kfia
崃	lhia
崌	jlia
崎	qkia
崖	ysia
崚	lgia
崛	jhia
崞	glia
崟	ybia
崡	hfia
崧	syia
崭	qfia
崶	fria
崿	xeia
嵌	qmia
嵖	wsia
嵚	qbia
嵛	ylia
嵫	zkia
嵴	jkia
嶂	qpia
嶍	xkia
嶦	qfia
巅	dmia
巇	xkia
巫	wjvi
差	ckou
巷	xxvi
巽	xwav
巾	jbia
帘	lmoo
帚	fdav
帜	fkia
帧	qria
帷	wwia
帼	glia
幂	mkoa
幄	wlia
幞	fjia
幡	ffia
幽	ydia
庀	pkov
庄	fmov
庄	fxov
庐	ljov
庑	wjov
庖	pzov
庱	jrov
庳	bkov
庶	ejov
庾	ylov
廆	gbov
廋	sdov
廑	jbov
廒	xzov
廖	lcov
廨	xdov
廾	gyvu
弆	jlvo
弇	yfiv
弈	ykov
弋	ykva
弑	ekuo
弘	hyav
弛	wkav
弜	jxav
弢	tzav
弩	njau
弸	prav
强	jxav
彀	gdvo
彐	jkav
彗	hbvv
彘	fkaa
彦	yfov
彭	bpvo
後	hduu
徛	jkuu
徵	fkuu
徵	qruu
忆	ykoo
忉	dzoo
忌	jkav
忡	wyoo
忤	wjoo
忭	bmoo
忮	fkoo
忺	xmoo
怃	wjoo
怄	xdoo
怍	fsoo
怍	zloo
怙	hjoo
急	jkua
怫	fjoo
怹	tfio
恃	ekoo
恍	hmoo
恍	hxoo
恓	xkoo
恔	xcoo
恙	ypou
恝	jsvv
恪	keoo
恭	gyvi
恶	wjvi
恺	khoo
恽	ywoo
恿	yyao
悈	jdoo
悉	xkuo
悍	hfoo
悒	ykoo
悚	syoo
悫	qhvo
悭	qmoo
悲	bwiv
悸	jkoo
悻	xgoo
惋	wfoo
惎	jkvi
惔	tfoo
惕	tkoo
惝	jpoo
惬	qdoo
惮	dsoo
惺	xgoo
愀	qcoo
愉	yloo
意	ykov
愚	ylia
愦	kboo
愫	sjoo
愭	qkoo
慕	mjii
慜	mbuv
慝	tevi
慥	zzoo
慬	qboo
慭	ybvo
慰	wwav
慵	yyoo
憔	qcoo
憕	jroo
憙	xkvo
憧	wyoo
憩	qkuv
憬	jgoo
憷	jjoo
憾	hfoo
懿	ykvo
戆	fmov
戆	fxov
戊	wjvu
戍	ejvu
戗	qxia
戚	qkvu
戡	kfvi
戥	droi
戬	jmvi
戮	ljao
戽	hjoa
戾	lkoa
扉	fwoa
扊	yfoa
手	ediu
扞	hfiu
扦	qmiu
执	fkiu
扮	bfiu
抉	jhiu
折	eeiu
抚	fjiu
抡	lwiu
拂	fjiu
拃	fsiu
拊	fjiu
拌	bfiu
拘	gdiu
拘	jliu
拚	pfiu
拤	qsiu
择	fhiu
择	qhiu
拭	ekiu
拮	jsiu
拽	yeiu
拾	eeiu
拾	ekiu
挓	fsiu
挚	fkiu
挟	xdiu
挢	jciu
挲	slai
捂	wjiu
捌	bsiu
捍	hfiu
捡	jmiu
捩	ldiu
捯	dziu
捱	xhiu
捷	jdiu
捻	nmiu
掂	dmiu
掊	pdiu
掎	jkiu
措	cliu
掮	qmiu
掰	bhiu
掳	ljiu
掷	fkiu
掸	efiu
掺	xmiu
掾	ytiu
揆	kbiu
提	dkiu
揕	qniu
揖	ykiu
揭	jdiu
揭	qkiu
揲	eeiu
揶	yeiu
揸	fsiu
揽	lfiu
揿	qbiu
搏	bliu
搛	jmiu
搽	wsiu
搿	geiu
摅	ejiu
摛	wkiu
摞	lliu
摩	mlov
摩	msov
摴	jjiu
摺	feiu
摺	qeiu
撂	lciu
撅	jhiu
撖	hfiu
撬	qciu
撮	cliu
撮	zliu
擂	lwiu
擘	blav
擢	fliu
擿	tkiu
攉	hliu
攫	jhiu
支	fkuo
攸	ydii
攻	gyvi
攽	bfuo
敉	mkou
敔	ylvi
敕	wkvi
敖	xzvv
敝	bkou
敞	jpio
敦	dbov
敫	jcui
敷	fjvi
斛	hjua
斧	fjuo
於	ylov
施	ekov
旃	qfov
旒	lqov
旗	qkov
日	rkoi
旴	xloi
旵	jfoi
旻	mboi
旿	wjoi
昈	hjoi
昒	hjoi
昡	xtoi
昤	lgoi
昫	xloi
昱	yloi
昳	ddoi
昳	ykoi
昼	fdav
晁	jzoi
晁	wzoi
晅	xtoi
晏	yfoi
晔	yeoi
晖	hboi
晗	hfoi
晢	feiu
晢	qeiu
晪	tmoi
晫	floi
晱	efoi
晶	jgoi
晷	gboi
智	fkuv
暌	kboi
暧	xhoi
暮	mjii
暴	pjoi
暵	hfoi
暹	xmoi
暿	xkoi
曈	tyoi
曌	fzoi
曌	qzoi
曙	ejoi
曝	bzoi
曝	pjoi
曦	xkoi
曰	yhoi
曳	yeia
曷	heoi
朋	pruu
朐	qluu
期	jkvi
札	fsva
术	qjvo
朴	pcvi
杈	wsva
杉	esvu
杏	xgvo
杓	bcvu
杕	dkvv
杙	ykvv
杞	qkva
杵	jjvu
枅	jkvv
枇	pkvv
枍	ykvu
枒	ysvv
林	lbvv
枞	zyvi
枥	lkvv
枧	jmvi
枨	jrvu
枲	xkao
枳	fkvo
枵	xcvo
柁	dlvo
柁	tlvo
柃	lgvi
柑	gfvv
柒	qkav
柙	xsvi
柚	ydvi
柝	tlvu
柢	dkvu
查	fsvo
柩	jqvv
柷	qjvo
柽	jrva
柿	ekvo
栅	efvu
栈	qfvv
栉	fkvi
栊	lyvv
栖	qkvv
栗	lkvi
栱	gyvv
核	hjvo
栻	ekvv
栾	ltov
桁	hpvu
桅	wwvu
桊	jtou
桓	htvv
桔	jdvv
桕	jqvu
桡	nzvv
桦	hqvi
桧	hbvi
桨	jxov
桲	blvu
桴	fjvu
桹	lpvo
梆	bpvv
梌	tjvi
梠	llvo
梧	wjvv
梳	ejvo
梼	tzvv
梽	fkvv
梿	lmvv
棐	fwiv
棓	bpvo
棘	jkvi
棣	dhva
棪	yfvo
棱	lgvv
棻	fnii
棼	fnvv
棽	jnvv
椅	ykvv
植	fkvu
椑	bwvu
椓	flvv
椠	qmva
椸	ykvo
椹	qnvv
椿	jwvv
楔	xdvv
楘	mjao
楙	mzva
楝	lmvv
楫	jkvo
楮	jjvu
楷	jdvv
楹	ygva
榆	ylvi
榇	jnvo
榍	xdva
榑	fjvv
榖	gjuo
榘	jluv
榙	tsvi
榛	qnvv
榭	xdvu
榴	lqvu
榻	tsvo
槊	elou
槎	wsvo
槎	xsvo
槑	mwov
槚	jsvv
槛	jmvi
槛	kfvi
槠	qjvo
槭	qkvv
槿	jbvv
樗	jjvv
樘	tpvi
樵	qcvi
樾	yhvv
橞	hbvv
橡	xxvu
橥	qjua
橦	tyvo
橱	jjvv
橹	ljvu
橼	ytva
檀	tfvo
檄	xkvu
檎	qbvi
檐	yfvu
檑	lwvv
檗	blav
檠	qgii
檩	lbvo
櫆	kbvu
欂	blvi
欷	xkuo
欹	qkvu
欹	ykvu
欺	qkvi
欻	xlou
歅	yfvi
歆	xbov
歙	eeiv
歙	xkiv
殂	cjvu
殆	dhvu
殖	ekvu
殖	fkvu
殚	dfvu
殛	jkvu
殪	ykvu
殷	yfuu
毂	gjvo
毅	ykov
毐	xhvo
毓	yluv
毖	bkva
毗	pkia
毪	mjuv
毹	ejiv
毽	jmuv
氍	qlia
氏	ekua
氏	fkua
氐	dkua
氘	dzuv
氟	fjuv
氡	dyuv
氪	keuv
氯	lluv
氰	qguv
氿	gbau
汐	xkau
汛	xwaa
汜	skaa
汧	qmav
汨	mkao
汩	ylao
汫	jgav
汲	jkau
汴	bmao
沂	ykau
沄	ywav
沅	ytav
沇	yfaa
沏	qkav
沔	mmav
沚	fkai
沤	xdav
沥	lkav
沭	ejav
泊	plau
泜	fkau
泠	lgai
泫	xtao
泱	ypai
泶	xhoo
泺	llau
洇	ybai
洈	wwau
洎	jkau
洑	fjai
洙	qjau
洣	mkao
津	jbaa
洧	wwav
洫	xlau
洮	tzau
洳	rjaa
洿	wjav
浆	jxov
浍	hbai
浐	jfao
浒	hjao
浚	jwaa
浚	xwaa
浛	hfai
浟	ydai
浣	htao
浬	lkai
浯	wjav
浰	lkau
浲	frau
涎	xmau
涐	xeau
涘	skaa
涡	wlao
涧	jmao
涪	fjao
淅	xkav
淇	qkav
淑	ejai
淜	pgau
淝	fwau
淟	tmai
淤	ylao
渌	ljaa
渎	djau
渔	ylau
渖	enao
渝	ylai
渤	blau
渥	wlaa
渫	xdav
渭	wwai
湑	xlaa
湔	jmao
湜	ekao
湝	jdav
湣	mbaa
湫	jcau
湮	yfav
湲	ytau
溆	xlai
溢	ykao
溧	lkav
溪	xkau
溵	ybau
溽	rjav
滁	jjaa
滍	fkaa
滏	fjau
滓	zkao
滟	yfav
滪	ylaa
漪	ykau
漯	llai
漯	lwai
漱	ejav
漳	qpao
漺	emav
漺	exav
漻	lcaa
潆	ygai
潍	wwaa
潞	ljao
潟	xkau
潩	ykai
潲	ezau
潴	qjau
潽	pjao
澂	jrai
澉	gfaa
澌	skav
澍	qjav
澥	xdau
澭	yyao
澴	htai
澼	pkaa
澽	jlai
濉	sbai
濞	bkau
濞	pkau
瀔	gjau
瀛	ygao
瀱	jkai
瀴	ygaa
灀	exav
灏	hzao
炀	ypou
炅	gboi
炆	wnou
炎	yfou
炕	kpou
炙	fkua
炜	wwou
炝	qxou
炟	dsou
炮	bzou
炱	thao
炷	qjou
炽	wkou
烈	ldvu
烙	llou
烜	xtou
烠	hbou
烨	yeou
烶	tgou
焆	jtou
焉	yfvi
焐	wjou
焓	hfou
焗	jlou
焯	flou
焯	jzou
焯	wzou
焰	yfou
煁	jnou
煃	kbou
煊	xtou
煎	jmou
煟	wwou
煦	xloi
煲	bzio
熄	xkou
熙	xkvi
熟	edov
熠	ykou
熥	trou
熻	xkou
燊	enou
燋	jcou
燏	ylou
燕	yfvi
燚	ykou
燠	ylou
燥	zzou
燧	sbou
燮	xdov
燹	xmvu
爇	rlii
爝	jhou
牂	zpai
牚	jrio
牡	mjuv
牮	jmiv
牯	gjuv
牲	eruv
牺	xkuv
牾	wjuv
犁	lkuv
犊	djuv
犋	jluv
犟	jxav
犨	wdio
犯	ffua
犰	qqua
狈	bwua
狉	pkua
狐	hjua
狝	xmua
狴	bkua
猁	lkua
猃	xmua
猗	ykua
猥	wwua
猹	wsua
猺	yzua
獒	xzvv
獬	xdua
獯	xwua
玃	jhua
玄	xtov
玑	jkvv
玕	gfvv
玘	qkvv
玙	ylvv
玠	jdvv
玦	jhvv
玮	wwvv
玶	pgvv
玹	xtvv
玺	xkua
珂	kevv
珅	envv
珋	lqvv
珌	bkvv
珏	jhvv
珐	fsvv
珑	lyvv
珒	jbvv
珕	lkvv
珛	xqvv
珝	xlvv
珪	gbvv
珲	hbvv
珵	jrvv
珸	wjvv
珹	jrvv
珺	jwvv
琀	hfvv
琈	fjvv
琊	ysvv
琎	jbvv
琚	jlvv
琟	wwvv
琡	ejvv
琥	hjvv
琦	qkvv
琬	wfvv
琭	ljvv
琯	gtvv
琰	yfvv
瑀	ylvv
瑂	mwvv
瑆	xgvv
瑓	lmvv
瑗	ytvv
瑜	ylvv
瑝	hmvv
瑝	hxvv
瑢	ryvv
瑬	lqao
瑰	gbvv
瑱	tmvv
璁	cyvv
璋	qpvv
璎	ygvv
璐	ljvv
璟	jgvv
璧	bkav
璨	cfvv
璮	tfvv
璱	sevv
璿	xtvv
瓖	xxvv
瓠	hjvu
瓯	xdvu
瓴	lgio
瓻	wkuo
瓿	bjov
甄	qnvi
甍	mrii
甏	brvo
甙	dhvv
甡	enuv
甥	eruv
甪	ljuu
甫	fjvi
甬	yyao
甯	ngoo
町	dgia
町	tgia
甾	zkaa
畀	bkia
畎	qtia
畏	wwia
畖	wsia
畛	qnia
畜	xlov
番	ffuo
番	pfuo
畯	jwia
畲	eeiv
畴	wdia
畹	wfia
疍	dfai
疑	nkua
疔	dgov
疖	jdov
疙	geov
疠	lkov
疡	ypov
疰	qjov
疵	ckov
痃	xtov
痄	fsov
痈	yyov
痉	jgov
痖	ysov
痞	pkov
痢	lkov
痣	fkov
痱	fwov
痹	bkov
瘀	ylov
瘃	qjov
瘅	dfov
瘆	enov
瘌	lsov
瘕	jsov
瘕	xsov
瘘	ldov
瘛	wkov
瘟	wnov
瘢	bfov
瘥	jhov
瘫	tfov
瘰	llov
瘴	qpov
瘵	fhov
瘵	qhov
瘸	qhov
癀	hmov
癀	hxov
癍	bfov
癗	lwov
癜	dmov
癣	xtov
皋	gzui
皑	xhui
皙	xkvu
皛	xcui
皤	plui
盅	fyia
益	ykou
盍	hevo
监	jmii
盖	geou
盦	xfio
盱	xlia
眄	mmia
眇	mcia
眙	wkia
眢	ytua
眦	zkia
眭	gbia
眭	sbia
眵	wkia
睄	qcia
睇	dkia
睑	jmia
睢	hbia
睢	sbia
睥	pkia
睫	jdia
瞀	mzao
瞎	xsia
瞢	mrii
瞩	qjia
瞫	enia
瞵	lbia
瞽	gjvo
矍	jhia
矜	gtao
矜	jbao
矞	xlao
矢	ekuv
矫	jcuv
矶	jkvu
矸	gfvu
矻	kjvu
矾	ffvu
砄	jhvu
砆	fjvu
砉	xlvv
砌	qkvu
砒	pkvu
砜	frvu
砝	fsvu
砟	fsvu
砠	jlvu
砦	fhiv
砦	qhiv
砫	qjvu
砬	lkvu
砮	njau
砵	blvu
砹	xhvu
砻	lyvu
砾	lkvu
硊	wwvu
硌	gevu
硒	xkvu
硔	hyvu
硖	xsvu
硗	qcvu
硙	wwvu
硚	qcvu
硷	jmvu
硼	prvu
碁	qkvi
碚	bwvu
碜	jnvu
碣	jdvu
碥	bmvu
碱	jmvu
碲	dkvu
磏	lmvu
磡	kfvu
磬	qgvo
磻	blvu
礌	lwvu
礴	blvu
示	ekvv
祀	skoa
祁	fkoa
祁	qkoa
祆	xmoa
祈	qkoa
祉	fkoa
祎	ykoa
祏	ekoa
祐	ydoa
祓	fjoa
祗	fkoa
祜	hjoa
祟	sbai
祢	mkoa
祥	xxoa
祭	jkua
祲	jboa
祺	qkoa
祼	gtoa
禀	bgov
禅	efoa
禅	jfoa
禊	xkoa
禋	yboa
禒	xmoa
禔	fkoa
禔	tkoa
禘	dkoa
禚	floa
禤	xtoa
禹	ylui
禽	qbio
秆	gfuv
秕	bkuv
秤	jruv
秩	fkuv
秫	ejuv
秭	zkuv
稆	lluv
稌	tjuv
稑	ljuv
稚	fkuv
稠	wduv
稷	jkuv
稹	qnuv
穙	pjuv
穸	xkoo
窅	yzoo
窈	yzoo
窊	wsoo
窖	jcoo
窠	keoo
窣	sjoo
窨	xwoo
窨	yboo
窭	jloo
窳	yloo
竑	hyov
竘	qlov
竞	jgov
笃	djuv
笈	jkuv
笕	jmuv
笛	dkuv
笮	zeuv
笱	gduv
笳	jsuv
笺	jmuv
筀	gbuv
筅	xmuv
筏	fsuv
筑	qjuv
筠	ywuv
筤	lpuv
筥	jluv
筦	gtuv
筱	xcuv
筵	yfuv
筶	gzuv
筻	gpuv
筼	ywuv
箅	bkuv
箓	ljuv
箔	bluv
箝	qmuv
箦	zeuv
箨	tluv
箪	dfuv
箱	xxuv
箸	qjuv
篁	hmuv
篁	hxuv
篙	gzuv
篚	fwuv
篥	lkuv
篦	bkuv
篪	wkuv
篱	lkuv
篼	dduv
簃	ykuv
簏	ljuv
簸	bluv
籀	fduv
籍	jkuv
籼	xmou
粑	bsou
粝	lkou
粞	xkou
粤	yhui
粳	jgou
粿	glou
糈	xlou
糊	hjou
糍	ckou
糒	bwou
糗	qqou
糜	mkov
糨	jxou
糵	ndii
系	jkua
絜	xdvv
絮	xlau
綦	qkvi
縠	hjvo
縻	mkov
繁	pluv
繄	ykvu
繇	yduo
纡	ylaa
纣	fdaa
约	yzaa
纨	wfaa
纪	jkaa
纮	hyaa
纴	rnaa
纶	gtaa
纻	qjaa
纼	qnaa
绁	xdaa
绂	fjaa
绅	enaa
织	fkaa
绉	fdaa
绋	fjaa
绛	jxaa
络	llaa
绞	jcaa
绡	xcaa
绤	xkaa
继	jkaa
绨	tkaa
绩	jkaa
绮	qkaa
绯	fwaa
绰	jzaa
绰	wzaa
绹	tzaa
综	zraa
缁	zkaa
缃	xxaa
缄	jmaa
缈	mcaa
缊	ywaa
缋	hbaa
缍	dlaa
缏	bmaa
缐	xmaa
缒	fbaa
缕	llaa
缡	lkaa
缢	ykaa
缣	jmaa
缧	lwaa
缪	mcaa
缱	qmaa
缲	szaa
缳	htaa
缴	flaa
缶	fduv
罍	lwia
罡	gpia
罨	yfia
罱	lfia
罴	pkia
罶	lqia
羁	jkia
羑	ydou
羝	dkou
羟	qxou
羼	jfav
羽	ylao
羿	ykao
翂	fnao
翈	xsia
翌	ykao
翎	lgio
翙	hbia
翚	hbao
翛	xcii
翡	fwiv
翥	qjuo
翮	hevo
翯	heao
翷	lbou
翼	ykao
翾	xtia
耄	mzuo
耆	qkuo
耋	dduo
耏	xjvu
耥	tpvv
耦	xdvv
耰	ydvv
耱	mlvv
聩	kbvi
聿	ylav
肄	ykua
肆	skvi
肇	fzoa
肇	qzoa
肢	fkuu
肤	fjuv
肫	jwuv
肴	yzuo
肷	qmuu
肸	xkuu
胃	wwia
胈	bsuv
胍	gquu
胣	wkuu
胤	ybua
胫	jgua
胬	njau
胰	ykuv
脂	fkuu
脉	mluo
脊	jkov
脒	mkuo
脘	wfuo
脯	fjuv
腈	jguv
腌	xsuv
腑	fjuo
腒	jlua
腱	jmua
腴	yluu
腽	wsuo
膂	llov
膝	xkuv
膨	pruv
膻	dfuo
膻	efuo
臂	bkav
臌	gjuv
臼	jqui
臾	ylui
舀	yzuo
舄	xkui
舐	ekuv
舣	ykuu
舨	bfuu
舭	bkuu
舶	bluu
舷	xmuu
舾	xkuu
艉	wwuu
艋	mruu
艎	hmuu
艎	hxuu
艴	fjav
艽	jcii
艾	ykii
芃	prii
芍	ezii
芑	qkii
芒	mpii
芟	efii
芡	qmii
芤	kdii
芥	jdii
芩	qbii
芫	yfii
芫	ytii
芭	psii
芮	rbii
芯	xbii
芴	hjii
芴	wjii
芷	fkii
芾	fwii
苁	cyii
苇	wwii
苈	lkii
苉	pkii
苊	xeii
苋	xmii
苌	jpii
苎	qjii
苓	lgii
苘	qgii
苞	bzii
苡	ykii
苣	jlii
苣	qlii
苴	jlii
苴	wsii
苹	prii
苻	fjii
苾	bkii
茀	fjii
茁	flii
茄	jsii
茅	mzii
茆	mzii
茇	bsii
茈	ckii
茉	mlii
茋	fkii
茎	jgii
茚	ybii
茝	jhii
茬	wsii
茭	jcii
茱	qjii
茲	ckii
茲	zkii
茴	hbii
茵	ybii
茸	ryii
茽	fyii
荁	htii
荄	ghii
荆	jgii
荇	xgii
荏	rnii
荐	jmii
荑	ykii
荓	pgii
荔	lkii
荖	lzii
荚	jsii
荜	bkii
荞	qcii
荦	llii
荧	ygii
荨	qmii
荨	xwii
荩	jbii
荭	hyii
荸	bkii
荻	dkii
莅	lkii
莆	fjii
莆	pjii
莎	slii
莒	jlii
莘	enii
莛	tgii
莜	ydii
莪	xeii
莹	ygii
莺	ygii
莼	jwii
莿	ckii
菀	wfii
菀	ywii
菁	jgii
菅	jmii
菈	lsii
菊	jlii
菍	ndii
菏	heii
菔	fjii
菖	jpii
菘	syii
菝	bsii
菟	tjii
菠	blii
菥	xkii
菩	pjii
菪	dpii
菰	gjii
萋	qkii
萘	nhii
萤	ygii
萦	ygii
萩	qqii
萸	ylii
萹	bmii
葆	bzii
葖	tjii
葙	xxii
葚	enii
葚	rnii
葡	pjii
葰	jwii
葸	xkii
葺	qkii
蒄	gtii
蒎	phii
蒗	lpii
蒨	qmii
蒯	kgii
蒱	pjii
蒲	pjii
蒺	jkii
蒻	rlii
蓁	qnii
蓂	mgii
蓇	gjii
蓍	ekii
蓟	jkii
蓠	lkii
蓢	lpii
蓣	ylii
蓦	mlii
蓰	xkii
蓼	ljii
蓿	xlii
蔃	qxii
蔊	hfii
蔬	ejii
蔹	lmii
蔼	xhii
蕃	blii
蕈	xwii
蕗	ljii
蕙	hbii
蕡	fnii
蕤	rbii
蕥	ysii
蕰	ywii
蕻	hyii
蕾	lwii
薇	wwii
薏	ykii
薜	bkii
薢	xdii
薯	ejii
薷	rjii
薹	thii
藓	xmii
藕	xdii
藜	lkii
藟	lwii
藨	bcii
藩	ffii
蘑	mlii
蘧	qlii
蘩	ffii
虍	hjiv
虓	xcua
虔	qmiv
虤	yfiv
虬	qqia
虵	eeia
虷	hfia
虸	zkia
虼	geia
蚀	ekua
蚣	fyia
蚧	jdia
蚪	ddia
蚬	xmia
蚰	ydia
蚱	fsia
蚲	pgia
蛀	qjia
蛄	gjia
蛆	qlia
蛉	lgia
蛊	gjia
蛎	lkia
蛏	jria
蛑	mdia
蛘	ypia
蛛	qjia
蛤	geia
蛩	qyvi
蛰	feiu
蛰	qeiu
蛱	jsia
蛳	skia
蛴	qkia
蛸	xcia
蜀	ejia
蜃	envu
蜊	lkia
蜍	jjia
蜎	ytia
蜘	fkia
蜚	fwiv
蜢	mria
蜥	xkia
蜩	tcia
蝌	keia
蝗	hmia
蝗	hxia
蝠	fjia
蝣	ydia
蝤	qqia
蝮	fjia
蝰	kbia
蝲	lsia
蝻	nfia
蝼	ldia
蝽	jwia
蝾	ryia
螈	ytia
螋	sdia
螗	tpia
螟	mgia
螨	mfia
螫	ekvo
螯	xzvv
螱	wwav
螺	llia
蟆	msia
蟋	xkia
蟠	pfia
蟥	hmia
蟥	hxia
蟪	hbia
蟫	ybia
蟹	xdua
蟾	jfia
蠃	llov
蠋	qjia
蠓	mria
蠖	hlia
蠲	jtou
行	hruu
衔	xmuu
衩	wsoa
衫	efoa
衰	cbov
衾	qbio
衿	jboa
袒	tfoa
袗	qnoa
袪	qloa
被	pkoa
袭	xkvu
袯	bloa
袱	fjoa
袴	kjoa
袷	jsoa
裁	chuo
裎	jroa
裒	pdov
裔	ykov
裟	esai
裣	lmoa
裥	jmoa
裰	dloa
裳	epio
裳	jpio
裼	xkoa
裾	jloa
褊	bmoa
褐	heoa
褚	feoa
褚	qeoa
褛	lloa
褟	tsoa
褫	wkoa
褯	jdoa
褰	qmoo
襄	xxov
襚	sboa
襻	pfoa
见	xmia
觃	yfia
视	ekoa
觊	jkia
觋	xkvi
觌	dkuo
觍	tmia
觎	yliv
觐	jbvi
觑	qliv
觖	jhua
觜	zkiv
解	xdua
觫	sjua
觱	bkvu
觿	xkua
訄	qqua
訚	yboi
訾	zkiv
詈	lkia
詟	fevu
詟	qevu
詧	wsua
誉	yloo
誓	ekiu
譬	pkav
讥	jkoa
讪	efoa
讱	rnoa
讼	syoa
访	fpoa
诃	heoa
诅	zjoa
识	ekoa
诇	xyoa
诋	dkoa
译	ykoa
诓	kmoa
诓	kxoa
诖	gqoa
诘	jdoa
诘	jkoa
诙	hboa
诛	qjoa
诜	enoa
询	xwoa
诣	ykoa
诧	wsoa
诩	xloa
诲	hboa
读	ddoa
诿	wwoa
谀	yloa
谂	enoa
谅	lxoa
谆	qwoa
谊	ykoa
谌	jnoa
谏	jmoa
谐	xdoa
谑	xhoa
谔	xeoa
谕	yloa
谗	jfoa
谝	pmoa
谧	mkoa
谪	feoa
谪	qeoa
谯	qcoa
谰	lfoa
谲	jhoa
谳	yfoa
谶	jnoa
豕	ekvu
豢	htou
豪	hzov
豫	ylao
豸	fkuo
豺	jhuo
貉	mluo
貊	mluo
贝	bwao
贠	ywao
贡	gyvi
贤	xmii
贱	jmao
贳	ekvi
贻	ykao
贽	fkiu
赀	zkiv
赁	lbiu
赆	jbao
赇	qqao
赍	jkuo
赑	bkao
赓	grov
赕	dfao
赟	ywov
赪	jrvo
赭	fevo
赭	qevo
趄	jlvo
趋	qlvo
趔	ldvo
趯	tkvo
趵	bzoi
趺	fjoi
趼	jmoi
趿	tsoi
跂	qkoi
跅	tloi
跐	ckoi
跖	fkoi
跗	fjoi
跚	efoi
跞	lkoi
跞	lloi
跫	qyvi
跬	kboi
跶	dsoi
跸	bkoi
跹	xmoi
跽	jkoi
踅	xhiu
踉	lxoi
踒	wloi
踞	jloi
踟	wkoi
踦	qkoi
踬	fkoi
踯	fkoi
踺	jmoi
踽	jloi
蹀	ddoi
蹄	tkoi
蹇	jmoo
蹊	xkoi
蹋	tsoi
蹐	jkoi
蹚	tpoi
蹢	dkoi
蹩	bdou
蹰	jjoi
蹴	jqoi
蹾	dwoi
躔	jfoi
躞	xdoi
车	jlva
轧	ysva
轳	ljva
轵	fkva
轶	ykva
轸	qnva
轹	lkva
轺	yzva
轾	fkva
辀	fdva
辂	ljva
辈	bwiv
辐	fjva
辜	gjuo
辟	bkav
辨	bmov
辫	bmov
辿	jfia
迁	qmuv
迂	ylvv
迓	ysva
迕	wjuv
这	qwov
迤	ykuv
迨	dhao
迩	xjua
迳	jgao
迹	jkov
适	ekuv
逍	xcio
逑	qqvi
递	dkou
逦	lkvi
逭	htoo
逯	ljav
逶	wwuv
逾	yliv
遁	dwuu
遄	wtia
遆	dkov
遗	wwia
遗	ykia
遘	gdvv
遨	xzvv
遴	lbou
遹	ylao
邂	xdua
邑	ykoa
邕	yyaa
邗	hfvv
邘	ylvv
邙	mpov
邢	xgvv
邱	qqui
邲	bkoa
邳	pkvu
邴	bgvi
邶	bwiv
邷	wsva
邸	dkua
邽	gbvo
邾	qjuv
邿	ekvo
郃	heiv
郅	fkva
郇	htua
郏	jsvo
郐	gbiv
郓	ywoa
郚	wjvi
郜	gzuv
郡	jwav
郢	ygov
郦	fkvi
郴	jnvv
郾	yfvo
郿	mwai
鄂	xeoo
鄃	ejiv
鄑	zkvi
鄗	hzov
鄙	bkou
鄜	fjov
鄠	hjvo
鄢	yfvi
鄣	qpov
鄫	zrou
鄯	efou
酆	friv
酊	dgvi
酏	ykvi
酐	gfvi
酡	tlvi
酤	gjvi
酥	sjvi
酦	plvi
酮	tyvi
酯	fkvi
酵	jcvi
酹	lwvi
酾	ekvi
醌	kwvi
醑	xlvi
醭	bjvi
醮	jcvi
醴	lkvi
醵	jlvi
金	jbio
銮	ltov
鋈	wjau
鎏	lqao
鏖	xzov
鐾	bwav
鑫	xbio
钇	ykio
钌	lcio
钎	qmio
钖	ypio
钘	xgio
钚	bjio
钜	jlio
钡	bwio
钣	bfio
钤	qmio
钥	yzio
钪	kpio
钬	hlio
钲	qrio
钳	qmio
钴	gjio
钶	keio
钹	blio
钽	tfio
铂	blio
铆	mzio
铈	ekio
铕	ydio
铗	jsio
铚	fkio
铛	jrio
铝	llio
铢	qjio
铣	xmio
铤	dgio
铪	keio
铫	dcio
铰	jcio
铱	ykio
铴	tpio
铹	lzio
铻	wjio
铼	lhio
锆	gzio
锇	xeio
锎	khio
锏	jmio
锓	qbio
锔	jlio
锖	qxio
锘	nlio
锣	llio
锦	jbio
锩	jtio
锪	hlio
锭	dgio
锴	khio
锶	skio
锺	fyio
锿	xhio
镃	zkio
镅	mwio
镉	geio
镌	jtio
镍	ndio
镎	nsio
镓	jsio
镔	bbio
镗	tpio
镟	xtio
镠	lqio
镡	jfio
镡	tfio
镡	xbio
镢	jhio
镤	pjio
镨	pjio
镪	qxio
镬	hlio
镮	htio
镰	lmio
镲	wsio
镳	bcio
镵	jfio
闱	wwoi
闸	fsoi
闼	tsoi
闾	lloi
阂	heoi
阈	yloi
阉	yfoi
阊	jpoi
阌	wnoi
阎	yfoi
阏	xeoi
阕	qhoi
阖	heoi
阚	hfoi
阰	pkai
陂	pkai
陎	ejai
险	xmai
陴	pkai
陷	xmai
隃	ylai
隈	wwai
隋	dlai
隐	ybai
隗	wwai
隰	xkai
隳	hbai
隽	jtio
隽	jwio
雀	qciu
雁	yfvu
雊	gdua
雍	yyov
雎	jlia
雏	jjua
雒	llua
雩	ylvo
雫	xsvo
霁	jkvo
霅	fsvo
霨	wwvi
霪	ybvo
霭	xhvo
靓	jgvv
靖	jgov
靛	dmvv
靬	jmva
靰	wjvi
靳	jbvi
靺	mlvi
靼	dsvi
鞁	bwvi
鞒	qcvi
鞠	jlvi
鞡	lsvi
鞮	dkvi
韦	wwvv
韫	wnvv
韫	ywvv
韬	tzvv
顽	wfvv
颅	ljiv
颉	jdvo
颊	jsvo
颋	tguv
颌	geiv
颍	ygua
颏	keov
颙	yyia
颚	xeoo
颟	mfii
颢	hzoi
颤	efov
颦	pbiv
颧	qtii
飏	ypua
飐	qfua
飑	bcua
飓	jlua
飔	skua
飧	swua
饔	yyov
饥	jkua
饧	xgua
饩	xkua
饫	ylua
饰	ekua
饳	dlua
饵	xjua
饷	xxua
饺	jcua
饻	xkua
馀	ylua
馏	lqua
馗	kbua
馝	bkuv
馞	bluv
馥	fjuv
驰	wkaa
驷	skaa
驸	fjaa
驿	ykaa
骀	dhaa
骉	bcaa
骊	lkaa
骋	jraa
骒	keaa
骓	fbaa
骘	fkai
骜	xzvv
骝	lqaa
骟	efaa
骠	pcaa
骡	llaa
骣	jfaa
骥	jkaa
骧	xxaa
骰	tdia
骶	dkia
骺	hdia
髀	bkia
髁	keia
髎	lcia
髑	djia
鬈	qtvi
鬒	qnvi
鬘	mfvi
鬲	gevo
鬲	lkvo
魄	blui
魇	yfvu
鲀	twua
鲃	bsua
鲉	ydua
鲊	fsua
鲋	fjua
鲌	blua
鲌	bsua
鲍	bzua
鲍	pzua
鲑	gbua
鲑	xdua
鲒	jdua
鲔	wwua
鲖	tyua
鲙	kgua
鲝	fsou
鲞	xxou
鲟	xwua
鲡	lkua
鲣	jmua
鲤	lkua
鲥	ekua
鲩	htua
鲫	jkua
鲬	yyua
鲯	qkua
鲱	fwua
鲳	jpua
鲴	gjua
鲵	nkua
鲷	dcua
鲺	ekua
鲿	jpua
鳁	wnua
鳇	hmua
鳇	hxua
鳏	gtua
鳑	ppua
鳒	jmua
鳓	leua
鳔	bcua
鳚	wwua
鳛	xkua
鳜	jhua
鳣	efua
鳤	gtua
鸠	jqua
鸡	jkao
鸢	ytva
鸤	ekav
鸥	xdvu
鸦	ysva
鸩	qnoa
鸬	ljiv
鸮	xcov
鸯	ypia
鸰	lgio
鸱	wkua
鸲	qlua
鸳	ytua
鸶	skaa
鸼	fduu
鸾	ltov
鹀	wjvi
鹁	bluo
鹂	lkvi
鹄	hjuv
鹆	yluo
鹈	tkou
鹉	wjvv
鹋	mcii
鹍	kwoi
鹎	bwui
鹐	qmua
鹑	jwov
鹒	grov
鹓	ytoo
鹔	sjav
鹗	xeoo
鹘	hjia
鹚	ckou
鹛	mwai
鹜	wjao
鹝	ykvo
鹢	ykuo
鹣	jmou
鹦	ygao
鹨	lqao
鹪	jcio
鹫	jqov
鹮	htia
鹰	ygov
鹱	hjua
鹲	mrii
鹴	emvo
鹴	exvo
麀	ydov
麑	nkov
麴	qlvi
麸	fjvv
麹	qlvv
麽	mlov
黇	tmii
黎	lkuv
黔	qmia
黛	dhiv
黢	qlia
黥	qgia
黩	djia
黯	xfia
黹	fkii
黾	mboi
鼋	ytvv
鼒	zkvi
鼬	ydui
鼹	yfui
鼻	bkui
鼽	qqui
齇	fsui
龁	heiv
龂	ybiv
龃	jliv
龉	yliv
龊	wliv
龟	qqua
㑊	ykio
㘎	hfoo
㙍	dlvo
㞎	bsav
㟃	skia
㤘	jjoo
㥄	lgoo
㫰	lpoi
㬎	xmoi
㭕	qlvv
㳘	wyao
㳚	ylav
㽏	gfai
㿠	hmui
㿠	hxui
䂮	lhvv
䎃	rfia
䏝	jwuv
䏲	dduo
䓛	qlii
䓫	jkii
䗖	dkia
䗛	xqia
䗪	feov
䗪	qeov
䗴	tgia
䜣	xkoa
䝙	jjuo
䥽	plio
䦃	flio
䲟	ybua
䲠	jwua
䲢	truo
䴓	ekvi
䴔	jcov
䴕	ldvu
䴖	jgvv
䴗	jlia
䶮	yfvu
𠅤	xkov
𠙶	xdai
𠳬	jguo
𣲘	wjav
𣸣	fnau
𤞤	xmua
𤧛	dkvv
𤩽	htvv
𤫉	xdvv
𥔲	xevu
𦈡	rjaa
𦒍	tyov
𦙶	gjuu
𦝼	lluo
𨙸	qkuo
𨚕	bmao
𨟠	qhia
𨟠	qtia
𨭉	bfov
𨱑	hmio
𨱑	hxio
𨱔	zwio
𩽾	xfua
𩾃	mmua
万	wfva
丈	qpvu
三	sfvv
上	epiv
下	xsvi
丌	jkvu
丌	qkvu
不	bjvu
与	ylva
丑	wdai
专	ftvv
且	jlia
且	qdia
业	yeii
丛	cyii
东	dyva
丢	dquv
两	lxvi
丧	spuo
中	fyia
丰	frvv
临	lbii
丸	wfua
丹	dfua
为	wwou
主	qjov
举	jloo
久	jqua
么	meua
之	fkoa
乎	hjuo
乏	fsuo
乐	leua
乐	lzua
乐	yhua
乒	pgui
乔	qcuv
乖	gguv
乘	eruv
也	yeai
乡	xxaa
书	ejaa
买	mhao
乱	ltuv
争	qrua
事	ekvi
于	ylvv
亏	kbvv
云	ywvv
互	hjva
亓	qkvv
五	wjvi
些	xdiv
交	jcov
亦	ykov
产	jfov
亩	mjov
亲	qbov
什	ekiu
仁	rniv
仂	leia
仇	wdiu
仍	rria
从	cyii
仓	cpia
仔	zhia
他	tsia
付	fjiv
仡	ykiu
代	dhiv
令	lgio
以	ykao
们	mnio
仵	wjiu
任	rniu
份	fniu
仿	fpio
企	qkii
伍	wjiv
伎	fkiu
众	fyii
会	hbiv
会	kgiv
伛	yliv
伞	sfio
传	wtiv
伣	qmii
伸	enii
似	skia
伽	gsia
佁	ykia
但	dfio
位	wwio
低	dkiu
住	qjio
体	tkiv
何	heiv
余	yliv
佛	fjia
作	zliu
你	nkiu
佥	qmiv
佧	ksii
佩	pwiu
佸	hliu
佺	qtii
佾	ykiu
使	ekiv
侃	kfio
例	lkiv
侑	ydiv
侘	wsio
供	gyiv
依	ykio
侠	xsiv
侧	ceia
侪	jhio
侬	nyio
侵	qbia
便	bmiv
促	cjio
俄	xeiu
俊	jwia
俎	zjii
俗	sjiu
俚	lkii
保	bzio
俟	qkia
信	xbio
俩	lsiv
俩	lxiv
俭	jmii
修	xqii
倒	dziv
倓	tfio
候	hdii
倭	wliu
倾	qgiv
假	jsia
偌	rlii
偏	pmio
做	zliu
停	tgio
偬	zyiu
偷	tdii
傉	njiv
储	jjio
催	cbii
傲	xziv
傻	esiu
像	xxiu
僚	lciv
僧	srio
僬	jcii
儆	jgii
儒	rjiv
允	ywao
元	ytvv
兄	xyou
充	wyov
先	xmuv
光	gmio
光	gxio
克	keuo
免	mmua
兑	dbou
兖	yfov
党	dpio
兜	ddui
全	qtiv
公	gyuo
六	lqov
兰	lfou
共	gyvi
兲	tmvv
关	gtou
兵	bgui
其	jkvi
其	qkvi
养	ypou
内	nwia
冉	rfia
册	ceua
再	zhvi
冒	mzia
写	xdoa
军	jwoa
农	nyoa
冬	dyua
冲	wyov
决	jhov
况	kmov
况	kxov
冷	lrov
准	qwov
凊	qgov
减	jmov
凑	cdov
凓	lkov
凝	ngov
几	jkua
凤	frua
凫	fjua
凭	pgiu
凯	khia
出	jjai
凼	dpaa
分	fnuo
切	qdva
划	hqva
列	ldvu
刘	lqov
则	zeao
刚	gpia
创	wmia
创	wxia
初	jjoa
删	efua
判	pfou
刨	pzua
利	lkuv
别	bdoa
刬	jfvv
刮	gquv
到	dzva
刷	eqav
券	qtou
刹	wsuo
刺	ckvi
前	qmou
剕	fwiv
剡	efou
剥	bzav
剩	eruv
副	fjvo
割	geoo
剿	jzaa
剿	wzaa
劄	fsuv
劝	qtao
办	bfau
加	jsau
动	dyvv
劲	jgao
劳	lzii
勇	yyao
勒	levi
勚	ykvi
匀	ywua
包	bzua
匆	cyua
匏	pzvu
化	hqiu
北	bwiv
匠	jxvu
匪	fwvi
匹	pkvu
区	qlvu
医	ykvu
匿	nkvi
千	qmuv
卅	ssvu
半	bfou
协	xduo
单	dfou
卖	mhuo
南	nfuo
南	nsuo
博	bluo
占	qfiv
卡	ksiv
卡	qsiv
卢	ljiv
卦	gqvo
卧	wlvi
卮	fkuu
印	ybua
即	jkav
却	qhvo
卵	ltua
卷	jtou
卿	qgua
厅	tgvu
压	ysvu
厕	cevu
厚	hdvu
原	ytvu
厣	yfvu
厥	jhvu
厦	esvu
厨	jjvu
去	qlvo
县	xmia
叁	sfao
参	cfao
双	emao
双	exao
反	ffuu
发	fsau
叔	ejiv
取	qlvi
受	eduo
变	bmov
古	gjuo
句	jlua
另	lgoa
叩	kdoa
只	fkou
叫	jcoa
召	fzau
召	qzau
可	kevo
台	thao
右	ydvu
号	hzov
司	skav
叹	tfoa
吃	wkou
各	geua
合	heiv
同	tyia
名	mgua
后	hduu
吐	tjov
向	xxui
吗	msoa
吞	twvv
吡	bkov
否	fdvu
吧	bsoa
吨	dwov
含	hfio
听	tgou
吭	hpoo
吭	kroo
吮	ewoa
吹	wbou
呀	ysov
呃	xeov
呈	jrov
告	gzuv
呖	lkov
呗	bhoa
呗	bwoa
员	ytoa
呛	qxoi
呞	ekoa
呢	neoa
呢	nkoa
呣	xmoa
周	fdua
味	wwov
呴	xlou
呵	hsov
呵	keov
呸	pwov
命	mgiv
咀	jloi
咋	zeou
咋	zsou
和	heuv
和	hjuv
和	hluv
咖	ksoa
咙	lyov
咝	skoa
咡	xjov
咧	ldov
咬	yzoo
咭	jkov
咱	zfou
咱	zsou
咺	xtov
哀	xhov
品	pboo
哈	hsoi
哌	phou
响	xxou
哏	gnoa
哗	hqoi
哙	kgoi
哦	xlou
哪	nsoa
哪	nwoa
哭	kjoo
哼	hroo
唐	tpov
唔	xrov
唛	mhov
唤	htou
唧	jkoa
唰	eqoa
唱	jpoo
唷	yloo
唾	tlou
啃	knoi
商	epov
啊	xsoa
啐	cboo
啥	esoi
啦	lsoi
啪	psoi
啬	seuo
啭	ftov
喃	nfou
善	efou
喈	jdov
喉	hdoi
喊	hfov
喏	reoi
喘	wtoi
喜	xkvo
喝	heoo
喰	swoi
喱	lkov
喷	pnou
嗓	spoa
嗖	sdou
嗡	wrou
嗣	skoi
嗦	slou
嗯	xnoi
嗯	xroi
嘁	qkov
嘌	pcov
嘎	gsov
嘚	deou
嘛	msoo
嘞	leov
嘧	mkoo
嘴	zboi
嘿	hwoi
噢	xzou
噶	gsoi
嚓	csoo
嚚	yboo
嚭	pkvo
嚷	rpoo
囊	npvi
囍	xkvo
囔	npov
囗	wwia
囚	qqia
四	skia
回	hbia
因	ybia
团	ttia
囤	twia
囧	jyia
囫	hjia
园	ytia
困	kwia
囷	qwia
囹	lgia
固	gjia
国	glia
图	tjia
圄	ylia
圈	qtia
圉	ylia
圣	erao
在	zhvu
地	devo
地	dkvo
场	jpvo
均	jwvo
坊	fpvo
坏	hgvo
坑	krvo
块	kgvo
坠	fbai
坡	plvo
坤	kwvo
坦	tfvo
坪	pgvo
坰	jyvo
坼	jevo
坼	wevo
垂	wbuv
垃	lsvo
垄	lyvu
垈	dhiv
垍	jkvo
垠	ybvo
垤	ddvo
垮	kqvo
垺	pdvo
埋	mfvo
埋	mhvo
城	jrvo
埘	ekvo
埴	fkvo
埸	ykvo
培	pwvo
埽	szvo
堂	tpio
堆	dbvo
堇	jbvi
堌	gjvo
堕	dlai
堕	hbai
堡	bjio
堤	dkvo
堧	rtvo
堪	kfvo
堲	jkav
塔	tsvo
塘	tpvo
塞	seoo
塞	shoo
填	tmvo
塬	ytvo
墉	yyvo
墒	epvo
墕	yfvo
增	zrvo
墼	jkvi
壤	rpvo
壬	rnuv
声	ervo
壳	kevo
处	jjua
备	bwua
复	fjuv
夏	xsvu
外	whua
多	dlua
夜	yeov
够	gdua
大	dsvu
天	tmvv
太	thvu
夬	ggav
头	tdoo
夸	kqvu
夹	jsvo
夺	dlvu
奂	htua
奄	yfvu
奋	fnvu
奎	kbvu
奏	zdvv
契	qkvv
契	xdvv
奔	bnvu
奕	ykov
套	tzvu
奘	fmai
奘	fxai
奢	eevu
奥	xzui
女	nlau
奴	njau
奶	nhau
她	tsau
好	hzau
妁	elau
如	rjau
妇	fjau
妈	msau
妖	yzau
妙	mcau
妞	nqau
妤	ylau
妲	dsau
妹	mwau
妻	qkva
始	ekau
姐	jdau
姑	gjau
姓	xgau
委	wwuv
姘	pbau
姞	jkau
姥	lzau
姮	hrau
姱	kqau
娃	wsau
娆	rzau
娘	nxau
娜	nlau
娣	dkau
娼	jpau
婆	plaa
婊	bcau
婠	wsau
婻	nfau
媂	dkau
嫩	nnau
嬛	qyau
嬿	yfau
孀	emau
孀	exau
孅	xmau
子	zkai
孔	kyai
字	zkoo
存	cwvu
孙	swai
孟	mrai
孥	njau
学	xhoo
孬	nzvu
孽	ndii
宁	ngoo
它	tsoo
宅	fhoo
宅	qhoo
安	xfoo
宋	syoo
完	wfoo
宏	hyoo
宗	zyoo
官	gtoo
定	dgoo
宝	bzoo
审	enoo
客	keoo
宣	xtoo
宧	ykoo
宫	gyoo
害	hhoo
家	jsoo
容	ryoo
宽	ktoo
宾	bboo
密	mkoo
寝	qboo
察	wsoo
寡	gqoo
对	dbao
寻	xwav
寿	edvv
射	eeui
将	jxov
尉	ylav
尊	zwou
小	xciu
少	eziu
尕	gsau
尘	jniu
尚	epio
尢	ydvu
尥	lcvu
尬	gsvu
就	jqov
尻	kzav
尼	nkav
尽	jbav
尿	ncav
局	jlav
层	crav
屄	bkav
居	jlav
屈	qlav
屋	wjav
屏	bgav
屏	pgav
展	qfav
屣	xkav
屯	qwva
屯	twva
山	efia
岁	sbia
岈	ysia
岍	qmia
岑	cnia
岛	dzua
岠	jlia
岨	jlia
岩	yfia
岱	dhiv
岵	hjia
峄	ykia
峗	wwia
峛	lkia
峦	ltov
峰	fria
峿	wjia
崄	xmia
崔	cbia
崦	yfia
崩	bria
崮	gjia
崴	whia
崴	wwia
嵁	kfia
嵅	hfia
嵇	jkuv
嵋	mwia
嵎	ylia
嵝	ldia
嵬	wwia
嶅	xzvv
嶒	cria
嶲	gbia
嶷	ykia
巉	jfia
巍	wwia
巛	wtaa
州	fdou
巡	xwaa
工	gyvi
左	zlvu
巧	qcvi
巨	jlva
巩	gyvi
差	wsou
已	ykav
巴	bsai
巿	fjvi
布	bjvu
帅	egiu
帏	wwia
帕	psia
帙	fkia
带	dhvi
席	xkov
帮	bpvv
帱	wdia
常	jpio
幕	mjii
幛	qpia
幪	mria
干	gfvv
平	pgvo
年	nmuv
并	bgou
广	gmov
广	gxov
床	wmov
床	wxov
库	kjov
应	ygov
底	dkov
店	dmov
庙	mcov
庚	grov
府	fjov
庞	ppov
废	fwov
庠	xxov
庤	fkov
度	djov
座	zlov
庭	tgov
康	kpov
庼	qgov
廙	ykov
廪	lbov
延	yfui
建	jmav
廿	nmvi
开	khvv
弁	bmao
弄	nyvv
弓	gyav
引	ybav
张	qpav
弥	mkav
弱	rlav
弶	jxav
弹	dfav
弹	tfav
强	qxav
弼	bkav
归	gbiu
当	dpio
彝	ykaa
形	xgvv
彧	ylvo
彪	bciv
彬	bbvv
影	ygoi
彷	fpuu
彻	jeuu
彻	weuu
往	wpuu
径	jguu
待	dhuu
很	hnuu
徊	hguu
律	lluu
徒	tjuu
得	deuu
得	dwuu
循	xwuu
德	deuu
心	xboa
必	bkoa
忍	rnau
忒	tbvo
忒	tevo
忖	cwoo
忘	wpov
忙	mpoo
忧	ydoo
快	kgoo
念	nmio
忸	nqoo
忾	xkoo
怀	hgoo
态	thvu
怎	znuv
怒	njau
怕	psoo
思	shia
怡	ykoo
性	xgoo
怨	ytua
怪	ggoo
总	zyou
怿	ykoo
恁	nniu
恋	lmov
恐	kyvi
恢	hboo
恣	zkov
恧	nlvu
恨	hnoo
恩	xnia
恬	tmoo
恰	qsoo
恳	knav
恶	xevi
恹	yfoo
恻	ceoo
恼	nzoo
悄	qcoo
悆	yliv
悌	tkoo
悝	kboo
患	htia
您	nbiu
悬	xtia
悰	cyoo
情	qgoo
惨	cfoo
想	xxvi
惴	fboo
惹	reii
愁	wduv
愃	xtoo
愔	yboo
感	gfvu
愣	lroo
愧	kboo
慊	qmoo
慌	hmoo
慌	hxoo
慢	mfoo
慨	khoo
憋	bdou
憭	lcoo
憺	dfoo
懂	dyoo
懑	mnai
戆	gpov
戏	xkao
成	jrvu
我	wluv
戕	qxai
或	hlvo
战	qfiv
戢	feov
戢	jkov
戢	qeov
戭	yfoo
户	hjoa
所	sluu
扅	ykoa
扆	ykoa
才	chvi
扎	zsiu
扑	pjiu
打	dsiu
扔	rriu
托	tliu
扛	kpiu
扣	kdiu
扩	kliu
扪	mniu
扫	sziu
扬	ypiu
扭	nqiu
扰	rziu
批	pkiu
扺	fkiu
扽	dniu
找	fziu
找	qziu
承	jrai
技	jkiu
抄	jziu
抄	wziu
把	bsiu
抓	fqiu
抖	ddiu
抗	kpiu
折	feiu
折	qeiu
抛	pziu
抟	ttiu
抢	qxiu
护	hjiu
报	bziu
披	pkiu
抬	thiu
抹	msiu
押	ysiu
抽	wdiu
担	dfiu
拆	csiu
拆	jhiu
拈	nmiu
拉	lsiu
拍	phiu
拐	ggiu
拔	bsiu
拖	tliu
招	fziu
招	qziu
拟	nkiu
拢	lyiu
拣	jmiu
拥	yyiu
拧	ngiu
拨	bliu
择	zeiu
括	gqiu
括	kliu
拮	jdiu
拴	etiu
拷	kziu
拼	pbiu
拽	fgiu
拿	nsiv
持	wkiu
挂	gqiu
指	fkiu
按	xfiu
挎	kqiu
挑	tciu
挛	ltov
挝	fqiu
挞	tsiu
挠	nziu
挣	qriu
挦	xmiu
挪	nliu
挹	ykiu
挼	rqiu
挽	wfiu
捆	kwiu
捉	fliu
捎	eziu
捏	ndiu
捐	jtiu
损	swiu
换	htiu
捧	priu
捭	bhiu
据	jliu
捽	zliu
掉	dciu
掌	qpio
掏	tziu
排	phiu
掞	efiu
探	tfiu
接	jdiu
控	kyiu
推	tbiu
掬	jliu
掺	jfiu
揉	rdiu
揍	zdiu
提	tkiu
插	wsiu
握	wliu
揣	wgiu
揳	xdiu
搂	ldiu
搋	wgiu
搓	cliu
搔	sziu
搜	sdiu
搞	gziu
搡	spiu
搬	bfiu
搴	qmoo
摁	xniu
摆	bhiu
摈	bbiu
摒	bgiu
摔	egiu
摘	fhiu
摘	qhiu
摭	fkiu
摸	mliu
撇	pdiu
撑	jriu
撒	ssiu
撙	zwiu
撞	fmiu
撞	fxiu
撤	jeiu
撤	weiu
播	bliu
撰	ftiu
撷	xdiu
擀	gfiu
擅	efiu
操	cziu
擦	csiu
攀	pfvu
攒	ctiu
攒	zfiu
攘	rpiu
攮	npiu
收	edai
改	ghav
放	fpov
故	gjuo
效	xcov
敏	mbuv
救	jqvi
教	jcuo
敢	gfav
散	sfvi
敩	xcoo
数	ejou
整	qrvi
文	wnov
斌	bbov
斗	ddoo
料	lcou
斜	xdiv
斠	jcii
斡	wluo
斥	wkuu
斩	qfva
断	dtou
新	xbov
方	fpov
於	wjov
旁	ppov
旌	jgov
旖	ykov
无	wjvv
既	jkav
旧	jqio
早	zzoi
旮	gsua
时	ekoi
旷	kmoi
旷	kxoi
昂	xpoi
昆	kwoi
明	mgoi
昏	hwua
春	jwvv
是	ekoi
显	xmoi
晊	fkoi
晒	ehoi
晕	ywoi
晚	wfoi
晞	xkoi
晟	eroi
晨	jnoi
普	pjou
暂	zfva
暅	xtoi
暕	jmoi
暖	ntoi
暨	jkav
暶	xtoi
暾	twoi
曲	qlia
更	grvi
曹	czvi
曾	crou
曾	zrou
替	tkvv
最	zboi
有	ydvu
朊	rtuv
服	fjua
朕	qnuo
朗	lpoa
望	wpov
朝	fzuo
朝	jzuo
朝	qzuo
朝	wzuo
未	wwvv
末	mlvv
本	bnvi
朱	qjuv
朴	pjvi
朵	dlua
朸	lkva
机	jkvu
朽	xqvv
杀	esuo
杂	zsua
权	qtva
杌	wjvv
材	chvv
村	cwvv
杠	gpvv
条	tcua
来	lhvo
杨	ypva
杪	mcvi
杭	hpvo
杯	bwvv
杰	jdvo
杻	nqva
松	syvu
构	gdvu
枘	rbvi
枪	qxvi
架	jsau
柄	bgvv
柊	fyvu
某	mdvi
染	rfau
柔	rdao
柜	jlvv
柠	ngvo
查	wsvo
柳	lqvu
栀	fkvu
标	bcvv
栎	lkvu
栏	lfvo
树	ejva
栓	etvi
校	xcvo
栲	kzvu
样	ypvo
核	hevo
根	gnva
桂	gbvv
桄	gmvi
桄	gxvi
框	kmvv
框	kxvv
案	xfoo
桌	fliv
桑	spao
桡	rzvv
桢	qnvi
档	dpvi
桤	qkvi
桥	qcvu
桩	fmvo
桩	fxvo
桯	tgvo
桶	tyva
梁	lxaa
梅	mwvu
梓	zkvo
梢	ezvi
梦	mrvv
梭	slva
梵	ffvv
检	jmvi
棉	mmvu
棍	gwvo
棕	zyvo
棚	prvu
棨	qkoa
棫	ylvv
森	snvv
棱	lrvv
棺	gtvo
椀	wfvo
椐	jlva
椪	prvo
椭	tlva
椴	dtvu
椽	wtva
楒	skvi
楠	nfvu
楩	pmvi
楯	ewvu
楷	khvv
楼	ldvo
概	ghva
榈	llvo
榫	swvi
榰	fkvu
槁	gzvo
槌	wbvu
槐	hgvu
横	hrvv
樽	zwvo
檬	mrvi
次	ckov
欣	xbuu
欧	xdvu
欻	wqou
款	ktvo
歌	gevo
正	qrvi
此	ckiv
步	bjiv
歪	whvu
死	skvu
殉	xwvu
残	cfvu
段	dtui
殿	dmav
毁	hbui
毌	gtaa
母	mjaa
每	mwuv
毒	djvv
比	bkva
毕	bkva
毛	mzuv
毯	tfuv
氅	jpio
民	mbav
气	qkuv
氕	pduv
氖	nhuv
氛	fnuv
氦	hhuv
氧	ypuv
氨	xfuv
永	yyoa
汀	tgav
求	qqvi
汇	hbav
汉	hfaa
汗	hfav
汝	rjaa
汞	gyvi
江	jxav
汤	epaa
汤	tpaa
汪	wpav
汭	rbai
汹	xyau
汽	qkau
沁	qbao
沃	wlau
沆	hpao
沉	jnao
沌	dwav
沓	tsao
沘	bkav
沙	esai
没	mlau
没	mwau
沧	cpai
河	heav
治	fkaa
沿	yfau
泂	jyai
泄	xdav
泅	qqai
泉	qtui
泐	leaa
法	fsav
泛	ffau
泞	ngao
泡	pzau
波	blaa
泥	nkaa
注	qjao
泪	lwai
泯	mbaa
泽	zeaa
洋	ypao
洒	ssav
洞	dyai
洪	hyav
洱	xjav
洲	fdao
活	hlau
洽	qsai
派	phau
流	lqao
浊	flai
测	ceaa
浍	kgai
浓	nyao
浔	xwaa
浕	jbaa
浙	feai
浙	qeai
浠	xkau
浡	blau
浥	ykao
浦	pjav
浩	hzau
浪	lpao
海	hhau
浼	mwau
涂	tjai
涅	ndao
消	xcai
涉	eeai
涌	wyaa
涍	xcau
涔	cnai
涕	tkao
涠	wwai
涡	glao
润	rwao
涨	qpaa
涩	seaa
涮	etaa
涯	ysav
液	yeao
淋	lbav
淏	hzao
淖	nzai
淘	tzau
淙	cyao
淞	syav
淮	hgai
淯	ylao
深	enao
混	hwao
添	tmav
清	qgav
渡	djao
温	wnao
港	gpav
渲	xtao
渴	keao
湍	ttai
湓	pnau
湖	hjau
湾	wfao
溁	ygai
溃	kbai
溞	szaa
溟	mgao
溦	wwai
溲	sdau
溶	ryao
滂	ppao
滃	wrau
滑	hqai
滕	truo
滗	bkau
滚	gwao
满	mfai
滥	lfai
滦	ltao
滨	bbao
滴	dkao
漂	pcav
漈	jkau
漉	ljao
漏	ldaa
漕	czav
漖	jcau
漠	mlai
漫	mfao
漭	mpai
漹	yfav
潏	ylaa
潖	psav
潘	pfau
潜	qmav
潢	gmav
潢	gxav
潮	jzau
潮	wzau
澈	jeao
澈	weao
澍	ejav
澎	prav
澡	zzao
澳	xzau
濑	lhav
瀍	jfao
瀼	rpao
火	hlou
灭	mdvo
灯	drou
灰	hbvu
灵	lgav
灾	zhoo
炉	ljou
炊	wbou
炒	jzou
炒	wzou
炮	pzou
炸	fsou
点	dmiv
炻	ekou
烀	hjou
烁	elou
烂	lfou
烊	ypou
烝	qrai
烤	kzou
烦	ffou
烧	ezou
热	reiu
烯	xkou
烹	prov
烻	yfov
焦	jcio
焱	yfou
然	rfua
煓	ttou
照	fzoi
照	qzoi
煳	hjou
熊	xyao
熔	ryou
熟	ejov
熬	xzvv
熰	xdou
燃	rfou
燐	lbou
燥	szou
爔	xkou
爪	fquu
爬	psuu
爱	xhuo
爷	yeuo
爻	yzuo
爽	emvu
爽	exvu
片	pmui
版	bfui
牌	phui
牙	ysva
牛	nquv
牟	mdao
牢	lzoo
牤	mpuv
牧	mjuv
物	wjuv
牵	qmvu
特	teuv
牿	gjuv
犄	jkuv
犍	jmuv
状	fmov
状	fxov
犸	msua
犹	ydua
狂	kmua
狂	kxua
狃	nqua
狗	gdua
狞	ngua
狠	hnua
狡	jcua
独	djua
狭	xsua
狳	ylua
狷	jtua
狺	ybua
狻	stua
狼	lpua
猄	jgua
猇	xcua
猎	ldua
猓	glua
猛	mrua
猢	hjua
猬	wwua
猯	ttua
猴	hdua
猾	hqua
獍	jgua
獠	lcua
獭	tsua
率	egov
率	llov
王	wpvv
玞	fjvv
玟	mbvv
玡	ysvv
玢	fnvv
玤	bpvv
现	xmvv
玻	blvv
珇	zjvv
珊	efvv
珥	xjvv
珩	hrvv
班	bfvv
珷	wjvv
球	qqvv
琄	xtvv
琅	lpvv
理	lkvv
琔	dmvv
琪	qkvv
琳	lbvv
琶	psvv
琼	qyvv
瑃	jwvv
瑞	rbvv
瑟	sevv
瑧	qnvv
瑨	jbvv
瑶	yzvv
璀	cbvv
璇	xtvv
璈	xzvv
璥	jgvv
瓮	wruo
瓶	pgou
甓	pkav
甗	yfiv
甚	envi
甜	tmuv
生	eruv
甦	sjvi
用	yyua
甩	egua
甭	brvu
田	tmia
由	ydia
电	dmia
男	nfia
甾	zhaa
畈	ffia
留	lqua
畚	bnao
畤	ekia
畤	fkia
畤	wdia
略	lhia
畦	qkia
畬	eeiv
畿	jkaa
疋	pkai
疐	fkuo
疑	ykua
疟	nhov
疫	ykov
疬	lkov
疯	frov
疲	pkov
疴	keov
疼	trov
病	bgov
痍	ykov
痓	fkov
痛	tyov
痤	clov
痦	wjov
痧	esov
痴	wkov
瘐	ylov
瘗	ykov
瘠	jkov
瘩	dsov
瘼	mlov
瘿	ygov
癔	ykov
癞	lhov
癸	gbao
登	drao
白	bhui
百	bhvu
的	deui
的	dkui
皇	hmui
皇	hxui
皓	hzui
皦	jcui
皭	jcui
皮	pkau
皱	fdua
皴	cwao
皿	mbia
盂	ylvv
盆	pnuo
盈	ygau
盎	xpia
盖	ghou
盘	pfuu
盟	mroi
目	mjia
盯	dgia
盲	mpov
盷	xmia
相	xxvi
盼	pfia
省	eriu
省	xgiu
眊	mzia
看	kfiu
眙	ykia
眚	eruv
真	qnuo
眠	mmia
眯	mkia
眶	kmia
眶	kxia
眷	jtou
眸	mdia
眼	yfia
着	feou
着	flou
着	qeou
睎	xkia
睚	ysia
睡	ebia
督	djiv
瞒	mfia
瞟	pcia
瞥	pdou
瞧	qcia
瞪	dria
瞬	ewia
瞿	jlia
矛	mzao
矞	ylao
知	fkuv
矬	cluv
短	dtuv
矰	zruv
矽	xkvu
码	msvu
研	yfvu
砚	yfvu
砯	pgvu
破	plvu
砸	zsvu
砺	lkvu
硁	krvu
硍	knvu
硕	elvu
硬	ygvu
硭	mpvu
确	qhvu
碉	dcvu
碎	sbvu
碘	dmvu
碛	qkvu
碨	wwvu
碰	prvu
碶	qkvu
磅	ppvu
磉	spvu
磋	clvu
磐	pfuu
磜	qkvu
磴	drvu
磺	hmvu
磺	hxvu
礅	dwvu
礤	csvu
礽	rroa
社	eeoa
祇	fkoa
祇	qkoa
祕	mkoa
祛	qloa
祝	qjoa
神	enoa
票	pcvi
祭	fhua
禁	jbvv
禛	qnoa
禺	ylia
禾	heuv
秀	xquv
私	skuv
秋	qquv
种	fyuv
科	keuv
秒	mcuv
秘	mkuv
租	zjuv
秦	qbvv
秬	jluv
称	jnuv
称	jruv
稃	fjuv
稍	ezuv
税	ebuv
稗	bhuv
稙	fkuv
稣	sjua
稳	wnuv
稽	jkuv
穄	jkuv
穗	sbuv
穰	rpuv
究	jqoo
穷	qyoo
穹	qyoo
空	kyoo
穿	wtoo
窃	qdoo
窗	wmoo
窗	wxoo
窘	jyoo
窜	ctoo
窝	wloo
窬	yloo
窸	xkoo
立	lkov
站	qfov
竟	jgov
章	qpov
竫	jgov
竭	jdov
竺	qjuv
笄	jkuv
笋	swuv
笏	hjuv
笑	xcuv
笔	bkuv
笙	eruv
笠	lkuv
笤	tcuv
笨	bnuv
第	dkuv
笯	njuv
笼	lyuv
笾	bmuv
筇	qyuv
等	druv
筒	tyuv
答	dsuv
筘	kduv
筚	bkuv
筛	ehuv
筜	dpuv
筮	ekuv
筷	kguv
简	jmuv
箐	qguv
箕	jkuv
算	stuv
箜	kyuv
管	gtuv
箧	qduv
箬	rluv
篆	ftuv
篇	pmuv
篠	xcuv
篡	ctuv
篮	lfuv
篯	jmuv
篾	mduv
簇	cjuv
簠	fjuv
簦	druv
簿	bjuv
簿	bluv
籁	lhuv
米	mkou
类	lwou
籽	zkou
粉	fnou
粗	cjou
粘	nmou
粢	zkov
糁	efou
糁	sfou
糕	gzou
糖	tpou
糙	czou
糟	zzou
糸	jcaa
糸	skaa
系	xkua
索	sluo
紫	zkiv
累	lwia
絷	fkiu
綮	qkoa
縢	truo
繇	yzuo
纂	ztuv
纛	dzvv
红	hyaa
约	yhaa
纩	kmaa
纩	kxaa
纯	jwaa
纳	nsaa
纵	zyaa
纷	fnaa
线	xmaa
练	lmaa
组	zjaa
终	fyaa
绊	bfaa
绍	ezaa
绎	ykaa
经	jgaa
绑	bpaa
绔	kjaa
绕	rzaa
给	gwaa
给	jkaa
绝	jhaa
绢	jtaa
绣	xqaa
续	xlaa
维	wwaa
绵	mmaa
绶	edaa
绷	braa
绿	llaa
缉	jkaa
缌	skaa
缎	dtaa
缓	htaa
缙	jbaa
缝	fraa
缟	gzaa
缠	jfaa
缩	slaa
缪	mdaa
缪	mqaa
缲	qcaa
缴	jcaa
缸	gpuv
缺	qhuv
罂	ygao
网	wpia
罗	llia
罘	fjia
罚	fsia
罟	gjia
罢	pkia
罪	zbia
罽	jkia
美	mwou
羓	bsou
羕	ypou
羖	gjou
羞	xqou
群	qwav
羲	xkou
翁	wruo
翊	ykov
翟	fhao
翟	qhao
翠	cbao
翦	jmou
翩	pmoa
翱	xzui
老	lzuo
考	kzuo
者	feuo
者	qeuo
而	xjvu
耍	eqvu
耐	nhvu
耕	grvv
耖	jzvv
耖	wzvv
耗	hzvv
耤	jkvv
耳	xjvi
耵	dgvi
耸	syii
耽	dfvi
聂	ndvi
聊	lcvi
聒	glvi
联	lmvi
聘	pbvi
聪	cyvi
聱	xzvv
肃	sjav
肉	rdia
肋	leua
肋	lwua
肜	ryuu
肝	gfuv
肠	jpua
肥	fwua
肫	qwuv
肮	xpuo
肯	kniv
肼	jguv
胀	qpuu
胄	fdia
胎	thua
胖	ppuo
胙	zluu
胚	pwuv
胛	jsui
胝	fkuu
胡	hjuo
胩	ksui
胯	kquv
胳	geuu
胸	xyuu
能	nrao
脆	cbuu
脏	zpuo
脑	nzuo
脓	nyuo
脔	ltov
脯	pjuv
脱	tluo
脸	lmui
脾	pkuu
腊	lsuv
腊	xkuv
腔	qxuo
腙	zyuo
腚	dguo
腠	cduv
腥	xguo
腨	etui
腮	shui
腰	yzuv
腻	nkuv
腾	truo
腿	tbua
膀	bpuo
膑	bbuo
膘	bcuv
膘	pcuv
膜	mlui
膣	fkuo
膪	wguo
膺	ygov
臀	twav
臃	yyuo
臊	szuo
臣	jnvi
臧	cpvu
臧	zpvu
自	zkui
臬	ndui
至	fkva
舁	ylui
舂	wyvv
舍	eeiv
航	hpuu
舱	cpuu
舴	zeuu
船	wtuu
艅	yluu
艇	tguu
艚	czuu
艮	gnav
色	seua
艾	xhii
节	jdii
芊	qmii
芎	xyii
芣	fjii
芨	jkii
芰	jkii
芼	mzii
芾	fjii
苏	sjii
苗	mcii
苜	mjii
苤	pdii
若	rlii
苦	kjii
苧	qjii
苯	bnii
英	ygii
范	ffii
茄	qdii
茑	ncii
茓	xhii
茔	ygii
茕	qyii
茛	gnii
茧	jmii
茫	mpii
茯	fjii
草	czii
荒	hmii
荒	hxii
荠	jkii
荠	qkii
荣	ryii
荤	hwii
荥	ygii
荬	mhii
药	yzii
莘	xbii
莙	jwii
莞	wfii
莠	ydii
莩	fjii
莫	mlii
莲	lmii
莶	xmii
获	hlii
莸	ydii
菂	dkii
菉	ljii
菜	chii
菽	ejii
萁	qkii
萆	bkii
萍	pgii
萨	ssii
落	llii
葎	llii
葛	geii
董	dyii
葬	zpii
葭	jsii
葳	wwii
葴	qnii
葵	kbii
蒉	kgii
蒋	jxii
蒙	mrii
蒜	stii
蒟	jlii
蒹	jmii
蒿	hzii
蓊	wrii
蓏	llii
蓐	rjii
蓝	lfii
蓥	ygii
蔓	wfii
蔚	wwii
蔡	chii
蔽	bkii
蕲	qkii
蕴	ywii
蕺	jkii
薁	ylii
薤	xdii
薮	sdii
薰	xwii
薳	ytii
藏	cpii
藏	zpii
藠	jcii
藤	trii
藦	mlii
藻	zzii
蘅	hrii
虐	nhiv
虚	xliv
虞	yliv
虫	wyia
虮	jkia
虹	hyia
虽	sboi
蚁	ykia
蚆	bsia
蚊	wnia
蚍	pkia
蚖	wfia
蚖	ytia
蚜	ysia
蚨	fjia
蚴	ydia
蚵	keia
蛇	ykia
蛐	qlia
蛤	hsia
蛭	fkia
蜇	feiu
蜇	qeiu
蜉	fjia
蜐	jdia
蜕	tbia
蜞	qkia
蜮	ylia
蜱	pkia
蜴	ykia
蜾	glia
蝈	glia
蝓	ylia
蝘	yfia
蝤	ydia
蝥	mzao
螂	lpia
螃	ppia
融	ryvo
螠	ykia
螲	ddia
螲	fkia
蟏	xcia
蟑	qpia
蟒	mria
蠼	qlia
衄	nlui
行	hpuu
行	xguu
衎	kfui
衒	xtuu
衙	ysuu
衡	hruu
补	bjoa
表	bcvv
衮	gwov
衷	fyov
袅	ncua
袆	hboa
袈	jsau
袋	dhiv
袤	mzov
被	bwoa
袷	qsoa
装	fmov
装	fxov
裆	dpoa
裛	ykov
裱	bcoa
褕	yloa
褚	qjoa
褥	rjoa
褪	tboa
襕	lfoa
襜	jfoa
襞	bkav
襫	ekoa
西	xkvi
要	yzvi
覃	qbvi
覅	fcvi
见	jmia
观	gtao
规	gbvv
觉	jhoo
角	jhua
觞	epua
解	jdua
觭	jkua
觯	fkua
觳	hjvo
言	yfov
訇	hyua
詹	qfua
警	jgii
订	dgoa
讣	fjoa
认	rnoa
讦	jdoa
讨	tzoa
让	rpoa
讫	qkoa
训	xwoa
记	jkoa
讲	jxoa
讴	xdoa
讷	neoa
许	hjoa
许	xloa
论	lwoa
设	eeoa
证	qroa
诉	sjoa
诊	qnoa
词	ckoa
诐	bkoa
诒	ykoa
试	ekoa
话	hqoa
诟	gdoa
该	ghoa
语	yloa
误	wjoa
说	eloa
诶	xwoa
请	qgoa
诹	zdoa
诺	nloa
读	djoa
谁	eboa
谁	ewoa
调	dcoa
调	tcoa
谈	tfoa
谋	mdoa
谞	xloa
谤	bpoa
谥	ekoa
谦	qmoa
谨	jboa
谫	jmoa
谬	mqoa
谮	znoa
谱	pjoa
谿	xkuo
豆	ddvo
豗	hbvu
豚	twuv
豨	xkvu
财	chao
责	zevv
败	bhao
贫	pbuo
购	gdao
贴	tdao
贸	mzua
费	fwav
贼	zwao
赃	zpao
资	zkov
赐	ckao
赖	lhvi
赘	fbvv
赙	fjao
赚	ftao
赚	ztao
赛	shoo
赝	yfvu
赞	zfuv
赠	zrao
赣	gfov
赤	wkvo
走	zdvo
赵	fzvo
赵	qzvo
起	qkvo
超	jzvo
超	wzvo
越	yhvo
足	zjoi
跆	thoi
跑	pzoi
跛	bloi
跛	ploi
跟	gnoi
跣	xmoi
跨	kqoi
跩	fgoi
跪	gboi
路	ljoi
跱	fkoi
踌	wdoi
踩	choi
踱	dloi
踹	wgoi
蹂	rdoi
蹑	ndoi
蹢	fkoi
蹦	broi
蹭	croi
蹴	cjoi
蹿	ctoi
躜	ztoi
身	enui
躯	qlui
躺	tpui
车	jeva
车	weva
转	fgva
转	ftva
轮	lwva
软	rtva
轰	hyva
轻	qgva
载	zhuo
较	jcva
辆	lxva
辏	cdva
辙	feva
辙	qeva
辞	ckuv
辱	rjvu
边	bmau
辻	ekuo
辽	lcai
达	dsvu
过	glvi
迎	ygua
运	ywvv
近	jbuu
还	hhvu
还	htvu
这	feov
这	qeov
进	jbvv
连	lmva
迟	wkav
迢	tcau
迥	jyia
迦	jsau
迫	plui
述	ejvo
迸	brou
追	dbui
追	fbui
退	tbav
送	syou
逃	tzuo
选	xtuv
透	tduv
逐	qjvu
途	tjiv
逖	tkua
通	tyao
逛	gmua
逛	gxua
逝	ekiu
速	sjvi
造	zzuv
逡	qwao
逮	dhav
逴	wliv
遍	bmoa
道	dzou
遢	tsoi
遭	zzvi
遮	feov
遮	qeov
避	bkav
邈	mcuo
邋	lsaa
那	neav
那	nsav
那	nwav
邦	bpvv
邬	wjua
邹	zdua
郇	xwua
郈	hduu
郗	xkuo
郛	fjuo
郤	xkuo
郦	lkvi
部	bjov
郪	qkva
郭	glov
都	dduo
鄄	jtvi
鄅	ylui
鄘	yyov
鄚	mzii
酅	xkia
酋	qqou
酌	flvi
配	pwvi
酒	jqav
酣	hfvi
酩	mgvi
酪	lzvi
酬	wdvi
酱	jxov
酷	kjvi
酸	stvi
酽	yfvi
酾	ehvi
酿	nxvi
醉	zbvi
醋	cjvi
醚	mkvi
醢	hhvi
醨	lkvi
醯	xkvi
采	chuo
里	lkia
重	wyuv
量	lxoi
釐	lkvv
釜	fjuo
鉴	jmii
銎	qyvi
鏊	xzvv
鐍	jhio
钋	plio
钓	dcio
钙	ghio
钝	dwio
钢	gpio
钥	yhio
钩	gdio
钱	qmio
钸	bjio
钻	ztio
铄	elio
铎	dlio
铒	xjio
铛	tpio
铜	tyio
铥	dqio
铫	yzio
铯	seio
银	ybio
铽	teio
铿	krio
销	xcio
锁	slio
锃	zrio
锐	rbio
错	clio
锝	deio
锡	xkio
锤	wbio
锥	fbio
锬	tfio
锻	dtio
镇	qnio
镈	blio
镋	tpio
镏	lqio
镑	bpio
镒	ykio
镙	llio
镦	dbio
镱	ykio
长	jpuv
门	mnoi
闩	etoi
闫	yfoi
问	wnoi
闰	rwoi
间	jmoi
闹	nzoi
闽	mboi
阅	yhoi
阋	xkoi
阏	yloi
阔	kloi
阘	tsoi
阚	kfoi
队	dbai
阮	rtai
防	fpai
阵	qnai
阻	zjai
阼	zlai
阿	xeai
阿	xsai
陆	ljai
陈	jnai
陕	efai
陡	ddai
院	ytai
除	jjai
陪	pwai
陲	wbai
陶	tzai
隆	lyai
隋	sbai
隍	hmai
隍	hxai
随	sbai
隔	geai
隘	xhai
隺	hjoa
难	nfao
雄	xyvu
雇	gjoa
雉	fkuv
雕	dcua
雪	xhvo
雫	nsvo
雯	wnvo
零	lgvo
雹	bzvo
需	xlvo
震	qnvo
霍	hlvo
露	ljvo
霸	bsvo
静	jgvv
非	fwiv
靠	kzuv
面	mmvu
靿	yzva
鞍	xfvi
鞔	mnvi
鞣	rdvi
鞧	qqvi
鞫	jlvi
鞬	jmvi
鞭	bmvi
鞯	jmvi
韧	rnvv
韨	fjvv
韩	hfuo
韪	wwoi
音	ybov
页	yevu
顶	dgvi
顺	ewui
须	xluu
顾	gjvu
顿	dwva
颂	syuo
预	ylao
领	lgio
颈	grao
颉	jsvo
颌	heiv
颎	jyua
颗	keia
题	tkoi
额	xeoo
颠	dmuo
颡	spao
颤	jfov
风	frua
飒	ssov
飗	lqua
飘	pcvi
飞	fwau
食	ykio
餍	yfvu
餐	cfiv
餮	tdvu
饭	ffua
饴	ykua
饶	rzua
饿	xeua
馁	nwua
馉	gjua
馊	sdua
馋	jfua
馒	mfua
馓	sfua
馕	npua
首	edou
馧	ywuv
馨	xbvo
驮	tlaa
驲	rkaa
驺	zdaa
驽	njau
骆	llaa
骐	qkaa
骑	jkaa
骖	cfaa
骗	pmaa
骚	szaa
骱	jdia
骸	hhia
髃	ylia
髋	ktia
高	gzov
髦	mzvi
髫	tcvi
髯	rfvi
髻	jkvi
髽	fqvi
鬶	gbvv
鬼	gbui
魁	kbui
魂	hwvv
魅	mwui
魉	lxui
魔	mlov
鱼	ylua
鱾	jkua
鲁	ljua
鲕	xjua
鲚	jkua
鲛	jcua
鲜	xmua
鲠	grua
鲧	gwua
鲮	lgua
鲲	kwua
鲾	bkua
鳂	wwua
鳆	fjua
鳉	jxua
鳜	gbua
鳞	lbua
鳟	zwua
鳠	hjua
鳢	lkua
鸟	ncua
鸨	bzua
鸪	gjuo
鸷	fkiu
鹇	xmoi
鹖	heoi
鹘	gjia
鹞	yzuo
鹠	lqua
鹡	jkov
鹬	ylao
鹯	qfov
鹳	gtii
麂	jkov
麇	jwov
麋	mkov
麒	qkov
麖	jgov
麟	lbov
麽	meov
黄	hmvi
黄	hxvi
黏	nmuv
黑	hwia
黝	ydia
黟	ykia
黠	xsia
黡	yfvu
黧	lkuv
黻	fjii
黼	fjii
黾	mmoi
鼙	pkvo
鼠	ejui
鼷	xkui
齐	qkov
齑	jkov
龈	kniv
龙	lyvu
龟	jwua
龢	heiv
㘵	bjvo
㙘	yzvo
㙦	xdiv
㛃	jdvv
㞌	ywav
㠓	mria
㨃	jriu
㬚	jeoi
㬚	weoi
㮾	lpoa
㰀	lkvu
㳇	fjau
㴔	ykau
㺄	ylua
䁖	ldia
䃅	dkvu
䃎	fsvu
䅟	cfuv
䎖	zrou
䏡	ekuv
䒤	rkii
䓛	fjii
䓛	gjii
䓨	ygii
䓫	qkii
䢼	gyvi
䣘	tpio
䴙	pkav
𡐓	kpvo
𣲗	wwav
𦭜	fkii
𨙸	fkuo
𨟠	jhia
𩾌	kpua
