𤭢	ww	亠瓦
𰻝	zx	辶心
嬢	nf	女𠀎
薙	cv	艹{隹右}
菈	cl	艹立
卻	ge	谷卩
濛	du	氵豕
诶	yu	讠矢
凃	dm	冫朩
咲	kt	口天
螓	ih	虫禾
珮	wj	𤣩巾
睆	oy	目元
挼	fn	扌女
嗯	kx	口心
欸	sq	厶欠
哟	ku	口勺
唷	ko	口⺝
育	wo	亠⺝
啊	kk	口可
阿	ek	⻖可
吖	ky	口丫
锕	jk	钅可
腌	od	⺼电
爱	vy	爫又
艾	cx	艹乂
哎	kx	口乂
唉	ku	口矢
哀	yk	衣口
挨	fu	扌矢
埃	tu	土矢
矮	un	矢女
碍	uc	石寸
暧	oy	日又
癌	bu	疒山
蔼	cr	艹人
隘	em	⻖皿
皑	bj	白己
霭	yr	雨人
嗳	ky	口又
嫒	ny	女又
毐	tm	士毋
叆	yy	云又
瑷	wy	𤣩又
砹	ux	石乂
锿	jk	钅口
嗌	km	口皿
按	fn	扌女
安	bn	宀女
暗	oo	日日
案	bm	宀木
岸	ug	山干
俺	rd	亻电
黯	lo	{里}日
庵	gd	广电
鞍	gn	革女
谙	yo	讠日
氨	qn	气女
胺	on	⺼女
鹌	dn	大鸟
桉	mn	木女
犴	qg	犭干
唵	kd	口电
铵	jn	钅女
埯	td	土电
盦	rm	𠆢皿
垵	tn	土女
𩽾	yn	鱼女
昂	oe	日卩
肮	oj	⺼几
盎	ym	央皿
卬	pe	丿卩
傲	rw	亻攵
奥	pd	丿大
熬	fh	龶灬
敖	fw	龶攵
澳	dd	氵大
凹	la	丨一
懊	xd	忄大
嗷	kw	口攵
拗	fl	扌力
袄	py	衤夭
鳌	fy	龶鱼
翱	bx	白习
獒	fq	龶犬
骜	fm	龶马
坳	tl	土力
鏖	lj	鹿金
遨	zw	辶攵
媪	nm	女皿
螯	fi	龶虫
岙	yu	夭山
璈	ww	𤣩攵
鏊	fj	龶金
聱	fe	龶耳
廒	gw	广攵
奡	bl	𦣻{⿰丿丨}
隩	ed	⻖大
薁	cd	艹大
嶅	fu	龶山
把	fb	扌巴
吧	kb	口巴
八	pn	丿乀
爸	fb	父巴
巴	sl	巳丨
罢	sq	罒去
拔	fy	扌又
霸	yo	雨月
疤	bb	疒巴
跋	zy	𧾷又
扒	fb	扌八
叭	kb	口八
芭	cb	艹巴
靶	gb	革巴
坝	tb	土贝
耙	lb	耒巴
笆	vb	竹巴
魃	gy	鬼又
粑	mb	米巴
钯	jb	钅巴
灞	do	氵月
捌	fd	扌刂
鲅	yy	鱼又
岜	ub	山巴
鲃	yb	鱼巴
菝	cy	艹又
蚆	ib	虫巴
胈	oy	⺼又
羓	yb	羊巴
朳	mb	木八
妭	ny	女又
白	po	丿日
百	ab	一白
败	bw	贝攵
摆	fq	扌去
拜	uf	龵丰
柏	mb	木白
掰	uu	手手
伯	rb	亻白
佰	rb	亻百
稗	hu	禾十
捭	fu	扌十
半	bf	丷𰀁
办	lb	力八
般	vu	舟殳
板	my	木又
班	wl	𤣩リ
伴	rb	亻半
版	py	片又
搬	fu	扌殳
扮	ff	扌分
斑	ww	𤣩文
扳	fy	扌又
瓣	xg	辛瓜
绊	sb	纟半
颁	fy	分页
拌	fb	扌半
阪	ey	⻖又
坂	ty	土又
瘢	bu	疒殳
钣	jy	钅又
癍	bw	疒文
攽	fw	分攵
柈	mb	木半
昄	oy	日又
湴	dy	氵业
靽	gb	革半
𨭉	wj	文金
帮	fj	丰巾
膀	of	⺼方
邦	fe	丰⻏
棒	mf	木𰀁
绑	se	纟⻏
榜	mf	木方
傍	rf	亻方
磅	uf	石方
梆	me	木⻏
镑	jf	钅方
谤	yf	讠方
蚌	if	虫丰
浜	db	氵八
蒡	cf	艹方
玤	wf	𤣩丰
搒	ff	扌方
塝	tf	土方
𠳐	ke	口⻏
保	rm	亻木
报	fy	扌又
包	bs	勹巳
宝	by	宀玉
抱	fb	扌包
暴	ou	日氺
爆	hu	火氺
薄	cc	艹寸
堡	rt	亻土
饱	ub	饣包
豹	vu	豸勺
胞	ob	⺼包
剥	ed	彐刂
鲍	yb	鱼包
褒	ym	衣木
刨	bd	包刂
苞	cb	艹包
鸨	bn	匕鸟
曝	ou	日氺
煲	rh	亻火
葆	cm	艹木
雹	yb	雨包
褓	pm	衤木
炮	hb	火包
龅	vb	止包
孢	zb	子包
趵	zu	𧾷勺
枹	mb	木包
瀑	du	氵氺
被	pp	衤皮
备	wt	夂田
北	lb	{北左}匕
背	bo	北⺝
呗	kb	口贝
杯	mb	木不
辈	fi	非车
悲	fx	非心
贝	kr	冂人
倍	rk	亻口
卑	pu	{卑上}十
惫	wx	夂心
碑	uu	石十
狈	qb	犭贝
蓓	ck	艹口
悖	xz	忄子
孛	uz	十子
焙	hk	火口
邶	be	北⻏
陂	ep	⻖皮
钡	jb	钅贝
褙	po	衤⺝
碚	uk	石口
鞴	gy	革用
鐾	uj	尸金
鹎	pn	{卑上}鸟
棓	mk	木口
糒	my	米用
琲	wf	𤣩非
椑	mu	木十
臂	uo	尸⺝
鞁	gp	革皮
𬇙	db	氵贝
本	ma	木一
奔	dc	大廾
笨	vb	竹本
贲	ub	十贝
苯	cb	艹本
锛	jc	钅廾
畚	st	厶田
犇	nn	牛牛
坌	ft	分土
倴	rc	亻廾
栟	mk	木开
夯	dl	大力
崩	uo	山月
蹦	zo	𧾷月
绷	so	纟月
迸	zk	辶开
甭	by	不用
嘣	ko	口月
泵	uu	石水
镚	jo	钅月
甏	tw	士瓦
琫	wf	𤣩𰀁
祊	pf	礻方
比	bb	匕匕
必	xp	心丿
毕	bu	匕十
笔	vm	竹毛
避	zx	辶辛
闭	mc	门才
鼻	zw	自丌
逼	zt	辶田
屄	ub	尸八
壁	ut	尸土
彼	rp	彳皮
碧	wu	𤣩石
币	pj	丿巾
陛	et	⻖土
鄙	ke	口⻏
蔽	cw	艹攵
匕	pv	丿乚
毙	bb	匕匕
辟	ux	尸辛
婢	nu	女十
弊	xc	⺌廾
璧	uy	尸玉
庇	gb	广匕
敝	xw	⺌攵
痹	bw	疒丌
弼	gb	弓百
俾	ru	亻十
裨	pu	衤十
薜	cx	艹辛
哔	ku	口十
愎	xw	忄夂
吡	kb	口匕
跸	zu	𧾷十
妣	nb	女匕
篦	vb	竹匕
荜	cu	艹十
狴	qt	犭土
毖	bb	匕必
蓖	cb	艹匕
嬖	un	尸女
筚	vu	竹十
髀	gu	冎十
荸	cz	艹子
濞	dw	氵丌
畀	tw	田丌
赑	bb	贝贝
秕	hb	禾匕
箅	vw	竹丌
芘	cb	艹匕
佛	rf	亻弗
襞	uy	尸衣
苾	cb	艹必
滗	dm	氵毛
铋	jb	钅必
庳	gu	广十
萆	cu	艹十
皕	bb	百百
咇	kb	口必
舭	vb	舟匕
沘	db	氵匕
珌	wb	𤣩必
觱	wy	戊用
诐	yp	讠皮
邲	be	必⻏
佖	rb	亻必
馝	hb	禾必
坒	bt	匕土
泌	db	氵必
秘	hb	禾必
鲾	yt	鱼田
边	zl	辶力
便	rg	亻更
变	wy	亠又
遍	zc	辶卄
编	sc	纟卄
辩	xy	辛讠
鞭	gg	革更
辨	xl	辛リ
扁	hc	户卄
辫	xs	辛纟
贬	bf	贝乏
蝙	ic	虫卄
匾	kc	匚卄
卞	wb	亠卜
汴	db	氵卜
弁	sc	厶廾
砭	uf	石乏
煸	hc	火卄
褊	pc	衤卄
笾	vl	竹力
鳊	yc	鱼卄
昪	oc	日廾
忭	xb	忄卜
苄	cb	艹卜
抃	fb	扌卜
碥	uc	石卄
萹	cc	艹卄
𨚕	se	厶⻏
表	fy	龶𧘇
标	mu	木示
镖	ju	钅示
彪	hp	虍彡
飙	qf	犬风
婊	ny	女𧘇
骠	mu	马示
镳	jh	钅灬
膘	ou	⺼示
裱	py	衤𧘇
杓	mu	木勺
飑	fb	风包
俵	ry	亻𧘇
鳔	yu	鱼示
摽	fu	扌示
瘭	bu	疒示
熛	hu	火示
藨	ch	艹灬
儦	rh	亻灬
骉	mm	马马
瀌	dh	氵灬
幖	ju	巾示
脿	oy	⺼𧘇
别	kd	口刂
憋	xx	⺌心
瘪	bl	疒仑
鳖	xy	⺌鱼
蹩	xz	⺌足
癿	bv	白乚
宾	bb	宀八
彬	mp	木彡
斌	wv	文止
滨	db	氵八
鬓	eb	E八
缤	sb	纟八
镔	jb	钅八
濒	dy	氵页
槟	mb	木八
殡	db	歹八
膑	ob	⺼八
摈	fb	扌八
玢	wf	𤣩分
傧	rb	亻八
豳	uu	山豕
邠	fe	分⻏
髌	gb	冎八
并	bk	丷开
兵	qb	丘八
冰	du	冫水
病	bn	疒内
柄	mn	木内
饼	uk	饣开
禀	wu	亠示
秉	qr	千人
丙	an	一内
炳	hn	火内
摒	fk	扌开
屏	uk	尸开
邴	be	丙⻏
昺	on	日内
蛃	in	虫内
波	dp	氵皮
博	uc	十寸
脖	oz	⺼子
拨	fy	扌又
播	ft	扌田
勃	ul	十力
玻	wp	𤣩皮
膊	oc	⺼寸
搏	fc	扌寸
驳	mx	马乂
泊	db	氵白
簸	vp	竹皮
帛	bj	白巾
钵	jb	钅本
跛	zp	𧾷皮
渤	dl	氵力
菠	cp	艹皮
礴	uc	石寸
啵	kp	口皮
舶	vb	舟白
卜	ld	丨丶
饽	uz	饣子
铂	jb	钅白
钹	jy	钅又
箔	vb	竹白
亳	wq	亠七
擘	uu	尸手
檗	um	尸木
鹁	un	十鸟
僰	ur	朿人
踣	zk	𧾷口
镈	jc	钅寸
砵	ub	石本
鲌	yb	鱼白
哱	kz	口子
嶓	ut	山田
浡	dz	氵子
馞	hz	禾子
艴	fb	弗巴
蕃	ct	艹田
欂	mc	木寸
袯	py	衤又
𬭛	jp	钅皮
不	ab	丆卜
部	le	立⻏
步	vu	止𣥂
布	uj	𠂇巾
补	pb	衤卜
怖	xj	忄巾
捕	ff	扌甫
簿	vc	竹寸
埔	tf	土甫
哺	kf	口甫
埠	tf	土阜
卟	kb	口卜
逋	zf	辶甫
钚	jb	钅不
晡	of	日甫
瓿	lw	立瓦
醭	yf	酉夫
蔀	ce	艹⻏
埗	tu	土𣥂
𬷕	fn	甫鸟
擦	fu	扌示
嚓	ku	口示
才	up	𬺰丿
菜	cc	艹采
彩	cp	采彡
采	vm	爫木
财	bc	贝才
材	mc	木才
猜	qo	犭⺝
蔡	cu	艹示
裁	gy	戈衣
踩	zc	𧾷采
睬	oc	目采
偲	rx	亻心
参	sp	厶彡
残	dj	歹戋
惨	xp	忄彡
餐	dg	歺艮
灿	hu	火山
惭	xj	忄斤
蚕	ti	天虫
璨	wm	𤣩米
粲	dm	歺米
骖	mp	马彡
黪	lp	{里}彡
䅟	hp	禾彡
藏	ci	艹臣
苍	cv	艹㔾
仓	rv	𠆢㔾
舱	vv	舟㔾
沧	dv	氵㔾
伧	rv	亻㔾
鸧	lh	仑灬
草	cu	艹十
操	fm	扌木
肏	rr	入肉
艹	al	一〢
曹	co	艹曰
嘈	ko	口曰
糙	mk	米口
槽	mo	木曰
漕	do	氵曰
屮	kl	凵丨
芔	cc	屮屮
艚	vo	舟曰
螬	io	虫曰
𥕢	uo	石曰
测	dd	氵刂
侧	rd	亻刂
册	ka	⺆一
策	vu	竹朿
厕	id	厂刂
恻	xd	忄刂
岑	uv	山㇇
涔	dv	氵㇇
曾	bo	丷日
层	uy	尸云
蹭	zo	𧾷日
噌	ko	口日
嶒	uo	山日
差	yg	⺶工
查	md	木旦
察	bu	宀示
茶	cm	艹朩
插	fj	扌臼
诧	yq	讠七
叉	yd	又丶
岔	fu	分山
茬	ct	艹土
衩	pi	衤叉
碴	ud	石旦
姹	nq	女七
杈	mi	木叉
搽	fm	扌朩
刹	xd	㐅刂
檫	mu	木示
槎	mg	木工
汊	di	氵叉
镲	ju	钅示
锸	jj	钅臼
馇	ud	饣旦
垞	tq	土七
侘	rq	亻七
猹	qd	犭旦
蹅	zd	𧾷旦
嵖	ud	山旦
喳	kd	口旦
𥻗	md	米旦
拆	fi	扌斥
柴	vm	止木
钗	ji	钅叉
豺	vc	豸才
侪	rq	亻齐
茝	ci	艹𦣞
虿	wi	万虫
瘥	bg	疒工
产	wi	亠厂
颤	wy	亠页
缠	sl	纟里
禅	pu	礻十
蝉	iu	虫十
搀	fd	扌⺀
铲	ji	钅厂
婵	nu	女十
掺	fp	扌彡
阐	mu	门十
忏	xq	忄千
馋	ud	饣⺀
潺	dz	氵子
蟾	ik	虫口
谄	yj	讠臼
谗	yd	讠⺀
孱	uz	尸子
冁	by	丷{𧘇-丿}
澶	dd	氵旦
觇	vj	占见
镡	ju	钅十
羼	uy	尸羊
廛	gt	广土
巉	ut	山兔
蒇	cb	艹贝
韂	gk	革口
躔	zt	𧾷土
刬	jd	戋刂
浐	di	氵厂
襜	pk	衤口
瀍	dt	氵土
骣	mz	马子
镵	jt	钅兔
旵	ou	日山
啴	ku	口十
梴	mv	木正
儳	rt	亻兔
单	bu	丷十
辿	zu	辶山
𬊤	hu	火十
长	pn	丿ㄟ
常	xj	龸巾
场	tp	土丿
唱	ko	口曰
厂	ap	一丿
尝	xy	龸云
昌	oo	日曰
畅	up	申丿
肠	op	⺼丿
偿	ry	亻云
敞	xw	⺌攵
怅	xi	忄长
倡	ro	亻曰
娼	no	女曰
嫦	nj	女巾
猖	qo	犭曰
昶	yo	永日
徜	rk	彳口
氅	xm	⺌毛
伥	ri	亻长
裳	xy	龸衣
菖	co	艹曰
苌	ci	艹长
阊	mo	门曰
鬯	kb	凵匕
惝	xk	忄口
鲳	yo	鱼曰
鲿	yy	鱼云
𬬮	ji	钅长
超	tk	土口
朝	uo	十月
潮	do	氵月
吵	ku	口少
嘲	ko	口月
抄	fu	扌少
炒	hu	火少
巢	vg	巛果
钞	ju	钅少
晁	ov	日兆
焯	hu	火十
耖	lu	耒少
怊	xk	忄口
弨	gk	弓口
绰	su	纟十
车	au	一十
彻	rd	彳刀
扯	fv	扌止
撤	fw	扌攵
澈	dw	氵攵
掣	nu	牛手
砗	ui	石车
坼	ti	土斥
尺	un	尸乀
㬚	ow	日攵
沉	dj	氵几
陈	ed	⻖东
臣	kl	匚丨
晨	oi	日辰
尘	xt	小土
趁	tp	土彡
辰	iy	厂{𧘇-丿}
衬	pc	衤寸
嗔	kb	口八
琛	wm	𤣩木
称	hx	禾小
宸	bi	宀辰
忱	xe	忄儿
抻	fu	扌申
碜	up	石彡
谌	yb	讠八
谶	yj	讠韭
郴	me	木⻏
棽	mv	木㇇
瞋	ob	目八
榇	mm	木木
龀	vb	止匕
疢	bh	疒火
梣	mv	木㇇
煁	hb	火八
𬘭	sm	纟木
成	wv	戊𠃌
城	ti	土成
程	hw	禾王
承	ln	了乀
诚	yi	讠成
盛	im	成皿
乘	qr	千人
撑	fu	扌手
呈	kw	口王
惩	rx	彳心
丞	la	了一
澄	db	氵䒑
逞	zw	辶王
橙	mb	木䒑
骋	mk	马丂
瞠	ot	目土
秤	hp	禾平
铖	ji	钅成
塍	ot	月土
琤	wy	𤣩{肀亅}
裎	pw	衤王
澂	dw	氵攵
埕	tw	土王
柽	mt	木土
蛏	it	虫土
酲	yw	酉王
枨	mi	木长
珵	ww	𤣩王
赪	ib	赤贝
偁	rr	亻冉
宬	bi	宀成
牚	xy	龸牙
珹	wi	𤣩成
憕	xb	忄䒑
庱	gw	广夂
晟	oi	日成
铛	je	钅彐
吃	kv	口乙
持	fc	扌寸
迟	zi	⻌尺
赤	tb	土{亦下}
痴	bk	疒口
池	dy	氵也
齿	vr	止人
斥	jd	斤丶
驰	my	马也
耻	ev	耳止
翅	vx	支习
哧	ki	口赤
炽	hv	火只
嗤	ki	口虫
蚩	ci	屮虫
叱	kb	口𠤎
弛	gy	弓也
侈	rx	亻夕
啻	wk	亠口
敕	uw	束攵
螭	in	虫禸
魑	gn	鬼禸
饬	ul	饣力
笞	vk	竹口
匙	ob	日匕
踟	zk	𧾷口
墀	tn	土牛
豉	dv	豆支
媸	ni	女虫
褫	pj	衤几
鸱	un	氐鸟
彳	pr	丿亻
茌	ct	艹士
篪	vj	竹几
瘛	bx	疒心
摛	fn	扌禸
眵	ox	目夕
傺	ru	亻示
漦	wu	未水
胣	oy	⺼也
瓻	xw	㐅瓦
痓	bt	疒土
𫄨	sj	纟巾
冲	dv	冫中
充	wy	亠允
重	ql	千里
虫	vd	中丶
崇	uu	山示
宠	bl	宀龙
忡	xv	忄中
憧	xl	忄里
铳	jy	钅允
舂	ij	𡗗臼
艟	vl	舟里
翀	xv	习中
茺	cy	艹允
珫	wy	𤣩允
漴	du	氵示
涌	dy	氵用
种	hv	禾中
㳘	dy	氵允
摏	fj	扌臼
抽	fy	扌由
仇	rj	亻九
臭	zq	自犬
丑	vt	𠃍土
愁	hx	禾心
筹	vc	竹寸
瞅	oh	目火
酬	yv	酉州
绸	sk	纟口
畴	tc	田寸
踌	zc	𧾷寸
惆	xk	忄口
稠	hk	禾口
俦	rc	亻寸
雠	ry	亻讠
瘳	bp	疒彡
犨	rn	亻牛
帱	jc	巾寸
杻	mi	木丑
侴	rd	𠆢刂
椆	mk	木口
出	uu	山山
处	wb	夂卜
楚	mz	木疋
除	em	⻖朩
初	pd	衤刀
触	di	⺈虫
厨	ic	厂寸
础	ui	石出
储	ro	亻日
畜	xt	玄田
褚	po	衤日
搐	ft	扌田
橱	mc	木寸
躇	zo	𧾷日
雏	dv	⺈{隹右}
锄	jl	钅力
矗	uq	十{具-八}
杵	mu	木十
楮	mo	木日
怵	xu	忄术
黜	li	{里}出
绌	si	纟出
蜍	im	虫朩
刍	de	⺈彐
滁	dm	氵朩
樗	mk	木丂
蹰	zc	𧾷寸
憷	xz	忄疋
亍	ad	一丁
俶	ry	亻又
斶	ji	斤虫
摴	fk	扌丂
䝙	vq	豸区
䢺	ie	出⻏
濋	dz	氵疋
琡	wy	𤣩又
𬺓	vz	止疋
欻	hq	火欠
揣	fe	扌而
踹	ze	𧾷而
搋	fj	扌几
啜	ky	口又
传	rv	亻专
穿	by	宀牙
船	vk	舟口
川	pl	丿〢
喘	ke	口而
串	kl	口丨
钏	ji	钅川
椽	mu	木𧰨
舛	xf	夕㐄
遄	ze	辶而
氚	qi	气川
床	gm	广木
窗	bw	宀夂
创	rd	𠆢刂
疮	bv	疒㔾
闯	mm	门马
怆	xv	忄㔾
幢	jl	巾里
噇	kl	口里
吹	kq	口欠
垂	qt	千士
锤	jt	钅士
捶	ft	扌士
炊	hq	火欠
槌	ml	木𠂤
陲	et	⻖士
棰	mt	木士
倕	rt	亻士
圌	ke	囗而
春	io	𡗗日
纯	st	纟屯
唇	ik	辰口
蠢	ii	𡗗虫
淳	dz	氵子
醇	yz	酉子
椿	mo	木日
鹑	wn	亠鸟
莼	ct	艹屯
蝽	io	虫日
瑃	wo	𤣩日
䲠	yo	鱼日
堾	to	土日
𬭚	jz	钅子
戳	xg	习戈
龊	vz	止足
辍	iy	车又
踔	zu	𧾷十
惙	xy	忄又
逴	zu	辶十
此	vb	止匕
次	dq	冫欠
刺	ud	朿刂
词	yk	讠口
辞	ux	舌辛
慈	bx	丷心
赐	bw	贝勿
磁	uy	石幺
伺	rk	亻口
瓷	dw	冫瓦
茨	cq	艹欠
雌	vv	止{隹右}
祠	pk	礻口
呲	kb	口匕
疵	bb	疒匕
泚	db	氵匕
糍	my	米幺
鹚	bn	丷鸟
茈	cb	艹匕
跐	zb	𧾷匕
玼	wb	𤣩匕
佽	rq	亻欠
兹	by	丷幺
莿	cd	艹刂
𫚖	vy	止鱼
从	rr	人人
匆	bd	勹丶
聪	ex	耳心
丛	ra	人一
葱	cx	艹心
琮	wu	𤣩示
淙	du	氵示
囱	pw	丿夂
骢	mx	马心
苁	cr	艹人
枞	mr	木人
璁	wx	𤣩心
熜	hx	火心
悰	xu	忄示
凑	dt	冫天
辏	it	车天
腠	ot	⺼天
粗	mq	米且
促	rz	亻足
醋	yo	酉日
簇	vu	竹矢
猝	qu	犭十
蹙	wz	戊足
蹴	zy	𧾷尤
卒	wu	亠十
徂	rq	彳且
殂	dq	歹且
蔟	cu	艹矢
窜	bi	宀串
蹿	zi	𧾷串
篡	vs	竹厶
撺	fi	扌串
攒	fb	扌贝
汆	ru	入水
爨	jh	𦥑火
镩	ji	钅串
脆	ov	⺼㔾
催	rv	亻{隹右}
翠	xu	习十
崔	uv	山{隹右}
摧	fv	扌{隹右}
粹	mu	米十
悴	xu	忄十
璀	wv	𤣩{隹右}
啐	ku	口十
萃	cu	艹十
瘁	bu	疒十
淬	du	氵十
榱	mv	木{⿻口一}
毳	mm	毛毛
漼	dv	氵{隹右}
缞	sv	纟{⿻口一}
存	uz	𠂇子
村	mc	木寸
寸	ud	𬺰丶
忖	xc	忄寸
皴	yp	允皮
邨	te	屯⻏
错	jo	钅日
措	fo	扌日
挫	fr	扌人
搓	fg	扌工
撮	fy	扌又
磋	ug	石工
蹉	zg	𧾷工
锉	jr	钅人
厝	io	厂日
矬	ur	矢人
嵯	ug	山工
痤	br	疒人
鹾	bg	⺊工
脞	or	⺼人
瑳	wg	𤣩工
棤	mo	木日
莝	cr	艹人
大	ar	一人
打	fd	扌丁
答	vk	竹口
达	zd	辶大
搭	fk	扌口
哒	kd	口大
瘩	bk	疒口
嗒	kk	口口
沓	uo	水日
耷	de	大耳
鞑	gd	革大
靼	gd	革旦
妲	nd	女旦
褡	pk	衤口
跶	zd	𧾷大
怛	xd	忄旦
笪	vd	竹旦
垯	td	土大
溚	dk	氵口
炟	hd	火旦
荙	cd	艹大
鿎	ud	石大
𨱏	jk	钅口
𫟼	jd	钅大
带	cj	{卅}巾
代	ry	亻弋
待	rc	彳寸
呆	km	口木
袋	ry	亻衣
戴	gg	戈共
黛	rh	亻灬
歹	ax	一夕
贷	rb	亻贝
逮	zl	辶隶
怠	sx	厶心
殆	dk	歹口
岱	ru	亻山
玳	wy	𤣩弋
呔	kt	口太
傣	ru	亻氺
迨	zk	辶口
绐	sk	纟口
叇	yl	云隶
埭	tl	土隶
骀	mk	马口
轪	id	车大
垈	rt	亻土
但	rd	亻旦
淡	dh	氵火
担	fd	扌旦
弹	gu	弓十
丹	kd	⺆丶
蛋	zi	疋虫
胆	od	⺼旦
旦	oa	日一
诞	yv	讠正
耽	ee	耳儿
惮	xu	忄十
石	ak	丆口
眈	oe	目儿
澹	dk	氵口
掸	fu	扌十
郸	be	丷⻏
殚	du	歹十
啖	kh	口火
氮	qh	气火
儋	rk	亻口
聃	er	耳冉
箪	vu	竹十
亶	wd	亠旦
疸	bd	疒旦
萏	cj	艹臼
瘅	bu	疒十
疍	zd	疋旦
赕	bh	贝火
憺	xk	忄口
膻	od	⺼旦
𫢸	ru	亻十
𬘘	se	纟儿
当	xe	⺌彐
党	xx	龸兄
荡	cp	艹丿
挡	fe	扌彐
档	me	木彐
裆	pe	衤彐
宕	bu	宀石
砀	up	石丿
珰	we	𤣩彐
凼	ku	凵水
谠	yx	讠兄
垱	te	土彐
菪	cu	艹石
筜	ve	竹彐
𣗋	mx	木兄
𬍡	dy	氵玉
到	gd	𠫔刂
倒	rd	亻刂
道	zz	辶自
刀	vp	𠃌丿
导	sc	巳寸
岛	nu	{鸟减一}山
盗	dm	冫皿
叨	kd	口刀
蹈	zj	𧾷臼
祷	pc	礻寸
捣	fu	扌山
稻	hj	禾臼
悼	xu	忄十
纛	fx	龶糸
忉	xd	忄刀
氘	ql	气{⿰丿丨}
捯	fd	扌刂
鱽	yd	鱼刀
舠	vd	舟刀
的	bu	白勺
地	ty	土也
得	rc	彳寸
德	rx	彳心
嘚	kc	口寸
锝	jc	钅寸
扽	ft	扌屯
等	vc	竹寸
灯	hd	火丁
登	bb	癶䒑
瞪	ob	目䒑
邓	ye	又⻏
凳	bj	癶几
蹬	zb	𧾷䒑
噔	kb	口䒑
镫	jb	钅䒑
磴	ub	石䒑
戥	og	日戈
嶝	ub	山䒑
璒	wb	𤣩䒑
第	vd	竹𢎨
弟	bd	丷𢎨
底	gu	广氐
低	ru	亻氐
帝	wj	亠巾
敌	uw	舌攵
抵	fu	扌氐
递	zd	辶𢎨
迪	zy	辶由
滴	dg	氵古
蒂	cj	艹巾
狄	qh	犭火
笛	vy	竹由
嘀	kg	口古
堤	tz	土龰
邸	ue	氐⻏
嫡	ng	女古
棣	ml	木隶
缔	sj	纟巾
谛	yj	讠巾
涤	dm	氵木
荻	ch	艹火
娣	nd	女𢎨
诋	yu	讠氐
氐	ud	氏丶
砥	uu	石氐
镝	jg	钅古
睇	od	目𢎨
坻	tu	土氐
柢	mu	木氐
鞮	gz	革龰
羝	yu	羊氐
觌	uj	十见
籴	rm	入米
骶	gu	冎氐
碲	uj	石巾
禘	pj	礻巾
翟	xv	习{隹右}
踶	zz	𧾷龰
菂	cu	艹勺
髢	ey	E也
玓	wu	𤣩勺
杕	md	木大
蹢	zg	𧾷古
媂	nj	女巾
提	fz	扌龰
䃅	uu	石十
䗖	ij	虫巾
茋	cu	艹氐
𤧛	wj	𤣩巾
𬱖	yy	由页
嗲	kx	口夕
点	vh	占灬
电	yv	由乚
店	gv	广占
殿	uu	尸殳
典	qb	{曲-一}八
颠	uy	十页
垫	ft	扌土
甸	bt	勹田
惦	xv	忄占
奠	bd	丷大
掂	fv	扌占
癫	by	疒页
巅	uy	山页
淀	dz	氵龰
滇	db	氵八
玷	wv	𤣩占
踮	zv	𧾷占
佃	rt	亻田
靛	fz	龶龰
碘	ub	石八
钿	jt	钅田
簟	vu	竹十
癜	bu	疒殳
坫	tv	土占
阽	ev	⻖占
扂	hv	户占
琔	wz	𤣩龰
掉	fu	扌十
调	yk	讠口
屌	uj	尸巾
雕	kv	⺆{隹右}
吊	kj	口巾
钓	ju	钅勺
刁	va	𠃌㇀
叼	kd	口刁
貂	vk	豸口
凋	dk	冫口
碉	uk	石口
鲷	yk	鱼口
铫	jv	钅兆
铞	jj	钅巾
窎	bn	宀鸟
汈	dd	氵刁
爹	fx	父夕
蝶	im	虫木
跌	zf	𧾷夫
叠	yq	又且
碟	um	石木
迭	zf	辶夫
谍	ym	讠木
喋	km	口木
牒	pm	片木
堞	tm	土木
耋	lt	老土
鲽	ym	鱼木
昳	of	日夫
蹀	zm	𧾷木
瓞	gf	瓜夫
垤	tt	土土
绖	st	纟土
楪	mm	木木
𫶇	uj	山巾
定	bz	宀龰
顶	dy	丁页
丁	al	一亅
盯	od	目丁
订	yd	讠丁
叮	kd	口丁
鼎	po	爿目
钉	jd	钅丁
锭	jz	钅龰
町	td	田丁
仃	rd	亻丁
酊	yd	酉丁
腚	oz	⺼龰
玎	wd	𤣩丁
碇	uz	石龰
疔	bd	疒丁
啶	kz	口龰
耵	ed	耳丁
萣	cz	艹龰
丢	pq	丿去
铥	jq	钅去
动	yl	云力
东	ax	一小
洞	dk	氵口
懂	xv	忄重
冬	wd	夂⺀
董	cv	艹重
冻	dd	冫东
栋	md	木东
咚	kd	口冬
峒	uk	山口
胴	ok	⺼口
侗	rk	亻口
恫	xk	忄口
鸫	dn	东鸟
垌	tk	土口
硐	uk	石口
氡	qd	气冬
胨	od	⺼东
岽	ud	山东
𬟽	id	虫东
都	le	耂⻏
斗	ud	十⺀
抖	fd	扌斗
豆	ab	一䒑
逗	zb	辶䒑
兜	pe	丿儿
陡	ez	⻖龰
窦	bd	宀⺀
痘	bb	疒䒑
蚪	id	虫斗
蔸	ce	艹儿
篼	ve	竹儿
钭	jd	钅斗
读	yd	讠⺀
度	gy	广又
独	qi	犭虫
毒	fm	龶母
杜	mt	木土
肚	ot	⺼土
赌	bo	贝日
督	uo	上目
渡	dy	氵又
嘟	ke	口⻏
堵	to	土日
妒	nh	女户
睹	oo	目日
笃	vm	竹马
渎	dd	氵⺀
镀	jy	钅又
犊	nd	牜⺀
牍	pd	片⺀
蠹	gi	𰀉虫
黩	ld	{里}⺀
阇	mo	门日
芏	ct	艹土
椟	md	木⺀
髑	gi	冎虫
厾	vq	⺄去
𬭊	jt	钅土
断	vj	𠃊斤
段	pu	{段-殳}殳
短	ub	矢䒑
端	le	立而
锻	ju	钅殳
缎	su	纟殳
煅	hu	火殳
椴	mu	木殳
耑	ue	山而
簖	vj	竹斤
塅	tu	土殳
瑖	wu	𤣩殳
对	yc	又寸
队	er	⻖人
堆	tv	土{隹右}
兑	bx	丷兄
怼	yx	又心
碓	uv	石{隹右}
祋	pu	礻殳
顿	ty	屯页
盾	io	𠂆目
蹲	zc	𧾷寸
敦	ww	亠攵
沌	dt	氵屯
遁	zo	辶目
吨	kt	口屯
钝	jt	钅屯
墩	tw	土攵
炖	ht	火屯
盹	ot	目屯
惇	xz	忄子
趸	wz	万足
礅	uw	石攵
蹾	zw	𧾷攵
砘	ut	石屯
镦	jw	钅攵
囤	kt	囗屯
多	xx	夕夕
躲	um	身木
朵	jm	𠘧木
夺	dc	大寸
堕	et	⻖土
哆	kx	口夕
跺	zm	𧾷木
踱	zy	𧾷又
舵	vb	舟匕
咄	ki	口出
剁	jd	𠘧刂
铎	jf	钅𰀁
惰	xo	忄月
垛	tm	土木
掇	fy	扌又
哚	km	口木
裰	py	衤又
埵	tt	土士
饳	ui	饣出
亸	wu	亠十
剟	yd	又刂
驮	md	马大
㙍	ty	土又
饿	uw	饣我
呃	kv	口㔾
恶	yx	亚心
额	by	宀页
俄	rw	亻我
愕	xk	忄丂
鹅	wn	我鸟
噩	wk	王口
娥	nw	女我
厄	iv	厂㔾
峨	uw	山我
鄂	ke	口⻏
遏	zr	辶人
扼	fv	扌㔾
鳄	yk	鱼丂
蛾	iw	虫我
婀	nk	女可
讹	yb	讠𠤎
锷	jk	钅丂
颚	ky	口页
鹗	kn	口鸟
萼	ck	艹丂
屙	uk	尸可
谔	yk	讠丂
垩	yt	亚土
腭	ok	⺼丂
莪	cw	艹我
轭	iv	车㔾
苊	cv	艹㔾
锇	jw	钅我
崿	uk	山丂
姶	nk	女口
涐	dw	氵我
哦	kw	口我
堨	tr	土人
𥔲	uk	石丂
𫫇	kx	口心
恩	yx	因心
摁	fx	扌心
蒽	cx	艹心
而	al	丆丨
儿	pv	丿乚
二	aa	一一
尔	dx	⺈小
耳	ol	目丨
饵	ue	饣耳
迩	zx	辶小
贰	yb	弋贝
洱	de	氵耳
珥	we	𤣩耳
铒	je	钅耳
鸸	en	而鸟
陑	ee	⻖而
鲕	ye	鱼而
咡	ke	口耳
耏	ep	而彡
发	fy	{𠃊丿}又
法	dq	氵去
罚	sd	罒刂
乏	pv	丿之
伐	rg	亻戈
阀	mg	门戈
筏	vg	竹戈
砝	uq	石去
珐	wq	𤣩去
垡	rt	亻土
反	iy	𠂆又
饭	uy	饣又
翻	cx	釆习
烦	hy	火页
凡	jd	几丶
犯	qv	犭㔾
范	cv	艹㔾
番	ct	釆田
繁	px	𠂉糸
返	zy	辶又
泛	df	氵乏
帆	jf	巾凡
贩	by	贝又
樊	md	木大
藩	ct	艹田
梵	mf	木凡
幡	jt	巾田
蘩	cx	艹糸
璠	wt	𤣩田
矾	uf	石凡
畈	ty	田又
燔	ht	火田
钒	jf	钅凡
氾	dv	氵㔾
蹯	zt	𧾷田
墦	tt	土田
𫔍	jt	钅田
𬸪	cn	釆鸟
放	fw	方攵
房	hf	户方
防	ef	⻖方
方	wv	亠𠃌
仿	rf	亻方
芳	cf	艹方
访	yf	讠方
妨	nf	女方
坊	tf	土方
纺	sf	纟方
肪	of	⺼方
舫	vf	舟方
枋	mf	木方
昉	of	日方
鲂	yf	鱼方
邡	fe	方⻏
钫	jf	钅方
牥	nf	牜方
蚄	if	虫方
飞	vd	㇈丶
非	ls	丨三
费	fb	弗贝
菲	cf	艹非
废	gy	广又
妃	nj	女己
肥	ob	⺼巴
啡	kf	口非
匪	kf	匚非
沸	df	氵弗
肺	ou	⺼巿
绯	sf	纟非
斐	fw	非文
霏	yf	雨非
翡	fx	非习
扉	hf	户非
吠	kq	口犬
诽	yf	讠非
蜚	fi	非虫
狒	qf	犭弗
腓	of	⺼非
悱	xf	忄非
淝	db	氵巴
芾	cu	艹巿
痱	bf	疒非
榧	mf	木非
鲱	yf	鱼非
篚	vf	竹非
朏	oi	月出
棐	fm	非木
镄	jb	钅贝
剕	fd	非刂
𬴂	mf	马非
分	bd	八刀
份	rf	亻分
纷	sf	纟分
奋	dt	大田
愤	xb	忄贝
粉	mf	米分
氛	qf	气分
吩	kf	口分
芬	cf	艹分
焚	mh	木火
坟	tw	土文
忿	fx	分心
粪	mg	米共
汾	df	氵分
酚	yf	酉分
棼	mf	木分
偾	rb	亻贝
鲼	yb	鱼贝
棻	cm	艹木
鼢	jf	臼分
翂	xf	习分
瀵	dg	氵共
坋	tf	土分
豮	ub	豕贝
𣸣	db	氵贝
风	jx	几乂
封	tc	土寸
凤	jy	⺇又
峰	uf	山丰
疯	bf	疒风
锋	jf	钅丰
枫	mf	木风
丰	sl	三丨
奉	if	𡗗𰀁
冯	dm	冫马
缝	sf	纟丰
逢	zf	辶丰
讽	yf	讠风
蜂	if	虫丰
烽	hf	火丰
俸	rf	亻𰀁
沣	df	氵丰
沨	df	氵风
酆	ue	山⻏
葑	cc	艹寸
唪	kf	口𰀁
砜	uf	石风
赗	bo	贝目
浲	df	氵丰
崶	uc	山寸
否	bk	不口
缶	pk	𠂉凵
服	oy	月又
夫	er	二人
父	bx	八乂
复	pw	𠂉夂
福	pt	礻田
府	gc	广寸
副	ad	𠮛刂
负	db	⺈贝
付	rc	亻寸
富	bt	宀田
妇	ne	女彐
附	ec	⻖寸
伏	rq	亻犬
傅	rc	亻寸
浮	dz	氵子
扶	ff	扌夫
抚	fw	扌无
符	vc	竹寸
肤	of	⺼夫
腹	ow	⺼夂
幅	jt	巾田
咐	kc	口寸
覆	xw	覀夂
腐	gr	广肉
弗	gl	弓丨
赴	tb	土卜
斧	fj	父斤
俯	rc	亻寸
赋	bv	贝止
辅	if	车甫
芙	cf	艹夫
拂	ff	扌弗
甫	uy	十用
俘	rz	亻子
缚	sc	纟寸
蝠	it	虫田
敷	fw	甫攵
脯	of	⺼甫
袱	pq	衤犬
腑	oc	⺼寸
辐	it	车田
孚	vz	爫子
驸	mc	马寸
釜	fb	父丷
苻	cc	艹寸
匐	bt	勹田
宓	bb	宀必
阜	lu	𠂤十
孵	lz	卵子
馥	hw	禾夂
茀	cf	艹弗
涪	dk	氵口
茯	cq	艹犬
凫	nj	{鸟减一}几
蚨	if	虫夫
拊	fc	扌寸
蝮	iw	虫夂
讣	yb	讠卜
黼	yf	业甫
趺	zf	𧾷夫
怫	xf	忄弗
氟	qf	气弗
蜉	iz	虫子
黻	yy	业又
麸	ff	龶夫
绂	sy	纟又
跗	zc	𧾷寸
鲋	yc	鱼寸
罘	sb	罒不
滏	db	氵丷
郛	ve	爫⻏
菔	cy	艹又
桴	mz	木子
幞	jf	巾夫
祓	py	礻又
呋	kf	口夫
绋	sf	纟弗
莩	cz	艹子
赙	bc	贝寸
鄜	le	鹿⻏
芣	cb	艹不
洑	dq	氵犬
簠	vm	竹皿
榑	mc	木寸
稃	hz	禾子
韨	wy	韦又
玞	wf	𤣩夫
砆	uf	石夫
垺	tz	土子
㕮	kf	口父
㳇	df	氵父
琈	wz	𤣩子
𫓧	jf	钅夫
𫖯	vy	兆页
尬	yj	尢介
嘎	kg	口戈
伽	rk	亻口
噶	kr	口人
旮	jo	九日
咖	kk	口口
尕	nx	乃小
尜	xx	小小
轧	iv	车乚
钆	jv	钅乚
戛	bg	𦣻戈
该	yr	讠人
改	jw	己攵
盖	ym	𦍌皿
概	mw	木旡
丐	av	一㇉
钙	jg	钅丐
溉	dw	氵旡
赅	br	贝人
垓	tr	土人
陔	er	⻖人
戤	ng	乃戈
荄	cr	艹人
晐	or	日人
𬮿	ej	⻖己
感	wx	戊心
干	au	一十
敢	ew	{⿱𠃍耳}攵
赶	tg	土干
甘	ca	廿一
尴	ym	尢皿
杆	mg	木干
肝	og	⺼干
竿	vg	竹干
橄	mw	木攵
赣	lb	立贝
秆	hg	禾干
柑	mg	木甘
擀	fg	扌干
玕	wg	𤣩干
淦	dj	氵金
泔	dg	氵甘
矸	ug	石干
坩	tg	土甘
绀	sg	纟甘
苷	cg	艹甘
旰	og	日干
疳	bg	疒甘
酐	yg	酉干
澉	dw	氵攵
虷	ig	虫干
鳡	yx	鱼心
㽏	dg	氵甘
刚	kd	冂刂
港	ds	氵巳
钢	jx	钅㐅
岗	ux	山㐅
冈	kx	冂㐅
缸	fg	缶工
纲	sx	纟㐅
罡	sv	罒正
杠	mg	木工
肛	og	⺼工
筻	vg	竹更
冮	dg	冫工
矼	ug	石工
堽	tv	土正
戆	lx	立心
扛	fg	扌工
㭎	mx	木㐅
鿍	tf	土㐄
高	wk	亠口
告	nk	⺧口
搞	fk	扌口
糕	mh	米灬
稿	hk	禾口
膏	wo	亠⺝
羔	yh	𦍌灬
皋	bu	白十
镐	jk	钅口
睾	pg	丿干
篙	vk	竹口
诰	yk	讠口
槁	mk	木口
杲	om	日木
缟	sk	纟口
锆	jk	钅口
郜	ne	⺧⻏
藁	cm	艹木
槔	mu	木十
筶	vk	竹口
个	rl	𠆢丨
哥	kk	可可
各	wk	夂口
格	mk	木口
歌	kq	可欠
革	cu	廿十
隔	eg	⻖鬲
阁	mk	门口
葛	cr	艹人
割	bd	宀刂
胳	ok	⺼口
戈	yp	弋丿
搁	fk	扌口
鸽	rn	𠆢鸟
疙	bv	疒乙
骼	gk	冎口
嗝	kg	口鬲
硌	uk	石口
咯	kk	口口
铬	jk	钅口
鬲	al	𠮛丨
圪	tv	土乙
蛤	ik	虫口
舸	vk	舟可
膈	og	⺼鬲
虼	iv	虫乙
袼	pk	衤口
哿	lk	力可
镉	jg	钅鬲
仡	rv	亻乙
饹	uk	饣口
塥	tg	土鬲
滆	dg	氵鬲
合	rk	𠆢口
给	sk	纟口
跟	zg	𧾷艮
根	mg	木艮
亘	ad	一旦
艮	oy	日{𧘇-丿}
哏	kg	口艮
茛	cg	艹艮
更	an	一乀
耿	eh	耳火
哽	kg	口更
耕	lj	耒井
羹	yd	𦍌大
庚	gr	广人
梗	mg	木更
赓	gb	广贝
埂	tg	土更
鲠	yg	鱼更
绠	sg	纟更
浭	dg	氵更
暅	od	日旦
颈	jy	𢀖页
鹒	gn	广鸟
𬒔	uo	石⺝
公	bs	八厶
工	aa	一丄
功	gl	工力
攻	gw	工攵
宫	bk	宀口
共	cb	卄八
供	rg	亻共
恭	gx	共⺗
弓	vv	𠃍㇉
贡	gb	工贝
躬	ug	身弓
拱	fg	扌共
龚	lg	龙共
巩	gf	工凡
蚣	ig	虫公
觥	de	⺈儿
汞	gu	工水
肱	os	⺼厶
珙	wg	𤣩共
䢼	ge	共⻏
硔	ug	石共
够	jx	句夕
狗	qj	犭句
构	mg	木勾
勾	bs	勹厶
购	bg	贝勾
沟	dg	氵勾
钩	jg	钅勾
苟	cj	艹句
垢	tk	土口
篝	vr	竹冉
佝	rj	亻句
媾	nr	女冉
枸	mj	木句
诟	yk	讠口
彀	tu	士殳
缑	su	纟矢
遘	zr	辶冉
鞲	gr	革冉
笱	vj	竹句
觏	fj	𠀎见
岣	uj	山句
姤	nk	女口
雊	jv	句{隹右}
耇	lj	耂句
句	bk	勹口
古	uk	十口
故	gw	古攵
顾	iy	厂页
股	ou	⺼殳
姑	ng	女古
骨	go	冎⺼
孤	zg	子瓜
谷	bk	八口
鼓	tv	士支
固	kg	囗古
估	rg	亻古
咕	kg	口古
辜	gx	古辛
雇	hv	户{隹右}
蛊	im	虫皿
菇	cg	艹古
汩	do	氵曰
箍	vj	竹巾
锢	jg	钅古
沽	dg	氵古
贾	xb	覀贝
鹘	gn	冎鸟
臌	ov	⺼支
牯	ng	牜古
轱	ig	车古
鸪	gn	古鸟
梏	mk	木口
痼	bg	疒古
钴	jg	钅古
毂	tu	士殳
崮	ug	山古
诂	yg	讠古
瞽	to	士目
菰	cg	艹瓜
蛄	ig	虫古
羖	yu	羊殳
觚	dg	⺈瓜
嘏	gy	古又
罟	sg	罒古
榖	tu	士殳
酤	yg	酉古
馉	uo	饣⺼
牿	nk	牜口
堌	tg	土古
蓇	co	艹⺼
鲴	yg	鱼古
呱	kg	口瓜
鹄	nn	⺧鸟
瀔	du	氵殳
𦙶	og	⺼古
挂	ft	扌土
瓜	in	𠂆乀
刮	ud	舌刂
寡	bf	宀分
卦	tb	土卜
褂	pb	衤卜
剐	kd	口刂
鸹	un	舌鸟
诖	yt	讠土
栝	mu	木舌
胍	og	⺼瓜
怪	xt	忄土
乖	qb	千北
拐	fl	扌力
掴	fy	扌玉
夬	vr	ユ人
关	bt	丷天
管	vl	竹㠯
官	bl	宀㠯
观	yj	又见
馆	ul	饣㠯
惯	xb	忄贝
冠	bc	冖寸
贯	mb	毌贝
灌	dv	氵{隹右}
罐	fv	缶{隹右}
棺	ml	木㠯
倌	rl	亻㠯
盥	jm	𦥑皿
掼	fb	扌贝
涫	dl	氵㠯
鳏	yx	鱼小
鹳	cn	艹鸟
瓘	wv	𤣩{隹右}
祼	pg	礻果
琯	wl	𤣩㠯
毌	ml	{𠃊𠃌一(母-丶丶)}丨
筦	vy	竹元
蒄	cc	艹寸
爟	hv	火{隹右}
纶	sl	纟仑
莞	cy	艹元
鳤	yl	鱼㠯
光	xe	⺌儿
广	di	丶厂
逛	zw	辶王
咣	ke	口儿
犷	qg	犭广
胱	oe	⺼儿
桄	me	木儿
洸	de	氵儿
珖	we	𤣩儿
垙	te	土儿
𨐈	ie	车儿
鬼	ps	丿厶
贵	vb	中贝
规	fj	夫见
归	le	リ彐
跪	zv	𧾷㔾
柜	mj	木巨
诡	yv	讠㔾
瑰	wg	𤣩鬼
桂	mt	木土
龟	dd	⺈电
轨	ij	车九
闺	mt	门土
圭	tt	土土
桧	my	木云
刽	rd	𠆢刂
癸	bt	癶天
硅	ut	石土
妫	nw	女为
珪	wt	𤣩土
皈	by	白又
晷	ok	日口
鲑	yt	鱼土
刿	ud	山刂
鳜	yq	鱼欠
姽	nv	女㔾
簋	vm	竹皿
庋	gv	广支
宄	bj	宀九
匦	kj	匚九
邽	te	土⻏
鬶	fg	夫鬲
炅	oh	日火
筀	vt	竹土
滚	dg	氵公
棍	mb	木匕
衮	yg	衣公
鲧	yx	鱼糸
磙	ug	石公
辊	ib	车匕
绲	sb	纟匕
过	zc	辶寸
国	ky	囗玉
果	tm	田木
郭	we	亠⻏
锅	jn	钅内
裹	yg	衣果
蝈	iy	虫玉
聒	eu	耳舌
帼	jy	巾玉
椁	mz	木子
虢	vj	爫几
埚	tn	土内
呙	kn	口内
崞	uz	山子
腘	oy	⺼玉
馘	ba	丷{一}
粿	mg	米果
蜾	ig	虫果
馃	ug	饣果
涡	dn	氵内
𬇹	dy	氵玉
哈	kk	口口
铪	jk	钅口
还	zb	辶不
海	dm	氵母
孩	zr	子人
害	bk	宀口
骇	mr	马人
嗨	km	口母
骸	gr	冎人
亥	wr	亠人
咳	kr	口人
嗐	kk	口口
氦	qr	气人
醢	ym	酉皿
胲	or	⺼人
咍	kk	口口
汉	dy	氵又
寒	bd	宀⺀
喊	kk	口口
韩	uw	十韦
汗	dg	氵干
含	rk	𠆢口
涵	du	氵{水}
翰	ux	十习
憾	xx	忄心
罕	bg	⺳干
撼	fx	扌心
悍	xg	忄干
瀚	dx	氵习
函	ku	凵{水}
憨	ex	{⿱𠃍耳}心
旱	og	日干
酣	yg	酉甘
颔	ry	𠆢页
邯	ge	甘⻏
捍	fg	扌干
鼾	zg	自干
晗	ok	日口
菡	cu	艹{水}
焊	hg	火干
顸	gy	干页
邗	ge	干⻏
焓	hk	火口
蚶	ig	虫甘
扞	fg	扌干
撖	fw	扌攵
暵	ot	日天
浛	dk	氵口
琀	wk	𤣩口
㘎	kw	口攵
垾	tg	土干
崡	uu	山{水}
嵅	uk	山口
蔊	cg	艹干
行	rd	彳丁
航	vj	舟几
杭	mj	木几
沆	dj	氵几
颃	wy	亠页
绗	sd	纟丁
吭	kj	口几
巷	gs	共巳
好	nz	女子
号	kk	口丂
毫	wm	亠毛
豪	wu	亠豕
浩	dk	氵口
耗	lm	耒毛
昊	ot	日天
郝	ie	赤⻏
嚎	ku	口豕
皓	bk	白口
壕	tu	土豕
嗥	ku	口十
颢	oy	日页
濠	du	氵豕
蒿	ck	艹口
灏	dy	氵页
貉	vk	豸口
蚝	im	虫毛
薅	cc	艹寸
皞	bu	白十
淏	dt	氵天
嚆	kk	口口
鄗	we	亠⻏
和	hk	禾口
何	rk	亻可
喝	kr	口人
呵	kk	口可
河	dk	氵可
赫	ii	赤赤
核	mr	木人
贺	lb	力贝
盒	rm	𠆢皿
荷	ck	艹可
鹤	bn	冖鸟
禾	pm	丿木
褐	pr	衤人
嗬	kk	口可
壑	bt	⺊土
阖	mm	门皿
吓	kx	口下
涸	dg	氵古
劾	wl	亠力
颌	ry	𠆢页
阂	mr	门人
诃	yk	讠可
郃	re	𠆢⻏
纥	sv	纟乙
龢	rh	𠆢禾
鞨	gr	革人
翮	gx	鬲习
曷	or	曰人
龁	vv	止乙
盍	qm	去皿
菏	ck	艹可
盉	hm	禾皿
饸	uk	饣口
熇	hk	火口
鹖	on	曰鸟
翯	xk	习口
垎	tk	土口
隺	bv	冖{隹右}
𬌗	yk	牙口
黑	lh	{里}灬
嘿	kh	口灬
𬭶	jh	钅灬
很	rg	彳艮
狠	qg	犭艮
恨	xg	忄艮
痕	bg	疒艮
𬣳	yg	讠艮
哼	kl	口了
横	mh	木黄
衡	rd	彳大
恒	xd	忄旦
亨	wl	亠了
蘅	cd	艹大
珩	wd	𤣩丁
姮	nd	女旦
桁	md	木丁
鸻	rn	彳鸟
堼	tt	土土
红	sg	纟工
轰	iy	车又
洪	dg	氵共
虹	ig	虫工
宏	bs	宀厶
鸿	dn	氵鸟
哄	kg	口共
弘	gs	弓厶
烘	hg	火共
泓	ds	氵厶
闳	ms	门厶
讧	yg	讠工
薨	cb	艹匕
訇	bk	勹口
荭	cg	艹工
纮	ss	纟厶
吽	kn	口牛
竑	ls	立厶
蕻	cg	艹共
翃	ux	𠂇习
黉	xh	𰃮黄
唝	kb	口贝
玒	wg	𤣩工
谼	gg	谷共
𫟹	jg	钅共
𬭎	js	钅厶
后	ik	𠂆口
候	ru	亻矢
厚	iz	厂子
吼	kv	口乚
侯	ru	亻矢
猴	qu	犭矢
喉	ku	口矢
逅	zk	辶口
篌	vu	竹矢
瘊	bu	疒矢
鲎	xy	𰃮鱼
堠	tu	土矢
垕	it	𠂆土
齁	zj	自句
骺	gk	冎口
糇	mu	米矢
郈	ie	𠂆⻏
鲘	yk	鱼口
𬭤	ju	钅矢
乎	pl	丿亅
呼	kh	口乎
忽	wx	勿心
护	fh	扌户
胡	go	古月
虎	hj	虍几
湖	do	氵月
糊	mo	米月
户	du	丶尸
互	ah	一彑
狐	qg	犭瓜
壶	ty	士业
蝴	io	虫月
惚	xx	忄心
弧	gg	弓瓜
唬	kj	口几
葫	co	艹月
沪	dh	氵户
扈	hb	户巴
瑚	wo	𤣩月
琥	wj	𤣩几
浒	du	氵十
斛	dd	⺈斗
囫	kw	囗勿
祜	pg	礻古
醐	yo	酉月
唿	kx	口心
猢	qo	犭月
笏	vw	竹勿
瓠	dg	大瓜
槲	md	木斗
怙	xg	忄古
煳	ho	火月
鹕	gn	古鸟
滹	dh	氵乎
觳	tu	士殳
岵	ug	山古
烀	hh	火乎
鄠	ye	雨⻏
戽	hd	户斗
縠	tu	士殳
冱	dh	冫互
鹱	ny	{鸟减一}又
淴	dx	氵心
昒	ow	日勿
鳠	yy	鱼又
嫭	nh	女乎
轷	ih	车乎
昈	oh	日户
话	yu	讠舌
花	cb	艹𠤎
化	rb	亻𠤎
华	ru	亻十
划	gd	戈刂
画	at	一田
滑	do	氵⺼
哗	ku	口十
猾	qo	犭⺼
桦	mu	木十
骅	mu	马十
婳	nt	女田
铧	ju	钅十
砉	fu	丰石
觟	dt	⺈土
坏	tb	土不
怀	xb	忄不
淮	dv	氵{隹右}
槐	mg	木鬼
徊	rk	彳口
踝	zg	𧾷果
换	fd	扌大
缓	sy	纟又
环	wb	𤣩不
幻	yv	幺𠃌
唤	kd	口大
欢	yq	又欠
患	ix	串心
焕	hd	火大
桓	md	木旦
鬟	ey	E𧘇
宦	bi	宀臣
寰	by	宀𧘇
浣	dy	氵元
痪	bd	疒大
涣	dd	氵大
奂	dd	⺈大
圜	ky	囗𧘇
豢	ju	龹豕
獾	qv	犭{隹右}
洹	dd	氵旦
嬛	ny	女𧘇
缳	sy	纟𧘇
萑	cv	艹{隹右}
鲩	yy	鱼元
郇	be	勹⻏
漶	dx	氵心
逭	zl	辶㠯
擐	fy	扌𧘇
锾	jy	钅又
镮	jy	钅𧘇
澴	dy	氵𧘇
鹮	sn	⺫鸟
貆	vd	豸旦
峘	ud	山旦
㬊	oy	日又
荁	cd	艹旦
𤩽	wq	𤣩犬
𬘫	sy	纟元
黄	cb	卄八
皇	bw	白王
晃	oe	日儿
慌	xi	忄𫶧
荒	ci	艹𫶧
恍	xe	忄儿
谎	yi	讠𫶧
惶	xw	忄王
凰	jw	⺇王
煌	hw	火王
簧	vh	竹黄
徨	rw	彳王
蝗	iw	虫王
幌	je	巾儿
潢	dh	氵黄
璜	wh	𤣩黄
遑	zw	辶王
磺	uh	石黄
隍	ew	⻖王
肓	wo	亡⺝
湟	dw	氵王
蟥	ih	虫黄
篁	vw	竹王
鳇	yw	鱼王
滉	de	氵儿
喤	kw	口王
癀	bh	疒黄
锽	jw	钅王
艎	vw	舟王
瑝	ww	𤣩王
媓	nw	女王
㿠	be	白儿
𨱑	jh	钅黄
会	ry	𠆢云
回	kk	囗口
挥	fi	扌车
灰	uh	𠂇火
慧	fx	丰心
辉	xi	⺌车
恢	xh	忄火
毁	ju	臼殳
悔	xm	忄母
惠	ix	{惠-心}心
汇	dk	氵匚
绘	sy	纟云
徽	rx	彳糸
讳	yw	讠韦
晖	oi	日车
晦	om	日母
贿	bo	贝月
秽	hx	禾夕
卉	uc	十廾
麾	gm	广毛
诲	ym	讠母
蕙	cx	艹心
彗	fe	丰彐
诙	yh	讠火
喙	ku	口𧰨
荟	cy	艹云
烩	hy	火云
虺	wi	兀虫
蛔	ik	虫口
珲	wi	𤣩车
咴	kh	口火
茴	ck	艹口
恚	tx	土心
洄	dk	氵口
袆	pw	衤韦
隳	ex	⻖⺗
翚	xi	习车
翙	ux	山习
浍	dy	氵云
蟪	ix	虫心
硊	uv	石㔾
橞	mx	木心
哕	kx	口夕
溃	db	氵贝
㧑	fw	扌为
烠	ho	火月
𬤝	yx	讠心
𬭬	je	钅彐
混	db	氵匕
婚	no	女日
魂	yg	云鬼
昏	uo	氏日
浑	di	氵车
荤	ci	艹车
馄	ub	饣匕
诨	yi	讠车
阍	mo	门日
溷	du	氵豕
惛	xo	忄日
碈	uo	石日
或	ga	戈{一}
活	du	氵舌
火	br	丷人
伙	rh	亻火
获	cq	艹犬
惑	gx	戈心
货	rb	亻贝
祸	pn	礻内
霍	yv	雨{隹右}
豁	bg	宀谷
夥	gx	果夕
嚯	kv	口{隹右}
藿	cv	艹{隹右}
镬	jy	钅又
蠖	iy	虫又
攉	fv	扌{隹右}
钬	jh	钅火
嚄	ky	口又
锪	jx	钅心
劐	cd	艹刂
濩	dy	氵又
耠	lk	耒口
漷	de	氵⻏
㸌	hv	火{隹右}
佸	ru	亻舌
𬴃	mu	马石
级	sj	纟及
集	rm	亻木
几	pv	丿㇈
及	pn	丿乀
机	mj	木几
记	yj	讠己
季	hz	禾子
击	fk	𰀁凵
急	dx	⺈心
鸡	yn	又鸟
挤	fq	扌齐
系	px	丿糸
即	ge	{艮}卩
既	gw	{艮}旡
极	mj	木及
计	yu	讠十
激	dw	氵攵
继	sm	纟米
基	ct	卄土
寄	bk	宀可
忌	jx	己心
己	kv	コ乚
际	eu	⻖示
纪	sj	纟己
技	fv	扌支
济	dq	氵齐
迹	zb	辶{亦下}
吉	tk	士口
积	hv	禾只
寂	by	宀又
疾	bu	疒矢
姬	ni	女𦣞
绩	sb	纟贝
祭	xu	𱼀示
肌	oj	⺼几
辑	ie	车耳
籍	vo	竹日
圾	tj	土及
妓	nv	女支
嫉	nu	女矢
饥	uj	饣几
剂	qd	齐刂
奇	dk	大可
脊	ro	人⺝
稽	ho	禾日
叽	kj	口几
唧	ke	口卩
讥	yj	讠几
藉	co	艹日
冀	bg	北共
戟	ug	十戈
棘	uu	朿朿
缉	se	纟耳
悸	xz	忄子
羁	sm	罒马
玑	wj	𤣩几
伎	rv	亻支
霁	yq	雨齐
矶	uj	石几
髻	ek	E口
稷	hw	禾夂
岌	uj	山及
汲	dj	氵及
畸	tk	田可
笈	vj	竹及
觊	uj	山见
骥	mg	马共
嵇	hu	禾山
蓟	cd	艹刂
箕	vb	竹八
佶	rk	亻口
瘠	bo	疒⺝
畿	gt	戈田
犄	nk	牜可
亟	la	了一
跻	zq	𧾷齐
殛	da	歹亟
暨	gd	{艮}旦
鲫	ye	鱼卩
偈	rr	亻人
齑	qj	齐韭
蒺	cu	艹矢
芨	cj	艹及
屐	uv	尸支
荠	cq	艹齐
楫	me	木耳
赍	ub	十贝
乩	vv	占乚
麂	lj	鹿几
笄	vk	竹开
芰	cv	艹支
墼	it	車土
鹡	rn	人鸟
剞	dd	大刂
戢	kg	口戈
虮	ij	虫几
伋	rj	亻及
垍	tz	土自
掎	fk	扌可
洎	dz	氵自
跽	zx	𧾷心
嵴	uo	山⺝
鲚	yq	鱼齐
蕺	cg	艹戈
罽	sd	罒刂
蹐	zo	𧾷⺝
姞	nk	女口
漈	du	氵示
穄	hu	禾示
耤	lo	耒日
觭	dk	⺈可
惎	cx	卄心
期	co	卄月
鱾	yj	鱼己
㴔	dx	氵心
堲	gt	{艮}土
徛	rk	彳可
枅	mk	木开
瀱	dd	氵刂
𪟝	fl	龶力
𫌀	pb	衤贝
𫓯	jt	钅土
𫓹	jb	钅八
𬯀	eq	⻖齐
𬶨	gy	{艮}鱼
𬶭	yu	鱼示
家	bu	宀豕
加	lk	力口
价	rj	亻介
假	ry	亻又
架	lm	力木
甲	tl	田丨
佳	rt	亻土
夹	ar	一人
嘉	tk	士口
嫁	nu	女豕
驾	lm	力马
颊	jy	夹页
迦	zk	辶口
茄	ck	艹口
稼	hu	禾豕
枷	mk	木口
珈	wk	𤣩口
袈	ly	力衣
葭	cy	艹又
浃	dj	氵夹
胛	oj	⺼甲
痂	bk	疒口
笳	vk	竹口
岬	uj	山甲
槚	mb	木贝
钾	jj	钅甲
荚	cj	艹夹
郏	je	夹⻏
铗	jj	钅夹
跏	zk	𧾷口
蛱	ij	虫夹
恝	fx	丰心
斝	kd	口斗
镓	ju	钅豕
瘕	by	疒又
泇	dk	氵口
𬂩	mj	木夹
见	ke	冂儿
间	mo	门日
剑	qd	佥刂
件	rn	亻牛
建	zy	廴聿
键	jy	钅聿
渐	dj	氵斤
简	vo	竹日
坚	lt	丨土
肩	ho	户⺝
箭	vd	竹刂
舰	vj	舟见
尖	xd	小大
监	lm	丨皿
健	ry	亻聿
检	mq	木佥
减	dk	冫口
奸	ng	女干
艰	yg	又艮
兼	bb	丷八
鉴	lj	丨金
贱	bj	贝戋
捡	fq	扌佥
剪	bd	丷刀
溅	dj	氵戋
践	zj	𧾷戋
荐	cz	艹子
歼	dq	歹千
拣	fd	扌𫠣
煎	bh	丷灬
俭	rq	亻佥
涧	do	氵日
茧	ci	艹虫
谏	yj	讠柬
柬	ur	十人
笺	vj	竹戋
缄	sk	纟口
戬	yg	亚戈
锏	jo	钅日
碱	uk	石口
睑	oq	目佥
翦	bx	丷习
饯	uj	饣戋
蹇	bz	宀足
僭	ro	亻曰
菅	cl	艹㠯
毽	my	毛聿
腱	oy	⺼聿
謇	bk	宀口
蒹	cj	艹兼
戋	ga	戈一
槛	mm	木皿
鞯	gz	革子
笕	vj	竹见
鹣	jn	兼鸟
搛	fj	扌兼
缣	sj	纟兼
鞬	gy	革聿
湔	dd	氵刂
裥	po	衤日
枧	mj	木见
鲣	yt	鱼土
趼	zk	𧾷开
谫	yd	讠刀
踺	zy	𧾷聿
楗	my	木聿
暕	oj	日柬
牮	rn	亻牛
篯	vj	竹戋
犍	ny	牜聿
鳒	yj	鱼兼
𬣡	yj	讠戋
将	lc	丬寸
江	dg	氵工
讲	yj	讠井
降	ef	⻖㐄
蒋	cc	艹寸
奖	ld	丬大
僵	rj	亻畺
姜	yn	𦍌女
疆	gj	弓畺
匠	kj	匚斤
浆	lu	丬水
酱	ly	丬酉
缰	sj	纟畺
绛	sf	纟㐄
桨	lm	丬木
犟	gn	弓牛
糨	mi	米虫
豇	dg	豆工
茳	cg	艹工
礓	uj	石畺
洚	df	氵㐄
耩	lr	耒冉
膙	oi	⺼虫
鳉	yc	鱼寸
弶	gx	弓小
强	gi	弓虫
叫	kj	口丩
教	lw	耂攵
交	wf	亠父
脚	oe	⺼卩
角	dy	⺈用
较	if	车父
娇	nl	女{⿰丿丨}
焦	rh	亻灬
骄	ml	马{⿰丿丨}
轿	il	车{⿰丿丨}
搅	fj	扌见
狡	qf	犭父
郊	we	亠⻏
胶	of	⺼父
觉	xj	𰃮见
嚼	kc	口寸
绞	sf	纟父
剿	vd	巛刂
浇	dw	氵兀
缴	sw	纟攵
蛟	if	虫父
椒	my	木又
侥	rw	亻兀
矫	ul	矢{⿰丿丨}
饺	uf	饣父
蕉	ch	艹灬
校	mf	木父
礁	uh	石灬
皎	bf	白父
窖	bk	宀口
跤	zf	𧾷父
佼	rf	亻父
姣	nf	女父
酵	yz	酉子
鲛	yf	鱼父
艽	cj	艹九
湫	dh	氵火
醮	yh	酉灬
铰	jf	钅父
峤	ul	山{⿰丿丨}
茭	cf	艹父
徼	rf	彳方
鹪	rn	亻鸟
敫	bw	白攵
噍	kh	口灬
僬	rh	亻灬
峧	uf	山父
滘	dk	氵口
燋	hh	火灬
藠	cb	艹白
皦	bw	白攵
斠	fd	𠀎斗
璬	ww	𤣩攵
皭	bc	白寸
恔	xf	忄父
䴔	wn	亠鸟
漖	dw	氵攵
接	fn	扌女
解	dn	⺈牛
姐	nq	女且
结	sk	纟口
界	tj	田介
节	ce	艹𰆊
杰	mh	木灬
街	rt	彳土
借	ro	亻日
介	rl	𠆢{⿰丿丨}
阶	ej	⻖介
洁	dk	氵口
戒	gc	戈廾
皆	bb	匕白
劫	ql	去力
截	gv	戈{隹右}
捷	fz	扌龰
揭	fr	扌人
竭	lr	立人
届	uy	尸由
婕	nz	女龰
睫	oz	目龰
诫	yc	讠廾
桀	xm	夕木
芥	cj	艹介
桔	mk	木口
诘	yk	讠口
颉	ty	士页
嗟	kg	口工
孑	la	了㇀
羯	yr	羊人
拮	fk	扌口
秸	hk	禾口
玠	wj	𤣩介
碣	ur	石人
讦	yg	讠干
疥	bj	疒介
喈	kb	口白
蚧	ij	虫介
疖	be	疒𰆊
絜	fx	丰糸
檞	mn	木牛
劼	tl	士力
骱	gj	冎介
鲒	yk	鱼口
褯	pj	衤巾
湝	db	氵白
岊	bu	巴山
楷	mb	木白
㛃	fn	丰女
悈	xc	忄廾
蜐	il	虫力
进	zj	⻌井
今	rv	𠆢㇇
金	rb	𠆢丷
紧	lx	丨糸
近	zj	辶斤
尽	id	尺⺀
仅	ry	亻又
禁	mu	木示
劲	jl	𢀖力
锦	jj	钅巾
巾	kl	冂丨
筋	vl	竹力
津	dy	氵聿
晋	yo	亚日
斤	il	𠂆丨
谨	yw	讠王
浸	dy	氵又
襟	pu	衤示
矜	mv	矛㇇
瑾	ww	𤣩王
烬	hd	火⺀
靳	gj	革斤
噤	ku	口示
觐	cj	廿见
妗	nv	女㇇
缙	so	纟日
堇	cw	廿王
槿	mw	木王
衿	pv	衤㇇
荩	cd	艹⺀
馑	uw	饣王
卺	lv	了㔾
瑨	wo	𤣩日
廑	gw	广王
琎	wj	𤣩井
赆	bd	贝⺀
溍	do	氵日
祲	py	礻又
浕	dd	氵⺀
墐	tw	土王
殣	dw	歹王
珒	wy	𤣩聿
𬬱	jj	钅斤
经	sj	纟𢀖
惊	xx	忄小
竟	le	立儿
静	fy	龶{肀亅}
精	mo	米⺝
睛	oo	目⺝
警	ck	艹口
京	wx	亠小
境	te	土儿
景	ox	日小
敬	cw	艹攵
镜	je	钅儿
晶	oo	日日
净	dy	冫{肀亅}
径	rj	彳𢀖
竞	lx	立兄
井	ca	廾一
靖	lo	立⺝
荆	cd	艹刂
菁	co	艹⺝
阱	ej	⻖井
兢	ux	十兄
憬	xx	忄小
婧	no	女⺝
鲸	yx	鱼小
茎	cj	艹𢀖
丼	jd	井丶
旌	fu	方生
痉	bj	疒𢀖
泾	dj	氵𢀖
迳	zj	辶𢀖
璟	wx	𤣩小
胫	oj	⺼𢀖
儆	rw	亻攵
靓	fj	龶见
粳	mg	米更
獍	qe	犭儿
刭	jd	𢀖刂
腈	oo	⺼⺝
肼	oj	⺼井
倞	rx	亻小
璥	ww	𤣩攵
麖	lx	鹿小
鼱	jo	臼⺝
猄	qx	犭小
䴖	fn	龶鸟
汫	dj	氵井
竫	ly	立{肀亅}
囧	kk	囗{囗-一}
炯	hk	火口
窘	bk	宀口
迥	zk	辶口
颎	by	匕页
扃	hk	户口
冏	kk	冂口
坰	tk	土口
泂	dk	氵口
䌹	sk	⺰口
𬳶	mk	马口
就	wy	亠尤
酒	dy	氵酉
久	dn	⺈乀
九	pv	丿㇈
究	bj	宀九
救	qw	求攵
旧	lo	丨日
舅	jl	臼力
纠	sj	纟丩
疚	bj	疒久
揪	fh	扌火
咎	wk	夂口
鹫	wn	亠鸟
鸠	jn	九鸟
啾	kh	口火
臼	pa	丿一
灸	jh	久火
赳	tj	土丩
厩	iw	厂旡
柩	mj	木久
玖	wj	𤣩久
韭	fa	非一
阄	md	门电
僦	ry	亻尤
鬏	eh	E火
桕	mj	木臼
氿	dj	氵九
㠇	uy	山尤
巨	kk	匚コ
举	xf	𭕄𰀁
居	ug	尸古
局	uk	尸口
具	qb	{具-八}八
据	fg	扌古
聚	eu	耳{水}
剧	ud	尸刂
距	zj	𧾷巨
惧	xb	忄八
拒	fj	扌巨
俱	rb	亻八
矩	uj	矢巨
菊	cm	艹米
拘	fj	扌句
沮	dq	氵且
鞠	gm	革米
狙	qq	犭且
橘	mk	木口
驹	mj	马句
飓	fb	风八
锯	jg	钅古
咀	kq	口且
踞	zg	𧾷古
炬	hj	火巨
掬	fm	扌米
遽	zu	辶豕
倨	rg	亻古
雎	qv	且{隹右}
钜	jj	钅巨
踽	zy	𧾷禹
裾	pg	衤古
琚	wg	𤣩古
疽	bq	疒且
莒	ck	艹口
車	uu	十十
龃	vq	止且
苣	cj	艹巨
榉	mf	木𰀁
讵	yj	讠巨
苴	cq	艹且
鞫	gk	革口
焗	hk	火口
椐	mg	木古
锔	jk	钅口
筥	vk	竹口
屦	un	尸女
窭	bn	宀女
醵	yu	酉豕
蒟	cj	艹句
犋	nb	牜八
澽	du	氵豕
娵	ny	女又
秬	hj	禾巨
崌	ug	山古
岠	uj	山巨
砠	uq	石且
腒	og	⺼古
弆	qc	去廾
泃	dj	氵句
岨	uq	山且
趄	tq	土且
䴗	on	目鸟
𬶋	yj	鱼句
卷	jv	龹㔾
娟	no	女⺝
倦	rv	亻㔾
捐	fo	扌⺝
眷	jo	龹目
绢	so	纟⺝
鹃	kn	口鸟
涓	do	氵⺝
圈	kv	囗㔾
隽	rn	亻乃
镌	jn	钅乃
蠲	bi	丷虫
狷	qo	犭⺝
鄄	xe	覀⻏
锩	jv	钅㔾
桊	jm	龹木
焆	ho	火⺝
绝	sb	纟巴
决	dg	冫夬
爵	vc	爫寸
诀	yg	讠夬
掘	fi	扌出
厥	iq	厂欠
倔	ri	亻出
撅	fq	扌欠
珏	wy	𤣩玉
崛	ui	山出
抉	fg	扌夬
噘	kq	口欠
攫	fy	扌又
谲	yk	讠口
獗	qq	犭欠
蹶	zq	𧾷欠
傕	rv	亻{隹右}
蕨	cq	艹欠
矍	oy	目又
橛	mq	木欠
镢	jq	钅欠
玦	wg	𤣩夬
孓	ln	了乀
桷	my	木用
觖	dg	⺈夬
爝	hc	火寸
劂	id	厂刂
玃	qy	犭又
砄	ug	石夬
㵐	dq	氵欠
𫔎	jk	钅口
𫘝	mg	马夬
均	ty	土匀
君	yk	尹口
军	bi	冖车
俊	rw	亻夂
郡	ye	尹⻏
峻	uw	山夂
钧	jy	钅匀
骏	mw	马夂
菌	ch	艹禾
竣	lw	立夂
浚	dw	氵夂
珺	wk	𤣩口
麇	lh	鹿禾
皲	bp	冖皮
焌	hw	火夂
葰	cw	艹夂
捃	fk	扌口
畯	tw	田夂
莙	ck	艹口
晙	ow	日夂
筠	vy	竹匀
鲪	yk	鱼口
䐃	oh	⺼禾
卡	ub	上卜
喀	kk	口口
咔	kb	口卜
胩	ob	⺼卜
开	ac	一廾
凯	uj	山几
慨	xw	忄旡
铠	jj	钅己
恺	xj	忄己
揩	fb	扌白
锴	jb	钅白
忾	xq	忄气
闿	mj	门己
剀	ud	山刂
垲	tj	土己
锎	jk	钅开
炌	hj	火介
蒈	cb	艹白
看	uo	龵目
堪	tb	土八
砍	uq	石欠
刊	gd	干刂
侃	ri	亻𫶧
坎	tq	土欠
勘	cl	卄力
阚	mw	门攵
瞰	ow	目攵
龛	rl	𠆢龙
戡	cg	卄戈
崁	uq	山欠
莰	cq	艹欠
衎	rg	彳干
磡	ul	石力
嵁	ub	山八
墈	tl	土力
抗	fj	扌几
康	gl	广隶
亢	wj	亠几
炕	hj	火几
慷	xl	忄隶
糠	ml	米隶
伉	rj	亻几
钪	jj	钅几
闶	mj	门几
𡐓	tl	土隶
𩾌	yl	鱼隶
靠	nf	⺧非
考	lk	耂丂
烤	hk	火丂
铐	jk	钅丂
拷	fk	扌丂
犒	nk	牜口
尻	uj	尸九
栲	mk	木丂
㸆	hf	火非
洘	dk	氵丂
可	dk	丁口
刻	wd	亠刂
克	ux	十兄
客	bk	宀口
科	hd	禾斗
课	yg	讠果
颗	gy	果页
渴	dr	氵人
柯	mk	木可
棵	mg	木果
壳	tj	士几
氪	qx	气兄
磕	um	石皿
嗑	km	口皿
珂	wk	𤣩可
苛	ck	艹可
轲	ik	车可
瞌	om	目皿
坷	tk	土可
恪	xk	忄口
蝌	id	虫斗
颏	wy	亠页
窠	bg	宀果
稞	hg	禾果
溘	dm	氵皿
疴	bk	疒可
岢	uk	山可
锞	jg	钅果
髁	gg	冎果
骒	mg	马果
缂	sg	纟革
牁	pk	爿可
匼	kk	匚口
炣	hk	火可
剋	ud	十刂
肯	vo	止⺝
恳	gx	艮心
啃	ko	口⺝
垦	gt	艮土
裉	pg	衤艮
坑	tj	土几
铿	jt	钅土
硁	uj	石𢀖
空	bg	宀工
恐	gx	工心
控	fg	扌工
孔	zv	子乚
崆	ug	山工
箜	vg	竹工
倥	rg	亻工
硿	ug	石工
埪	tg	土工
口	la	丨一
扣	fk	扌口
寇	by	宀又
叩	ke	口卩
抠	fq	扌区
蔻	cy	艹又
芤	cv	艹乚
筘	vk	竹口
眍	oq	目区
𫸩	gq	弓区
苦	cg	艹古
哭	kq	口犬
酷	yk	酉口
库	gi	广车
裤	pi	衤车
枯	mg	木古
骷	gg	冎古
窟	bi	宀出
绔	sk	纟丂
喾	xk	𰃮口
刳	dd	大刂
矻	uv	石乙
圐	kf	囗方
夸	dk	大丂
跨	zk	𧾷丂
垮	tk	土丂
胯	ok	⺼丂
挎	fk	扌丂
侉	rk	亻丂
姱	nk	女丂
快	xg	忄夬
块	tg	土夬
筷	vg	竹夬
蒯	cd	艹刂
哙	ky	口云
侩	ry	亻云
脍	oy	⺼云
狯	qy	犭云
郐	re	𠆢⻏
鲙	yy	鱼云
㧟	fk	扌匚
宽	bj	宀见
款	tq	士欠
髋	gj	冎见
况	dx	冫兄
狂	qw	犭王
矿	ug	石广
旷	og	日广
眶	ow	目王
框	mw	木王
匡	kw	匚王
筐	vw	竹王
哐	kw	口王
邝	ge	广⻏
诳	yw	讠王
诓	yw	讠王
圹	tg	土广
纩	sg	纟广
贶	bx	贝兄
夼	di	大川
洭	dw	氵王
𫛭	qn	犭鸟
亏	ak	一丂
愧	xg	忄鬼
盔	um	𠂇皿
魁	gd	鬼斗
窥	bj	宀见
奎	dt	大土
葵	ct	艹天
傀	rg	亻鬼
睽	ot	目天
馈	ub	饣贝
逵	zt	辶土
馗	jz	九自
匮	kb	匚贝
喟	ko	口⺝
夔	bw	丷夂
篑	vb	竹贝
岿	ue	山彐
揆	ft	扌天
聩	eb	耳贝
跬	zt	𧾷土
愦	xb	忄贝
悝	xl	忄里
蝰	it	虫土
暌	ot	日天
蒉	cb	艹贝
櫆	md	木斗
骙	mt	马天
喹	kt	口土
煃	ht	火土
戣	bg	癶戈
𫠆	vy	支页
困	km	囗木
昆	ob	日匕
坤	tu	土申
捆	fm	扌木
鲲	yb	鱼匕
琨	wb	𤣩匕
锟	jb	钅匕
髡	ew	E兀
阃	mm	门木
悃	xm	忄木
堃	ft	方土
焜	hb	火匕
壸	ty	士业
鹍	on	日鸟
裈	pi	衤车
醌	yb	酉匕
婫	nb	女匕
括	fu	扌舌
扩	fg	扌广
阔	mu	门舌
廓	ge	广⻏
蛞	iu	虫舌
啦	kl	口立
拉	fl	扌立
辣	xu	辛束
垃	tl	土立
腊	oo	⺼日
喇	kd	口刂
蜡	io	虫日
落	ck	艹口
剌	ud	束刂
邋	zv	辶{鼠下}
旯	oj	日九
瘌	bd	疒刂
砬	ul	石立
镴	jv	钅{鼠下}
蝲	id	虫刂
鞡	gl	革立
𬶟	yd	鱼刂
来	am	一木
莱	cl	艹来
赖	ub	束贝
籁	vb	竹贝
睐	ol	目来
癞	bb	疒贝
濑	db	氵贝
徕	rl	彳来
崃	ul	山来
涞	dl	氵来
赉	lb	来贝
俫	rl	亻来
铼	jl	钅来
梾	ml	木来
蓝	cm	艹皿
烂	hl	火兰
懒	xb	忄贝
拦	fl	扌兰
篮	vm	竹皿
岚	uf	山风
兰	bs	丷三
栏	ml	木兰
览	lj	丨见
澜	dj	氵柬
揽	fj	扌见
滥	dm	氵皿
婪	mn	木女
阑	mj	门柬
榄	mj	木见
斓	wj	文柬
缆	sj	纟见
褴	pm	衤皿
谰	yj	讠柬
罱	sg	罒干
襕	pj	衤柬
镧	jj	钅柬
漤	dn	氵女
𬒗	uj	石见
狼	ql	犭良
浪	dl	氵良
郎	le	良⻏
朗	lo	良月
廊	ge	广⻏
螂	ie	虫⻏
琅	wl	𤣩良
啷	ke	口⻏
榔	me	木⻏
锒	jl	钅良
阆	ml	门良
烺	hl	火良
蒗	cl	艹良
莨	cl	艹良
稂	hl	禾良
崀	ul	山良
㫰	ol	日良
㮾	lm	良木
埌	tl	土良
塱	lt	良土
桹	ml	木良
筤	vl	竹良
蓢	co	艹月
老	lb	耂匕
劳	cl	艹力
牢	bn	宀牛
姥	nl	女老
捞	fl	扌力
唠	kl	口力
佬	rl	亻老
烙	hk	火口
酪	yk	酉口
涝	dl	氵力
崂	ul	山力
嫪	np	女彡
痨	bl	疒力
醪	yp	酉彡
栳	ml	木老
铑	jl	钅老
耢	ll	耒力
荖	cl	艹老
铹	jl	钅力
络	sk	纟口
𫭼	tl	土力
了	al	乛亅
乐	px	丿小
勒	gl	革力
叻	kl	口力
泐	dl	氵力
鳓	yl	鱼力
仂	rl	亻力
簕	vl	竹力
嘞	kl	口力
雷	yt	雨田
类	md	米大
泪	do	氵目
累	tx	田糸
蕾	ct	艹田
磊	uu	石石
垒	st	厶土
擂	ft	扌田
肋	ol	⺼力
儡	rt	亻田
镭	jt	钅田
羸	wy	亡羊
檑	mt	木田
耒	fr	丰人
诔	yl	讠耒
嫘	nx	女糸
酹	yc	酉寸
缧	sx	纟糸
礌	ut	石田
罍	tf	田缶
藟	ct	艹田
癗	bt	疒田
冷	ds	冫龴
愣	xf	忄方
楞	mf	木方
棱	mw	木夂
塄	tf	土方
崚	uw	山夂
堎	tw	土夂
里	tt	田土
力	vp	𠃌丿
理	wl	𤣩里
李	mz	木子
立	wb	亠䒑
离	wn	亠禸
利	hd	禾刂
梨	hm	禾木
丽	ad	一丶
历	il	厂力
礼	pv	礻乚
厉	iw	厂万
例	rd	亻刂
莉	cd	艹刂
黎	hu	禾氺
璃	wn	𤣩禸
励	il	厂力
哩	kl	口里
狸	ql	犭里
粒	ml	米立
隶	yu	肀水
吏	gn	古乀
栗	xm	覀木
漓	dn	氵禸
雳	yl	雨力
厘	il	厂里
俐	rd	亻刂
笠	vl	竹立
沥	dl	氵力
篱	vn	竹禸
戾	hq	户犬
鲤	yl	鱼里
犁	hn	禾牛
砾	ul	石乐
荔	cl	艹力
砺	uw	石万
郦	le	丽⻏
藜	cu	艹氺
骊	md	马丶
俪	rd	亻丶
鹂	ln	丽鸟
蠡	hi	彑虫
栎	ml	木乐
唳	kq	口犬
喱	kl	口里
罹	sv	罒{隹右}
痢	bd	疒刂
莅	cl	艹立
俚	rl	亻里
逦	zd	⻌丶
呖	kl	口力
蛎	iw	虫万
猁	qd	犭刂
澧	db	氵䒑
醴	yb	酉䒑
娌	nl	女里
蓠	cn	艹禸
詈	sk	⺫口
黧	hh	禾灬
蜊	id	虫刂
缡	sn	纟禸
傈	rm	亻木
枥	ml	木力
溧	dm	氵木
坜	tl	土力
疠	bw	疒万
粝	mw	米万
嫠	wn	未女
锂	jl	钅里
篥	vm	竹木
轹	il	车乐
鲡	yd	鱼丶
疬	bl	疒力
苈	cl	艹力
浬	dl	氵里
跞	zl	𧾷乐
浰	dd	氵刂
鳢	yb	鱼䒑
醨	yn	酉禸
凓	dm	冫木
朸	ml	木力
㰀	mu	木氺
珕	wl	𤣩力
𫵷	ul	山力
𬍛	wl	𤣩乐
俩	rl	亻两
连	zi	⻌车
脸	oq	⺼佥
联	et	耳天
练	sd	纟𫠣
恋	wx	亠心
怜	xs	忄龴
炼	hd	火𫠣
莲	ci	艹车
链	ji	钅车
帘	bj	宀巾
廉	gj	广兼
敛	qw	佥攵
涟	di	氵车
镰	jj	钅兼
琏	wi	𤣩车
濂	dj	氵兼
潋	dw	氵攵
殓	dq	歹佥
奁	dq	大区
裢	pi	衤车
楝	mj	木柬
裣	pq	衤佥
鲢	yi	鱼车
梿	mi	木车
蠊	ij	虫兼
蔹	cw	艹攵
瑓	wj	𤣩柬
𬶠	yj	鱼柬
两	ar	一人
量	ol	日里
亮	wj	亠几
良	dg	丶艮
凉	dx	冫小
梁	dm	氵木
辆	il	车两
粮	ml	米良
谅	yx	讠小
踉	zl	𧾷良
晾	ox	日小
粱	dm	氵米
魉	gl	鬼两
椋	mx	木小
辌	ix	车小
墚	tm	土木
悢	xl	忄良
俍	rl	亻良
𫟅	sx	纟小
𬜯	cl	艹两
聊	ee	耳卩
料	md	米斗
疗	bl	疒了
辽	zl	辶了
廖	gp	广彡
撩	fx	扌小
寥	bp	宀彡
僚	rx	亻小
缭	sx	纟小
燎	hx	火小
撂	fk	扌口
獠	qx	犭小
潦	dx	氵小
镣	jx	钅小
嘹	kx	口小
瞭	ox	目小
寮	bx	宀小
蓼	cp	艹彡
尥	yu	尢勺
鹩	dn	大鸟
嫽	nx	女小
髎	gp	冎彡
钌	jl	钅了
蹽	zx	𧾷小
漻	dp	氵彡
憭	xx	忄小
簝	vx	竹小
橑	mx	木小
𪤗	tp	土彡
列	dd	歹刂
裂	dy	歹衣
猎	qo	犭日
咧	kd	口刂
烈	dh	歹灬
劣	ul	少力
冽	dd	冫刂
趔	td	土刂
洌	dd	氵刂
鬣	ev	E{鼠下}
捩	fq	扌犬
埒	tc	土寸
躐	zv	𧾷{鼠下}
峛	ud	山刂
脟	oc	⺼寸
䴕	dn	歹鸟
𫚭	yv	鱼{鼠下}
林	mm	木木
临	lk	〢𫩏
琳	wm	𤣩木
淋	dm	氵木
邻	re	𠆢⻏
麟	lf	鹿㐄
凛	du	冫示
拎	fs	扌龴
霖	ym	雨木
鳞	yf	鱼㐄
吝	wk	文口
躏	zv	𧾷{隹右}
粼	mv	米巜
磷	uf	石㐄
嶙	uf	山㐄
蔺	cv	艹{隹右}
赁	rb	亻贝
懔	xu	忄示
辚	if	车㐄
遴	zf	辶㐄
廪	gu	广示
潾	df	氵㐄
檩	mu	木示
璘	wf	𤣩㐄
啉	km	口木
瞵	of	目㐄
膦	of	⺼㐄
翷	mx	米习
箖	vm	竹木
𬭸	jf	钅㐄
𬴊	mf	马㐄
令	rs	𠆢龴
灵	eh	彐火
领	ry	𠆢页
另	kl	口力
凌	dw	冫夂
玲	ws	𤣩龴
零	ys	雨龴
龄	vs	止龴
铃	js	钅龴
陵	ew	⻖夂
岭	us	山龴
菱	cw	艹夂
伶	rs	亻龴
聆	es	耳龴
翎	rx	𠆢习
绫	sw	纟夂
〇	vv	〇〇
羚	ys	羊龴
呤	ks	口龴
苓	cs	艹龴
泠	ds	氵龴
棂	mh	木火
瓴	rw	𠆢瓦
酃	ye	雨⻏
囹	ks	囗龴
鲮	yw	鱼夂
蛉	is	虫龴
鸰	rn	𠆢鸟
柃	ms	木龴
舲	vs	舟龴
澪	ds	氵龴
昤	os	日龴
祾	pw	礻夂
姈	ns	女龴
㥄	xw	忄夂
坽	ts	土龴
流	di	氵𫶧
刘	wd	文刂
留	pt	{丿𠄌丶}田
六	wb	亠八
柳	me	木卩
溜	dt	氵田
琉	wi	𤣩𫶧
榴	mt	木田
浏	dd	氵刂
瘤	bt	疒田
硫	ui	石𫶧
遛	zt	辶田
陆	ej	⻖击
绺	sk	纟口
鎏	dj	氵金
馏	ut	饣田
骝	mt	马田
镏	jt	钅田
旒	fi	方𫶧
镠	jp	钅彡
锍	ji	钅𫶧
熘	ht	火田
鹨	xn	习鸟
飗	ft	风田
瑬	dy	氵玉
珋	we	𤣩卩
罶	st	罒田
鹠	pn	{丿𠄌丶}鸟
疁	tp	田彡
碌	uu	石⺢
龙	yp	尤丿
隆	eu	⻖生
笼	vl	竹龙
拢	fl	扌龙
胧	ol	⺼龙
珑	wl	𤣩龙
咙	kl	口龙
聋	le	龙耳
垄	lt	龙土
窿	bu	宀生
陇	el	⻖龙
泷	dl	氵龙
茏	cl	艹龙
眬	ol	目龙
栊	ml	木龙
砻	lu	龙石
哢	kc	口廾
昽	ol	日龙
癃	bu	疒生
漋	du	氵生
弄	wc	王廾
𬕂	vb	竹贝
楼	mn	木女
搂	fn	扌女
漏	dy	氵雨
髅	gn	冎女
露	yk	雨口
陋	en	⻖内
喽	kn	口女
娄	mn	米女
篓	vn	竹女
镂	jn	钅女
偻	rn	亻女
蝼	in	虫女
耧	ln	耒女
蒌	cn	艹女
瘘	bn	疒女
嵝	un	山女
溇	dn	氵女
䁖	on	目女
剅	dd	豆刂
𦝼	on	⺼女
𪣻	tn	土女
路	zk	𧾷口
鲁	yo	鱼日
录	eu	彐⺢
撸	fo	扌日
卢	bu	⺊尸
鹿	gb	广匕
炉	hh	火户
芦	ch	艹户
禄	pu	礻⺢
虏	hl	虍力
璐	wk	𤣩口
噜	ko	口日
戮	xg	习戈
颅	by	⺊页
庐	gh	广户
漉	dl	氵鹿
掳	fl	扌力
辘	il	车鹿
赂	bk	贝口
麓	ml	木鹿
卤	bx	⺊㐅
鹭	zn	𧾷鸟
泸	du	氵尸
潞	dk	氵口
橹	mo	木日
辂	ik	车口
箓	vu	竹⺢
胪	ou	⺼尸
鲈	yu	鱼尸
轳	iu	车尸
垆	tu	土尸
渌	du	氵⺢
逯	zu	辶⺢
鸬	bn	⺊鸟
甪	py	丿用
蕗	ck	艹口
舻	vu	舟尸
栌	mu	木尸
簏	vl	竹鹿
菉	cu	艹⺢
氇	mo	毛日
僇	rp	亻彡
琭	wu	𤣩⺢
镥	jo	钅日
勠	xl	习力
稑	ht	禾土
绿	su	纟⺢
澛	do	氵日
𫘧	mu	马⺢
𬬻	ju	钅尸
乱	uv	舌乚
卵	pd	𠂎丶
鸾	wn	亠鸟
峦	wu	亠山
挛	wu	亠手
銮	wj	亠金
孪	wz	亠子
栾	wm	亠木
滦	dm	氵木
脔	wr	亠肉
娈	wn	亠女
论	yl	讠仑
伦	rl	亻仑
轮	il	车仑
仑	rb	𠆢匕
沦	dl	氵仑
抡	fl	扌仑
囵	kl	囗仑
𫭢	tl	土仑
𬬭	jl	钅仑
罗	sx	罒夕
洛	dk	氵口
裸	pg	衤果
逻	zx	⻌夕
骆	mk	马口
萝	cx	艹夕
螺	ix	虫糸
锣	jx	钅夕
啰	kx	口夕
珞	wk	𤣩口
骡	mx	马糸
摞	fx	扌糸
雒	wv	夂{隹右}
荦	cn	艹牛
箩	vx	竹夕
椤	mx	木夕
猡	qx	犭夕
蠃	wi	亡虫
脶	on	⺼内
漯	dx	氵糸
倮	rg	亻果
捋	fc	扌寸
瘰	bx	疒糸
泺	dl	氵乐
蓏	cg	艹瓜
律	ry	彳聿
率	wu	亠十
旅	fy	方{𧘇}
吕	kk	口口
缕	sn	纟女
侣	rk	亻口
驴	mh	马户
屡	un	尸女
履	uw	尸夂
滤	dx	氵心
虑	hx	虍心
褛	pn	衤女
铝	jk	钅口
闾	mk	门口
榈	mk	木口
氯	qu	气⺢
膂	fo	方⺝
稆	hk	禾口
葎	cy	艹聿
垏	ty	土聿
梠	mk	木口
略	tk	田口
掠	fx	扌小
锊	jc	钅寸
䂮	fu	丰石
圙	km	囗面
吗	km	口马
马	va	𠃌一
妈	nm	女马
麻	gm	广木
嘛	km	口木
骂	km	口马
码	um	石马
玛	wm	𤣩马
抹	fw	扌末
蚂	im	虫马
蟆	id	虫大
犸	qm	犭马
杩	mm	木马
祃	pm	礻马
摩	gu	广手
买	ad	乛⺀
卖	ud	十⺀
埋	tl	土里
脉	oy	⺼永
麦	fw	龶夂
迈	zw	⻌万
霾	yl	雨里
劢	wl	万力
唛	kw	口夂
荬	cd	艹⺀
鿏	jw	钅夂
满	dl	氵两
慢	xy	忄又
漫	dy	氵又
曼	oy	⺜又
蛮	wi	亠虫
瞒	ol	目两
蔓	cy	艹又
馒	uy	饣又
幔	jy	巾又
谩	yy	讠又
鳗	yy	鱼又
缦	sy	纟又
嫚	ny	女又
墁	ty	土又
颟	cy	艹页
螨	il	虫两
鞔	ge	革儿
镘	jy	钅又
鬘	ey	E又
𬜬	ck	艹口
忙	xw	忄亡
芒	cw	艹亡
茫	cw	艹亡
氓	wm	亡民
莽	cc	艹廾
盲	wo	亡目
蟒	ic	虫廾
邙	we	亡⻏
漭	dc	氵廾
牤	nw	牜亡
硭	uw	石亡
尨	lp	龙丿
牻	np	牜丿
厖	ip	厂丿
杧	mw	木亡
毛	pv	丿乚
冒	oo	⺜目
貌	ve	豸儿
猫	qt	犭田
矛	yp	予丿
帽	jo	巾目
贸	pb	{丿𠄌丶}贝
茂	cw	艹戊
茅	cm	艹矛
冇	uk	𠂇冂
髦	em	E毛
卯	pe	𠂎卩
锚	jt	钅田
袤	ym	衣矛
瑁	wo	𤣩目
懋	mx	木心
牦	nm	牜毛
铆	je	钅卩
昴	oe	日卩
耄	lm	老毛
蟊	mi	矛虫
峁	ue	山卩
旄	fm	方毛
楙	mm	木木
泖	de	氵卩
瞀	mo	矛目
茆	ce	艹卩
蝥	mi	矛虫
芼	cm	艹毛
眊	om	目毛
鄚	ce	艹⻏
么	ps	丿厶
没	du	氵殳
美	yd	𦍌大
每	pm	𠂉母
妹	nw	女未
眉	uo	𠃜目
梅	mm	木母
媚	no	女目
魅	gw	鬼未
玫	ww	𤣩攵
枚	mw	木攵
媒	nm	女木
霉	ym	雨母
昧	ow	日未
煤	hm	火木
寐	bw	宀未
嵋	uo	山目
莓	cm	艹母
湄	do	氵目
袂	pg	衤夬
楣	mo	木目
酶	ym	酉母
镁	jd	钅大
郿	ue	𠃜⻏
浼	de	氵儿
鹛	un	𠃜鸟
镅	jo	钅目
渼	dd	氵大
糜	gm	广米
媄	nd	女大
瑂	wo	𤣩目
们	rm	亻门
门	dv	丶𠃌
闷	mx	门心
懑	dx	氵心
扪	fm	扌门
焖	hx	火心
钔	jm	钅门
呇	uk	水口
𫞩	wl	𤣩两
梦	mx	木夕
猛	qm	犭皿
蒙	cu	艹豕
孟	zm	子皿
盟	om	日皿
朦	ou	月豕
萌	co	艹月
懵	xo	忄目
檬	mu	木豕
蜢	im	虫皿
勐	zl	子力
虻	iw	虫亡
艨	vu	舟豕
锰	jm	钅皿
幪	ju	巾豕
艋	vm	舟皿
蠓	iu	虫豕
瞢	co	艹目
甍	cw	艹瓦
獴	qu	犭豕
礞	uu	石豕
㠓	uu	山豕
鹲	cn	艹鸟
𫑡	ke	口⻏
密	bu	宀山
米	bm	丷木
迷	zm	辶米
弥	gx	弓小
蜜	bi	宀虫
眯	om	目米
咪	km	口米
谜	ym	讠米
觅	vj	爫见
靡	gf	广非
谧	ym	讠皿
祢	px	礻小
芈	cf	卝𰀁
麋	lm	鹿米
弭	ge	弓耳
汨	do	氵日
猕	qx	犭小
幂	bj	冖巾
縻	gx	广糸
蘼	cf	艹非
醚	ym	酉米
祕	pb	礻必
敉	mw	米攵
嘧	ku	口山
蓂	cl	艹六
脒	om	⺼米
洣	dm	氵米
醾	ym	酉米
面	ao	丆{丨丨二}
免	de	⺈儿
勉	dl	⺈力
绵	sj	纟巾
眠	om	目民
棉	mj	木巾
缅	sm	纟面
冕	oe	⺜儿
腼	om	⺼面
娩	ne	女儿
湎	dm	氵面
沔	dg	氵丏
渑	dd	氵电
眄	og	目丏
丏	gl	丐丨
勔	ml	面力
愐	xm	忄面
偭	rm	亻面
𩾃	ye	鱼儿
妙	nu	女少
秒	hu	禾少
描	ft	扌田
苗	ct	艹田
庙	gy	广由
渺	du	氵少
瞄	ot	目田
淼	uu	水水
喵	kt	口田
缈	su	纟少
藐	ce	艹儿
邈	ze	辶儿
眇	ou	目少
杪	mu	木少
鹋	cn	艹鸟
缪	sp	纟彡
灭	ah	一火
蔑	cd	艹丶
乜	vv	𠃌乚
咩	ky	口羊
篾	vd	竹丶
民	vv	𠃍乚
敏	pw	𠂉攵
抿	fm	扌民
悯	xw	忄文
闵	mw	门文
珉	wm	𤣩民
泯	dm	氵民
闽	mi	门虫
皿	ka	冂一
岷	um	山民
旻	ow	日文
缗	so	纟日
愍	mx	民心
湣	do	氵日
黾	kd	口电
忞	wx	文心
鳘	py	𠂉鱼
苠	cm	艹民
明	oo	日月
名	xk	夕口
命	re	𠆢卩
鸣	kn	口鸟
冥	bl	冖六
铭	jk	钅口
茗	ck	艹口
瞑	ol	目六
溟	dl	氵六
酩	yk	酉口
暝	ol	日六
螟	il	虫六
洺	dk	氵口
谬	yp	讠彡
魔	gg	广鬼
莫	cd	艹大
默	lq	{里}犬
模	md	木大
摸	fd	扌大
磨	gu	广石
末	am	一木
漠	dd	氵大
墨	lt	{里}土
麽	gm	广么
陌	eb	⻖百
寞	bd	宀大
蓦	cm	艹马
沫	dw	氵末
膜	od	⺼大
茉	cw	艹末
嬷	nm	女么
蘑	cu	艹石
摹	cu	艹手
馍	ud	饣大
谟	yd	讠大
嫫	nd	女大
秣	hw	禾末
殁	du	歹殳
貊	vb	豸百
靺	gw	革末
貘	vd	豸大
镆	jd	钅大
瘼	bd	疒大
耱	lu	耒石
万	av	丆𠃌
无	ay	一尢
藦	cu	艹手
𬙊	st	纟土
某	gm	甘木
谋	ym	讠木
眸	on	目牛
牟	sn	厶牛
哞	kn	口牛
鍪	mj	矛金
侔	rn	亻牛
蛑	in	虫牛
目	ke	囗二
母	md	{𠃊𠃌一(母-丶丶)}丶
木	ur	十人
慕	cx	艹⺗
幕	cj	艹巾
姆	nm	女母
穆	hp	禾彡
牧	nw	牜攵
墓	ct	艹土
沐	dm	氵木
暮	co	艹日
拇	fm	扌母
牡	nt	牜土
亩	wt	亠田
募	cl	艹力
睦	ot	目土
苜	co	艹目
呒	kw	口无
钼	jo	钅目
毪	mn	毛牛
仫	rm	亻么
𧿹	zm	𧾷母
𬭁	jm	钅母
那	ve	𭃂⻏
哪	ke	口⻏
拿	ru	𠆢手
娜	ne	女⻏
纳	sn	纟内
呐	kn	口内
捺	fu	扌示
衲	pn	衤内
钠	jn	钅内
肭	on	⺼内
镎	ju	钅手
乸	ym	也母
南	ug	十干
𦰡	ce	艹⻏
奶	nn	女乃
奈	du	大示
耐	ec	而寸
乃	vp	𠄎丿
鼐	no	乃目
氖	qn	气乃
萘	cu	艹示
艿	cn	艹乃
柰	mu	木示
佴	re	亻耳
迺	zx	辶西
难	yv	又{隹右}
男	tl	田力
喃	kg	口干
楠	mg	木干
囡	kn	囗女
赧	iy	赤又
腩	og	⺼干
蝻	ig	虫干
萳	cg	艹干
婻	ng	女干
囊	gy	𰀉𧘇
囔	ky	口𧘇
馕	uy	饣𧘇
攮	fy	扌𧘇
曩	ox	日襄
齉	zy	自𧘇
脑	ox	⺼凶
闹	mj	门巾
恼	xx	忄凶
挠	fw	扌兀
瑙	wx	𤣩㐅
孬	bz	不子
呶	ky	口又
淖	du	氵十
猱	qm	犭木
铙	jw	钅兀
垴	tx	土凶
蛲	iw	虫兀
硇	ux	石㐅
臑	oe	⺼而
峱	qu	犭山
呢	kb	口匕
讷	yn	讠内
内	kr	冂人
馁	un	饣女
嫩	nw	女攵
恁	rx	亻心
能	sb	厶匕
你	rx	亻小
尼	ub	尸匕
妮	nb	女匕
泥	db	氵匕
逆	zn	辶屰
拟	fr	扌人
腻	ob	⺼贝
倪	re	亻儿
霓	ye	雨儿
匿	kk	匚口
溺	dg	氵𢎥
昵	ob	日匕
睨	oe	目儿
旎	fb	方匕
怩	xb	忄匕
猊	qe	犭儿
鲵	ye	鱼儿
伲	rb	亻匕
坭	tb	土匕
铌	jb	钅匕
麑	le	鹿儿
薿	cz	艹疋
𨺙	ee	⻖儿
𫐐	ie	车儿
𫠜	ve	止儿
年	pf	𠂉㐄
念	rx	𠆢心
黏	hv	禾占
拈	fv	扌占
捻	fx	扌心
碾	uy	石{𧘇-丿}
撵	fi	扌车
蔫	ch	艹灬
廿	ca	艹一
辇	fi	夫车
鲇	yv	鱼占
鲶	yx	鱼心
埝	tx	土心
粘	mv	米占
娘	nl	女良
酿	yl	酉良
鸟	na	{鸟减一}一
尿	uu	尸水
袅	ny	{鸟减一}衣
茑	cn	艹鸟
脲	ou	⺼水
捏	ft	扌土
聂	ey	耳又
孽	cz	艹子
涅	dt	氵土
蹑	zy	𧾷又
嗫	ky	口又
啮	kr	口人
臬	zm	自木
镊	jy	钅又
镍	jm	钅木
蘖	cm	艹木
颞	ey	耳页
糵	cm	艹米
陧	et	⻖土
嵲	um	山木
菍	cx	艹心
𫔶	mm	门木
您	rx	亻心
宁	bd	宀丁
凝	dz	冫疋
狞	qd	犭丁
拧	fd	扌丁
柠	md	木丁
咛	kd	口丁
泞	dd	氵丁
佞	rn	亻女
甯	by	宀用
苧	cd	艹丁
聍	ed	耳丁
牛	pu	𠂉十
扭	fi	扌丑
纽	si	纟丑
妞	ni	女丑
钮	ji	钅丑
忸	xi	忄丑
狃	qi	犭丑
农	by	冖𧘇
浓	dy	氵𧘇
哝	ky	口𧘇
侬	ry	亻𧘇
脓	oy	⺼𧘇
秾	hy	禾𧘇
𬪩	yy	酉𧘇
耨	lc	耒寸
怒	nx	女心
努	nl	女力
奴	ny	女又
弩	ng	女弓
驽	nm	女马
孥	nz	女子
傉	rc	亻寸
胬	nr	女肉
砮	nu	女石
笯	vy	竹又
暖	oy	日又
诺	yk	讠口
挪	fe	扌⻏
懦	xe	忄而
喏	kk	口口
糯	me	米而
傩	rv	亻{隹右}
搦	fg	扌𢎥
锘	jk	钅口
女	va	𡿨一
钕	jn	钅女
恧	ex	而心
衄	pi	丿丑
虐	he	虍𰀂
疟	be	疒𰀂
噢	kd	口大
喔	kt	口土
欧	qq	区欠
偶	rd	亻丶
呕	kq	口区
殴	qu	区殳
鸥	qn	区鸟
藕	cd	艹丶
区	kx	匚㐅
怄	xq	忄区
瓯	qw	区瓦
讴	yq	讠区
沤	dq	氵区
耦	ld	耒丶
𠙶	kl	凵了
𬉼	hq	火区
怕	xb	忄白
爬	vb	爪巴
帕	jb	巾白
啪	kb	口白
趴	zb	𧾷八
琶	wb	𤣩巴
葩	cb	艹巴
杷	mb	木巴
筢	vb	竹巴
舥	vb	舟巴
潖	db	氵巴
派	dy	氵{𧘇}
排	ff	扌非
拍	fb	扌白
牌	pu	片十
徘	rf	彳非
湃	df	氵丰
俳	rf	亻非
哌	ky	口{𧘇}
簰	vu	竹十
蒎	cy	艹{𧘇}
迫	zb	辶白
盘	vm	舟皿
判	bd	半刂
叛	by	半又
盼	of	目分
潘	dt	氵田
攀	mu	木手
畔	tb	田半
蹒	zl	𧾷两
磐	vu	舟石
蟠	it	虫田
槃	vm	舟木
爿	vl	𠃊丨
泮	db	氵半
袢	pb	衤半
磻	ut	石田
襻	pu	衤手
胖	ob	⺼半
旁	wf	亠方
庞	gl	广龙
彷	rf	彳方
乓	qd	丘丶
螃	if	虫方
滂	df	氵方
逄	zf	辶㐄
雱	yf	雨方
耪	lf	耒方
鳑	yf	鱼方
跑	zb	𧾷包
泡	db	氵包
抛	fl	扌力
袍	pb	衤包
咆	kb	口包
庖	gb	广包
狍	qb	犭包
疱	bb	疒包
匏	db	大包
脬	oz	⺼子
陪	ek	⻖口
配	yj	酉己
佩	rj	亻巾
培	tk	土口
赔	bk	贝口
裴	fy	非衣
沛	du	氵巿
呸	kp	口丕
胚	op	⺼丕
帔	jp	巾皮
辔	sk	纟口
霈	yu	雨巿
旆	fu	方巿
醅	yk	酉口
锫	jk	钅口
衃	pb	丿不
喷	kb	口贝
盆	fm	分皿
湓	dm	氵皿
碰	uy	石业
朋	oo	月月
鹏	on	月鸟
捧	ff	扌𰀁
砰	up	石平
蓬	cf	艹丰
篷	vf	竹丰
彭	tp	士彡
棚	mo	木月
膨	op	⺼彡
澎	dp	氵彡
怦	xp	忄平
嘭	kp	口彡
烹	wh	亠灬
抨	fp	扌平
芃	cf	艹凡
硼	uo	石月
蟛	ip	虫彡
堋	to	土月
椪	my	木业
弸	go	弓月
淜	do	氵月
皮	py	{乛丿丨}又
批	fb	扌匕
屁	ub	尸匕
疲	bp	疒皮
匹	ke	匚儿
劈	ud	尸刀
披	fp	扌皮
脾	ou	⺼十
啤	ku	口十
僻	rx	亻辛
霹	yx	雨辛
痞	bk	疒口
譬	uk	尸口
噼	kx	口辛
琵	wb	𤣩匕
癖	bx	疒辛
媲	nb	女匕
丕	ba	不一
毗	tb	田匕
坯	tp	土丕
纰	sb	纟匕
睥	ou	目十
邳	be	不⻏
砒	ub	石匕
貔	vb	豸匕
枇	mb	木匕
罴	sh	罒灬
圮	tj	土己
鼙	tu	士十
蚍	ib	虫匕
铍	jp	钅皮
郫	pe	{卑上}⻏
仳	rb	亻匕
伾	rp	亻丕
蜱	iu	虫十
埤	tu	土十
嚭	tk	士口
陴	eu	⻖十
淠	dw	氵丌
甓	uw	尸瓦
狉	qp	犭丕
澼	dx	氵辛
鲏	yp	鱼皮
䴙	un	尸鸟
苉	cp	艹匹
𬳵	mp	马丕
片	pv	丿𠃍
偏	rc	亻卄
骗	mc	马卄
篇	vc	竹卄
翩	hx	户习
骈	mk	马开
蹁	zc	𧾷卄
谝	yc	讠卄
胼	ok	⺼开
犏	nc	牜卄
楩	mg	木更
㛹	ng	女更
𡎚	tc	土卄
飘	xf	覀风
漂	du	氵示
票	xu	覀示
瞟	ou	目示
嫖	nu	女示
瓢	xg	覀瓜
缥	su	纟示
剽	xd	覀刂
朴	mb	木卜
殍	dz	歹子
嘌	ku	口示
螵	iu	虫示
蔈	cu	艹示
薸	cu	艹示
撇	fw	扌攵
瞥	xo	⺌目
苤	cp	艹丕
氕	qp	气丿
𬭯	jw	钅攵
品	kk	口口
拼	fk	扌开
贫	fb	分贝
频	vy	止页
聘	ek	耳丂
嫔	nb	女八
颦	vu	止十
姘	nk	女开
牝	nb	牜匕
玭	wb	𤣩匕
𬞟	cy	艹页
平	au	一十
凭	rj	亻几
评	yp	讠平
瓶	bw	丷瓦
萍	cp	艹平
苹	cp	艹平
坪	tp	土平
乒	qp	丘丿
娉	nk	女丂
枰	mp	木平
鲆	yp	鱼平
俜	rk	亻丂
泙	dp	氵平
洴	dk	氵开
帡	jk	巾开
荓	ck	艹开
蚲	ip	虫平
涄	dk	氵丂
玶	wp	𤣩平
破	up	石皮
婆	dn	氵女
颇	py	皮页
坡	tp	土皮
魄	bg	白鬼
泼	dy	氵又
珀	wb	𤣩白
叵	kk	匚口
鄱	ce	釆⻏
粕	mb	米白
笸	vk	竹口
皤	bt	白田
钋	jb	钅卜
钷	jk	钅口
桲	mz	木子
䥽	jy	钅又
酦	yy	酉又
剖	ld	立刂
抔	fb	扌不
裒	yj	衣臼
掊	fk	扌口
普	bo	丷日
扑	fb	扌卜
铺	jf	钅甫
仆	rb	亻卜
谱	yo	讠日
葡	cf	艹甫
菩	ck	艹口
噗	kf	口夫
浦	df	氵甫
蒲	cf	艹甫
濮	df	氵夫
璞	wf	𤣩夫
圃	kf	囗甫
溥	dc	氵寸
匍	bf	勹甫
莆	cf	艹甫
蹼	zf	𧾷夫
氆	mo	毛日
潽	do	氵日
酺	yf	酉甫
镨	jo	钅日
镤	jf	钅夫
蒱	cf	艹甫
墣	tf	土夫
穙	hf	禾夫
起	tj	土己
气	pv	𠂉⺄
其	cb	卄八
七	av	一乚
器	kk	口口
骑	mk	马可
齐	wl	文{⿰丿丨}
弃	wc	亠廾
妻	un	{十⺕}女
企	rv	𠆢止
启	hk	户口
旗	fb	方八
欺	cq	卄欠
岂	uj	山己
汽	dq	氵气
棋	mb	木八
琪	wb	𤣩八
泣	dl	氵立
凄	dn	冫女
漆	du	氵氺
戚	wx	戊小
契	fd	丰大
乞	pv	𠂉乙
祈	pj	礻斤
麒	lb	鹿八
歧	vv	止支
琦	wk	𤣩可
祁	pe	礻⻏
绮	sk	纟可
栖	mx	木西
炁	wh	旡灬
淇	db	氵八
崎	uk	山可
砌	ud	石刀
蹊	zd	𧾷大
祺	pb	礻八
迄	zv	辶乙
杞	mj	木己
岐	uv	山支
脐	oq	⺼齐
颀	jy	斤页
沏	dd	氵刀
跂	zv	𧾷支
憩	ux	舌心
萋	cn	艹女
嘁	kx	口小
耆	lo	老日
芑	cj	艹己
蜞	ib	虫八
讫	yv	讠乙
祇	pu	礻氏
鳍	yo	鱼日
亓	aw	一丌
葺	ce	艹耳
柒	dm	氵木
綦	cx	卄糸
蕲	cj	艹斤
畦	tt	田土
芪	cu	艹氏
圻	tj	土斤
萁	cb	艹八
骐	mb	马八
欹	dq	大欠
碛	ub	石贝
汔	dv	氵乙
锜	jk	钅可
槭	mx	木小
蛴	iq	虫齐
屺	uj	山己
玘	wj	𤣩己
桤	mj	木己
埼	tk	土可
棨	hm	户木
郪	ue	{十⺕}⻏
磜	uu	石示
鲯	yb	鱼八
愭	xo	忄日
碶	ud	石大
俟	ru	亻矢
婍	nk	女可
洓	du	氵朿
䓫	ck	艹可
𨙸	ve	支⻏
𬨂	iu	车氏
恰	xk	忄口
掐	fj	扌臼
洽	dk	氵口
拤	fb	扌卜
葜	cd	艹大
袷	pk	衤口
髂	gk	冎口
前	bd	丷刂
钱	jj	钅戋
千	pu	丿十
潜	do	氵曰
牵	dn	大牛
倩	ro	亻⺝
浅	dj	氵戋
签	vq	竹佥
歉	jq	兼欠
欠	dr	⺈人
乾	uv	十乙
谦	yj	讠兼
迁	zq	辶千
遣	zl	辶㠯
茜	cx	艹西
芊	cq	艹千
嵌	uq	山欠
虔	hw	虍文
铅	jk	钅口
谴	yl	讠㠯
钳	jg	钅甘
黔	lv	{里}㇇
堑	it	车土
骞	bm	宀马
佥	ra	𠆢一
仟	rq	亻千
缱	sl	纟㠯
纤	sq	纟千
阡	eq	⻖千
钎	jq	钅千
钤	jv	钅㇇
掮	fo	扌⺝
芡	cq	艹欠
荨	cc	艹寸
扦	fq	扌千
愆	rx	彳心
悭	xt	忄土
搴	bu	宀手
慊	xj	忄兼
褰	by	宀衣
汧	dk	氵开
肷	oq	⺼欠
蒨	co	艹⺝
靬	gg	革干
椠	im	车木
杄	mq	木千
鹐	dn	⺈鸟
岍	uk	山开
圲	tq	土千
伣	rj	亻见
墘	tv	土乙
磏	uj	石兼
𬘬	so	纟⺝
枪	mv	木㔾
墙	tk	土口
抢	fv	扌㔾
腔	og	⺼工
呛	kv	口㔾
跄	zv	𧾷㔾
蔷	ck	艹口
锵	jc	钅寸
羌	yv	⺶乚
戕	pg	爿戈
戗	rg	𠆢戈
襁	pi	衤虫
嫱	nk	女口
樯	mk	木口
镪	ji	钅虫
炝	hv	火㔾
羟	yj	羊𢀖
蜣	iv	虫乚
玱	wv	𤣩㔾
锖	jo	钅⺝
蔃	ci	艹虫
巧	gk	工丂
悄	xo	忄⺝
瞧	oh	目灬
敲	wy	亠又
桥	ml	木{⿰丿丨}
乔	yl	夭{⿰丿丨}
俏	ro	亻⺝
翘	yx	𫠠习
窍	bk	宀丂
鞘	go	革⺝
憔	xh	忄灬
峭	uo	山⺝
跷	zw	𧾷兀
侨	rl	亻{⿰丿丨}
樵	mh	木灬
撬	fm	扌毛
锹	jh	钅火
谯	yh	讠灬
橇	mm	木毛
诮	yo	讠⺝
荞	cl	艹{⿰丿丨}
愀	xh	忄火
劁	rd	亻刂
硗	uw	石兀
鞒	gl	革{⿰丿丨}
硚	ul	石{⿰丿丨}
缲	sm	纟木
雀	xv	小{隹右}
且	oa	⺝一
切	qd	七刀
窃	bd	宀刀
怯	xq	忄去
妾	ln	立女
惬	xj	忄夹
锲	jd	钅大
挈	fu	丰手
箧	vj	竹夹
郄	xe	㐅⻏
亲	lm	立木
秦	ih	𡗗禾
琴	wv	𤣩㇇
侵	ry	亻又
勤	cl	廿力
寝	by	宀又
擒	fn	扌禸
钦	jq	钅欠
芹	cj	艹斤
沁	dx	氵心
禽	rn	𠆢禸
覃	xu	覀十
噙	kn	口禸
衾	ry	𠆢衣
揿	fq	扌欠
芩	cv	艹㇇
溱	dh	氵禾
吣	kx	口心
嗪	kh	口禾
锓	jy	钅又
檎	mn	木禸
骎	my	马又
慬	xw	忄王
嵚	uq	山欠
请	yo	讠⺝
轻	ij	车𢀖
清	do	氵⺝
青	fo	龶⺝
情	xo	忄⺝
庆	gd	广大
晴	oo	日⺝
倾	ry	亻页
卿	pg	𠂎{艮}
擎	cu	艹手
顷	by	匕页
蜻	io	虫⺝
箐	vo	竹⺝
氢	qj	气𢀖
罄	tf	士缶
磬	tu	士石
綮	hx	户糸
氰	qo	气⺝
黥	lx	{里}小
檠	cm	艹木
鲭	yo	鱼⺝
苘	ck	艹口
圊	ko	囗⺝
碃	uo	石⺝
庼	gy	广页
勍	wl	亠力
穷	bl	宀力
琼	wx	𤣩小
穹	bg	宀弓
茕	cu	艹十
邛	ge	工⻏
筇	ve	竹⻏
蛩	gi	工虫
銎	gj	工金
䓖	cl	艹力
求	ud	𬺰丶
球	wq	𤣩求
秋	hh	禾火
丘	ja	斤一
邱	qe	丘⻏
囚	kr	囗人
裘	qy	求衣
酋	by	丷酉
虬	iv	虫乚
糗	mq	米犬
鳅	yh	鱼火
蚯	iq	虫丘
俅	rq	亻求
泅	dr	氵人
遒	zy	辶酉
逑	zq	辶求
楸	mh	木火
犰	qj	犭九
萩	ch	艹火
蝤	iy	虫酉
璆	wp	𤣩彡
巯	ji	𢀖𫶧
赇	bq	贝求
鹙	hn	禾鸟
鞧	gy	革酉
鼽	zj	自九
訄	jk	九口
𨱇	jq	钅求
去	ts	土厶
取	ey	耳又
趣	ty	土又
曲	kc	囗艹
屈	ui	尸出
躯	uq	身区
驱	mq	马区
娶	en	耳女
趋	te	土彐
渠	dm	氵木
觑	hj	虍见
瞿	ov	目{隹右}
岖	uq	山区
蛐	iq	虫曲
蛆	iq	虫且
衢	rv	彳{隹右}
祛	pq	礻去
黢	lw	{里}夂
癯	bv	疒{隹右}
阒	mq	门犬
龋	vy	止禹
蕖	cm	艹木
蘧	cu	艹豕
朐	oj	月句
璩	wu	𤣩豕
劬	jl	句力
磲	um	石木
诎	yi	讠出
蠼	iy	虫又
袪	pq	衤去
氍	om	目毛
鸲	jn	句鸟
麹	fm	龶米
胠	oq	⺼去
灈	dv	氵{隹右}
鼩	jj	臼句
竘	lj	立句
戌	wa	戊{一}
㭕	mq	木去
䓛	ci	艹出
坥	tq	土且
𪨰	uq	山曲
𫭟	tq	土区
全	rw	𠆢王
权	my	木又
拳	ju	龹手
劝	yl	又力
泉	bu	白水
犬	dd	大丶
券	jd	龹刀
蜷	iv	虫㔾
痊	bw	疒王
诠	yw	讠王
荃	cw	艹王
颧	cy	艹页
绻	sv	纟㔾
铨	jw	钅王
筌	vw	竹王
鬈	ev	E㔾
醛	yw	酉王
悛	xw	忄夂
佺	rw	亻王
畎	tq	田犬
棬	mv	木㔾
鳈	yu	鱼水
辁	iw	车王
婘	nv	女㔾
瑔	wu	𤣩水
𨟠	oe	目⻏
却	qe	去卩
确	uy	石用
缺	fg	缶夬
瘸	br	疒肉
鹊	cn	卄鸟
阙	mq	门欠
阕	mt	门天
榷	mv	木{隹右}
炔	hg	火夬
悫	tx	士心
碏	uo	石日
埆	ty	土用
𬒈	xu	⺍石
群	yy	尹羊
裙	pk	衤口
逡	zw	辶夂
囷	kh	囗禾
然	xh	𱼀灬
染	dm	氵木
燃	hh	火灬
冉	kt	冂土
髯	er	E冉
苒	cr	艹冉
蚺	ir	虫冉
䎃	rx	冉习
让	yu	讠上
嚷	kx	口襄
壤	tx	土襄
攘	fx	扌襄
瓤	xg	襄瓜
禳	px	礻襄
穰	hx	禾襄
瀼	dx	氵襄
蘘	cx	艹襄
儴	rx	亻襄
绕	sw	纟兀
扰	fy	扌尤
饶	uw	饣兀
娆	nw	女兀
桡	mw	木兀
荛	cw	艹兀
热	fh	扌灬
惹	cx	艹心
人	pn	丿乀
任	rt	亻士
认	yr	讠人
忍	rx	刃心
仁	re	亻二
刃	dd	刀丶
韧	wr	韦刃
壬	pt	丿士
饪	ut	饣士
仞	rr	亻刃
纫	sr	纟刃
稔	hx	禾心
荏	ct	艹士
妊	nt	女士
衽	pt	衤士
轫	ir	车刃
纴	st	纟士
讱	yr	讠刃
葚	cb	艹八
仍	rn	亻乃
扔	fn	扌乃
日	ka	囗一
驲	mo	马日
容	bg	宀谷
荣	cm	艹木
融	gi	鬲虫
蓉	cg	艹谷
绒	su	纟十
溶	dg	氵谷
戎	gu	戈十
榕	mg	木谷
茸	ce	艹耳
熔	hg	火谷
冗	bj	冖几
嵘	um	山木
镕	jg	钅谷
蝾	im	虫木
狨	qu	犭十
瑢	wg	𤣩谷
肉	nr	内人
柔	mm	矛木
揉	fm	扌木
蹂	zm	𧾷木
糅	mm	米木
鞣	gm	革木
𫐓	im	车木
如	nk	女口
入	pn	丿乀
辱	ic	辰寸
乳	vv	爫乚
儒	re	亻而
茹	ck	艹口
汝	dn	氵女
蠕	ie	虫而
孺	ze	子而
褥	pc	衤寸
嚅	ke	口而
濡	de	氵而
缛	sc	纟寸
襦	pe	衤而
溽	dc	氵寸
蓐	cc	艹寸
洳	dk	氵口
薷	ce	艹而
颥	yy	雨页
嬬	ne	女而
铷	jk	钅口
软	iq	车欠
阮	ey	⻖元
堧	td	土大
瓀	we	𤣩而
媆	nd	女大
瑞	we	𤣩而
锐	jx	钅兄
蕊	cx	艹心
睿	bo	⺊目
芮	cn	艹内
蚋	in	虫内
蕤	cu	艹生
枘	mn	木内
汭	dn	氵内
润	dw	氵王
闰	mw	门王
若	ck	艹口
弱	gg	𢎥𢎥
偌	rk	亻口
箬	vk	竹口
婼	nk	女口
爇	ch	艹灬
蒻	cg	艹𢎥
鄀	ce	艹⻏
撒	fw	扌攵
洒	dx	氵西
飒	lf	立风
仨	rs	亻三
萨	ci	艹厂
卅	ai	一川
靸	gj	革及
挲	du	氵手
潵	dw	氵攵
脎	om	⺼木
赛	bb	宀贝
塞	bt	宀土
腮	ox	⺼心
噻	kt	口土
鳃	yx	鱼心
三	ae	一二
散	cw	卄攵
伞	ru	𠆢{伞下}
叁	ss	厶三
馓	uw	饣攵
毵	sm	厶毛
糁	mp	米彡
丧	ty	土{𧘇-丿}
桑	ym	又木
嗓	km	口木
搡	fm	扌木
颡	yy	又页
磉	um	石木
扫	fe	扌彐
骚	mi	马虫
嫂	ny	女又
搔	fi	扌虫
臊	om	⺼木
瘙	bi	疒虫
缫	sg	纟果
埽	tj	土巾
溞	di	氵虫
色	db	⺈巴
瑟	wb	𤣩必
涩	dv	氵止
啬	tk	土口
穑	hk	禾口
铯	jb	钅巴
璱	wb	𤣩必
森	mm	木木
僧	ro	亻日
啥	kg	口古
傻	rw	亻夊
杀	xm	㐅木
莎	cu	艹少
煞	dh	⺈灬
纱	su	纟少
沙	du	氵少
厦	iw	厂夂
霎	yn	雨女
砂	uu	石少
鲨	dy	氵鱼
裟	dy	氵衣
铩	jm	钅木
嗄	kw	口夂
歃	qq	千欠
痧	bu	疒少
唼	kn	口女
杉	mp	木彡
晒	ox	日西
筛	vj	竹巾
山	kl	凵丨
删	cd	册刂
闪	mr	门人
善	yk	羊口
扇	hx	户习
衫	pp	衤彡
珊	wc	𤣩册
擅	fd	扌旦
姗	nc	女册
讪	yu	讠山
陕	ej	⻖夹
煽	hx	火习
膳	ok	⺼口
跚	zc	𧾷册
潸	do	氵⺝
缮	sk	纟口
汕	du	氵山
赡	bk	贝口
鳝	yk	鱼口
舢	vu	舟山
苫	cv	艹占
嬗	nd	女旦
鄯	ye	羊⻏
骟	mx	马习
蟮	ik	虫口
墡	tk	土口
剡	hd	火刂
疝	bu	疒山
芟	cu	艹殳
埏	tv	土正
钐	jp	钅彡
嶦	uk	山口
晱	oh	日火
栅	mc	木册
烻	hv	火正
𫮃	tu	土十
上	ba	⺊一
伤	rl	亻力
商	wk	亠口
尚	xk	⺌口
赏	xb	龸贝
晌	ok	日口
殇	dp	歹丿
觞	dp	⺈丿
熵	hk	火口
墒	tk	土口
绱	sk	纟口
垧	tk	土口
少	xp	小丿
烧	hw	火兀
稍	ho	禾⺝
绍	sk	纟口
哨	ko	口⺝
邵	de	刀⻏
勺	bd	勹丶
梢	mo	木⺝
韶	lk	立口
劭	dl	刀力
捎	fo	扌⺝
芍	cu	艹勺
苕	ck	艹口
艄	vo	舟⺝
筲	vo	竹⺝
潲	do	氵⺝
蛸	io	虫⺝
睄	oo	目⺝
召	dk	刀口
柖	mk	木口
玿	wk	𤣩口
射	uc	身寸
设	yu	讠殳
舍	rg	𠆢古
蛇	ib	虫匕
舌	qk	千口
涉	du	氵𣥂
摄	fy	扌又
社	pt	礻土
奢	do	大日
慑	xy	忄又
赦	iw	赤攵
折	fj	扌斤
佘	ru	𠆢示
麝	lc	鹿寸
赊	bu	贝示
畲	rt	𠆢田
猞	qg	犭古
歙	rq	𠆢欠
滠	dy	氵又
厍	ii	厂车
拾	fk	扌口
𪨶	ui	山车
谁	yv	讠{隹右}
神	pu	礻申
深	dm	氵木
身	zc	自才
甚	cb	卄八
什	ru	亻十
伸	ru	亻申
沈	de	氵儿
审	bu	宀申
申	tl	田丨
慎	xb	忄八
呻	ku	口申
渗	dp	氵彡
婶	nu	女申
绅	su	纟申
肾	lo	丨⺝
莘	cx	艹辛
珅	wu	𤣩申
蜃	ii	辰虫
哂	kx	口西
娠	ni	女辰
燊	hm	火木
瘆	bp	疒彡
椹	mb	木八
砷	uu	石申
诜	ye	讠儿
甡	uu	生生
谂	yx	讠心
矧	ul	矢丨
胂	ou	⺼申
侁	re	亻儿
瞫	ou	目十
鲹	yp	鱼彡
屾	uu	山山
𬬹	ju	钅申
𬳽	me	马儿
生	pf	丿龶
声	tu	士𠃜
圣	yt	又土
胜	ou	⺼生
升	pc	丿廾
省	uo	少目
剩	qd	千刂
绳	sd	纟电
牲	nu	牜生
笙	vu	竹生
甥	ul	生力
昇	oc	日廾
嵊	ur	山人
眚	uo	生目
陞	et	⻖土
是	oz	日龰
时	oc	日寸
事	gy	古{肀亅}
实	bd	宀⺀
十	al	一丨
师	lj	リ巾
使	rl	亻吏
屎	um	尸米
世	cv	廿𠃊
始	nk	女口
失	pf	丿夫
士	ua	十一
湿	dy	氵业
识	yv	讠只
视	pj	礻见
势	fl	扌力
市	wj	亠巾
室	bt	宀土
式	yg	弋工
示	ex	二小
试	yg	讠工
史	kn	口乀
食	rg	𠆢艮
施	fy	方也
适	zu	辶舌
释	cf	釆𰀁
诗	yc	讠寸
尸	vp	𠃍丿
氏	pv	丿乚
侍	rc	亻寸
饰	uj	饣巾
誓	fk	扌口
驶	mu	马史
逝	zj	辶斤
狮	qj	犭巾
噬	kr	口人
仕	rt	亻士
矢	pd	𠂉大
拭	fg	扌工
嗜	ko	口日
似	rr	亻人
蚀	ui	饣虫
恃	xc	忄寸
柿	mj	木巾
弑	xg	㐅工
轼	ig	车工
虱	vi	⺄虫
谥	ym	讠皿
舐	uu	舌氏
媞	nz	女龰
豕	au	一𧰨
莳	cc	艹寸
筮	vr	竹人
蓍	co	艹日
螫	ii	赤虫
炻	hu	火石
鲥	yc	鱼寸
奭	db	大百
湜	dz	氵龰
埘	tc	土寸
酾	yd	酉丶
祏	pu	礻石
栻	mg	木工
贳	ub	世贝
铈	jj	钅巾
鲺	yi	鱼虫
鼫	ju	臼石
邿	te	土⻏
鸤	un	尸鸟
嘘	ky	口业
峙	uc	山寸
殖	dq	歹{具-八}
浉	dj	氵巾
襫	pb	衤百
䏡	ou	⺼示
䴓	bn	帀鸟
𫚕	yj	鱼巾
𬤊	yz	讠龰
手	py	丿于
受	vy	爫又
收	jw	丩攵
首	bz	丷自
守	bc	宀寸
熟	wh	亠灬
兽	bk	丷口
授	fy	扌又
瘦	by	疒又
售	rk	亻口
寿	fc	{寿上丰}寸
狩	qc	犭寸
绶	sy	纟又
艏	vz	舟自
书	vd	𠃍丶
数	mw	米攵
术	md	木丶
树	mc	木寸
属	uy	尸禹
叔	uy	上又
束	gr	古人
舒	ry	𠆢予
输	id	车刂
述	zu	辶术
殊	dw	歹未
鼠	jv	臼{鼠下}
疏	vi	⺪𫶧
淑	dy	氵又
竖	ll	丨立
署	so	罒日
墅	lt	里土
梳	mi	木𫶧
蜀	si	⺫虫
恕	nx	女心
倏	rq	亻犬
暑	oo	日日
庶	gh	广灬
漱	dq	氵欠
赎	bd	贝⺀
姝	nw	女未
枢	mq	木区
蔬	ci	艹𫶧
薯	co	艹日
曙	oo	日日
抒	fy	扌予
孰	ww	亠丸
戍	wd	戊丶
塾	wt	亠土
纾	sy	纟予
澍	dc	氵寸
黍	hu	禾氺
沭	du	氵术
秫	hu	禾术
殳	jy	几又
菽	cy	艹又
腧	od	⺼刂
毹	rm	𠆢毛
摅	fx	扌心
婌	ny	女又
鄃	re	𠆢⻏
隃	ed	⻖刂
陎	ew	⻖未
𬬸	ju	钅术
刷	ud	尸刂
耍	en	而女
唰	kd	口刂
帅	lj	リ巾
摔	fu	扌十
甩	yv	用乚
衰	yv	衣{⿻口一}
蟀	iu	虫十
栓	mw	木王
拴	fw	扌王
涮	dd	氵刂
闩	ma	门一
腨	oe	⺼而
双	yy	又又
爽	dx	大乂
霜	yo	雨目
孀	no	女目
鹴	yn	雨鸟
骦	mo	马目
礵	uo	石目
水	ln	丨ㄟ
睡	ot	目士
税	hx	禾兄
帨	jx	巾兄
说	yx	讠兄
顺	iy	川页
瞬	of	目㐄
吮	ky	口允
舜	vf	爫㐄
楯	mo	木目
烁	hl	火乐
硕	uy	石页
朔	no	屰月
铄	jl	钅乐
槊	nm	屰木
搠	fo	扌月
妁	nu	女勺
蒴	co	艹月
死	db	歹匕
四	ke	囗儿
思	tx	田心
斯	cj	卄斤
司	vk	𠃌口
丝	sa	{纟上}一
私	hs	禾厶
寺	tc	土寸
撕	fj	扌斤
肆	ey	E聿
嘶	kj	口斤
厮	ij	厂斤
祀	ps	礻巳
嗣	kk	口口
饲	uk	饣口
巳	kv	コ乚
泗	ds	氵四
咝	ks	口丝
姒	nr	女人
汜	ds	氵巳
驷	ms	马四
鸶	sn	{纟上}鸟
兕	ae	凹儿
涘	du	氵矢
缌	sx	纟心
蛳	ij	虫巾
澌	dj	氵斤
锶	jx	钅心
笥	vk	竹口
耜	ll	耒㠯
飔	fx	风心
凘	dj	冫斤
虒	ij	𠂆几
㟃	uk	山口
楒	mx	木心
送	zt	辶天
松	mg	木公
宋	bm	宀木
耸	re	人耳
诵	yy	讠用
怂	rx	人心
𪨊	ur	尸人
颂	gy	公页
嵩	uk	山口
悚	xu	忄束
讼	yg	讠公
忪	xg	忄公
淞	dg	氵公
崧	ug	山公
竦	lu	立束
凇	dg	冫公
菘	cg	艹公
娀	nu	女十
㧐	fy	扌又
搜	fy	扌又
艘	vy	舟又
嗽	kq	口欠
嗖	ky	口又
叟	jy	𦥔又
飕	fy	风又
擞	fw	扌攵
馊	uy	饣又
薮	cw	艹攵
廋	gy	广又
溲	dy	氵又
嗾	ku	口矢
锼	jy	钅又
瞍	oy	目又
蒐	cg	艹鬼
螋	iy	虫又
诉	yi	讠斥
速	zu	辶束
苏	cb	艹办
素	fx	龶糸
宿	bb	宀百
俗	rg	亻谷
肃	yb	肀八
塑	nt	屰土
酥	yh	酉禾
簌	vq	竹欠
粟	xm	覀米
稣	yh	鱼禾
溯	do	氵月
愫	xx	忄糸
夙	jd	几歹
谡	yw	讠夂
窣	bu	宀十
蔌	cq	艹欠
涑	du	氵束
嗉	kx	口糸
僳	rm	亻米
觫	du	⺈束
骕	mb	马八
甦	gu	更生
鹔	yn	肀鸟
傃	rx	亻糸
蹜	zb	𧾷百
缩	sb	纟百
𫗧	uu	饣束
算	vc	竹廾
酸	yw	酉夂
蒜	cu	艹示
狻	qw	犭夂
虽	ki	口虫
随	eo	⻖月
岁	ux	山夕
碎	uu	石十
遂	zu	辶豕
隋	eo	⻖月
髓	go	冎月
祟	iu	出示
穗	hx	禾心
邃	zu	辶豕
隧	eu	⻖豕
绥	sn	纟女
燧	hu	火豕
睢	ov	目{隹右}
眭	ot	目土
荽	cn	艹女
谇	yu	讠十
濉	dv	氵{隹右}
穟	hu	禾豕
璲	wu	𤣩豕
襚	pu	衤豕
旞	fu	方豕
𫟦	iu	车豕
𬭼	ju	钅豕
孙	zx	子小
损	fb	扌贝
笋	vy	竹尹
隼	ru	亻十
荪	cx	艹小
狲	qx	犭小
榫	mu	木十
飧	xg	夕艮
所	hj	戶斤
索	ux	十糸
锁	jb	钅贝
嗦	kx	口糸
梭	mw	木夂
琐	wb	𤣩贝
唆	kw	口夂
娑	dn	氵女
蓑	cv	艹{⿻口一}
桫	mu	木少
唢	kb	口贝
睃	ow	目夂
嗍	ko	口月
羧	yw	羊夂
溹	dx	氵糸
他	ry	亻也
她	ny	女也
它	bb	宀匕
塔	tk	土口
踏	zo	𧾷日
拓	fu	扌石
塌	tx	土习
榻	mx	木习
蹋	zx	𧾷习
遢	zx	辶习
挞	fd	扌大
趿	zj	𧾷及
獭	qb	犭贝
祂	py	礻也
闼	md	门大
鳎	yx	鱼习
铊	jb	钅匕
溻	dx	氵习
阘	mx	门习
褟	px	衤习
鞳	gk	革口
太	dd	大丶
台	sk	厶口
态	tx	太心
抬	fk	扌口
泰	iu	𡗗氺
胎	ok	⺼口
汰	dt	氵太
苔	ck	艹口
跆	zk	𧾷口
钛	jt	钅太
邰	se	厶⻏
薹	ct	艹土
肽	ot	⺼太
炱	sh	厶火
酞	yt	酉太
鲐	yk	鱼口
谈	yh	讠火
叹	ky	口又
探	fm	扌木
坦	td	土旦
贪	rb	𠆢贝
坛	ty	土云
摊	fv	扌{隹右}
滩	dv	氵{隹右}
谭	yu	讠十
潭	du	氵十
瘫	bv	疒{隹右}
毯	mh	毛火
炭	uh	山火
忐	ux	上心
檀	md	木旦
痰	bh	疒火
碳	uh	石火
袒	pd	衤旦
昙	oy	日云
坍	td	土丹
郯	he	火⻏
倓	rh	亻火
锬	jh	钅火
钽	jd	钅旦
璮	wd	𤣩旦
惔	xh	忄火
菼	ch	艹火
榃	mt	木田
磹	uu	石十
躺	uk	身口
汤	dp	氵丿
糖	mk	米口
趟	tk	土口
烫	dh	氵火
堂	xt	龸土
唐	gk	广口
膛	ot	⺼土
倘	rk	亻口
淌	dk	氵口
棠	xm	龸木
塘	tk	土口
搪	fk	扌口
螳	it	虫土
傥	rx	亻兄
瑭	wk	𤣩口
镗	jt	钅土
帑	nj	女巾
樘	mt	木土
蹚	zt	𧾷土
嘡	kt	口土
溏	dk	氵口
螗	ik	虫口
羰	yh	羊火
镋	jx	钅兄
耥	lk	耒口
埫	tk	土口
铴	jp	钅丿
䣘	xe	龸⻏
鄌	ge	广⻏
套	ds	大厶
逃	zv	辶兆
讨	yc	讠寸
桃	mv	木兆
涛	dc	氵寸
掏	ff	扌缶
陶	ef	⻖缶
滔	dj	氵臼
萄	cf	艹缶
淘	df	氵缶
韬	wj	韦臼
焘	fh	{寿上丰}灬
啕	kf	口缶
饕	kg	口艮
绦	sm	纟木
洮	dv	氵兆
梼	mc	木寸
绹	sf	纟缶
弢	gy	弓又
鼗	vv	兆支
慆	xj	忄臼
𫘦	mf	马缶
特	nc	牜寸
忑	xx	下心
慝	kx	匚心
铽	jx	钅心
忒	yx	弋心
疼	bd	疒冬
腾	om	月马
藤	cu	艹氺
滕	ou	月氺
誊	jk	龹口
螣	oi	月虫
縢	ox	月糸
熥	hy	火用
䲢	oy	月鱼
题	oy	日页
体	rb	亻本
替	fo	夫曰
踢	zw	𧾷勿
梯	md	木𢎨
蹄	zj	𧾷巾
惕	xw	忄勿
涕	dd	氵𢎨
啼	kj	口巾
剔	od	日刂
屉	uu	尸世
剃	bd	丷刂
嚏	kz	口疋
倜	rk	亻口
缇	sz	纟龰
逖	zh	辶火
荑	cy	艹夷
醍	yz	酉龰
悌	xd	忄𢎨
鹈	bn	丷鸟
绨	sd	纟𢎨
锑	jd	钅𢎨
裼	pw	衤勿
趯	tv	土{隹右}
遆	zj	辶巾
鳀	yz	鱼龰
擿	fg	扌古
䏲	od	⺼𢎨
䴘	in	𠂆鸟
瑅	wz	𤣩龰
𫘨	mz	马龰
天	ad	一大
田	ku	囗十
甜	ug	舌甘
添	dx	氵⺗
填	tb	土八
舔	ux	舌⺗
恬	xu	忄舌
腆	ob	⺼八
阗	mb	门八
殄	dp	歹彡
忝	tx	天⺗
湉	du	氵舌
畋	tw	田攵
觍	qj	{曲-一}见
瑱	wb	𤣩八
掭	fx	扌⺗
盷	oy	目匀
淟	db	氵八
晪	ob	日八
沺	dt	氵田
黇	hv	黄占
条	wm	夂木
跳	zv	𧾷兆
挑	fv	扌兆
眺	ov	目兆
迢	zk	辶口
窕	bv	宀兆
佻	rv	亻兆
笤	vk	竹口
祧	pv	礻兆
髫	ek	E口
粜	im	出米
龆	vk	止口
蜩	ik	虫口
鲦	ym	鱼木
朓	ov	月兆
嬥	nv	女{隹右}
铁	jf	钅夫
贴	bv	贝占
帖	jv	巾占
餮	dg	歹艮
萜	cv	艹占
听	kj	口斤
停	rd	亻丁
厅	id	厂丁
挺	ft	扌土
庭	gt	广土
廷	zt	廴土
婷	nd	女丁
亭	wd	亠丁
艇	vt	舟土
霆	yt	雨土
汀	dd	氵丁
蜓	it	虫土
铤	jt	钅土
葶	cd	艹丁
莛	ct	艹土
珽	wt	𤣩土
梃	mt	木土
烃	hj	火𢀖
渟	dd	氵丁
颋	zy	廴页
桯	mw	木王
侹	rt	亻土
䗴	it	虫土
圢	td	土丁
烶	ht	火土
𬘩	st	纟土
同	kk	冂口
通	zy	辶用
痛	by	疒用
统	sy	纟允
童	ll	立里
铜	jk	钅口
筒	vk	竹口
桶	my	木用
捅	fy	扌用
瞳	ol	目里
桐	mk	木口
佟	rd	亻冬
彤	dp	丹彡
恸	xl	忄力
潼	dl	氵里
嗵	ky	口用
僮	rl	亻里
酮	yk	酉口
仝	rg	𠆢工
茼	ck	艹口
曈	ol	日里
砼	ug	石工
烔	hk	火口
橦	ml	木里
哃	kk	口口
穜	hl	禾里
鲖	yk	鱼口
㛚	ny	女用
峂	ud	山冬
𦒍	lx	立习
𫍣	yk	讠口
头	dd	大⺀
投	fu	扌殳
偷	rd	亻刂
透	zn	辶乃
骰	gu	冎殳
突	bq	宀犬
图	kd	囗冬
土	ua	十一
徒	rz	彳龰
吐	kt	口土
途	zm	辶朩
涂	dm	氵朩
屠	uo	尸日
兔	dd	⺈丶
秃	hj	禾几
凸	la	丨一
荼	cm	艹朩
菟	ct	艹兔
钍	jt	钅土
堍	tt	土兔
酴	ym	酉朩
稌	hm	禾朩
腯	oo	⺼目
葖	cq	艹犬
梌	mm	木朩
㻬	wk	𤣩丂
𬳿	mm	马朩
团	kc	囗才
湍	de	氵而
抟	fv	扌专
彖	hu	彑𧰨
疃	tl	田里
猯	qe	犭而
煓	he	火而
推	fv	扌{隹右}
退	zg	辶艮
腿	og	⺼艮
颓	hy	禾页
褪	pg	衤艮
蜕	ix	虫兄
煺	hg	火艮
魋	gv	鬼{隹右}
𬯎	eb	⻖贝
吞	tk	天口
屯	av	一乚
臀	uo	尸⺝
豚	ou	⺼豕
饨	ut	饣屯
暾	ow	日攵
鲀	yt	鱼屯
坉	tt	土屯
忳	xt	忄屯
焞	hz	火子
拖	fy	扌也
脱	ox	⺼兄
托	fq	扌七
妥	vn	爫女
陀	eb	⻖匕
驼	mb	马匕
唾	kt	口士
佗	rb	亻匕
椭	mo	木月
坨	tb	土匕
沱	db	氵匕
砣	ub	石匕
鸵	nb	{鸟减一}匕
跎	zb	𧾷匕
柁	mb	木匕
酡	yb	酉匕
橐	gm	𰀉木
柝	mi	木斥
侂	rq	亻七
鼍	kd	口电
庹	gi	广尺
箨	vf	竹𰀁
萚	cf	艹𰀁
圫	tq	土七
𬶍	yb	鱼匕
哇	kt	口土
瓦	ad	一丶
娃	nt	女土
挖	fv	扌乙
袜	pw	衤末
蛙	it	虫土
娲	nn	女内
洼	dt	氵土
佤	rw	亻瓦
窊	bg	宀瓜
腽	om	⺼皿
坬	tg	土瓜
畖	tg	田瓜
外	xb	夕卜
歪	bv	不正
崴	un	山女
完	by	宀元
晚	oe	日儿
玩	wy	𤣩元
弯	wg	亠弓
碗	uv	石㔾
湾	dg	氵弓
婉	nv	女㔾
挽	fe	扌儿
腕	ov	⺼㔾
宛	bv	宀㔾
顽	yy	元页
丸	ld	力丶
卍	vl	㇅丨
惋	xv	忄㔾
蜿	iv	虫㔾
琬	wv	𤣩㔾
纨	sw	纟丸
婠	nl	女㠯
皖	by	白元
绾	sl	纟㠯
剜	bd	宀刂
菀	cv	艹㔾
豌	dv	豆㔾
畹	tv	田㔾
烷	hy	火元
脘	oy	⺼元
芄	cw	艹丸
塆	tg	土弓
椀	mv	木㔾
𬇕	dw	氵万
王	at	一土
望	ww	亡王
往	rv	彳主
忘	wx	亡心
网	kx	冂乂
亡	wv	亠𠃊
汪	dw	氵王
妄	wn	亡女
旺	ow	日王
枉	mw	木王
惘	xw	忄亡
罔	kw	冂亡
魍	gw	鬼亡
尢	uv	𠂇乚
辋	iw	车亡
尪	yw	尢王
为	ld	力丶
位	rl	亻立
微	rj	彳几
未	am	一木
围	kw	囗韦
卫	ea	𰆊一
威	wn	戊女
味	kw	口未
维	sv	纟{隹右}
危	dv	⺈㔾
委	hn	禾女
伟	rw	亻韦
谓	yo	讠⺝
唯	kv	口{隹右}
慰	ux	尸心
尾	um	尸毛
喂	ky	口{𧘇-丿}
魏	hg	禾鬼
薇	cj	艹几
惟	xv	忄{隹右}
违	zw	⻌韦
韦	fv	丰𠃌
畏	ty	田{𧘇-丿}
伪	rw	亻为
尉	uc	尸寸
胃	to	田⺝
巍	ug	山鬼
蔚	cc	艹寸
偎	ry	亻{𧘇-丿}
萎	cn	艹女
苇	cw	艹韦
炜	hw	火韦
玮	ww	𤣩韦
猥	qy	犭{𧘇-丿}
娓	nm	女毛
帷	jv	巾{隹右}
纬	sw	纟韦
渭	do	氵⺝
桅	mv	木㔾
嵬	ug	山鬼
猬	qo	犭⺝
隗	eg	⻖鬼
葳	cn	艹女
痿	bn	疒女
闱	mw	门韦
煨	hy	火{𧘇-丿}
诿	yn	讠女
韪	ow	日韦
逶	zn	辶女
帏	jw	巾韦
圩	ty	土于
潍	dv	氵{隹右}
溦	dj	氵几
鲔	yo	鱼月
艉	vm	舟毛
隈	ey	⻖{𧘇-丿}
洧	do	氵月
沩	dw	氵为
廆	gg	广鬼
霨	yc	雨寸
涠	dw	氵韦
亹	wq	亠且
碨	uy	石{𧘇-丿}
煟	ho	火⺝
琟	wv	𤣩{隹右}
硙	uj	石己
薳	cy	艹𧘇
峗	uv	山㔾
洈	dv	氵㔾
螱	ui	尸虫
鳂	yy	鱼{𧘇-丿}
鳚	yc	鱼寸
𣲗	dw	氵韦
𫇭	cw	艹为
𬀩	ow	日韦
𬱟	dy	⺈页
𬶏	yv	鱼㔾
问	mk	门口
文	wx	亠乂
温	dm	氵皿
闻	me	门耳
稳	hx	禾心
吻	kw	口勿
纹	sw	纟文
雯	yw	雨文
蚊	iw	虫文
芠	cw	艹文
瘟	bm	疒皿
紊	wx	文糸
汶	dw	氵文
玟	ww	𤣩文
刎	wd	勿刂
炆	hw	火文
璺	jy	𦥑玉
阌	my	门又
辒	im	车皿
榅	mm	木皿
蕰	cm	艹皿
鳁	ym	鱼皿
𫘜	mw	马文
翁	gx	公习
嗡	kx	口习
瓮	gw	公瓦
蓊	cx	艹习
蕹	cv	艹{隹右}
滃	dx	氵习
鹟	gn	公鸟
𬭩	jx	钅习
我	ga	{戈丿}㇀
握	ft	扌土
窝	bn	宀内
卧	ib	臣卜
沃	dy	氵夭
倭	rn	亻女
龌	vt	止土
蜗	in	虫内
渥	dt	氵土
斡	ud	十斗
幄	jt	巾土
挝	fc	扌寸
莴	cn	艹内
硪	uw	石我
肟	ok	⺼丂
偓	rt	亻土
涴	dv	氵㔾
踒	zn	𧾷女
物	nw	牜勿
五	aw	一𫝀
武	gv	戈止
务	wl	夂力
屋	ut	尸土
舞	pf	𠂉㐄
吴	kt	口天
午	pu	𠂉十
误	yt	讠天
雾	yl	雨力
乌	pa	丿一
悟	xk	忄口
伍	rw	亻五
呜	kw	口乌
巫	gr	工人
吾	wk	五口
污	dk	氵丂
捂	fk	扌口
勿	bp	勹丿
兀	ae	一儿
侮	rm	亻母
唔	kk	口口
梧	mk	木口
妩	nw	女无
芜	cw	艹无
诬	yr	讠人
坞	tw	土乌
毋	mp	{𠃊𠃌一(母-丶丶)}丿
晤	ok	日口
蜈	it	虫{𠃑大}
邬	we	乌⻏
鹉	gn	戈鸟
戊	gp	戈丿
忤	xu	忄十
骛	mm	矛马
鹜	mn	矛鸟
仵	ru	亻十
婺	mn	矛女
钨	jw	钅乌
杌	mw	木兀
焐	hk	火口
庑	gw	广无
寤	bk	宀口
鋈	dj	氵金
痦	bk	疒口
怃	xw	忄无
牾	nk	牜口
圬	tk	土丂
浯	dk	氵口
芴	cw	艹勿
迕	zu	辶十
鼯	jk	臼口
旿	ou	日十
靰	gw	革兀
洿	dk	氵丂
鹀	gn	工鸟
郚	we	五⻏
屼	uw	山兀
珷	wv	𤣩止
铻	jk	钅口
峿	uk	山口
珸	wk	𤣩口
𣲘	dw	氵无
西	ak	一口
喜	tk	士口
息	zx	自心
细	st	纟田
希	xj	㐅巾
习	vd	𠃌冫
吸	kj	口及
戏	yg	又戈
洗	de	氵儿
惜	xo	忄日
席	gj	广巾
袭	ly	龙衣
悉	cx	釆心
嘻	kk	口口
析	mj	木斤
稀	hj	禾巾
熙	ih	𦣞灬
夕	pd	丿丶
晰	oj	日斤
溪	dd	氵大
兮	bk	八丂
牺	nx	牜西
膝	ou	⺼氺
媳	nx	女心
隙	eo	⻖日
昔	co	卄日
锡	jw	钅勿
嬉	nk	女口
熄	hx	火心
犀	un	尸牛
曦	ok	日丂
禧	pk	礻口
皙	mb	木白
玺	dy	⺈玉
汐	dx	氵夕
蜥	ij	虫斤
奚	vd	爫大
唏	kj	口巾
羲	yk	𦍌丂
淅	dj	氵斤
徙	rz	彳龰
熹	th	士灬
蟋	ix	虫心
翕	rx	𠆢习
檄	mw	木攵
僖	rk	亻口
窸	bx	宀心
铣	je	钅儿
郗	xe	㐅⻏
晞	oj	日巾
烯	hj	火巾
屃	ub	尸贝
浠	dj	氵巾
阋	me	门儿
樨	mn	木牛
傒	rd	亻大
醯	ym	酉皿
隰	eh	⻖灬
螅	ix	虫心
爔	hk	火丂
屣	uz	尸龰
硒	ux	石西
釐	wl	未里
葸	cx	艹心
咥	kt	口土
豨	uj	豕巾
禊	pd	礻大
饩	uq	饣气
郤	ge	谷⻏
觋	gj	工见
穸	bx	宀夕
嶲	uk	山{凹-一}
舄	jh	臼灬
舾	vx	舟西
谿	vg	爫谷
恓	xx	忄西
蓰	cz	艹龰
鼷	jd	臼大
粞	mx	米西
巇	ug	山戈
憙	tx	士心
绤	sg	纟谷
菥	cj	艹斤
枲	sm	厶木
潟	dh	氵灬
肸	ou	⺼十
酅	ue	山⻏
睎	oj	目巾
觿	dk	⺈口
嶍	ub	山白
暿	ok	日口
俙	rj	亻巾
熻	hx	火习
饻	uy	饣衣
鳛	yb	鱼白
𠅤	wx	亠心
𫘬	md	马大
𬭳	jk	钅口
𬶮	yk	鱼口
下	ab	一卜
夏	bw	𦣻夂
侠	rj	亻夹
霞	yy	雨又
瞎	ok	目口
狭	qj	犭夹
暇	oy	日又
峡	uj	山夹
虾	ix	虫下
辖	ik	车口
匣	kj	匚甲
瑕	wy	𤣩又
遐	zy	辶又
黠	lk	{里}口
呷	kj	口甲
狎	qj	犭甲
罅	fh	缶乎
硖	uj	石夹
柙	mj	木甲
叚	uy	尸又
翈	jx	甲习
先	ne	⺧儿
现	wj	𤣩见
显	oy	日业
线	sj	纟戋
险	eq	⻖佥
仙	ru	亻山
咸	wk	戊口
鲜	yy	鱼羊
限	eg	⻖艮
闲	mm	门木
陷	ej	⻖臼
县	qs	且厶
献	uq	十犬
贤	lb	丨贝
嫌	nj	女兼
羡	yq	𦍌欠
弦	gx	弓玄
掀	fq	扌欠
宪	be	宀儿
衔	rj	彳钅
娴	nm	女木
涎	dv	氵正
馅	uj	饣臼
舷	vx	舟玄
腺	ou	⺼水
暹	zv	辶{隹右}
苋	cj	艹见
冼	de	冫儿
藓	cy	艹羊
锨	jq	钅欠
霰	yw	雨攵
跹	zq	𧾷千
忺	xq	忄欠
痫	bm	疒木
祆	pt	礻天
岘	uj	山见
酰	ye	酉儿
跣	ze	𧾷儿
燹	uh	豕火
狝	qx	犭小
蚬	ij	虫见
猃	qq	犭佥
籼	mu	米山
鹇	mn	门鸟
筅	ve	竹儿
莶	cq	艹佥
氙	qu	气山
挦	fc	扌寸
崄	uq	山佥
缐	su	纟水
孅	nj	女韭
伭	rx	亻玄
禒	pu	礻𧰨
㬎	oh	日灬
𪾢	oj	目见
𫍯	yk	讠口
𬀪	oj	日见
𬸣	bn	宀鸟
想	mx	木心
向	pk	丿口
相	mo	木目
像	ru	亻𧰨
象	du	{⺈丿口}𧰨
响	kk	口口
香	ho	禾日
项	gy	工页
乡	vp	𠃋𠂈
享	wz	亠子
翔	yx	羊习
箱	vo	竹目
祥	py	礻羊
详	yy	讠羊
湘	do	氵目
厢	io	厂目
襄	yf	衣𠀎
镶	jx	钅襄
橡	mu	木𧰨
饷	uk	饣口
骧	mx	马襄
飨	xg	乡艮
庠	gy	广羊
缃	so	纟目
芗	cx	艹乡
鲞	jy	龹鱼
瓖	wx	𤣩襄
葙	co	艹目
珦	wk	𤣩口
𬙋	sx	纟襄
小	lb	亅八
笑	vy	竹夭
消	do	氵⺝
晓	ow	日兀
萧	cb	艹八
效	ww	亠攵
销	jo	钅⺝
肖	xo	⺌⺝
啸	kb	口八
孝	lz	耂子
逍	zo	辶⺝
潇	db	氵八
削	xd	⺌刂
嚣	kk	口口
霄	yo	雨⺝
宵	bo	宀⺝
哮	kz	口子
箫	vb	竹八
筱	vw	竹攵
枭	nm	{鸟减一}木
硝	uo	石⺝
骁	mw	马兀
淆	do	氵月
魈	go	鬼⺝
绡	so	纟⺝
哓	kw	口兀
鸮	kn	口鸟
崤	uo	山月
枵	mk	木丂
猇	qj	犭几
洨	df	氵父
翛	rx	亻习
虓	jj	九几
涍	dz	氵子
蟏	ib	虫八
敩	xw	𰃮攵
滧	dw	氵攵
皛	bb	白白
𫍲	yy	讠又
些	ve	止二
血	pm	丿皿
谢	yc	讠寸
写	by	冖与
邪	ye	牙⻏
协	ub	十办
鞋	gt	革土
斜	rd	𠆢斗
泄	du	氵世
胁	ob	⺼办
歇	oq	曰欠
屑	uo	尸⺝
械	mc	木廾
携	fn	扌乃
谐	yb	讠白
卸	ve	𦈢卩
挟	fj	扌夹
泻	dy	氵与
懈	xn	忄牛
蝎	ir	虫人
蟹	di	⺈虫
亵	yw	衣丸
邂	zn	辶牛
偕	rb	亻白
榭	mc	木寸
燮	hy	火又
楔	md	木大
撷	fy	扌页
瀣	dj	氵韭
獬	qn	犭牛
勰	lx	力心
廨	gn	广牛
缬	sy	纟页
躞	zy	𧾷又
绁	su	纟世
渫	dm	氵木
薤	cj	艹韭
榍	mo	木⺝
揳	fd	扌大
澥	dn	氵牛
薢	cn	艹牛
叶	ku	口十
㙦	rt	𠆢土
偰	rd	亻大
𤫉	wy	𤣩又
𬹼	vj	止介
新	lj	立斤
心	dd	丶丶
信	rk	亻口
欣	jq	斤欠
辛	lu	立十
馨	to	士日
薪	cj	艹斤
歆	lq	立欠
昕	oj	日斤
衅	pb	丿半
芯	cx	艹心
鑫	jj	金金
忻	xj	忄斤
锌	jx	钅辛
炘	hj	火斤
囟	px	丿㐅
伈	rx	亻心
䜣	yj	讠斤
𫷷	gq	广欠
性	xu	忄生
星	ou	日生
形	kp	开彡
兴	xb	𭕄八
醒	yu	酉生
幸	tg	土干
型	kt	开土
姓	nu	女生
刑	kd	开刂
腥	ou	⺼生
杏	mk	木口
猩	qu	犭生
惺	xu	忄生
邢	ke	开⻏
悻	xg	忄干
荥	cu	艹水
擤	fw	扌丌
陉	ej	⻖𢀖
荇	cd	艹丁
饧	up	饣丿
骍	mx	马辛
硎	ud	石刂
钘	jk	钅开
瑆	wu	𤣩生
婞	ng	女干
铏	jd	钅刂
煋	hu	火生
𫰛	nj	女𢀖
兄	ke	口儿
胸	ox	⺼凶
雄	uv	𠂇{隹右}
凶	kx	凵㐅
熊	sh	厶灬
汹	dx	氵凶
匈	bx	勹凶
芎	cg	艹弓
讻	yx	讠凶
夐	dw	⺈攵
诇	yk	讠口
修	rp	亻彡
秀	hn	禾乃
休	rm	亻木
羞	yi	⺶丑
袖	py	衤由
绣	sn	纟乃
嗅	kq	口犬
朽	mk	木丂
锈	jn	钅乃
咻	km	口木
岫	uy	山由
貅	vm	豸木
馐	ui	饣丑
庥	gm	广木
脩	ro	亻⺝
溴	dq	氵犬
琇	wn	𤣩乃
髹	em	E木
鸺	rn	亻鸟
珛	wo	𤣩月
滫	do	氵⺝
䗛	io	虫⺝
许	yu	讠十
续	sd	纟⺀
需	ye	雨而
须	py	彡页
虚	hy	虍业
徐	rm	彳朩
绪	so	纟日
序	gy	广予
旭	jo	九日
叙	ry	𠆢又
吁	ky	口于
蓄	ct	艹田
絮	nx	女糸
婿	no	女⺝
恤	xm	忄皿
栩	mx	木习
墟	ty	土业
诩	yx	讠习
煦	oh	日灬
胥	zo	疋⺝
酗	yx	酉凶
顼	wy	𤣩页
勖	ol	⺜力
蓿	cb	艹百
盱	oy	目于
魆	gl	鬼𠄌
洫	dm	氵皿
溆	dy	氵又
糈	mo	米⺝
谞	yo	讠⺝
媭	pn	彡女
昫	oj	日句
醑	yo	酉⺝
珝	wx	𤣩习
旴	oy	日于
湑	do	氵⺝
垿	ty	土予
㳚	dd	氵丶
冔	oy	⺜于
𦈡	se	纟而
𬣙	yy	讠于
选	ze	⻌儿
玄	wy	亠幺
宣	bd	宀旦
旋	fz	方疋
轩	ig	车干
悬	qx	且心
喧	kd	口旦
璇	wz	𤣩疋
眩	ox	目玄
炫	hx	火玄
萱	cd	艹旦
漩	dz	氵疋
绚	so	纟日
暄	od	日旦
渲	dd	氵旦
煊	hd	火旦
泫	dx	氵玄
铉	jx	钅玄
瑄	wd	𤣩旦
烜	hd	火旦
癣	by	疒羊
禤	px	礻习
谖	yy	讠又
儇	ry	亻𧘇
玹	wx	𤣩玄
楦	md	木旦
碹	ud	石旦
晅	od	日旦
衒	rx	彳玄
翾	sx	⺫习
痃	bx	疒玄
昡	ox	日玄
咺	kd	口旦
暶	oz	日疋
愃	xd	忄旦
琄	wo	𤣩⺝
𫍽	yy	讠𧘇
𫓶	jo	钅⺝
𫠊	mx	马玄
学	xz	𰃮子
雪	ye	雨彐
穴	bb	宀八
薛	cx	艹辛
靴	gb	革𠤎
谑	ye	讠𰀂
噱	ku	口豕
踅	fz	扌足
鳕	ye	鱼彐
茓	cb	艹八
峃	xu	𰃮山
寻	ec	彐寸
训	yi	讠川
迅	zu	辶十
巡	zv	辶巛
讯	yu	讠十
询	yo	讠日
逊	zx	⻌小
循	ro	彳目
勋	kl	口力
熏	qh	千灬
旬	bo	勹日
驯	mi	马川
荀	co	艹日
薰	ch	艹灬
殉	do	歹日
醺	yh	酉灬
洵	do	氵日
峋	uo	山日
巽	sg	巳共
珣	wo	𤣩日
汛	du	氵十
徇	ro	彳日
浔	dc	氵寸
埙	tb	土贝
恂	xo	忄日
蕈	cu	艹十
鲟	yc	鱼寸
曛	oh	日灬
獯	qh	犭灬
噀	kg	口共
栒	mo	木日
𫄸	sh	纟灬
𬊈	hc	火寸
𬍤	wc	𤣩寸
𬘓	si	纟川
𬩽	ee	彐阝
呀	ky	口牙
亚	ay	一业
压	id	厂丶
雅	yv	牙{隹右}
牙	gp	𡕒丿
丫	bl	丷丨
讶	yy	讠牙
涯	dt	氵土
哑	ky	口业
崖	ut	山土
娅	ny	女业
押	fj	扌甲
鸭	jn	甲鸟
鸦	yn	牙鸟
衙	rk	彳口
芽	cy	艹牙
伢	ry	亻牙
琊	we	𤣩⻏
桠	my	木业
睚	ot	目土
垭	ty	土业
岈	uy	山牙
迓	zy	辶牙
蚜	iy	虫牙
玡	wy	𤣩牙
揠	fn	扌女
猰	qd	犭大
氩	qy	气业
砑	uy	石牙
堐	tt	土土
眼	og	目艮
言	wk	亠口
严	ai	一厂
烟	hy	火因
演	db	氵八
验	mq	马佥
研	uk	石开
燕	ch	廿灬
颜	wy	亠页
掩	fd	扌电
延	zv	廴正
厌	iq	厂犬
艳	fb	丰巴
炎	hh	火火
沿	dk	氵口
焰	hj	火臼
岩	uu	山石
淹	dd	氵电
咽	ky	口因
宴	bn	宀女
嫣	nh	女灬
妍	nk	女开
彦	wp	亠彡
雁	iv	厂{隹右}
阎	mj	门臼
盐	tm	土皿
焉	vh	正灬
衍	rd	彳氵
檐	mk	木口
奄	dd	大电
砚	uj	石见
焱	hh	火火
俨	ry	亻严
晏	on	日女
胭	oy	⺼因
蜒	iv	虫正
魇	ig	厂鬼
阉	md	门电
湮	dt	氵土
琰	wh	𤣩火
筵	vv	竹正
偃	rn	亻女
闫	ms	门三
阏	md	门⺀
恹	xq	忄犬
谚	yp	讠彡
兖	ly	六允
堰	tn	土女
鄢	ve	正⻏
滟	db	氵巴
赝	ib	厂贝
唁	kk	口口
鼹	jn	臼女
芫	cy	艹元
郾	ke	匚⻏
酽	yy	酉严
餍	ig	厂艮
厣	ij	厂甲
谳	yq	讠犬
崦	ud	山电
弇	rc	𠆢廾
黡	ih	厂灬
罨	sd	罒电
渰	dc	氵廾
掞	fh	扌火
嬿	nh	女灬
棪	mh	木火
扊	hh	户火
沇	dy	氵允
甗	hw	虍瓦
殷	pu	㐆殳
䶮	lt	龙天
墕	th	土灬
戭	bg	宀戈
漹	dh	氵灬
虤	hj	虍几
蝘	in	虫女
觃	jz	见子
𪩘	uq	山犬
𫄧	sv	纟正
𬙂	sb	纟八
𬸘	kn	匚鸟
样	my	木羊
阳	eo	⻖日
杨	mp	木丿
扬	fp	扌丿
养	yl	⺶{⿰丿丨}
洋	dy	氵羊
仰	re	亻卩
央	kr	{囗-一}人
羊	bf	丷𰀁
痒	by	疒羊
漾	dy	氵永
氧	qy	气羊
恙	yx	𦍌心
佯	ry	亻羊
鸯	yn	央鸟
殃	dy	歹央
怏	xy	忄央
秧	hy	禾央
炀	hp	火丿
泱	dy	氵央
鞅	gy	革央
徉	ry	彳羊
烊	hy	火羊
疡	bp	疒丿
旸	op	日丿
飏	fp	风丿
羕	yy	𦍌永
蛘	iy	虫羊
垟	ty	土羊
玚	wp	𤣩丿
咉	ky	口央
钖	jp	钅丿
要	xn	覀女
摇	ff	扌缶
药	cu	艹勺
妖	ny	女夭
腰	on	⺼女
咬	kf	口父
遥	zf	辶缶
耀	xv	⺌{隹右}
瑶	wf	𤣩缶
姚	nv	女兆
邀	zw	辶攵
钥	jo	钅月
夭	pd	丿大
谣	yf	讠缶
幺	vs	𠃋厶
窑	bf	宀缶
尧	yw	𫠠兀
吆	ky	口幺
肴	xo	㐅月
约	su	纟勺
曜	ov	日{隹右}
窈	bl	宀力
杳	mo	木日
舀	vj	爫臼
爻	xx	乂乂
鹞	vn	爫鸟
徭	rf	彳缶
轺	ik	车口
鳐	yf	鱼缶
崾	un	山女
窅	bo	宀目
峣	uw	山兀
垚	tt	土土
珧	wv	𤣩兆
靿	gl	革力
猺	qf	犭缶
媱	nf	女缶
㙘	tn	土女
也	vv	𠃌乚
业	la	〢一
夜	ww	亠{夜右下}
爷	fe	父𰆊
野	ly	里予
液	dw	氵{夜右下}
耶	ee	耳⻏
页	ab	丆贝
曳	yp	由丿
冶	dk	冫口
烨	hu	火十
噎	kb	口䒑
腋	ow	⺼{夜右下}
靥	im	厂面
椰	me	木⻏
掖	fw	扌{夜右下}
晔	ou	日十
邺	ye	业⻏
谒	yr	讠人
揶	fe	扌⻏
铘	je	钅⻏
倻	re	亻⻏
馌	um	饣皿
一	aa	一一
以	lr	𠄌人
已	kv	コ乚
意	lx	立心
衣	wy	亠𧘇
亿	rv	亻乙
易	ow	日勿
依	ry	亻衣
义	dx	丶乂
异	jc	己廾
疑	bz	匕疋
议	yy	讠义
医	ku	匚矢
伊	ry	亻尹
移	hx	禾夕
忆	xv	忄乙
艺	cv	艹乙
亦	wb	亠{亦下}
翼	xg	习共
遗	zb	⻌贝
益	bm	丷皿
宜	bq	宀且
椅	mk	木可
仪	ry	亻义
逸	zt	辶兔
姨	ny	女夷
怡	xk	忄口
抑	fe	扌卩
毅	lu	立殳
役	ru	彳殳
译	yf	讠𰀁
夷	ar	一人
溢	dm	氵皿
咦	ky	口夷
倚	rk	亻可
矣	su	厶矢
谊	yq	讠且
乙	vv	乙乙
蚁	iy	虫义
奕	wd	亠大
漪	dk	氵可
疫	bu	疒殳
绎	sf	纟𰀁
裔	yk	衣口
揖	fe	扌耳
颐	iy	𦣞页
驿	mf	马𰀁
弈	wc	亠廾
懿	tx	士心
邑	kb	口巴
熠	hb	火白
屹	uv	山乙
沂	dj	氵斤
羿	xc	习廾
诣	yo	讠日
翌	xl	习立
轶	if	车夫
呓	kv	口乙
翊	lx	立习
蜴	iw	虫勿
弋	yd	𫠠丶
咿	ky	口尹
旖	fk	方可
祎	pw	礻韦
臆	ox	⺼心
彝	hc	彑廾
贻	bk	贝口
噫	kx	口心
佚	rf	亻夫
迤	zy	辶也
壹	tb	士䒑
缢	sm	纟皿
翳	kx	匚习
胰	oy	⺼夷
痍	by	疒夷
薏	cx	艹心
嶷	uz	山疋
饴	uk	饣口
苡	cr	艹人
悒	xb	忄巴
猗	qk	犭可
诒	yk	讠口
黟	lx	{里}夕
峄	uf	山𰀁
镱	jx	钅心
怿	xf	忄𰀁
眙	ok	目口
肄	by	匕聿
铱	jy	钅衣
挹	fb	扌巴
乂	pn	丿乀
刈	xd	㐅刂
癔	bx	疒心
镒	jm	钅皿
埸	tw	土勿
佾	ro	亻⺝
圯	ts	土巳
瘗	bt	疒土
燚	hh	火火
劓	zd	自刂
殪	db	歹䒑
浥	db	氵巴
扆	hy	户衣
廙	gg	广共
簃	vx	竹夕
嫕	nx	女心
舣	vy	舟义
杙	my	木弋
钇	jv	钅乙
鹢	bn	丷鸟
宧	bi	宀𦣞
洢	dy	氵尹
酏	yy	酉也
繄	kx	匚糸
裛	yb	衣巴
椸	my	木也
踦	zk	𧾷可
扅	hx	户夕
佁	rk	亻口
勚	ul	世力
匜	ky	匚也
鹝	gn	鬲鸟
㑊	rb	亻{亦下}
枍	mk	木丂
潩	dg	氵共
螠	im	虫皿
𫄷	sx	纟心
𫖮	uy	山页
𬟁	cn	艹鸟
𬬩	jy	钅弋
𬺈	vk	止可
因	kd	囗大
音	lo	立日
引	gl	弓丨
隐	ex	⻖心
银	jg	钅艮
阴	eo	⻖月
印	pe	𠀉卩
吟	kv	口㇇
饮	uq	饣欠
淫	dt	氵士
姻	ny	女因
尹	ep	⺕丿
茵	cy	艹因
瘾	bx	疒心
胤	eo	儿⺝
荫	co	艹月
寅	bb	宀八
垠	tg	土艮
氤	qy	气因
蚓	il	虫丨
喑	ko	口日
洇	dy	氵因
龈	vg	止艮
鄞	ce	廿⻏
夤	xb	夕八
窨	bo	宀日
霪	yt	雨士
狺	qk	犭口
愔	xo	忄日
堙	tt	土土
訚	mk	门口
吲	kl	口丨
铟	jy	钅因
嚚	kk	口口
禋	pt	礻土
骃	my	马因
慭	lx	来心
硍	ug	石艮
珢	wg	𤣩艮
茚	ce	艹卩
蟫	iu	虫十
龂	vj	止斤
崟	uj	山金
溵	du	氵殳
歅	xq	覀欠
䲟	ye	鱼卩
𬘡	sy	纟因
𬤇	yt	讠土
𬮱	mt	门土
应	ga	广一
影	op	日彡
英	cy	艹央
营	ck	艹口
迎	ze	辶卩
硬	ug	石更
鹰	gn	广鸟
赢	wb	亡贝
映	oy	日央
莹	cy	艹玉
盈	nm	乃皿
婴	bn	贝女
樱	mn	木女
颖	by	匕页
莺	cn	艹鸟
蝇	id	虫电
嬴	wn	亡女
萤	ci	艹虫
荧	ch	艹火
萦	cx	艹糸
瑛	wy	𤣩央
缨	sn	纟女
瀛	dn	氵女
嘤	kn	口女
膺	go	广⺝
滢	dy	氵玉
鹦	bn	贝鸟
罂	bf	贝缶
璎	wn	𤣩女
郢	ke	口⻏
颍	by	匕页
茔	ct	艹土
楹	mm	木皿
撄	fn	扌女
潆	dx	氵糸
媵	on	月女
瘿	bn	疒女
锳	jy	钅央
蓥	cj	艹金
溁	dm	氵木
媖	ny	女央
䓨	cf	艹缶
用	kf	冂𰀁
永	du	丶水
拥	fy	扌用
勇	sl	龴力
佣	ry	亻用
庸	go	广月
泳	dy	氵永
雍	wv	亠{隹右}
咏	ky	口永
甬	sy	龴用
慵	xo	忄月
俑	ry	亻用
恿	sx	龴心
臃	ov	⺼{隹右}
蛹	iy	虫用
邕	vb	巛巴
踊	zy	𧾷用
墉	to	土月
镛	jo	钅月
颙	ty	田页
痈	by	疒用
壅	wt	亠土
饔	wg	亠艮
鳙	yo	鱼月
澭	dv	氵{隹右}
鄘	ge	广⻏
埇	ty	土用
栐	my	木永
喁	kd	口丶
㶲	hy	火用
鲬	yy	鱼用
有	uo	𠂇月
又	vn	㇇乀
由	lt	丨田
友	uy	𠂇又
游	dz	氵子
右	uk	𠂇口
优	ry	亻尤
犹	qy	犭尤
幽	uy	山幺
油	dy	氵由
尤	yd	尢丶
忧	xy	忄尤
悠	rx	亻心
诱	yn	讠乃
幼	yl	幺力
佑	rk	亻口
邮	ye	由⻏
黝	ll	{里}力
呦	kl	口力
攸	rw	亻攵
鱿	yy	鱼尤
酉	xa	西一
繇	vx	爫糸
柚	my	木由
祐	pk	礻口
铀	jy	钅由
猷	bq	丷犬
釉	cy	采由
莠	cn	艹乃
囿	ko	囗月
鼬	jy	臼由
宥	bo	宀月
莜	cw	艹攵
疣	by	疒尤
侑	ro	亻月
牖	pf	片甫
蝣	iz	虫子
蚴	il	虫力
羑	yj	𦍌久
蚰	iy	虫由
莸	cy	艹尤
卣	bk	⺊コ
麀	lb	鹿匕
耰	lw	耒夂
浟	dw	氵攵
槱	mh	木灬
铕	jo	钅月
鲉	yy	鱼由
𬨎	iy	车酉
与	va	㇉一
于	au	一十
语	yk	讠口
雨	ad	一丶
玉	wd	王丶
余	rm	𠆢朩
遇	zd	辶丶
欲	gq	谷欠
羽	xx	习习
宇	by	宀于
鱼	da	⺈一
预	yy	予页
御	re	彳卩
郁	ue	𠂇⻏
豫	yu	予𧰨
域	ta	土{一}
狱	qq	犭犬
予	sl	龴亅
愈	rx	𠆢心
浴	dg	氵谷
誉	xk	𭕄口
愉	xd	忄刂
愚	tx	田心
於	fd	方⺀
裕	pg	衤谷
娱	nt	女天
瑜	wd	𤣩刂
喻	kd	口刂
寓	bd	宀丶
渔	dy	氵鱼
虞	ht	虍{𠃑大}
俞	rd	𠆢刂
禹	pd	丿丶
煜	hl	火立
舆	jb	𦥑八
谕	yd	讠刂
逾	zd	辶刂
榆	md	木刂
屿	uy	山与
钰	jy	钅玉
驭	my	马又
渝	dd	氵刂
迂	zy	辶于
淤	dd	氵⺀
毓	pi	𠂉𫶧
瑀	wy	𤣩禹
妤	ny	女予
昱	ol	日立
隅	ed	⻖丶
禺	td	田丶
芋	cy	艹于
聿	yg	肀干
臾	jr	𦥑人
揄	fd	扌刂
峪	ug	山谷
觎	rj	𠆢见
妪	nq	女区
谀	yr	讠人
腴	or	⺼人
盂	ym	于皿
彧	ga	𢦑{一}
庾	gr	广人
瘀	bd	疒⺀
燏	hk	火口
棫	ma	木{一}
蜮	ia	虫{一}
圄	kk	囗口
竽	vy	竹于
欤	yq	与欠
萸	cr	艹人
鹬	mn	矛鸟
鬻	gg	弓鬲
龉	vk	止口
窳	bg	宀瓜
圉	kg	囗干
纡	sy	纟于
狳	qm	犭朩
俣	rt	亻天
燠	hd	火大
瘐	br	疒人
伛	rq	亻区
饫	uy	饣夭
淯	do	氵⺝
阈	ma	门{一}
蝓	id	虫刂
舁	jc	臼廾
遹	zk	辶口
雩	yk	雨丂
鹆	gn	谷鸟
窬	bd	宀刂
熨	uh	尸火
玙	wy	𤣩与
嵛	ud	山刂
堉	to	土⺝
褕	pd	衤刂
矞	mk	矛口
畬	rt	𠆢田
嵎	ud	山丶
蓣	cy	艹页
髃	gd	冎丶
滪	dy	氵页
潏	dk	氵口
悆	rx	𠆢心
敔	ww	五攵
邘	ye	于⻏
鄅	ye	禹⻏
艅	vm	舟朩
㺄	qd	犭刂
原	ix	厂小
远	zy	⻌元
员	kb	口贝
元	aw	一兀
院	ey	⻖元
愿	ix	厂心
园	ky	囗元
源	dx	氵小
圆	kb	囗贝
缘	su	纟𧰨
怨	xx	夕心
援	fy	扌又
袁	ty	土𧘇
辕	iy	车𧘇
渊	dl	氵丨
冤	bt	冖兔
媛	ny	女又
苑	cv	艹㔾
猿	qy	犭𧘇
鸳	xn	夕鸟
垣	td	土旦
鸢	yn	弋鸟
沅	dy	氵元
爰	vy	爫又
瑗	wy	𤣩又
塬	tx	土小
鼋	yd	元电
掾	fu	扌𧰨
垸	ty	土元
螈	ix	虫小
橼	mu	木𧰨
蜎	io	虫⺝
嫄	nx	女小
箢	vv	竹㔾
湲	dy	氵又
眢	xo	夕目
妧	ny	女元
羱	yx	羊小
𫘪	mx	马小
越	tl	土𠄌
月	ke	⺆二
跃	zy	𧾷夭
岳	qu	丘山
悦	xx	忄兄
曰	ka	囗一
阅	mx	门兄
粤	pk	丿丂
玥	wo	𤣩月
钺	jl	钅𠄌
樾	ml	木𠄌
刖	od	月刂
彟	ey	彐又
瀹	dc	氵卄
龠	rc	𠆢卄
爚	hc	火卄
籥	vc	竹卄
𫐄	iw	车兀
𬸚	qn	犭鸟
云	as	一厶
运	zy	辶云
晕	oi	日车
允	se	厶儿
韵	ly	立匀
芸	cy	艹云
孕	nz	乃子
蕴	cm	艹皿
匀	bd	勹冫
陨	eb	⻖贝
酝	yy	酉云
愠	xm	忄皿
氲	qm	气皿
耘	ly	耒云
昀	oy	日匀
纭	sy	纟云
殒	db	歹贝
韫	wm	韦皿
郓	be	冖⻏
赟	wb	文贝
恽	xi	忄车
鋆	tj	土金
郧	ke	口⻏
狁	qy	犭允
沄	dy	氵云
妘	ny	女云
缊	sm	纟皿
煴	hm	火皿
筼	vb	竹贝
涢	db	氵贝
馧	hm	禾皿
𫖳	yy	尹页
咋	kv	口乍
砸	uj	石巾
杂	jm	九木
咂	kj	口巾
匝	kj	匚巾
扎	fv	扌乚
臜	ob	⺼贝
拶	fx	扌夕
在	ut	𠂇土
再	ar	一冉
载	gi	戈车
灾	bh	宀火
宰	bx	宀辛
栽	gm	戈木
哉	gk	戈口
仔	rz	亻子
崽	ux	山心
甾	vt	巛田
咱	kz	口自
赞	nb	⺧贝
暂	io	车日
簪	vo	竹曰
瓒	wb	𤣩贝
錾	ij	车金
糌	mo	米日
趱	tb	土贝
昝	wo	夂日
酂	ne	⺧⻏
寁	bz	宀龰
脏	ot	⺼土
葬	cc	艹廾
赃	bt	贝土
臧	vi	𠃊臣
奘	pd	爿大
牂	py	爿羊
驵	mq	马且
早	ou	日十
造	zk	辶口
遭	zo	辶曰
糟	mo	米曰
澡	dm	氵木
躁	zm	𧾷木
燥	hm	火木
凿	kg	凵干
噪	km	口木
灶	ht	火土
枣	ud	朿⺀
皂	bq	白七
藻	cm	艹木
蚤	ii	叉虫
唣	kq	口七
璪	wm	𤣩木
慥	xk	忄口
簉	vk	竹口
𥖨	um	石木
则	bd	贝刂
责	fb	龶贝
择	ff	扌𰀁
泽	df	氵𰀁
啧	kb	口贝
仄	ir	厂人
笮	vv	竹乍
帻	jb	巾贝
赜	ib	𦣞贝
昃	or	日人
舴	vv	舟乍
箦	vb	竹贝
迮	zv	辶乍
贼	bu	贝十
鲗	yd	鱼刂
怎	vx	乍心
谮	yo	讠曰
增	to	土日
赠	bo	贝日
憎	xo	忄日
锃	jw	钅王
缯	so	纟日
甑	bw	丷瓦
罾	so	罒日
矰	uo	矢日
鄫	be	丷⻏
综	su	纟示
䎖	bx	丷习
炸	hv	火乍
眨	of	目乏
诈	yv	讠乍
乍	pe	𠂉二
渣	dd	氵旦
札	mv	木乚
闸	mj	门甲
榨	mv	木乍
吒	kq	口七
咤	kq	口七
蚱	iv	虫乍
铡	jd	钅刂
楂	md	木旦
鲊	yv	鱼乍
揸	fd	扌旦
砟	uv	石乍
哳	kj	口斤
奓	dx	大夕
拃	fv	扌乍
挓	fq	扌七
痄	bv	疒乍
劄	vd	竹刂
霅	yk	雨口
柞	mv	木乍
䃎	ux	石夕
溠	dg	氵工
鲝	yy	⺶鱼
齇	zq	自且
寨	bm	宀木
宅	bq	宀七
摘	fg	扌古
债	rb	亻贝
窄	bv	宀乍
斋	we	文而
瘵	bu	疒示
豸	pp	丿丿
站	lv	立占
战	vg	占戈
展	uy	尸{𧘇-丿}
占	bk	⺊囗
斩	ij	车斤
沾	dv	氵占
蘸	ch	艹灬
绽	sz	纟龰
栈	mj	木戋
盏	jm	戋皿
詹	dk	⺈口
湛	db	氵八
崭	uj	山斤
瞻	ok	目口
辗	iy	车{𧘇-丿}
毡	mv	毛占
旃	fd	方丹
谵	yk	讠口
搌	fy	扌{𧘇-丿}
飐	fv	风占
鹯	wn	亠鸟
偡	rb	亻八
栴	md	木丹
鳣	yd	鱼旦
𫗴	ud	饣旦
张	gi	弓长
章	lu	立十
掌	xu	龸手
丈	an	一乀
帐	ji	巾长
仗	rv	亻丈
障	eu	⻖十
涨	di	氵长
杖	mv	木丈
账	bi	贝长
璋	wu	𤣩十
胀	oi	⺼长
彰	lp	立彡
蟑	iu	虫十
瘴	bu	疒十
樟	mu	木十
漳	du	氵十
獐	qu	犭十
嶂	uu	山十
幛	ju	巾十
鄣	le	立⻏
嫜	nu	女十
暲	ou	日十
仉	rj	亻几
找	fg	扌戈
照	oh	日灬
招	fk	扌口
赵	tx	土㐅
罩	su	罒十
着	yo	⺶目
爪	in	𠂆乀
昭	ok	日口
兆	ed	儿{冫⿱丿丶}
诏	yk	讠口
沼	dk	氵口
肇	hy	户聿
钊	jd	钅刂
棹	mu	木十
笊	vv	竹爪
曌	og	日工
啁	kk	口口
旐	fv	方兆
𬬿	jk	钅口
𬶐	yv	鱼兆
这	zw	⻌文
者	lo	耂日
哲	fk	扌口
遮	zh	辶灬
浙	dj	氵斤
辙	iw	车攵
辄	iv	车𠃊
褶	pb	衤白
蛰	fi	扌虫
蔗	ch	艹灬
蜇	fi	扌虫
鹧	gn	广鸟
喆	tk	士口
谪	yg	讠古
赭	io	赤日
柘	mu	木石
磔	um	石木
锗	jo	钅日
啫	ko	口日
晢	fo	扌日
詟	lk	龙口
䗪	gi	广虫
真	ub	十八
阵	ei	⻖车
震	yi	雨辰
镇	jb	钅八
珍	wp	𤣩彡
针	ju	钅十
振	fi	扌辰
朕	ot	月天
侦	rb	亻贝
贞	bb	⺊贝
枕	me	木儿
诊	yp	讠彡
甄	xw	覀瓦
帧	jb	巾贝
斟	cd	卄斗
祯	pb	礻贝
臻	gh	𠫔禾
桢	mb	木贝
箴	vk	竹口
缜	sb	纟八
圳	ti	土川
榛	mh	木禾
赈	bi	贝辰
蓁	ch	艹禾
禛	pb	礻八
疹	bp	疒彡
砧	uv	石占
鸩	bn	冖鸟
轸	ip	车彡
稹	hb	禾八
浈	db	氵贝
瑧	wh	𤣩禾
畛	tp	田彡
胗	op	⺼彡
鬒	eb	E八
袗	pp	衤彡
葴	ck	艹口
揕	fb	扌八
昣	op	日彡
纼	sl	纟丨
正	av	一止
整	uv	束正
政	vw	正攵
争	dy	⺈{肀亅}
证	yv	讠正
征	rv	彳正
郑	be	丷⻏
睁	oy	目{肀亅}
挣	fy	扌{肀亅}
怔	xv	忄正
症	bv	疒正
蒸	ch	艹灬
铮	jy	钅{肀亅}
筝	vy	竹{肀亅}
狰	qy	犭{肀亅}
拯	fi	扌丞
峥	uy	山{肀亅}
钲	jv	钅正
诤	yy	讠{肀亅}
烝	lh	了灬
只	kb	口八
知	uk	矢口
直	uq	十{具-八}
至	gt	𠫔土
之	dn	丶乀
指	fo	扌日
值	rq	亻{具-八}
制	nd	牛刂
支	uy	十又
志	tx	士心
止	lb	丨⺊
治	dk	氵口
质	ib	𠂆贝
置	sq	罒{具-八}
致	gw	𠫔攵
职	ev	耳只
智	uo	矢日
纸	su	纟氏
织	sv	纟只
执	fw	扌丸
枝	mv	木支
植	mq	木{具-八}
旨	bo	匕日
芝	cv	艹之
吱	kv	口支
肢	ov	⺼支
侄	rt	亻土
脂	oo	⺼日
址	tv	土止
汁	du	氵十
滞	dj	氵巾
稚	hv	禾{隹右}
掷	fe	扌⻏
秩	hf	禾夫
窒	bt	宀土
芷	cv	艹止
挚	fu	扌手
蜘	ik	虫口
帜	jv	巾只
炙	xh	𱼀火
趾	zv	𧾷止
咫	iv	尺只
痣	bx	疒心
徵	rw	彳王
雉	uv	矢{隹右}
祗	pu	礻氐
栀	mv	木㔾
痔	bc	疒寸
栉	me	木𰆊
祉	pv	礻止
桎	mt	木土
蛭	it	虫土
鸷	fn	扌鸟
郅	ge	𠫔⻏
踯	ze	𧾷⻏
贽	fb	扌贝
陟	eu	⻖𣥂
骘	em	⻖马
彘	hb	彑匕
跖	zu	𧾷石
轾	it	车土
摭	fh	扌灬
枳	mv	木只
酯	yo	酉日
帙	jf	巾夫
禔	pz	礻龰
卮	iv	𠂆㔾
沚	dv	氵止
胝	ou	⺼氐
觯	du	⺈十
絷	fx	扌糸
埴	tq	土{具-八}
轵	iv	车只
黹	yx	业小
踬	zb	𧾷贝
忮	xv	忄支
晊	ot	日土
畤	tc	田寸
滍	di	氵虫
稙	hq	禾{具-八}
扺	fu	扌氏
铚	jt	钅土
锧	jb	钅贝
疐	uz	十疋
跱	zc	𧾷寸
庤	gc	广寸
泜	du	氵氐
梽	mx	木心
榰	mo	木日
𦭜	cv	艹只
𬃊	mb	木贝
中	kl	口丨
终	sd	纟冬
众	rr	人人
钟	jv	钅中
忠	vx	中心
仲	rv	亻中
衷	yv	衣中
肿	ov	⺼中
冢	bu	冖豖
踵	zv	𧾷重
盅	vm	中皿
锺	jv	钅重
舯	vv	舟中
螽	di	冬虫
柊	md	木冬
茽	cv	艹中
周	kk	⺆口
州	dl	丶丨
皱	dp	⺈皮
洲	dv	氵州
咒	kj	口几
宙	by	宀由
舟	pd	丿丶
骤	mu	马{水}
粥	gm	弓米
肘	oc	⺼寸
轴	iy	车由
昼	id	尺旦
帚	ej	彐巾
胄	yo	由⺝
纣	sc	纟寸
绉	se	纟彐
诌	ye	讠彐
妯	ny	女由
碡	um	石母
籀	vt	竹田
酎	yc	酉寸
辀	iv	车舟
赒	bk	贝口
鸼	vn	舟鸟
荮	cc	艹寸
婤	nk	女口
㑇	re	亻彐
㤘	xe	忄彐
住	rv	亻主
主	wt	亠土
注	dv	氵主
助	ql	且力
著	co	艹日
朱	pw	丿未
珠	ww	𤣩未
诸	yo	讠日
逐	zu	辶豕
竹	gg	亇亇
猪	qo	犭日
祝	px	礻兄
筑	vf	竹凡
柱	mv	木主
驻	mv	马主
嘱	ky	口禹
烛	hi	火虫
煮	lh	耂灬
蛛	iw	虫未
株	mw	木未
铸	jc	钅寸
诛	yw	讠未
竺	ve	竹二
瞩	oy	目禹
伫	rv	亻㝉
拄	fv	扌主
侏	rw	亻未
贮	bv	贝㝉
茱	cw	艹未
洙	dw	氵未
蛀	iv	虫主
渚	do	氵日
箸	vo	竹日
炷	hv	火主
铢	jw	钅未
躅	zi	𧾷虫
苎	cv	艹㝉
杼	my	木予
翥	lx	耂习
槠	mo	木日
麈	lv	鹿主
潴	do	氵日
舳	vy	舟由
邾	pe	丿⻏
纻	sv	纟㝉
橥	qm	犭木
砫	uv	石主
柷	mx	木兄
疰	bv	疒主
蠋	ii	虫虫
瘃	bu	疒豖
𬣞	yv	讠㝉
抓	fv	扌爪
髽	er	E人
拽	fy	扌曳
转	iv	车专
专	ts	土龴
赚	bj	贝兼
砖	uv	石专
撰	fg	扌共
篆	vu	竹𧰨
馔	ug	饣共
颛	uy	山页
啭	kv	口专
僎	rg	亻共
瑑	wu	𤣩𧰨
䏝	ov	⺼专
装	ly	丬衣
状	lq	丬犬
庄	gt	广土
撞	fl	扌里
壮	lt	丬士
妆	ln	丬女
桩	mt	木土
追	zl	辶𠂤
坠	et	⻖土
缀	sy	纟又
锥	jv	钅{隹右}
惴	xe	忄而
赘	fb	龶贝
椎	mv	木{隹右}
骓	mv	马{隹右}
缒	sl	纟𠂤
隹	rv	亻{隹右}
准	dv	冫{隹右}
谆	yz	讠子
肫	ot	⺼屯
窀	bt	宀屯
衠	rb	彳八
𬘯	sz	纟子
桌	bm	⺊木
卓	bu	⺊十
捉	fz	扌足
琢	wu	𤣩豖
灼	hu	火勺
拙	fi	扌出
浊	di	氵虫
镯	ji	钅虫
酌	yu	酉勺
啄	ku	口豖
茁	ci	艹出
涿	du	氵豖
擢	fv	扌{隹右}
斫	uj	石斤
濯	dv	氵{隹右}
倬	ru	亻十
浞	dz	氵足
诼	yu	讠豖
棁	mx	木兄
禚	ph	礻灬
椓	mu	木豖
晫	ou	日十
叕	yy	又又
汋	du	氵勺
䓬	cu	艹十
䦃	jo	钅日
𬸦	fn	方鸟
子	la	了一
自	po	丿目
字	bz	宀子
资	db	冫贝
紫	vx	止糸
姿	dn	冫女
滋	dy	氵幺
姊	nd	女𠂔
咨	dk	冫口
梓	mx	木辛
孜	zw	子攵
渍	db	氵贝
籽	mz	米子
恣	dx	冫心
龇	vb	止匕
辎	it	车田
淄	dt	氵田
眦	ob	目匕
滓	dx	氵辛
嗞	ky	口幺
髭	eb	E匕
孳	bz	丷子
缁	st	纟田
笫	vd	竹𠂔
锱	jt	钅田
秭	hd	禾𠂔
赀	vb	止贝
訾	vk	止口
觜	vy	止用
嵫	uy	山幺
趑	tq	土欠
孖	zz	子子
粢	dm	冫米
鲻	yt	鱼田
镃	jy	钅幺
耔	lz	耒子
鼒	co	才目
虸	iz	虫子
鄑	ye	亚⻏
总	bx	丷心
宗	bu	宀示
纵	sr	纟人
踪	zu	𧾷示
棕	mu	木示
鬃	eu	E示
粽	mu	米示
偬	rx	亻心
倧	ru	亻示
鬷	gw	鬲夂
腙	ou	⺼示
疭	br	疒人
走	tz	土龰
奏	it	𡗗天
揍	ft	扌天
邹	de	⺈⻏
诹	yy	讠又
驺	me	马彐
陬	ey	⻖又
鄹	ee	耳⻏
鲰	yy	鱼又
组	sq	纟且
足	kz	口龰
族	fu	方矢
祖	pq	礻且
阻	eq	⻖且
租	hq	禾且
诅	yq	讠且
俎	rq	人且
镞	ju	钅矢
菹	cq	艹且
崒	uu	山十
珇	wq	𤣩且
钻	jv	钅占
攥	fx	扌糸
纂	vx	竹糸
缵	sb	纟贝
躜	zb	𧾷贝
最	oy	日又
嘴	ky	口用
罪	sf	罒非
醉	yu	酉十
蕞	cy	艹又
槜	mn	木乃
尊	bc	丷寸
遵	zc	辶寸
樽	mc	木寸
鳟	yc	鱼寸
撙	fc	扌寸
噂	kc	口寸
僔	rc	亻寸
嶟	uc	山寸
𨱔	jc	钅寸
做	rw	亻攵
作	rv	亻乍
坐	tr	土人
左	ug	𠂇工
座	gr	广人
昨	ov	日乍
佐	rg	亻工
祚	pv	礻乍
嘬	ky	口又
酢	yv	酉乍
怍	xv	忄乍
胙	ov	⺼乍
唑	kr	口人
捽	fu	扌十
阼	ev	⻖乍
岞	uv	山乍