啊啊	aa
阿布	ab
啊擦	ac
阿达	ad
阿尔	ae
安抚	af
爱国	ag
安徽	ah
爱吃	ai
案件	aj
爱看	ak
案例	al
澳门	am
爱你	an
啊哦	ao
安排	ap
安全	aq
爱人	ar
阿三	as
爱他	at
爱上	au
安装	av
阿文	aw
爱心	ax
哎呀	ay
阿紫	az
保安	ba
宝宝	bb
不错	bc
百度	bd
八二	be
部分	bf
不过	bg
不会	bh
保持	bi
比较	bj
包括	bk
本来	bl
部门	bm
不能	bn
北欧	bo
不怕	bp
并且	bq
别人	br
比赛	bs
不同	bt
不是	bu
标准	bv
帮我	bw
不行	bx
不要	by
不在	bz
惨啊	ca
从不	cb
此次	cc
菜单	cd
从而	ce
财富	cf
采购	cg
才会	ch
存储	ci
参加	cj
参考	ck
材料	cl
聪明	cm
才能	cn
猜哦	co
彩票	cp
采取	cq
此人	cr
厕所	cs
词条	ct
测试	cu
财政	cv
财务	cw
促销	cx
参与	cy
操作	cz
答案	da
豆瓣	db
多次	dc
得到	dd
第二	de
地方	df
大概	dg
的话	dh
调查	di
大家	dj
打开	dk
到了	dl
代码	dm
电脑	dn
的哦	do
店铺	dp
地区	dq
的人	dr
打算	ds
地图	dt
但是	du
地址	dv
单位	dw
东西	dx
对于	dy
电子	dz
饿啊	ea
二百	eb
二层	ec
二点	ed
呃呃	ee
二分	ef
俄国	eg
二号	eh
而成	ei
耳机	ej
儿科	ek
二零	el
恶魔	em
二年	en
饿哦	eo
二篇	ep
而且	eq
二日	er
饿死	es
儿童	et
二十	eu
二战	ev
额外	ew
恶心	ex
而已	ey
儿子	ez
方案	fa
发表	fb
讽刺	fc
反对	fd
反而	fe
方法	ff
法国	fg
发货	fh
非常	fi
附件	fj
反馈	fk
分类	fl
方面	fm
妇女	fn
发哦	fo
发票	fp
父亲	fq
夫人	fr
发送	fs
发帖	ft
方式	fu
发展	fv
服务	fw
发现	fx
费用	fy
负责	fz
公安	ga
改变	gb
刚才	gc
更多	gd
感恩	ge
官方	gf
刚刚	gg
规划	gh
工程	gi
感觉	gj
公开	gk
管理	gl
干嘛	gm
给你	gn
乖哦	go
股票	gp
过去	gq
个人	gr
公司	gs
沟通	gt
故事	gu
关注	gv
给我	gw
关系	gx
关于	gy
工作	gz
好啊	ha
好吧	hb
缓存	hc
好的	hd
花儿	he
回复	hf
韩国	hg
哈哈	hh
火车	hi
环境	hj
好看	hk
回来	hl
还没	hm
还能	hn
海鸥	ho
害怕	hp
回去	hq
华人	hr
黑色	hs
合同	ht
还是	hu
或者	hv
和我	hw
好像	hx
还有	hy
合作	hz
长安	ia
成本	ib
尺寸	ic
成都	id
初二	ie
吃饭	if
成功	ig
出货	ih
出差	ii
创建	ij
查看	ik
出来	il
出门	im
承诺	in
吃藕	io
产品	ip
出去	iq
承认	ir
场所	is
传统	it
城市	iu
成长	iv
成为	iw
出现	ix
成员	iy
创造	iz
骄傲	ja
举报	jb
检测	jc
觉得	jd
金额	je
积分	jf
结果	jg
计划	jh
检查	ji
经济	jj
即可	jk
记录	jl
节目	jm
九年	jn
解耦	jo
精品	jp
进去	jq
进入	jr
计算	js
今天	jt
就是	ju
记者	jv
今晚	jw
进行	jx
建议	jy
就在	jz
可爱	ka
科比	kb
库存	kc
看到	kd
卡尔	ke
开发	kf
看过	kg
客户	kh
课程	ki
空间	kj
看看	kk
考虑	kl
昆明	km
可能	kn
看哦	ko
恐怕	kp
空气	kq
客人	kr
快速	ks
开通	kt
开始	ku
控制	kv
看完	kw
科学	kx
可以	ky
裤子	kz
恋爱	la
老板	lb
两次	lc
领导	ld
六二	le
浪费	lf
两个	lg
厉害	lh
流程	li
了解	lj
离开	lk
零零	ll
里面	lm
六年	ln
了哦	lo
老婆	lp
两千	lq
例如	lr
零四	ls
论坛	lt
老师	lu
楼主	lv
另外	lw
联系	lx
六月	ly
来自	lz
没啊	ma
目标	mb
每次	mc
面对	md
名额	me
麻烦	mf
美国	mg
漫画	mh
名称	mi
面积	mj
模块	mk
买了	ml
妈妈	mm
美女	mn
木偶	mo
名片	mp
目前	mq
没人	mr
貌似	ms
明天	mt
没事	mu
民主	mv
名为	mw
模型	mx
没有	my
名字	mz
你啊	na
那边	nb
农村	nc
你的	nd
女儿	ne
能否	nf
那个	ng
你好	nh
拿出	ni
那就	nj
你看	nk
能力	nl
你们	nm
那你	nn
你哦	no
哪怕	np
年轻	nq
内容	nr
浓缩	ns
那天	nt
你是	nu
那种	nv
那我	nw
那些	nx
那样	ny
你在	nz
哦啊	oa
欧巴	ob
哦操	oc
殴打	od
偶尔	oe
偶发	of
欧冠	og
耦合	oh
欧辰	oi
欧锦	oj
欧克	ok
哦了	ol
欧美	om
哦那	on
哦哦	oo
哦怕	op
怄气	oq
偶然	or
藕丝	os
呕吐	ot
欧式	ou
欧洲	ov
欧文	ow
偶像	ox
欧阳	oy
偶在	oz
平安	pa
旁边	pb
评测	pc
频道	pd
普尔	pe
皮肤	pf
苹果	pg
配合	ph
赔偿	pi
评价	pj
贫困	pk
评论	pl
排名	pm
陪你	pn
配偶	po
品牌	pp
脾气	pq
派人	pr
菩萨	ps
平台	pt
平时	pu
配置	pv
排位	pw
培训	px
朋友	py
骗子	pz
去啊	qa
全部	qb
其次	qc
确定	qd
企鹅	qe
缺乏	qf
全国	qg
前后	qh
汽车	qi
期间	qj
情况	qk
起来	ql
前面	qm
七年	qn
去哦	qo
七篇	qp
侵权	qq
确认	qr
轻松	qs
其他	qt
其实	qu
其中	qv
请问	qw
取消	qx
企业	qy
妻子	qz
人啊	ra
日本	rb
如此	rc
人的	rd
日俄	re
乳房	rf
如果	rg
然后	rh
日常	ri
人家	rj
人口	rk
人类	rl
人们	rm
让你	rn
日哦	ro
人品	rp
日期	rq
让人	rr
染色	rs
让他	rt
认识	ru
认证	rv
认为	rw
如下	rx
人员	ry
日子	rz
色啊	sa
三百	sb
三次	sc
速度	sd
索尔	se
算法	sf
三个	sg
似乎	sh
四川	si
司机	sj
思考	sk
算了	sl
扫描	sm
四年	sn
丧偶	so
三篇	sp
三千	sq
虽然	sr
搜索	ss
三天	st
三十	su
随着	sv
死亡	sw
思想	sx
所以	sy
所在	sz
图案	ta
贴吧	tb
套餐	tc
他的	td
胎儿	te
头发	tf
通过	tg
挺好	th
提出	ti
推荐	tj
痛苦	tk
讨论	tl
他们	tm
同年	tn
脱欧	to
图片	tp
提前	tq
突然	tr
投诉	ts
天天	tt
同时	tu
调整	tv
台湾	tw
同学	tx
天涯	ty
投资	tz
是啊	ua
设备	ub
收藏	uc
是的	ud
十二	ue
是否	uf
是个	ug
时候	uh
删除	ui
时间	uj
上课	uk
数量	ul
什么	um
十年	un
是哦	uo
视频	up
申请	uq
输入	ur
十四	us
身体	ut
水水	uu
设置	uv
十五	uw
实现	ux
使用	uy
实在	uz
障碍	va
准备	vb
这次	vc
知道	vd
周二	ve
政府	vf
这个	vg
之后	vh
支持	vi
直接	vj
展开	vk
这里	vl
这么	vm
只能	vn
中欧	vo
照片	vp
之前	vq
主任	vr
周三	vs
状态	vt
这是	vu
这种	vv
中午	vw
这些	vx
这样	vy
正在	vz
晚安	wa
五百	wb
卧槽	wc
我的	wd
巍峨	we
无法	wf
我国	wg
文化	wh
完成	wi
文件	wj
我看	wk
为了	wl
我们	wm
五年	wn
我哦	wo
物品	wp
完全	wq
微软	wr
哇塞	ws
问题	wt
我是	wu
文章	wv
威威	ww
微信	wx
我要	wy
我在	wz
西安	xa
下班	xb
下次	xc
兄弟	xd
邪恶	xe
幸福	xf
相关	xg
喜欢	xh
现场	xi
小姐	xj
辛苦	xk
心里	xl
项目	xm
性能	xn
西欧	xo
芯片	xp
需求	xq
新人	xr
迅速	xs
系统	xt
学生	xu
行政	xv
希望	xw
谢谢	xx
需要	xy
现在	xz
议案	ya
一百	yb
因此	yc
一点	yd
一二	ye
衣服	yf
一个	yg
以后	yh
一场	yi
已经	yj
一块	yk
原来	yl
页面	ym
一年	yn
亚欧	yo
一篇	yp
要求	yq
有人	yr
意思	ys
一天	yt
也是	yu
一直	yv
因为	yw
一下	yx
一样	yy
原则	yz
最爱	za
总部	zb
再次	zc
自动	zd
总额	ze
字符	zf
最高	zg
最后	zh
造成	zi
自己	zj
再看	zk
资料	zl
怎么	zm
在哪	zn
择偶	zo
作品	zp
足球	zq
自然	zr
赠送	zs
昨天	zt
早上	zu
作者	zv
作为	zw
最新	zx
资源	zy
坐在	zz
