啊	a
不	b
才	c
的	d
二	e
非	f
个	g
和	h
出	i
就	j
可	k
了	l
没	m
你	n
哦	o
平	p
去	q
人	r
三	s
他	t
是	u
这	v
我	w
小	x
一	y
在	z
阿	aa
昂	ah
爱	ai
安	an
奥	ao
把	ba
滨	bb
报	bc
白	bd
本	bf
蹦	bg
帮	bh
比	bi
办	bj
并	bk
边	bm
表	bn
拨	bo
别	bp
部	bu
被	bw
擦	ca
草	cc
菜	cd
测	ce
岑	cf
曾	cg
藏	ch
次	ci
参	cj
错	co
窜	cr
从	cs
粗	cu
催	cv
村	cy
凑	cz
大	da
到	dc
代	dd
得	de
等	dg
当	dh
地	di
但	dj
定	dk
点	dm
调	dn
多	do
跌	dp
丢	dq
段	dr
动	ds
读	du
对	dv
得	dw
顿	dy
都	dz
额	ee
鹤	eh
欸	ei
恩	en
而	er
法	fa
分	ff
风	fg
放	fh
反	fj
佛	fo
副	fu
费	fw
否	fz
嘎	ga
高	gc
该	gd
各	ge
跟	gf
更	gg
刚	gh
干	gj
怪	gk
光	gl
过	go
关	gr
共	gs
古	gu
贵	gv
给	gw
挂	gx
滚	gy
够	gz
哈	ha
好	hc
还	hd
何	he
很	hf
横	hg
行	hh
含	hj
坏	hk
黄	hl
或	ho
换	hr
红	hs
户	hu
会	hv
黑	hw
话	hx
混	hy
后	hz
差	ia
超	ic
拆	id
车	ie
陈	if
成	ig
长	ih
吃	ii
产	ij
揣	ik
窗	il
戳	io
传	ir
冲	is
处	iu
吹	iv
纯	iy
抽	iz
进	jb
几	ji
经	jk
将	jl
间	jm
叫	jn
接	jp
久	jq
卷	jr
据	ju
加	jx
均	jy
卡	ka
靠	kc
开	kd
克	ke
肯	kf
坑	kg
抗	kh
看	kj
快	kk
况	kl
扩	ko
宽	kr
空	ks
酷	ku
亏	kv
剋	kw
夸	kx
困	ky
口	kz
拉	la
林	lb
老	lc
来	ld
乐	le
冷	lg
浪	lh
里	li
另	lk
两	ll
连	lm
料	ln
落	lo
列	lp
刘	lq
乱	lr
龙	ls
路	lu
率	lv
类	lw
论	ly
楼	lz
吗	ma
民	mb
毛	mc
买	md
么	me
们	mf
梦	mg
忙	mh
米	mi
慢	mj
名	mk
面	mm
秒	mn
末	mo
灭	mp
目	mu
每	mw
某	mz
那	na
您	nb
闹	nc
呢	ne
嫩	nf
能	ng
囊	nh
泥	ni
难	nj
宁	nk
年	nm
鸟	nn
挪	no
捏	np
牛	nq
暖	nr
弄	ns
虐	nt
怒	nu
女	nv
内	nw
嗯	og
喔	oo
欧	ou
怕	pa
品	pb
跑	pc
排	pd
盆	pf
碰	pg
旁	ph
批	pi
盘	pj
凭	pk
片	pm
票	pn
破	po
撇	pp
普	pu
配	pw
剖	pz
亲	qb
其	qi
请	qk
强	ql
前	qm
桥	qn
且	qp
求	qq
全	qr
穷	qs
却	qt
区	qu
恰	qx
群	qy
绕	rc
热	re
任	rf
仍	rg
让	rh
日	ri
然	rj
若	ro
软	rr
容	rs
如	ru
肉	rz
撒	sa
扫	sc
赛	sd
色	se
森	sf
僧	sg
四	si
散	sj
所	so
算	sr
送	ss
苏	su
岁	sv
搜	sz
她	ta
套	tc
太	td
特	te
疼	tg
汤	th
体	ti
谈	tj
听	tk
天	tm
调	tn
托	to
贴	tp
团	tr
同	ts
图	tu
推	tv
头	tz
啥	ua
少	uc
晒	ud
设	ue
深	uf
生	ug
上	uh
事	ui
山	uj
帅	uk
双	ul
说	uo
拴	ur
数	uu
水	uv
谁	uw
顺	uy
受	uz
扎	va
找	vc
着	ve
真	vf
正	vg
长	vh
只	vi
占	vj
拽	vk
装	vl
桌	vo
转	vr
中	vs
主	vu
追	vv
抓	vx
周	vz
挖	wa
外	wd
问	wf
翁	wg
王	wh
完	wj
握	wo
无	wu
为	ww
新	xb
系	xi
行	xk
想	xl
先	xm
笑	xn
些	xp
修	xq
选	xr
熊	xs
学	xt
需	xu
下	xx
亚	ya
因	yb
要	yc
也	ye
样	yh
以	yi
眼	yj
应	yk
哟	yo
元	yr
用	ys
月	yt
与	yu
云	yy
有	yz
咋	za
早	zc
再	zd
则	ze
怎	zf
增	zg
藏	zh
字	zi
做	zo
总	zs
组	zu
最	zv
贼	zw
走	zz
阿	aae
锕	aaj
吖	aak
腌	aao
肮	aho
卬	ahp
盎	ahy
癌	aib
艾	aic
隘	aie
挨	aif
锿	aij
唉	aik
嫒	ain
暧	aio
爱	aip
欸	ais
埃	ait
矮	aiu
哀	aiw
霭	aiy
案	anb
鹌	and
岸	ane
按	anf
庵	ang
黯	anh
铵	anj
唵	ank
桉	anm
暗	ano
氨	anq
俺	anr
埯	ant
谙	any
奡	aoa
翱	aob
澳	aod
隩	aoe
熬	aof
鏖	aog
嗷	aok
凹	aol
媪	aon
袄	aop
傲	aor
坳	aot
璈	aow
懊	aox
岙	aoy
遨	aoz
鲅	baa
爸	bab
芭	bac
灞	bad
岜	bae
拔	baf
靶	bag
钯	baj
吧	bak
耙	bal
粑	bam
妭	ban
胈	bao
八	bap
罢	bas
坝	bat
巴	bav
霸	bay
跋	baz
鬓	bba
宾	bbb
殡	bbd
豳	bbe
摈	bbf
髌	bbg
镔	bbj
彬	bbm
膑	bbo
傧	bbr
缤	bbs
斌	bbw
鲍	bca
包	bcb
薄	bcc
瀑	bcd
剥	bce
抱	bcf
爆	bch
暴	bco
褓	bcp
保	bcr
饱	bcu
豹	bcv
褒	bcw
雹	bcy
趵	bcz
百	bda
摆	bdf
稗	bdh
败	bdk
柏	bdm
佰	bdr
拜	bdu
本	bfa
坌	bfb
苯	bfc
奔	bfd
锛	bfj
栟	bfm
犇	bfn
畚	bfs
笨	bfv
甭	bgb
崩	bge
蚌	bgi
镚	bgj
嘣	bgk
祊	bgp
绷	bgs
泵	bgu
琫	bgw
迸	bgz
蒡	bhc
浜	bhd
邦	bhf
蚌	bhi
镑	bhj
棒	bhm
膀	bho
傍	bhr
绑	bhs
塝	bht
磅	bhu
玤	bhw
谤	bhy
鲾	bia
毙	bib
蔽	bic
必	bid
陛	bie
庇	big
秕	bih
彼	bii
铋	bij
哔	bik
闭	bim
婢	bin
币	bip
狴	biq
俾	bir
畀	bit
壁	biu
笔	biv
碧	biw
愎	bix
诐	biy
避	biz
颁	bjb
半	bjd
阪	bje
搬	bjf
瓣	bjl
板	bjm
版	bjp
伴	bjr
绊	bjs
坂	bjt
般	bjv
班	bjw
丙	bka
病	bkb
冰	bkd
摒	bkf
炳	bkh
蛃	bki
柄	bkm
昺	bko
秉	bkp
兵	bkq
饼	bku
禀	bkw
鳊	bma
苄	bmc
汴	bmd
抃	bmf
鞭	bmg
扁	bmh
贬	bmk
辩	bml
昪	bmo
褊	bmp
便	bmr
编	bms
砭	bmu
变	bmw
忭	bmx
遍	bmz
鳔	bna
瘭	bnb
蔈	bnc
彪	bnh
镖	bnj
标	bnm
婊	bnn
膘	bno
裱	bnp
飙	bnq
俵	bnr
鲌	boa
帛	bob
薄	boc
波	bod
剥	boe
播	bof
馞	boh
铂	boj
啵	bok
卜	bol
柏	bom
膊	boo
伯	bor
博	bou
箔	bov
玻	bow
跛	boz
瘪	bpb
憋	bpd
别	bpk
不	bua
蔀	buc
捕	buf
钚	buj
哺	buk
卜	bul
晡	buo
补	bup
堡	bur
埠	but
布	buu
步	buv
怖	bux
逋	buz
蓓	bwc
陂	bwe
悲	bwf
焙	bwh
钡	bwj
呗	bwk
北	bwl
杯	bwm
卑	bwp
狈	bwq
倍	bwr
碑	bwu
备	bww
悖	bwx
擦	caf
嚓	cak
曹	cca
漕	ccd
操	ccf
螬	cci
嘈	cck
槽	ccm
艚	ccv
才	cda
蔡	cdc
财	cdk
材	cdm
睬	cdo
采	cdp
猜	cdq
偲	cdr
裁	cdu
踩	cdz
测	ced
厕	cei
册	cep
侧	cer
策	cev
恻	cex
涔	cfd
岑	cfe
参	cfs
曾	cgb
嶒	cge
噌	cgk
层	cgu
蹭	cgz
苍	chc
沧	chd
仓	chr
舱	chv
刺	cia
慈	cib
茨	cic
瓷	cid
赐	cik
糍	cim
祠	cip
辞	ciq
伺	cir
磁	ciu
此	civ
词	ciy
跐	ciz
残	cjd
掺	cjf
灿	cjh
餐	cjl
骖	cjm
蚕	cjt
孱	cju
璨	cjw
惨	cjx
痤	cob
莝	coc
嵯	coe
搓	cof
厝	coi
锉	coj
鹾	col
酂	con
脞	coo
矬	cou
蹉	coz
窜	crb
攒	crf
镩	crj
爨	crp
汆	crr
篡	crv
蹿	crz
匆	csb
葱	csc
淙	csd
聪	cse
熜	csh
骢	csm
囱	csp
丛	csr
琮	csw
悰	csx
蹙	cua
蔟	cuc
殂	cud
徂	cui
粗	cum
猝	cuq
促	cur
簇	cuv
卒	cuw
醋	cuy
蹴	cuz
瘁	cvb
萃	cvc
淬	cvd
崔	cve
摧	cvf
啐	cvk
粹	cvm
脆	cvo
催	cvr
缞	cvs
璀	cvw
翠	cvx
寸	cya
皴	cys
邨	cyt
存	cyu
忖	cyx
辏	czi
腠	czo
瘩	dab
荙	dac
耷	dad
打	daf
鞑	dag
炟	dah
哒	dak
妲	dan
褡	dap
垯	dat
沓	dau
答	dav
怛	dax
达	daz
鱽	dca
盗	dcd
捣	dcf
稻	dch
帱	dcj
叨	dck
岛	dcp
氘	dcq
倒	dcr
导	dcs
刀	dcv
悼	dcx
道	dcz
歹	dda
殆	ddd
叇	dde
带	ddf
待	ddi
呆	ddk
贷	ddr
怠	dds
戴	ddu
玳	ddw
逮	ddz
德	dei
锝	dej
嘚	dek
地	det
扽	dff
澄	dgd
嶝	dge
灯	dgh
噔	dgk
瞪	dgo
磴	dgu
登	dgv
璒	dgw
邓	dgy
蹬	dgz
宕	dhb
荡	dhc
挡	dhf
铛	dhj
档	dhm
裆	dhp
垱	dht
凼	dhu
珰	dhw
党	dhx
谠	dhy
髢	dia
弟	dib
蒂	dic
涤	did
抵	dif
底	dig
䗖	dii
镝	dij
嘀	dik
棣	dim
嫡	din
睇	dio
敌	diq
低	dir
缔	dis
堤	dit
氐	diu
第	div
帝	diw
谛	diy
递	diz
石	dja
单	djb
萏	djc
淡	djd
耽	dje
担	djf
弹	djg
啖	djk
胆	djo
丹	djp
氮	djq
儋	djr
蛋	djv
惮	djx
诞	djy
丁	dka
疔	dkb
顶	dkd
耵	dke
钉	dkj
叮	dkk
盯	dko
仃	dkr
町	dkt
碇	dku
玎	dkw
订	dky
癫	dmb
滇	dmd
巅	dme
垫	dmf
店	dmg
扂	dmh
钿	dmj
电	dml
佃	dmr
殿	dmu
玷	dmw
惦	dmx
踮	dmz
鲷	dna
窎	dnb
凋	dnd
掉	dnf
钓	dnj
吊	dnk
鸟	dnp
刁	dnv
鸟	dnw
夺	dod
堕	doe
掇	dof
度	dog
朵	doj
咄	dok
驮	dom
裰	dop
垛	dot
躲	dou
舵	dov
惰	dox
跺	doz
鲽	dpa
爹	dpb
瓞	dpg
蝶	dpi
喋	dpk
耋	dpl
昳	dpo
牒	dpp
绖	dps
垤	dpt
碟	dpu
叠	dpy
迭	dpz
铥	dqj
丢	dqp
耑	dre
煅	drh
锻	drj
端	drl
断	drm
缎	drs
塅	drt
短	dru
簖	drv
东	dsa
董	dsc
洞	dsd
岽	dse
咚	dsk
栋	dsm
胴	dso
氡	dsq
侗	dsr
垌	dst
硐	dsu
冬	dsw
懂	dsx
蠹	dua
渡	dud
毒	duf
度	dug
黩	duh
镀	duj
赌	duk
都	dul
杜	dum
妒	dun
肚	duo
牍	dup
独	duq
堵	dut
督	duu
笃	duv
读	duy
兑	dvb
队	dve
镦	dvj
祋	dvp
堆	dvt
碓	dvu
敦	dvw
怼	dvy
得	dwi
嗲	dxk
沌	dyd
炖	dyh
钝	dyj
吨	dyk
盹	dyo
盾	dyp
墩	dyt
敦	dyw
蹲	dyz
豆	dza
痘	dzb
蔸	dzc
斗	dzd
陡	dze
抖	dzf
蚪	dzi
钭	dzj
兜	dzp
篼	dzv
逗	dzz
鳄	eea
额	eeb
萼	eec
峨	eee
扼	eef
厄	eei
锷	eej
呃	eek
阏	eem
娥	een
腭	eeo
俄	eer
饿	eeu
鹅	eew
愕	eex
恶	eey
遏	eez
欸	eis
蒽	enc
摁	enf
嗯	enk
耳	era
尔	erd
鸸	ere
铒	erj
咡	erk
儿	erp
佴	err
饵	eru
珥	erw
贰	ery
迩	erz
阀	fam
乏	fap
伐	far
罚	fas
砝	fau
发	fav
珐	faw
鲼	ffa
忿	ffb
芬	ffc
奋	ffd
吩	ffk
粉	ffm
氛	ffq
份	ffr
纷	ffs
坟	fft
玢	ffw
愤	ffx
酚	ffy
丰	fga
疯	fgb
葑	fgc
冯	fgd
峰	fge
奉	fgf
烽	fgh
蜂	fgi
锋	fgj
唪	fgk
枫	fgm
俸	fgr
缝	fgs
封	fgt
砜	fgu
讽	fgy
逢	fgz
鲂	fha
芳	fhc
方	fhd
防	fhe
邡	fhf
房	fhh
彷	fhi
钫	fhj
枋	fhm
妨	fhn
肪	fho
仿	fhr
纺	fhs
坊	fht
舫	fhv
访	fhy
范	fjc
泛	fjd
烦	fjh
凡	fjj
贩	fjk
樊	fjm
翻	fjp
犯	fjq
畈	fjt
饭	fju
璠	fjw
返	fjz
佛	for
夫	fua
富	fub
芙	fuc
负	fud
附	fue
扶	fuf
府	fug
馥	fuh
辅	fui
幅	fuj
赋	fuk
孵	ful
驸	fum
妇	fun
服	fuo
福	fup
氟	fuq
付	fur
缚	fus
赴	fut
砆	fuu
符	fuv
覆	fux
讣	fuy
跗	fuz
鲱	fwa
痱	fwb
菲	fwc
沸	fwd
斐	fwf
废	fwg
扉	fwh
镄	fwj
匪	fwk
榧	fwm
妃	fwn
肥	fwo
狒	fwq
绯	fws
飞	fwv
诽	fwy
否	fzb
缶	fzw
夹	gaa
轧	gai
噶	gak
尕	gan
胳	gao
伽	gar
尬	gau
尜	gax
尬	gay
皋	gcb
藁	gcc
搞	gcf
稿	gch
镐	gcj
糕	gcm
告	gcn
杲	gco
睾	gcp
篙	gcv
膏	gcw
羔	gcy
丐	gda
荄	gdc
溉	gdd
陔	gde
改	gdj
赅	gdk
概	gdm
戤	gdn
晐	gdo
垓	gdt
盖	gdy
歌	gea
割	geb
葛	gec
歌	ged
隔	gee
搁	gef
骼	geg
蛤	gei
铬	gej
嗝	gek
哿	gel
格	gem
革	gen
胳	geo
袼	gep
鸽	ger
纥	ges
圪	get
硌	geu
舸	gev
盖	gey
亘	gfa
茛	gfc
艮	gfe
哏	gfk
根	gfm
艮	gfv
鲠	gga
浭	ggd
耿	gge
庚	ggg
哽	ggk
耕	ggl
梗	ggm
暅	ggo
绠	ggs
埂	ggt
颈	ggv
羹	ggy
港	ghd
岗	ghe
缸	ghf
钢	ghj
冈	ghk
戆	ghl
杠	ghm
肛	gho
纲	ghs
堽	ght
矼	ghu
筻	ghv
甘	gja
疳	gjb
苷	gjc
淦	gjd
擀	gjf
秆	gjh
赣	gjl
杆	gjm
甘	gjn
肝	gjo
绀	gjs
赶	gjt
尴	gju
敢	gjv
感	gjw
感	gjx
尴	gjy
拐	gkf
乖	gkq
夬	gkv
广	gld
咣	glk
胱	glo
犷	glq
广	glw
逛	glz
馘	gob
聒	goe
掴	gof
蜾	goi
锅	goj
国	gok
果	gol
腘	goo
虢	gop
埚	got
郭	gow
鳏	gra
官	grb
莞	grc
灌	grd
罐	grf
贯	grg
爟	grh
棺	grm
盥	grp
倌	grr
纶	grs
馆	gru
管	grv
惯	grx
观	gry
工	gsa
公	gsb
恭	gsc
觥	gsd
拱	gsf
贡	gsg
蚣	gsi
唝	gsk
龚	gsl
肱	gso
供	gsr
躬	gsu
弓	gsv
珙	gsw
鲴	gua
谷	gub
菇	guc
沽	gud
崮	gue
鹘	gug
雇	guh
顾	gui
钴	guj
固	guk
骨	gul
梏	gum
姑	gun
股	guo
估	gur
罟	gus
鼓	guu
箍	guv
贾	gux
诂	guy
孤	guz
鲑	gva
皈	gvb
龟	gvd
刿	gve
规	gvf
庋	gvg
轨	gvi
匦	gvk
归	gvl
桂	gvm
妫	gvn
晷	gvo
鬼	gvp
刽	gvr
圭	gvt
硅	gvu
癸	gvv
瑰	gvw
诡	gvy
跪	gvz
给	gws
寡	gxb
挂	gxf
剐	gxk
栝	gxm
胍	gxo
瓜	gxp
刮	gxq
卦	gxt
鲧	gya
辊	gyi
棍	gym
绲	gys
磙	gyu
衮	gyw
觏	gza
勾	gzb
苟	gzc
沟	gzd
岣	gze
鞲	gzg
钩	gzj
购	gzk
构	gzm
媾	gzn
狗	gzq
佝	gzr
缑	gzs
垢	gzt
篝	gzv
诟	gzy
遘	gzz
蛤	hai
铪	haj
哈	hak
皓	hcb
薅	hcc
浩	hcd
蚝	hci
镐	hcj
号	hck
耗	hcl
昊	hco
郝	hct
貉	hcv
豪	hcw
害	hdb
海	hdd
骸	hdg
嗨	hdk
骇	hdm
胲	hdo
氦	hdq
亥	hdw
醢	hdy
孩	hdz
翮	hea
荷	hec
河	hed
鞨	heg
熇	heh
喝	hek
贺	hel
核	hem
曷	heo
褐	hep
禾	heq
合	her
纥	hes
赫	het
貉	hev
劾	hew
翯	hex
诃	hey
痕	hfb
狠	hfq
恨	hfx
蘅	hgc
衡	hgi
哼	hgk
桁	hgm
姮	hgn
亨	hgw
恒	hgx
巷	hhc
夯	hhd
行	hhi
吭	hhk
杭	hhm
绗	hhs
航	hhv
颃	hhw
寒	hjb
菡	hjc
汉	hjd
崡	hje
捍	hjf
邯	hjg
焊	hjh
蚶	hji
喊	hjk
函	hjl
阚	hjm
旱	hjo
犴	hjq
颔	hjr
韩	hju
憨	hjv
憾	hjx
酣	hjy
鼾	hjz
淮	hkd
徊	hki
槐	hkm
坏	hkt
怀	hkx
踝	hkz
鳇	hla
皇	hlb
荒	hlc
湟	hld
隍	hle
煌	hlh
蝗	hli
凰	hlj
媓	hln
晃	hlo
簧	hlv
慌	hlx
谎	hly
遑	hlz
豁	hob
获	hoc
活	hod
彟	hoe
攉	hof
惑	hog
和	hoh
蠖	hoi
镬	hoj
嚯	hok
耠	hol
祸	hop
货	hor
霍	hoy
鲩	hra
痪	hrb
萑	hrc
涣	hrd
峘	hre
擐	hrf
焕	hrh
患	hri
豢	hrj
唤	hrk
桓	hrm
嬛	hrn
㬊	hro
獾	hrq
缓	hrs
貆	hrv
环	hrw
欢	hry
还	hrz
宏	hsb
蕻	hsc
洪	hsd
弘	hsg
烘	hsh
虹	hsi
哄	hsk
竑	hsl
闳	hsm
翃	hsu
黉	hsx
讧	hsy
互	hua
葫	huc
沪	hud
岵	hue
护	huf
弧	hug
虎	huh
蝴	hui
呼	huk
糊	hum
鹄	hun
昒	huo
乎	hup
狐	huq
胡	huu
笏	huv
忽	huw
怙	hux
醐	huy
惠	hva
荟	hvc
汇	hvd
堕	hve
挥	hvf
麾	hvg
秽	hvh
徽	hvi
毁	hvj
回	hvk
桧	hvm
晖	hvo
会	hvr
绘	hvs
灰	hvu
珲	hvw
悔	hvx
讳	hvy
嘿	hwk
画	hxa
花	hxc
滑	hxd
划	hxg
铧	hxj
哗	hxk
桦	hxm
婳	hxn
猾	hxq
化	hxr
荤	hyc
浑	hyd
魂	hye
阍	hym
婚	hyn
昏	hyu
珲	hyw
诨	hyy
鲘	hza
瘊	hzb
骺	hzg
厚	hzi
吼	hzk
糇	hzm
垕	hzp
猴	hzq
候	hzr
篌	hzv
鲎	hzx
逅	hzz
察	iab
茶	iac
汊	iad
嵖	iae
插	iaf
镲	iaj
喳	iak
查	iam
姹	ian
衩	iap
猹	iaq
侘	iar
碴	iau
刹	iax
叉	iay
蹅	iaz
潮	icd
抄	icf
弨	icg
炒	ich
钞	icj
吵	ick
耖	icl
晁	ico
绰	ics
超	ict
朝	icu
巢	icv
怊	icx
瘥	idb
茝	idc
钗	idj
侪	idr
柴	idv
虿	idw
差	idy
车	iea
澈	ied
撤	ief
彻	iei
㬚	ieo
掣	iep
坼	iet
砗	ieu
宸	ifb
沉	ifd
陈	ife
抻	iff
称	ifh
辰	ifi
臣	ifk
郴	ifm
晨	ifo
衬	ifp
伧	ifr
趁	ift
碜	ifu
龀	ifv
琛	ifw
尘	ifx
谶	ify
澄	igd
撑	igf
称	igh
惩	igi
铖	igj
呈	igk
丞	igl
橙	igm
瞠	igo
裎	igp
乘	igq
城	igt
承	igv
珵	igw
诚	igy
逞	igz
厂	iha
苌	ihc
徜	ihi
唱	ihk
阊	ihm
娼	ihn
肠	iho
猖	ihq
偿	ihr
场	iht
畅	ihu
常	ihx
昶	ihy
豉	iia
痴	iib
茌	iic
池	iid
耻	iie
持	iif
弛	iig
炽	iih
螭	iii
嗤	iik
驰	iim
媸	iin
匙	iio
斥	iip
侈	iir
赤	iit
尺	iiu
齿	iiv
啻	iiw
迟	iiz
单	ijb
蒇	ijc
潺	ijd
巉	ije
搀	ijf
蝉	iji
铲	ijj
啴	ijk
阐	ijm
婵	ijn
旵	ijo
禅	ijp
缠	ijs
馋	iju
颤	ijw
忏	ijx
谄	ijy
躔	ijz
搋	ikf
啜	ikk
踹	ikz
疮	ilb
床	ilg
幢	ilj
噇	ilk
闯	ilm
创	ilr
怆	ilx
辍	ioi
啜	iok
绰	ios
龊	iov
惙	iox
踔	ioz
穿	irb
钏	irj
喘	irk
串	irl
椽	irm
川	irp
氚	irq
船	irv
舛	irx
遄	irz
宠	isb
茺	isc
崇	ise
舂	isf
种	ish
铳	isj
重	isp
虫	isv
充	isw
憧	isx
亍	iua
触	iud
除	iue
搐	iuf
黜	iuh
厨	iui
锄	iuj
楚	ium
初	iup
储	iur
绌	ius
础	iuu
畜	iuw
怵	iux
躇	iuz
陲	ive
捶	ivf
炊	ivh
锤	ivj
圌	ivk
槌	ivm
垂	ivp
倕	ivr
䲠	iya
莼	iyc
淳	iyd
春	iyf
唇	iyi
椿	iym
鹑	iyw
醇	iyy
瘳	izb
愁	izh
帱	izj
杻	izm
瞅	izo
仇	izr
绸	izs
畴	izt
丑	izv
惆	izx
酬	izy
臭	izz
荩	jbc
津	jbd
靳	jbg
烬	jbh
尽	jbi
锦	jbj
噤	jbk
紧	jbl
禁	jbm
妗	jbn
斤	jbp
金	jbr
缙	jbs
劲	jbv
瑾	jbw
谨	jby
近	jbz
击	jia
寄	jib
藉	jic
急	jid
际	jie
挤	jif
即	jig
稽	jih
辑	jii
忌	jij
唧	jik
冀	jil
机	jim
嫉	jin
肌	jio
及	jip
基	jiq
集	jir
级	jis
圾	jit
吉	jiu
己	jiv
剂	jiw
悸	jix
记	jiy
迹	jiz
井	jka
痉	jkb
敬	jkc
净	jkd
阱	jke
静	jkf
径	jki
镜	jkj
竟	jkl
精	jkm
婧	jkn
晶	jko
獍	jkq
儆	jkr
经	jks
境	jkt
兢	jku
劲	jkv
京	jkw
惊	jkx
迳	jkz
豇	jla
蒋	jlc
江	jld
降	jle
疆	jlg
匠	jlk
耩	jll
糨	jlm
膙	jlo
僵	jlr
缰	jls
礓	jlu
讲	jly
柬	jma
兼	jmb
荐	jmc
减	jmd
捡	jmf
鞯	jmg
肩	jmh
键	jmj
见	jmk
坚	jml
检	jmm
奸	jmn
腱	jmo
裥	jmp
件	jmr
缄	jms
碱	jmu
简	jmv
尖	jmx
谏	jmy
建	jmz
鲛	jna
窖	jnb
蕉	jnc
角	jnd
峤	jne
搅	jnf
较	jni
铰	jnj
嚼	jnk
教	jnl
椒	jnm
娇	jnn
脚	jno
狡	jnq
焦	jnr
缴	jns
礁	jnu
剿	jnv
交	jnw
觉	jnx
酵	jny
跤	jnz
鲒	jpa
皆	jpb
节	jpc
洁	jpd
阶	jpe
揭	jpf
戒	jpg
秸	jph
街	jpi
竭	jpl
杰	jpm
姐	jpn
睫	jpo
借	jpr
结	jps
界	jpt
截	jpu
孑	jpv
桀	jpx
诫	jpy
鬏	jqa
究	jqb
酒	jqd
㠇	jqe
揪	jqf
厩	jqi
舅	jqj
啾	jqk
旧	jql
柩	jqm
九	jqp
救	jqq
纠	jqs
赳	jqt
玖	jqw
蠲	jrb
涓	jrd
捐	jrf
眷	jrj
鹃	jrk
娟	jrn
狷	jrq
倦	jrr
绢	jrs
窘	jsb
炯	jsh
炅	jso
䌹	jss
坰	jst
迥	jsz
蕨	jtc
决	jtd
崛	jte
掘	jtf
爝	jth
厥	jti
嚼	jtk
桷	jtm
矍	jto
爵	jtp
獗	jtq
倔	jtr
绝	jts
砄	jtu
孓	jtv
玦	jtw
觉	jtx
诀	jty
蹶	jtz
车	jua
句	jub
菊	juc
沮	jud
聚	jue
拒	juf
鞠	jug
炬	juh
锯	juj
巨	juk
且	jul
橘	jum
裾	jup
具	juq
俱	jur
趄	jut
局	juu
龃	juv
琚	juw
举	jux
醵	juy
距	juz
夹	jxa
家	jxb
荚	jxc
浃	jxd
岬	jxe
恝	jxf
稼	jxh
蛱	jxi
钾	jxj
架	jxl
枷	jxm
嫁	jxn
胛	jxo
假	jxr
嘉	jxu
笳	jxv
珈	jxw
贾	jxx
迦	jxz
军	jyb
菌	jyc
龟	jyd
峻	jye
麇	jyg
焌	jyh
钧	jyj
竣	jyl
骏	jym
晙	jyo
俊	jyr
鋆	jyt
筠	jyv
君	jyy
咖	kak
胩	kao
卡	kau
洘	kcd
拷	kcf
烤	kch
铐	kcj
考	kcl
栲	kcm
犒	kcn
尻	kcu
开	kda
蒈	kdc
凯	kde
揩	kdf
炌	kdh
楷	kdm
垲	kdt
慨	kdx
客	keb
苛	kec
渴	ked
岢	kee
颗	keg
科	keh
轲	kei
锞	kej
咳	kek
棵	kem
瞌	keo
牁	kep
氪	keq
缂	kes
坷	ket
壳	keu
刻	kew
恪	kex
课	key
恳	kfg
啃	kfk
裉	kfp
龈	kfv
铿	kgj
吭	kgk
坑	kgt
硁	kgu
扛	khf
康	khg
炕	khh
钪	khj
糠	khm
伉	khr
亢	khw
慷	khx
莰	kjc
崁	kje
刊	kjg
槛	kjm
瞰	kjo
勘	kjq
侃	kjr
坎	kjt
砍	kju
鲙	kka
蒯	kkc
浍	kkd
㧟	kkf
哙	kkk
脍	kko
狯	kkq
会	kkr
块	kkt
筷	kkv
夼	kld
邝	klg
匡	klk
框	klm
旷	klo
狂	klq
纩	kls
圹	klt
矿	klu
筐	klv
诳	kly
括	kof
廓	kog
蛞	koi
阔	kom
适	koz
宽	krb
髋	krg
款	kru
崆	kse
控	ksf
恐	ksg
倥	ksr
硿	ksu
箜	ksv
孔	ksz
窟	kub
苦	kuc
刳	kud
库	kug
哭	kuk
枯	kum
裤	kup
绔	kus
矻	kuu
喾	kux
酷	kuy
窥	kvb
葵	kvc
溃	kvd
岿	kve
揆	kvf
魁	kvg
煃	kvh
蝰	kvi
馗	kvj
匮	kvk
睽	kvo
傀	kvr
盔	kvu
篑	kvv
愧	kvx
逵	kvz
挎	kxf
姱	kxn
胯	kxo
侉	kxr
垮	kxt
跨	kxz
鲲	kya
捆	kyf
焜	kyh
锟	kyj
昆	kyo
坤	kyt
壸	kyu
琨	kyw
寇	kzb
蔻	kzc
扣	kzf
叩	kzk
口	kzl
眍	kzo
筘	kzv
瘌	lab
落	lac
鞡	lag
蜡	lai
镴	laj
啦	lak
辣	lal
腊	lao
垃	lat
剌	lau
邋	laz
鳞	lba
蔺	lbc
淋	lbd
嶙	lbe
拎	lbf
麟	lbg
辚	lbi
啉	lbk
临	lbl
粼	lbm
瞵	lbo
邻	lbr
磷	lbu
琳	lbw
霖	lby
躏	lbz
牢	lcb
劳	lcc
涝	lcd
崂	lce
捞	lcf
烙	lch
铑	lcj
唠	lck
耢	lcl
栳	lcm
姥	lcn
乐	lcp
佬	lcr
络	lcs
酪	lcy
来	lda
癞	ldb
莱	ldc
濑	ldd
崃	lde
徕	ldi
梾	ldm
睐	ldo
赖	ldu
籁	ldv
鳓	lea
泐	led
勒	leg
嘞	lek
肋	leo
乐	lep
仂	ler
饹	leu
簕	lev
崚	lge
楞	lgm
塄	lgt
愣	lgx
莨	lhc
郎	lhd
崀	lhe
廊	lhg
烺	lhh
螂	lhi
啷	lhk
榔	lhm
㫰	lho
狼	lhq
琅	lhw
丽	lia
痢	lib
莉	lic
漓	lid
峛	lie
利	lih
历	lii
锂	lij
哩	lik
郦	lil
李	lim
娌	lin
礼	lip
狸	liq
例	lir
罹	lis
坜	lit
砾	liu
力	liv
离	liw
栗	lix
雳	liy
逦	liz
兰	ljb
蓝	ljc
滥	ljd
岚	lje
拦	ljf
烂	ljh
镧	ljj
览	ljl
栏	ljm
褴	ljp
缆	ljs
篮	ljv
斓	ljw
懒	ljx
谰	ljy
鲮	lka
菱	lkc
凌	lkd
岭	lke
蛉	lki
铃	lkj
呤	lkk
棱	lkm
姈	lkn
祾	lkp
令	lkr
绫	lks
坽	lkt
龄	lkv
玲	lkw
零	lky
两	lla
莨	llc
梁	lld
靓	llf
魉	llg
辆	lli
粮	llm
量	llo
俩	llr
墚	llt
亮	llw
悢	llx
谅	lly
踉	llz
鲢	lma
帘	lmb
莲	lmc
殓	lmd
联	lme
廉	lmg
炼	lmh
蠊	lmi
链	lmj
楝	lmm
脸	lmo
裢	lmp
敛	lmr
练	lms
恋	lmw
怜	lmx
鹩	lna
疗	lnb
蓼	lnc
潦	lnd
聊	lne
撩	lnf
廖	lng
燎	lnh
镣	lnj
嘹	lnk
料	lnm
瞭	lno
獠	lnq
僚	lnr
缭	lns
尥	lnu
了	lnv
憭	lnx
尥	lny
辽	lnz
瘰	lob
萝	loc
洛	lod
摞	lof
烙	loh
螺	loi
锣	loj
咯	lok
骡	lom
脶	loo
裸	lop
猡	loq
倮	lor
罗	los
硌	lou
箩	lov
雒	low
逻	loz
鬣	lpa
裂	lpd
捩	lpf
咧	lpk
脟	lpo
猎	lpq
趔	lpt
劣	lpu
躐	lpz
瘤	lqb
流	lqd
陆	lqe
旒	lqf
熘	lqh
镏	lqj
柳	lqm
留	lqp
绺	lqs
硫	lqu
六	lqw
鹨	lqx
遛	lqz
滦	lrd
卵	lrp
乱	lrq
鸾	lrw
窿	lsb
泷	lsd
隆	lse
拢	lsf
咙	lsk
聋	lsl
栊	lsm
胧	lso
龙	lsu
笼	lsv
弄	lsw
掠	ltf
圙	ltk
略	ltt
鲁	lua
芦	luc
泸	lud
录	lue
撸	luf
鹿	lug
炉	luh
轳	lui
镥	luj
赂	luk
卢	lul
橹	lum
胪	luo
禄	lup
绿	lus
垆	lut
碌	luu
箓	luv
璐	luw
勠	lux
露	luy
鹭	luz
葎	lvc
滤	lvd
旅	lvf
虑	lvh
律	lvi
铝	lvj
吕	lvk
驴	lvm
褛	lvp
氯	lvq
侣	lvr
绿	lvs
屡	lvu
率	lvw
耒	lwa
蕾	lwc
泪	lwd
擂	lwf
勒	lwg
镭	lwj
嘞	lwk
檑	lwm
嫘	lwn
肋	lwo
儡	lwr
垒	lws
累	lwt
磊	lwu
羸	lww
雷	lwy
俩	lxr
沦	lyd
抡	lyf
轮	lyi
囵	lyk
伦	lyr
纶	lys
剅	lza
瘘	lzb
蒌	lzc
漏	lzd
陋	lze
搂	lzf
髅	lzg
蝼	lzi
镂	lzj
喽	lzk
耧	lzl
娄	lzm
䁖	lzo
偻	lzr
篓	lzv
露	lzy
抹	maf
麻	mag
蚂	mai
嘛	mak
杩	mam
妈	man
祃	map
犸	maq
码	mau
马	mav
玛	maw
孖	maz
苠	mbc
泯	mbd
岷	mbe
抿	mbf
黾	mbk
皿	mbl
闽	mbm
旻	mbo
敏	mbp
缗	mbs
玟	mbw
悯	mbx
髦	mca
茂	mcc
泖	mcd
峁	mce
旄	mcf
帽	mcj
冒	mck
耄	mcl
懋	mcm
牦	mcn
冒	mco
贸	mcp
猫	mcq
矛	mcs
貌	mcv
袤	mcw
荬	mdc
麦	mdf
唛	mdk
脉	mdo
埋	mdt
卖	mdu
劢	mdw
霾	mdy
迈	mdz
么	mep
门	mfd
扪	mff
焖	mfh
钔	mfj
闷	mfm
萌	mgc
㠓	mge
蜢	mgi
锰	mgj
檬	mgm
盟	mgo
猛	mgq
礞	mgu
艋	mgv
氓	mgw
懵	mgx
茫	mhc
漭	mhd
蟒	mhi
牤	mhn
硭	mhu
盲	mhw
忙	mhx
蜜	mib
蘼	mic
泌	mid
弥	mig
秘	mih
咪	mik
芈	mil
敉	mim
眯	mio
觅	mip
猕	miq
谜	miy
迷	miz
鳗	mja
蔓	mjc
满	mjd
鞔	mjg
螨	mji
幔	mjj
嫚	mjn
瞒	mjo
缦	mjs
馒	mju
蛮	mjw
慢	mjx
谩	mjy
冥	mkb
茗	mkc
溟	mkd
螟	mki
铭	mkj
鸣	mkk
明	mko
命	mkr
酩	mky
丏	mma
免	mmd
冕	mmk
棉	mmm
娩	mmn
眠	mmo
绵	mms
愐	mmx
苗	mnc
渺	mnd
描	mnf
庙	mng
喵	mnk
杪	mnm
妙	mnn
瞄	mno
缈	mns
淼	mnu
邈	mnz
万	moa
寞	mob
莫	moc
漠	mod
陌	moe
摸	mof
磨	mog
墨	moh
镆	moj
耱	mol
模	mom
嬷	mon
膜	moo
馍	mou
貊	mov
谟	moy
灭	mpa
蔑	mpc
咩	mpk
篾	mpv
缪	mqs
谬	mqy
木	mua
幕	muc
沐	mud
拇	muf
穆	muh
钼	muj
目	muk
模	mum
姆	mun
睦	muo
牟	mus
木	muu
母	muv
亩	muw
寐	mwb
莓	mwc
湄	mwd
嵋	mwe
魅	mwg
煤	mwh
镁	mwj
枚	mwm
妹	mwn
昧	mwo
袂	mwp
眉	mwv
玫	mww
霉	mwy
蛑	mzi
哞	mzk
眸	mzo
侔	mzr
牟	mzs
谋	mzy
捺	naf
钠	naj
哪	nak
娜	nan
肭	nao
衲	nap
拿	nar
纳	nas
南	nau
您	nbr
孬	ncb
淖	ncd
挠	ncf
蛲	nci
铙	ncj
呶	nck
闹	ncm
脑	nco
猱	ncq
垴	nct
硇	ncu
瑙	ncw
恼	ncx
萘	ndc
奈	ndd
耐	nde
柰	ndm
奶	ndn
氖	ndq
佴	ndr
乃	ndv
呐	nek
讷	ney
恁	nfr
能	ngs
囊	nha
攮	nhf
囔	nhk
曩	nho
鲵	nia
薿	nic
溺	nid
拟	nif
铌	nij
匿	nik
妮	nin
腻	nio
猊	niq
倪	nir
坭	nit
尼	niu
怩	nix
霓	niy
逆	niz
南	nja
萳	njc
蝻	nji
喃	njk
楠	njm
婻	njn
腩	njo
男	njt
南	nju
甯	nkb
凝	nkd
聍	nke
拧	nkf
咛	nkk
柠	nkm
狞	nkq
佞	nkr
娘	nln
酿	nly
廿	nma
蔫	nmc
撵	nmf
黏	nmh
辗	nmi
粘	nmm
年	nmp
念	nmr
埝	nmt
碾	nmu
茑	nnc
溺	nnd
脲	nno
袅	nnp
尿	nnu
鸟	nnw
挪	nof
锘	noj
喏	nok
糯	nom
娜	non
傩	nor
懦	nox
诺	noy
孽	npc
涅	npd
聂	npe
捏	npf
镍	npj
啮	npk
乜	npv
蹑	npz
扭	nqf
钮	nqj
杻	nqm
妞	nqn
狃	nqq
纽	nqs
忸	nqx
暖	nro
农	nsd
秾	nsh
哝	nsk
脓	nso
侬	nsr
弄	nsw
疟	ntb
虐	nth
奴	nun
钕	nvj
女	nvv
衄	nvx
哪	nwk
馁	nwu
那	nwv
呣	omk
嗯	onk
噢	ook
藕	ouc
沤	oud
呕	ouk
耦	oul
偶	our
怄	oux
讴	ouy
葩	pac
扒	paf
帕	paj
啪	pak
耙	pal
杷	pam
爬	pav
琶	paw
趴	paz
贫	pbb
聘	pbe
拼	pbf
品	pbk
嫔	pbn
频	pbv
玭	pbw
刨	pcb
泡	pcd
抛	pcf
庖	pcg
炮	pch
咆	pck
脬	pco
袍	pcp
狍	pcq
跑	pcz
蒎	pdc
派	pdd
拍	pdf
徘	pdi
哌	pdk
牌	pdp
俳	pdr
迫	pdz
湓	pfd
喷	pfk
蓬	pgc
澎	pgd
捧	pgf
蟛	pgi
嘭	pgk
棚	pgm
朋	pgo
堋	pgt
彭	pgu
篷	pgv
烹	pgw
怦	pgx
鳑	pha
滂	phd
庞	phg
螃	phi
耪	phl
胖	pho
乓	phq
磅	phu
旁	phw
雱	phy
逄	phz
鲏	pia
疲	pib
芘	pic
淠	pid
陂	pie
披	pif
蜱	pii
铍	pij
啤	pik
枇	pim
媲	pin
脾	pio
郫	pip
僻	pir
纰	pis
坯	pit
屁	piu
皮	piv
琵	piw
霹	piy
判	pjb
潘	pjd
蟠	pji
攀	pjm
盼	pjo
襻	pjp
畔	pjt
磐	pjv
蹒	pjz
平	pka
瓶	pkb
萍	pkc
洴	pkd
枰	pkm
娉	pkn
乒	pkq
俜	pkr
坪	pkt
屏	pku
玶	pkw
评	pky
扁	pmh
骗	pmm
犏	pmn
胼	pmo
偏	pmr
篇	pmv
谝	pmy
蹁	pmz
薸	pnc
漂	pnd
螵	pni
嘌	pnk
朴	pnm
嫖	pnn
瞟	pno
缥	pns
飘	pnx
魄	pob
泼	pod
陂	poe
钋	poj
叵	pok
粕	pom
鄱	pop
坡	pot
破	pou
颇	pov
珀	pow
迫	poz
苤	ppc
瞥	ppd
撇	ppf
氕	ppq
匍	pub
蒲	puc
瀑	pud
扑	puf
穙	puh
铺	puj
噗	puk
朴	pum
曝	puo
仆	pur
埔	put
璞	puw
谱	puy
蹼	puz
沛	pwd
陪	pwe
裴	pwf
帔	pwj
赔	pwk
胚	pwo
佩	pwr
辔	pws
培	pwt
霈	pwy
抔	pzf
剖	pzl
裒	pzw
寝	qbb
芹	qbc
沁	qbd
嵚	qbe
秦	qbf
钦	qbj
噙	qbk
檎	qbm
勤	qbn
侵	qbr
矜	qbs
琴	qbw
覃	qbx
七	qia
蕲	qic
柒	qid
岂	qie
旗	qif
麒	qig
启	qih
蛴	qii
颀	qij
器	qik
耆	qil
骑	qim
婍	qin
脐	qio
气	qip
欺	qiq
企	qir
绮	qis
起	qit
砌	qiu
歧	qiv
齐	qiw
愭	qix
讫	qiy
蹊	qiz
鲭	qka
顷	qkb
擎	qkc
清	qkd
青	qkf
庆	qkg
黥	qkh
轻	qki
亲	qkl
晴	qko
卿	qkp
氢	qkq
倾	qkr
磬	qku
箐	qkv
勍	qkw
情	qkx
蔷	qlc
抢	qlf
炝	qlh
蜣	qli
镪	qlj
呛	qlk
枪	qlm
嫱	qln
腔	qlo
襁	qlp
戗	qlr
墙	qlt
玱	qlw
羌	qly
跄	qlz
歉	qmb
茜	qmc
浅	qmd
嵌	qme
扦	qmf
黔	qmh
堑	qmi
钱	qmj
犍	qmn
肷	qmo
千	qmp
仟	qmr
缱	qms
乾	qmu
签	qmv
慊	qmx
谦	qmy
迁	qmz
翘	qna
窍	qnb
荞	qnc
峭	qne
撬	qnf
巧	qng
锹	qnj
橇	qnm
瞧	qno
俏	qnr
缲	qns
壳	qnu
敲	qnw
悄	qnx
乔	qny
跷	qnz
窃	qpb
茄	qpc
挈	qpf
锲	qpj
妾	qpl
切	qpq
伽	qpr
趄	qpt
砌	qpu
怯	qpx
鳅	qqa
酋	qqb
萩	qqc
龟	qqd
鞧	qqg
秋	qqh
蚯	qqi
丘	qqj
囚	qqk
糗	qqm
丘	qqp
邱	qqq
仇	qqr
巯	qqv
球	qqw
逑	qqz
鬈	qra
泉	qrb
颧	qrc
犬	qrd
蜷	qri
拳	qrj
圈	qrk
权	qrm
婘	qrn
佺	qrr
绻	qrs
筌	qrv
瑔	qrw
悛	qrx
劝	qry
穹	qsb
茕	qsc
邛	qsg
筇	qsv
琼	qsw
瘸	qtb
鹊	qtc
缺	qtf
炔	qth
阙	qtm
埆	qtt
确	qtu
癯	qub
苣	quc
渠	qud
取	que
觑	quh
蛆	qui
鼩	quj
区	quk
曲	qul
驱	qum
瞿	quo
祛	qup
趣	qut
屈	quu
龋	quv
璩	quw
诎	quy
葜	qxc
洽	qxd
掐	qxf
髂	qxg
袷	qxp
卡	qxu
恰	qxx
麇	qyg
囷	qyk
裙	qyp
逡	qyz
荛	rcc
扰	rcf
桡	rcm
娆	rcn
绕	rcs
饶	rcu
惹	rec
热	ref
喏	rek
荏	rfc
刃	rfd
稔	rfh
轫	rfi
妊	rfn
壬	rfp
壬	rfq
忍	rfr
纫	rfs
饪	rfu
韧	rfw
认	rfy
扔	rgf
仍	rgr
蘘	rhc
瀼	rhd
攘	rhf
穰	rhh
嚷	rhk
禳	rhp
壤	rht
瓤	rhw
让	rhy
日	rik
髯	rja
苒	rjc
染	rjd
燃	rjh
蚺	rji
冉	rjl
䎃	rjr
鄀	roc
弱	rog
婼	ron
偌	ror
箬	rov
阮	rre
软	rri
媆	rrn
堧	rrt
瓀	rrw
融	rsa
冗	rsb
荣	rsc
溶	rsd
嵘	rse
戎	rsg
熔	rsh
蝾	rsi
镕	rsj
榕	rsm
狨	rsq
绒	rss
瑢	rsw
茹	ruc
汝	rud
辱	rui
铷	ruj
嚅	ruk
嬬	run
入	rup
儒	rur
缛	rus
孺	ruz
蕊	rvc
汭	rvd
蚋	rvi
锐	rvj
睿	rvl
枘	rvm
瑞	rvw
润	ryd
闰	rym
揉	rzf
鞣	rzg
糅	rzm
柔	rzs
蹂	rzz
卅	saa
萨	sac
洒	sad
撒	saf
靸	sag
飒	sal
脎	sao
仨	sar
瘙	scb
溞	scd
搔	scf
骚	scm
嫂	scn
臊	sco
缫	scs
埽	sct
鳃	sda
塞	sdb
噻	sdk
腮	sdo
塞	seb
涩	sed
穑	seh
铯	sej
啬	seu
瑟	sew
搡	shf
嗓	shk
丧	shu
桑	shy
肆	sia
死	sid
㟃	sie
撕	sif
私	sih
厮	sii
锶	sij
嘶	sik
耜	sil
驷	sim
姒	sin
祀	sip
斯	siq
似	sir
缌	sis
思	sit
饲	siu
司	siv
漦	siw
三	sja
糁	sjm
伞	sjr
叁	sjs
馓	sju
蓑	soc
挲	sod
锁	soj
唆	sok
梭	som
睃	soo
缩	sos
索	sou
琐	sow
羧	soy
蒜	src
狻	srq
算	srv
酸	sry
宋	ssb
菘	ssc
淞	ssd
嵩	sse
㧐	ssf
竦	ssl
松	ssm
怂	ssr
忪	ssx
讼	ssy
送	ssz
稣	sua
宿	sub
蔌	suc
涑	sud
素	suf
甦	sug
夙	suj
嗉	suk
俗	sur
肃	suv
粟	sux
酥	suy
速	suz
荽	svc
濉	svd
随	sve
髓	svg
穗	svh
祟	svi
虽	svk
眭	svo
绥	svs
碎	svu
璲	svw
遂	svz
荪	syc
损	syf
榫	sym
狲	syq
隼	syr
笋	syv
飧	syx
孙	syz
薮	szc
溲	szd
擞	szf
螋	szi
飕	szj
嗖	szk
瞍	szo
叟	szp
馊	szu
艘	szv
鳎	taa
它	tab
溻	tad
拓	taf
鞳	tag
铊	taj
嗒	tak
榻	tam
她	tan
褟	tap
獭	taq
塌	tat
沓	tau
踏	taz
萄	tcc
涛	tcd
陶	tce
掏	tcf
弢	tcg
啕	tck
桃	tcm
绦	tcs
韬	tcw
慆	tcx
讨	tcy
逃	tcz
鲐	tda
苔	tdc
汰	tdd
抬	tdf
钛	tdj
呔	tdk
骀	tdm
胎	tdo
台	tds
态	tdt
酞	tdy
跆	tdz
铽	tej
慝	tek
特	ten
忑	tex
忒	tey
疼	tgb
藤	tgc
熥	tgh
誊	tgj
腾	tgo
烫	thd
搪	thf
唐	thg
螳	thi
镗	thj
嘡	thk
糖	thm
帑	thn
膛	tho
倘	thr
趟	tht
躺	thu
瑭	thw
堂	thx
羰	thy
蹚	thz
鳀	tia
剃	tib
荑	tic
涕	tid
提	tif
趯	tif
锑	tij
啼	tik
梯	tim
媞	tin
题	tio
裼	tip
倜	tir
缇	tis
屉	tiu
悌	tix
醍	tiy
踢	tiz
瘫	tjb
滩	tjd
炭	tje
摊	tjf
弹	tjg
郯	tjh
叹	tjk
毯	tjm
昙	tjo
袒	tjp
贪	tjr
坦	tjt
碳	tju
璮	tjw
覃	tjx
谭	tjy
葶	tkc
汀	tkd
挺	tkf
庭	tkg
烃	tkh
厅	tki
铤	tkj
梃	tkm
婷	tkn
停	tkr
町	tkt
艇	tkv
亭	tkw
霆	tky
廷	tkz
添	tmd
掭	tmf
钿	tmj
田	tmk
阗	tmm
腆	tmo
甜	tmq
佃	tmr
填	tmt
恬	tmx
鲦	tna
窕	tnb
苕	tnc
挑	tnf
蜩	tni
嬥	tnn
眺	tno
祧	tnp
佻	tnr
龆	tnv
条	tnw
跳	tnz
橐	toa
萚	toc
沱	tod
陀	toe
拖	tof
庹	tog
铊	toj
唾	tok
驼	tom
鸵	ton
脱	too
妥	top
佗	tor
坨	tot
砣	tou
箨	tov
酡	toy
跎	toz
萜	tpc
餮	tpd
铁	tpj
湍	trd
抟	trf
煓	trh
团	trk
疃	trt
彖	trv
鲖	tsa
痛	tsb
茼	tsc
彤	tsd
峂	tse
捅	tsf
铜	tsj
嗵	tsk
童	tsl
桶	tsm
㛚	tsn
瞳	tso
侗	tsr
统	tss
垌	tst
筒	tsv
恸	tsx
酮	tsy
通	tsz
突	tub
荼	tuc
涂	tud
秃	tuh
徒	tui
钍	tuj
吐	tuk
凸	tul
腯	tuo
堍	tut
土	tuu
㻬	tuw
酴	tuy
途	tuz
魋	tvg
颓	tvh
蜕	tvi
腿	tvo
褪	tvp
忒	tvy
退	tvz
忒	twy
屯	tya
囤	tyk
豚	tyo
吞	tyt
臀	tyu
投	tzf
骰	tzg
偷	tzr
透	tzz
痧	uab
莎	uac
沙	uad
厦	uai
铩	uaj
嗄	uak
杉	uam
歃	uaq
傻	uar
纱	uas
砂	uau
杀	uax
霎	uay
勺	ucb
苕	ucc
邵	ucd
捎	ucf
鞘	ucg
稍	uch
哨	uck
韶	ucl
梢	ucm
睄	uco
绍	ucs
艄	ucv
少	ucx
色	udd
晒	udo
筛	udv
酾	udy
涉	ued
摄	uef
麝	ueg
蛇	uei
赊	uek
阇	uem
社	uep
舌	ueq
舍	uer
赦	uet
射	ueu
慑	uex
鲹	ufa
审	ufb
莘	ufc
沈	ufd
蜃	ufi
哂	ufk
申	ufl
糁	ufm
婶	ufn
胂	ufo
身	ufp
甚	ufq
什	ufr
参	ufs
砷	ufu
珅	ufw
慎	ufx
谂	ufy
渑	ugd
嵊	uge
盛	ugi
牲	ugn
胜	ugo
升	ugp
剩	ugq
绳	ugs
声	ugu
笙	ugv
圣	ugy
殇	uhd
熵	uhh
晌	uho
伤	uhr
绱	uhs
墒	uht
商	uhw
尚	uhx
十	uia
实	uib
蓍	uic
湿	uid
示	uie
拾	uif
轼	uii
嗜	uik
师	uil
驶	uim
始	uin
时	uio
视	uip
狮	uiq
使	uir
螫	uit
蚀	uiu
尸	uiv
市	uiw
恃	uix
式	uiy
适	uiz
鳝	uja
单	ujb
删	ujc
汕	ujd
陕	uje
擅	ujf
扇	ujh
蟮	uji
赡	ujk
闪	ujm
姗	ujn
膳	ujo
衫	ujp
缮	ujs
埏	ujt
舢	ujv
珊	ujw
善	ujy
跚	ujz
摔	ukf
蟀	uki
甩	ukk
衰	ukw
爽	ula
爽	uld
孀	uln
霜	uly
朔	uob
蒴	uoc
搠	uof
烁	uoh
铄	uoj
妁	uon
硕	uou
说	uoy
涮	urd
闩	urm
腨	uro
束	uua
薯	uuc
澍	uud
隃	uue
抒	uuf
庶	uug
黍	uuh
输	uui
鼠	uuj
赎	uuk
竖	uul
树	uum
恕	uun
暑	uuo
舒	uur
署	uus
属	uuu
书	uuv
熟	uuw
述	uuz
税	uvh
睡	uvo
谁	uvy
耍	uxe
唰	uxk
刷	uxu
顺	uyi
吮	uyk
楯	uym
瞬	uyo
舜	uyp
首	uzb
授	uzf
手	uzp
狩	uzq
售	uzr
绶	uzs
收	uzv
熟	uzw
鲊	vaa
痄	vab
渣	vad
揸	vaf
炸	vah
轧	vai
铡	vaj
喳	vak
榨	vam
眨	vao
乍	vap
砟	vau
劄	vav
诈	vay
齇	vaz
召	vcd
兆	vce
招	vcf
肇	vch
钊	vcj
嘲	vck
棹	vcm
照	vco
爪	vcp
罩	vcs
赵	vct
朝	vcu
笊	vcv
诏	vcy
窄	vdb
摘	vdf
祭	vdp
债	vdr
斋	vdw
翟	vdx
蔗	vec
浙	ved
折	vef
鹧	veg
辙	vei
锗	vej
啫	vek
者	vel
柘	vem
褶	vep
赭	vet
喆	veu
谪	vey
遮	vez
臻	vfa
疹	vfb
蓁	vfc
溱	vfd
阵	vfe
振	vff
稹	vfh
轸	vfi
镇	vfj
赈	vfk
贞	vfl
枕	vfm
朕	vfo
祯	vfp
斟	vfq
侦	vfr
缜	vfs
圳	vft
砧	vfu
箴	vfv
珍	vfw
甄	vfx
震	vfy
丁	vga
郑	vgb
蒸	vgc
争	vgd
峥	vge
挣	vgf
征	vgi
铮	vgj
烝	vgl
睁	vgo
狰	vgq
整	vgu
政	vgv
怔	vgx
证	vgy
丈	vha
瘴	vhb
涨	vhd
障	vhe
张	vhg
蟑	vhi
帐	vhj
账	vhk
章	vhl
樟	vhm
嫜	vhn
胀	vho
獐	vhq
仗	vhr
璋	vhw
掌	vhx
至	via
旨	vib
芝	vic
治	vid
职	vie
指	vif
秩	vih
咫	vii
帜	vij
吱	vik
止	vil
枝	vim
脂	vio
制	vip
值	vir
纸	vis
址	vit
知	viu
彘	viv
忮	vix
识	viy
踯	viz
鳣	vja
蘸	vjc
沾	vjd
崭	vje
搌	vjf
斩	vji
盏	vjj
站	vjl
粘	vjm
瞻	vjo
偡	vjr
绽	vjs
展	vju
颤	vjw
谵	vjy
拽	vkf
壮	vld
撞	vlf
庄	vlg
幢	vlj
桩	vlm
奘	vlp
僮	vlr
奘	vlv
茁	voc
浊	vod
捉	vof
灼	voh
镯	voj
啄	vok
卓	vol
椓	vom
晫	voo
禚	vop
倬	vor
缴	vos
斫	vou
琢	vow
酌	voy
专	vra
沌	vrd
颛	vre
撰	vrf
转	vri
赚	vrk
䏝	vro
传	vrr
砖	vru
篆	vrv
冢	vsb
种	vsh
钟	vsj
柊	vsm
肿	vso
重	vsp
众	vsr
终	vss
忠	vsv
衷	vsw
踵	vsz
著	vuc
注	vud
拄	vuf
竹	vug
烛	vuh
蛛	vui
铸	vuj
嘱	vuk
煮	vul
柱	vum
朱	vun
瞩	vuo
祝	vup
猪	vuq
住	vur
纻	vus
筑	vuv
珠	vuw
诸	vuy
逐	vuz
坠	vve
赘	vvf
锥	vvj
椎	vvm
隹	vvr
缀	vvs
惴	vvx
追	vvz
这	vwz
髽	vxa
爪	vxp
屯	vya
准	vyd
衠	vyi
肫	vyo
谆	vyy
宙	vzb
荮	vzc
州	vzd
帚	vze
粥	vzg
轴	vzi
咒	vzk
骤	vzm
妯	vzn
肘	vzo
舟	vzp
㑇	vzr
绉	vzs
碡	vzu
籀	vzv
㤘	vzx
诌	vzy
瓦	waa
窊	wab
洼	wad
蛙	wai
哇	wak
凹	wal
娃	wan
腽	wao
袜	wap
佤	war
畖	wat
歪	wdb
崴	wde
鳁	wfa
瘟	wfb
芠	wfc
温	wfd
稳	wfh
蚊	wfi
吻	wfk
闻	wfm
璺	wfp
纹	wfs
文	wfw
雯	wfy
瓮	wgb
蓊	wgc
嗡	wgk
王	wha
汪	whd
魍	whg
往	whi
网	whk
枉	whm
旺	who
望	whw
惘	whx
万	wja
皖	wjb
莞	wjc
湾	wjd
顽	wje
挽	wjf
烷	wjh
蜿	wji
婉	wjn
晚	wjo
丸	wjp
纨	wjs
畹	wjt
碗	wju
玩	wjw
惋	wjx
窝	wob
莴	woc
沃	wod
挝	wof
卧	woi
幄	woj
喔	wok
肟	woo
我	wop
倭	wor
斡	wou
龌	wov
踒	woz
五	wua
勿	wub
芜	wuc
污	wud
屼	wue
捂	wuf
巫	wug
焐	wuh
蜈	wui
钨	wuj
吴	wuk
梧	wum
物	wun
晤	wuo
舞	wup
伍	wur
婺	wus
圬	wut
屋	wuu
毋	wuv
务	wuw
悟	wux
误	wuy
迕	wuz
未	wwa
痿	wwb
薇	wwc
危	wwd
巍	wwe
委	wwh
微	wwi
帷	wwj
味	wwk
闱	wwm
娓	wwn
韪	wwo
猥	wwq
伟	wwr
维	wws
胃	wwt
尾	wwu
卫	wwv
威	www
威	wwx
谓	wwy
违	wwz
芯	xbc
心	xbd
炘	xbh
锌	xbj
辛	xbl
昕	xbo
囟	xbp
信	xbr
馨	xbu
衅	xbx
䜣	xby
西	xia
兮	xib
昔	xic
洗	xid
隙	xie
席	xig
稀	xih
徙	xii
锡	xij
吸	xik
袭	xil
析	xim
媳	xin
膝	xio
夕	xip
翕	xir
细	xis
喜	xiu
习	xiv
希	xix
戏	xiy
息	xiz
荇	xkc
陉	xke
擤	xkf
形	xkk
杏	xkm
姓	xkn
星	xko
猩	xkq
幸	xkt
省	xku
性	xkx
醒	xky
巷	xlc
象	xld
降	xle
项	xlg
香	xlh
厢	xli
镶	xlj
响	xlk
相	xlm
向	xlp
像	xlr
饷	xlu
乡	xlv
享	xlw
飨	xlx
详	xly
鲜	xma
宪	xmb
藓	xmc
冼	xmd
限	xme
掀	xmf
弦	xmg
衔	xmi
铣	xmj
见	xmk
贤	xml
闲	xmm
嫌	xmn
显	xmo
祆	xmp
县	xmq
仙	xmr
线	xms
献	xmu
舷	xmv
现	xmw
咸	xmx
羡	xmy
跹	xmz
宵	xnb
萧	xnc
消	xnd
崤	xne
魈	xng
蛸	xni
销	xnj
啸	xnk
孝	xnl
校	xnm
晓	xno
枭	xnp
绡	xns
硝	xnu
箫	xnv
效	xnw
肖	xnx
霄	xny
逍	xnz
鲑	xpa
写	xpb
薤	xpc
泄	xpd
携	xpf
鞋	xpg
燮	xph
蝎	xpi
叶	xpk
械	xpm
歇	xpo
血	xpp
獬	xpq
斜	xpr
绁	xps
协	xpu
卸	xpw
懈	xpx
谢	xpy
邂	xpz
髹	xqa
宿	xqb
溴	xqd
岫	xqe
庥	xqg
秀	xqh
锈	xqj
嗅	xqk
朽	xqm
袖	xqp
休	xqr
绣	xqs
馐	xqu
貅	xqv
琇	xqw
羞	xqy
臭	xqz
宣	xrb
萱	xrc
渲	xrd
旋	xrf
炫	xrh
轩	xri
铉	xrj
喧	xrk
楦	xrm
眩	xro
禤	xrp
悬	xrq
儇	xrr
绚	xrs
碹	xru
玄	xrw
愃	xrx
匈	xsb
芎	xsc
汹	xsd
兄	xsk
胸	xso
熊	xss
雄	xsu
凶	xsx
讻	xsy
鳕	xta
穴	xtb
薛	xtc
踅	xtf
靴	xtg
噱	xtk
血	xtp
削	xtx
雪	xty
戌	xua
蓄	xuc
溆	xud
砉	xuf
序	xug
虚	xuh
徐	xui
旭	xuj
嘘	xuk
栩	xum
婿	xun
煦	xuo
须	xup
叙	xur
续	xus
墟	xut
胥	xuv
畜	xuw
恤	xux
许	xuy
夏	xxa
峡	xxe
罅	xxf
黠	xxh
虾	xxi
吓	xxk
瞎	xxo
狭	xxq
侠	xxr
硖	xxu
叚	xxv
瑕	xxw
霞	xxy
遐	xxz
鲟	xya
旬	xyb
薰	xyc
殉	xyd
寻	xye
循	xyi
勋	xyk
驯	xym
曛	xyo
熏	xyp
獯	xyq
巽	xys
埙	xyt
珣	xyw
讯	xyy
迅	xyz
牙	yaa
丫	yab
芽	yac
涯	yad
崖	yae
押	yaf
压	yai
鸭	yaj
呀	yak
桠	yam
娅	yan
睚	yao
氩	yaq
伢	yar
垭	yat
砑	yau
琊	yaw
雅	yay
迓	yaz
䲟	yba
瘾	ybb
荫	ybc
淫	ybd
阴	ybe
引	ybg
蚓	ybi
银	ybj
吟	ybk
音	ybl
訚	ybm
姻	ybn
印	ybp
狺	ybq
垠	ybt
饮	ybu
尹	ybv
珢	ybw
夤	ybx
霪	yby
尧	yca
窑	ycb
药	ycc
崾	yce
摇	ycf
靿	ycg
徭	yci
钥	ycj
咬	yck
杳	ycm
妖	ycn
腰	yco
夭	ycp
侥	ycr
约	ycs
幺	ycv
瑶	ycw
耀	ycx
谣	ycy
邀	ycz
页	yea
爷	yeb
液	yed
耶	yee
揶	yef
烨	yeh
靥	yei
铘	yej
叶	yek
业	yel
椰	yem
腋	yeo
馌	yeu
也	yev
夜	yew
邺	yey
痒	yhb
洋	yhd
阳	yhe
扬	yhf
鞅	yhg
秧	yhh
徉	yhi
飏	yhj
咉	yhk
央	yhl
杨	yhm
旸	yho
氧	yhq
仰	yhr
玚	yhw
怏	yhx
养	yhy
夷	yia
益	yib
艺	yic
溢	yid
屹	yie
抑	yif
移	yih
役	yii
镒	yij
咦	yik
毅	yil
椅	yim
姨	yin
易	yio
祎	yip
猗	yiq
依	yir
异	yis
圯	yit
壹	yiu
已	yiv
亦	yiw
翼	yix
议	yiy
遗	yiz
宴	yjb
芫	yjc
演	yjd
岩	yje
艳	yjf
烟	yjh
颜	yji
鼹	yjj
咽	yjk
验	yjm
燕	yjn
腌	yjo
殷	yjp
俨	yjr
罨	yjs
盐	yjt
研	yju
筵	yjv
言	yjw
恹	yjx
严	yjy
延	yjz
颖	ykb
英	ykc
瀛	ykd
撄	ykf
鹰	ykg
蝇	yki
婴	ykk
樱	ykm
盈	ykn
影	yko
缨	yks
硬	yku
赢	ykw
迎	ykz
哟	yok
冤	yrb
苑	yrc
源	yrd
院	yre
援	yrf
原	yri
员	yrk
橼	yrm
媛	yrn
爰	yrp
猿	yrq
缘	yrs
袁	yrt
箢	yrv
瑗	yrw
怨	yrx
鸢	yry
远	yrz
鳙	ysa
痈	ysb
永	ysd
拥	ysf
庸	ysg
蛹	ysi
镛	ysj
咏	ysk
栐	ysm
臃	yso
佣	ysr
勇	yss
墉	yst
邕	ysv
雍	ysw
慵	ysx
颙	ysy
踊	ysz
瀹	ytd
爚	yth
钺	ytj
曰	ytk
阅	ytm
刖	yto
乐	ytp
岳	ytq
龠	ytr
约	yts
越	ytt
籥	ytv
玥	ytw
悦	ytx
说	yty
跃	ytz
于	yua
宇	yub
芋	yuc
鱼	yud
屿	yue
揄	yuf
庾	yug
虞	yuh
御	yui
喻	yuk
禺	yul
驭	yum
娱	yun
昱	yuo
禹	yup
狱	yuq
余	yur
预	yus
域	yut
郁	yuu
聿	yuv
玉	yuw
羽	yux
语	yuy
遇	yuz
匀	yyb
芸	yyc
殒	yyd
陨	yye
郧	yyk
韵	yyl
孕	yyn
晕	yyo
氲	yyq
允	yys
熨	yyu
筠	yyv
韫	yyw
酝	yyy
运	yyz
鱿	yza
疣	yzb
莜	yzc
游	yzd
幽	yze
黝	yzh
蝣	yzi
铀	yzj
呦	yzk
由	yzl
柚	yzm
祐	yzp
犹	yzq
优	yzr
右	yzu
又	yzv
忧	yzx
诱	yzy
扎	zaf
杂	zaj
咂	zak
臜	zao
砸	zau
枣	zca
皂	zcb
藻	zcc
澡	zcd
灶	zch
蚤	zci
噪	zck
糟	zcm
早	zco
璪	zcw
凿	zcy
造	zcz
再	zda
灾	zdb
崽	zde
仔	zdr
载	zdu
甾	zdv
泽	zed
责	zef
仄	zei
帻	zej
啧	zek
昃	zeo
笮	zev
迮	zez
怎	zfv
谮	zfy
曾	zgb
锃	zgj
赠	zgk
缯	zgs
矰	zgu
憎	zgx
臧	zha
葬	zhc
赃	zhk
驵	zhm
脏	zho
奘	zhp
奘	zhv
臧	zhw
鲻	zia
兹	zib
茈	zic
资	zid
嵫	zie
秭	zih
辎	zii
锱	zij
吱	zik
耔	zil
梓	zim
姊	zin
眦	zio
自	zip
仔	zir
缁	zis
趑	zit
子	ziv
鄑	ziy
孜	ziz
寁	zjb
攒	zjf
暂	zji
咱	zjk
糌	zjm
赞	zjn
趱	zjt
簪	zjv
瓒	zjw
阼	zoe
撮	zof
座	zog
嘬	zok
柞	zom
昨	zoo
祚	zop
作	zor
左	zou
笮	zov
琢	zow
怍	zox
酢	zoy
攥	zrf
钻	zrj
赚	zrk
缵	zrs
纂	zrv
躜	zrz
鬃	zsa
宗	zsb
棕	zsm
腙	zso
偬	zsr
纵	zss
踪	zsz
菹	zuc
阻	zue
族	zuf
租	zuh
足	zuk
祖	zup
俎	zur
组	zus
卒	zuw
诅	zuy
蕞	zvc
嘴	zvk
槜	zvm
最	zvo
罪	zvs
觜	zvv
醉	zvy
鲗	zwa
贼	zwk
鳟	zya
尊	zyb
嶟	zye
撙	zyf
噂	zyk
樽	zym
遵	zyz
鲰	zza
邹	zzd
陬	zze
奏	zzf
驺	zzm
诹	zzy
鸨	bcb
龅	bcv
璧	biu
槟	bkm
煸	bmh
辨	bml
膻	djo
箪	djv
簟	dmv
汾	ffd
钒	fjj
梵	fjm
矾	fju
敷	fuf
蜉	fui
脯	fuo
凫	fup
俯	fur
弗	fuv
槁	gcm
阁	gem
汞	gsg
枸	gzm
濠	hcd
涸	hed
嗬	hek
恍	hlx
奂	hrd
泓	hsd
斛	hud
烩	hvh
骅	hxm
馇	iau
怅	ihx
蚩	iiv
忡	isx
蜍	iui
巾	jbl
矜	jbs
蓟	jic
奇	jid
觊	jie
嵇	jih
骥	jim
系	jip
继	jis
戟	jiu
笈	jiv
玑	jiw
计	jiy
靖	jkl
腈	jko
憬	jkx
煎	jmb
溅	jmd
监	jml
槛	jmm
僭	jmr
戬	jmy
醮	jny
诘	jpy
疚	jqb
苣	juc
飓	juj
驹	jum
惧	jux
遽	juz
镓	jxj
咯	kak
贶	klk
喇	lak
吏	lia
荔	lic
厘	lii
鹂	lil
骊	lim
俚	lir
蠡	liv
璃	liw
泠	lkd
囹	lkk
羚	lky
粱	lld
骝	lqm
麋	mig
沔	mmd
眄	mmo
蘑	moc
摩	mog
苜	muc
媒	mwn
匏	pcd
莆	puc
芑	qic
漆	qid
棋	qim
祈	qip
憩	qiq
骞	qmb
铅	qmj
觫	sud
燧	svh
遢	taz
嚏	tik
拓	tof
椭	tom
桐	tsm
厍	uei
伸	ufr
绅	ufs
裳	uhx
舐	uiq
虱	uiv
潸	ujd
姝	uun
倏	uur
楂	vam
蜇	vef
拯	vgf
筝	vgv
汁	vid
执	vif
帙	vij
枳	vim
祗	vip
智	viu
湛	vjd
渚	vud
株	vum
诬	wuy
葳	wwc
畏	wwt
浠	xid
熄	xih
嬉	xin
晞	xio
奚	xip
硒	xiu
庠	xlg
岘	xme
蚬	xmi
娴	xmn
骁	xnm
蟹	xpd
谐	xpy
谑	xty
醺	xyy
衙	yai
讶	yay
龈	ybv
漾	yhd
肄	yib
沂	yid
贻	yik
翊	yil
伊	yir
彝	yiv
奕	yiw
怡	yix
淹	yjd
衍	yji
檐	yjm
鄢	yjv
琰	yjw
酽	yjy
莹	ykc
膺	ykg
鹦	ykk
楹	ykm
嬴	ykw
沅	yrd
鸳	yrx
泳	ysd
彧	yua
萸	yuc
浴	yud
鬻	yug
圄	yuk
觎	yur
鹬	yus
谀	yuy
纭	yys
尢	yzu
渍	zid
镞	zuj
阿	aaek
锕	aajk
啊	aakk
嗄	aakw
吖	aaky
腌	aaod
昂	ahoe
肮	ahoj
卬	ahpe
盎	ahym
癌	aibe
皑	aibj
蔼	aicv
艾	aicx
隘	aiem
叆	aiey
锿	aijy
嗌	aikm
哎	aikx
嗳	aiky
嫒	ainy
暧	aioy
爱	aipy
欸	aisr
埃	aitu
毐	aiua
碍	aiuc
矮	aiun
毐	aiuw
砹	aiux
瑷	aiwy
霭	aiyv
安	anbn
鹌	andn
岸	aneg
按	anfn
庵	angd
鞍	angn
黯	anho
唵	ankd
桉	anmn
胺	anon
暗	anoo
犴	anqg
氨	anqn
俺	anrd
盦	anrm
垵	antn
谙	anyo
奡	aoal
翱	aobx
澳	aodd
隩	aoed
鳌	aofa
聱	aofe
熬	aofh
螯	aofi
鏊	aofj
拗	aofl
骜	aofm
獒	aofq
敖	aofw
鏖	aogj
廒	aogw
嗷	aokw
凹	aola
媪	aonm
奥	aopd
袄	aopy
傲	aorw
坳	aotl
璈	aoww
懊	aoxd
遨	aozw
鲃	baab
鲅	baad
疤	babb
芭	bacb
菝	bacd
灞	bado
岜	baeb
扒	bafb
捌	bafd
靶	bagb
魃	bagd
蚆	baib
钯	bajb
叭	bakb
朳	bamb
妭	band
胈	baod
八	bapn
巴	basl
罢	bass
坝	batr
笆	bavb
巴	bavv
羓	bayb
霸	bayo
跋	bazd
鬓	bbab
宾	bbbb
邠	bbbe
殡	bbdb
濒	bbdr
豳	bbeu
摈	bbfb
髌	bbgb
槟	bbmb
彬	bbmp
膑	bbob
傧	bbrb
缤	bbsb
玢	bbwd
斌	bbwv
鲍	bcas
刨	bcbd
包	bcbs
宝	bcby
薄	bccc
葆	bccm
苞	bccs
剥	bced
抱	bcfs
炮	bchs
枹	bcms
胞	bcos
曝	bcou
煲	bcrh
保	bcrm
堡	bcrt
饱	bcus
褒	bcwy
雹	bcys
孢	bczs
百	bdab
摆	bdfs
捭	bdfu
呗	bdkr
败	bdkw
柏	bdmb
白	bdpo
伯	bdrb
掰	bduu
本	bfaa
坌	bfbt
苯	bfcb
奔	bfdc
锛	bfjc
倴	bfrc
坋	bftd
贲	bfur
甭	bgby
崩	bgeo
蚌	bgif
镚	bgjo
嘣	bgko
祊	bgpf
绷	bgso
泵	bguu
甏	bguw
琫	bgwl
迸	bgzk
蹦	bgzo
蒡	bhcf
浜	bhdb
邦	bhfe
搒	bhff
帮	bhfj
镑	bhjf
梆	bhme
榜	bhmf
棓	bhmk
膀	bhof
绑	bhse
塝	bhtf
磅	bhuf
玤	bhwf
谤	bhyf
鲾	biat
觱	biay
毖	bibb
邲	bibe
痹	bibl
坒	bibt
毕	bibu
蓖	bicb
薜	bicu
蔽	bicw
荸	bicz
泌	bidb
弊	bidc
濞	bidl
滗	bidm
敝	bidw
陛	biet
弼	bigg
髀	bigu
秘	bihb
彼	biiy
吡	bikb
鄙	bike
赑	bikr
哔	biku
妣	binb
婢	binu
币	bipj
裨	bipu
匕	bipv
狴	biqt
佖	birb
畀	bitl
嬖	biun
臂	biuo
贲	biur
壁	biut
篦	bivb
箅	bivl
筚	bivu
珌	biwb
觱	biwy
觱	bixy
鼻	bizl
逼	bizt
颁	bjbr
癍	bjbw
瘢	bjby
湴	bjdy
拌	bjfb
扮	bjfd
扳	bjfy
靽	bjgb
钣	bjjy
办	bjld
柈	bjmb
昄	bjoy
版	bjpy
伴	bjrb
绊	bjsb
斑	bjww
病	bkbb
邴	bkbe
摒	bkfk
炳	bkhb
蛃	bkib
昺	bkob
秉	bkpn
兵	bkqb
屏	bkuk
禀	bkwx
鳊	bmac
苄	bmcb
萹	bmcc
汴	bmdb
卞	bmdx
抃	bmfb
蝙	bmic
匾	bmkc
贬	bmkf
辫	bmlu
昪	bmoc
便	bmrg
弁	bmsc
碥	bmuc
变	bmwy
边	bmzl
鳔	bnax
瘭	bnbx
藨	bnch
蔈	bncx
瀌	bndh
摽	bnfx
表	bnfy
彪	bnhp
熛	bnhx
镳	bnjh
飑	bnjs
杓	bnmu
骠	bnmx
膘	bnox
脿	bnoy
裱	bnpy
飙	bnqx
儦	bnrh
俵	bnry
鲌	boab
僰	boar
帛	bobj
薄	bocc
蕃	boct
菠	bocy
泊	bodb
渤	bodl
波	body
剥	boed
嶓	boet
搏	bofc
拨	bofd
播	boft
馞	bohz
钵	bojb
镈	bojc
钹	bojd
啵	boky
哱	bokz
卜	bold
柏	bomb
欂	bomc
驳	bomx
桲	bomz
膊	booc
脖	booz
袯	bopd
伯	borb
砵	boub
礴	bouc
勃	boul
檗	boum
鹁	boun
擘	bouu
饽	bouz
舶	bovb
簿	bovc
簸	bovy
亳	bowq
玻	bowy
踣	bozk
跛	bozy
瘪	bpbb
鳖	bpda
蹩	bpdr
憋	bpdx
别	bpkd
不	buad
卟	bukb
晡	buof
堡	burt
埔	butf
簿	buvc
步	buvp
怖	buxj
醭	buyn
逋	buzf
蓓	bwck
陂	bwey
辈	bwfi
悲	bwfx
庳	bwgu
鞴	bwgy
焙	bwhk
钡	bwjr
贝	bwkr
北	bwlb
背	bwlo
杯	bwmb
椑	bwmu
糒	bwmy
卑	bwpu
被	bwpy
倍	bwrk
鐾	bwuj
碚	bwuk
臂	bwuo
备	bwwt
惫	bwwx
擦	cafx
嚓	cakx
曹	ccao
草	cccu
操	ccfm
螬	ccio
嘈	ccko
槽	ccmo
糙	ccmz
艚	ccvo
才	cdap
菜	cdcm
蔡	cdcx
财	cdkc
睬	cdom
采	cdpm
彩	cdpp
猜	cdqo
偲	cdrx
裁	cduy
踩	cdzm
测	cedd
厕	ceid
册	cepa
侧	cerd
策	cevn
恻	cexd
涔	cfdv
岑	cfev
参	cfsp
曾	cgbo
嶒	cgeo
噌	cgko
层	cgus
蹭	cgzo
藏	chci
沧	chdv
鸧	chrn
伧	chrv
舱	chvv
刺	ciad
疵	cibb
鹚	cibn
慈	cibx
兹	ciby
茈	cicb
莿	cicd
茨	cicr
泚	cidb
瓷	cidw
呲	cikb
赐	cikw
糍	cimy
伺	cirk
佽	cirr
磁	ciuy
此	civb
雌	civf
玼	ciwb
差	ciyg
跐	cizb
掺	cjfp
黪	cjhp
餐	cjll
粲	cjlm
骖	cjmp
参	cjsp
蚕	cjti
孱	cjuz
璨	cjwm
惭	cjxj
瘥	cobg
痤	cobt
莝	coct
嵯	coeg
措	cofo
挫	coft
撮	cofy
厝	coio
错	cojo
鹾	colg
酂	cone
脞	coot
磋	coug
矬	cout
瑳	cowg
蹉	cozg
窜	crbi
撺	crfi
攒	crfr
酂	crne
爨	crph
篡	crvs
蹿	crzi
苁	cscr
葱	cscx
淙	csdx
聪	csex
枞	csmr
骢	csmx
囱	cspw
丛	csra
从	csrr
璁	cswx
悰	csxx
蹙	cuar
殂	cudq
徂	cuiq
粗	cumq
猝	cuqu
促	curr
簇	cuvu
蹙	cuwr
醋	cuyo
酢	cuyv
蹴	cuzy
瘁	cvbu
漼	cvdf
淬	cvdu
崔	cvef
摧	cvff
啐	cvku
粹	cvmu
榱	cvmy
脆	cvov
催	cvrf
缞	cvsy
衰	cvwy
悴	cvxu
寸	cyad
村	cymc
皴	cysy
邨	cyte
存	cyuz
忖	cyxc
凑	czdt
辏	czit
腠	czot
荙	dacz
耷	dade
打	dafd
搭	dafk
靼	daga
炟	daha
嗒	dakk
大	daun
沓	dauo
笪	dava
答	davk
怛	daxa
跶	dazz
到	dcad
捯	dcfd
捣	dcfe
焘	dcfh
纛	dcfx
帱	dcjc
叨	dckd
祷	dcpc
岛	dcpe
倒	dcrd
导	dcsc
舠	dcvd
刀	dcvp
忉	dcxd
蹈	dczj
歹	ddax
叇	ddez
待	ddic
轪	ddid
呆	ddkm
呔	ddkt
岱	ddre
黛	ddrh
贷	ddrr
垈	ddrt
傣	ddru
袋	ddry
绐	ddsk
怠	ddsx
埭	ddtn
戴	ddub
大	ddun
玳	ddwy
迨	ddzk
逮	ddzn
得	deic
德	deix
锝	dejc
嘚	dekc
地	dety
扽	dfft
嶝	dgea
灯	dghd
镫	dgja
噔	dgka
瞪	dgoa
戥	dgog
磴	dgua
登	dgva
凳	dgvj
璒	dgwa
邓	dgye
蹬	dgza
荡	dhcp
菪	dhcu
挡	dhfe
铛	dhje
裆	dhpe
垱	dhte
凼	dhuk
砀	dhup
珰	dhwe
当	dhxe
髢	diay
弟	dibp
荻	dich
蒂	dicj
菂	dicu
邸	dide
滴	didk
抵	difd
提	difr
骶	digd
鞮	digr
镝	dijk
嘀	dikk
柢	dimd
棣	dimn
媂	dinj
嫡	dink
娣	dinp
睇	diop
狄	diqh
敌	diqw
低	dird
籴	dirm
坻	ditd
堤	ditr
地	dity
砥	diud
觌	diue
碲	diuj
䃅	diul
第	divp
笛	divy
翟	dixf
诋	diyd
蹢	dizk
递	dizp
踶	dizr
迪	dizy
石	djak
疸	djba
郸	djbe
瘅	djbl
萏	djcj
殚	djdl
聃	djer
耽	djev
担	djfa
掸	djfl
赕	djkh
旦	djoa
眈	djov
丹	djpa
氮	djqh
但	djra
儋	djrk
疍	djva
亶	djwa
憺	djxk
丁	dkal
疔	dkbd
定	dkbr
萣	dkcr
耵	dked
钉	dkjd
锭	dkjr
铤	dkjz
叮	dkkd
啶	dkkr
盯	dkod
腚	dkor
鼎	dkov
仃	dkrd
町	dktd
碇	dkur
玎	dkwd
酊	dkyd
奠	dmbd
癫	dmbr
甸	dmbt
癜	dmby
滇	dmdb
淀	dmdr
阽	dmek
巅	dmer
掂	dmfk
靛	dmfr
垫	dmft
店	dmgk
扂	dmhk
钿	dmjt
典	dmlb
点	dmlh
电	dmlv
佃	dmrt
坫	dmtk
碘	dmub
颠	dmur
玷	dmwk
琔	dmwr
踮	dmzk
鲷	dnak
窎	dnbn
掉	dnfu
铫	dnjd
铞	dnjj
叼	dnkd
雕	dnkf
吊	dnkj
鸟	dnpa
碉	dnuk
貂	dnvk
鸟	dnwd
调	dnyk
堕	doet
掇	dofy
度	dogy
剁	dojd
铎	dojl
咄	doki
哚	dokm
哆	dokx
柁	domb
杕	domd
裰	dopy
埵	doti
㙍	doty
躲	doum
舵	dovb
亸	dowl
惰	doxo
剟	doyd
跺	dozm
踱	dozy
鲽	dpam
爹	dpbx
瓞	dpgu
蝶	dpim
喋	dpkm
耋	dplt
楪	dpmm
䏲	dpop
昳	dpou
绖	dpst
堞	dptm
垤	dptt
碟	dpum
谍	dpym
叠	dpyq
蹀	dpzm
跌	dpzu
铥	dqjs
丢	dqps
耑	dree
锻	drjy
椴	drmy
段	drpy
缎	drsy
塅	drty
短	drua
簖	drvj
瑖	drwy
东	dsad
董	dscv
冻	dsdd
洞	dsdk
鸫	dsdn
岽	dsed
峒	dsek
动	dsel
胨	dsod
胴	dsok
氡	dsqd
侗	dsrk
硐	dsuk
冬	dswd
恫	dsxk
懂	dsxv
芏	duct
渎	dudd
毒	dufm
髑	dugi
镀	dujy
嘟	duke
赌	duko
椟	dumd
杜	dumt
犊	dund
睹	duoo
肚	duot
堵	duto
顿	dutr
督	duuo
笃	duvm
厾	duvs
兑	dvbe
队	dver
镦	dvjw
祋	dvpy
堆	dvtf
碓	dvuf
对	dvyc
得	dwic
嘚	dwkc
嗲	dxkx
沌	dydt
炖	dyht
囤	dykt
楯	dymo
盹	dyot
盾	dypo
顿	dytr
墩	dytw
砘	dyut
礅	dyuw
趸	dywr
惇	dyxz
蹲	dyzc
遁	dyzo
豆	dzaa
痘	dzba
窦	dzbd
兜	dzbe
蔸	dzce
陡	dzer
蚪	dziu
钭	dzju
兜	dzpe
篼	dzve
读	dzyd
逗	dzza
鳄	eeak
额	eebr
萼	eeck
苊	eecv
莪	eecw
涐	eedw
阿	eeek
峨	eeew
扼	eefv
轭	eeiv
蛾	eeiw
锷	eejk
锇	eejw
鄂	eeke
鹗	eekn
颚	eekr
呃	eekv
哦	eekw
阏	eemd
婀	eenk
娥	eenw
腭	eeok
俄	eerw
堨	eetv
屙	eeuk
饿	eeuw
噩	eewk
鹅	eewn
讹	eeyb
谔	eeyk
垩	eeyt
恶	eeyx
遏	eezv
欸	eisr
蒽	encx
摁	enfx
恩	enkx
二	eraa
鲕	erae
而	eral
洱	erde
尔	erdx
陑	eree
鸸	eren
耏	erep
铒	erje
儿	erpv
佴	erre
饵	erue
珥	erwe
迩	erzx
乏	fapv
伐	farg
垡	fart
罚	fasd
砝	faus
发	favd
筏	favg
珐	faws
鲼	ffar
忿	ffbx
棻	ffcm
瀵	ffdb
奋	ffdt
鼢	ffjd
粪	ffmb
棼	ffmd
焚	ffmh
氛	ffqd
份	ffrd
坋	fftd
坟	fftw
豮	ffur
翂	ffxd
愤	ffxr
酚	ffyd
丰	fgal
疯	fgbx
葑	fgcc
沣	fgdf
沨	fgdx
崶	fgec
酆	fgee
峰	fgef
酆	fgfe
烽	fghf
锋	fgjf
风	fgjx
凤	fgjy
赗	fgko
枫	fgmx
俸	fgrl
缝	fgsz
封	fgtc
堼	fgtt
砜	fgux
讽	fgyx
逢	fgzf
鲂	fhaf
芳	fhcf
方	fhdw
防	fhef
邡	fhfe
房	fhhf
钫	fhjf
牥	fhnf
昉	fhof
纺	fhsf
坊	fhtf
藩	fjct
范	fjcv
蘩	fjcx
泛	fjdf
燔	fjht
帆	fjjf
幡	fjjt
番	fjpt
繁	fjpx
反	fjpy
犯	fjqv
墦	fjtt
畈	fjty
饭	fjuy
璠	fjwt
蹯	fjzt
返	fjzy
佛	forf
鲋	fuac
甫	fuad
釜	fuba
宓	fubb
斧	fubj
匐	fubt
父	fubx
芣	fucb
苻	fucc
茀	fucf
芾	fucj
芾	fucl
茯	fucq
菔	fucy
莩	fucz
滏	fuda
涪	fudk
洑	fudq
负	fudr
㳇	fudx
浮	fudz
附	fuec
艴	fufb
拊	fufc
拂	fuff
鄜	fuge
腐	fugr
稃	fuhz
蚨	fuif
辐	fuit
蝮	fuiw
幞	fujn
幅	fujt
咐	fukc
呋	fukf
呒	fukw
孵	fulz
榑	fumc
桴	fumz
妇	fune
腑	fuoc
肤	fuof
腹	fuow
服	fuoy
郛	fupe
袱	fupq
福	fupt
阜	fupu
复	fupw
孚	fupz
氟	fuqf
傅	furc
伏	furq
俘	furz
罘	fusb
缚	fusc
绂	fusd
绋	fusf
赴	futb
符	fuvc
簠	fuvm
韨	fuwd
玞	fuwf
琈	fuwz
怫	fuxf
覆	fuxw
黻	fuyd
黼	fuyf
趺	fuzf
鲱	fwaf
菲	fwcf
芾	fwcj
芾	fwcl
淝	fwdb
沸	fwdf
剕	fwfd
蜚	fwfi
棐	fwfm
费	fwfr
翡	fwfx
扉	fwhf
镄	fwjr
啡	fwkf
吠	fwkq
非	fwla
肥	fwob
腓	fwof
朏	fwoi
肺	fwoj
肺	fwol
狒	fwqf
绯	fwsf
飞	fwvd
篚	fwvf
悱	fwxf
霏	fwyf
否	fzbk
缶	fzwk
戛	gaag
夹	gaan
轧	gaiv
旮	gajo
钆	gajv
嘎	gakg
呷	gakj
咖	gakk
噶	gakv
尕	ganx
胳	gaok
伽	gark
尬	gaul
尜	gaxx
尬	gayl
皋	gcbu
藁	gccm
搞	gcfk
锆	gcjk
糕	gcmh
槔	gcmu
郜	gcne
告	gcnk
杲	gcom
睾	gcpg
缟	gcsk
筶	gcvk
高	gcwk
膏	gcwo
诰	gcyk
丐	gdav
荄	gdcr
溉	gddv
陔	gder
钙	gdjg
改	gdjw
赅	gdkr
概	gdmv
晐	gdor
垓	gdtr
该	gdyr
戈	gead
哥	geak
鬲	geal
歌	gear
割	gebd
疙	gebq
葛	gecv
哥	gedk
滆	gedl
隔	geel
搁	gefk
骼	gegk
蛤	geik
虼	geiq
镉	gejl
咯	gekk
嗝	gekl
哿	gelk
革	genl
胳	geok
膈	geol
袼	gepk
合	gerk
个	gerl
鸽	gern
仡	gerq
颌	gerr
纥	gesq
塥	getl
圪	getq
饹	geuk
舸	gevk
各	gewk
盖	geym
亘	gfaa
茛	gfcg
艮	gfen
哏	gfkg
根	gfmg
艮	gfvn
跟	gfzg
鲠	ggag
更	ggan
浭	ggdg
耿	ggeh
鹒	gggn
赓	gggr
哽	ggkg
耕	gglj
梗	ggmg
暅	ggoa
绠	ggsg
埂	ggtg
颈	ggvr
羹	ggyd
冮	ghdg
港	ghds
岗	ghex
扛	ghfg
刚	ghkd
冈	ghkx
戆	ghlx
㭎	ghmx
肛	ghog
罡	ghsv
纲	ghsx
鿍	ghtl
堽	ghtv
矼	ghug
甘	gjaa
干	gjau
鳡	gjax
苷	gjcg
泔	gjdg
澉	gjdw
擀	gjfg
秆	gjhg
赣	gjlr
柑	gjmg
橄	gjmw
甘	gjna
旰	gjog
绀	gjsg
坩	gjtg
矸	gjug
尴	gjum
竿	gjvg
玕	gjwg
感	gjwx
感	gjxx
酐	gjyg
尴	gjym
拐	gkfl
乖	gkqb
夬	gkvn
怪	gkxt
广	gldi
洸	gldw
咣	glkw
桄	glmw
胱	glow
犷	glqg
垙	gltw
广	glwp
光	glxw
逛	glzw
涡	godn
聒	goek
崞	goez
掴	gofy
蝈	goiy
帼	gojy
呙	gokn
国	goky
果	goln
粿	gomg
椁	gomz
腘	gooy
埚	gotn
郭	gowe
裹	gowy
鳏	grad
鳤	grak
冠	grbc
关	grbt
蒄	grcc
鹳	grcn
灌	grdf
涫	grdk
掼	grfr
爟	grhf
贯	grmr
祼	grpg
盥	grpm
倌	grrk
纶	grsb
矜	grsv
馆	gruk
毌	grva
管	grvk
贯	grvr
瓘	grwf
琯	grwk
惯	grxr
观	grye
工	gsaa
宫	gsbk
公	gsbs
共	gscb
恭	gscx
觥	gsdw
拱	gsfb
巩	gsgf
功	gsgl
攻	gsgw
蚣	gsis
肱	gsos
供	gsrb
红	gssg
弓	gsvv
珙	gswb
鲴	guak
痼	gubk
菰	gucg
菇	guck
汩	gudo
瀔	gudy
崮	guek
鹘	gugn
雇	guhf
轱	guik
蛊	guim
顾	guir
锢	gujk
呱	gukg
咕	gukk
骨	gulo
梏	gumk
牯	gunk
臌	guoy
估	gurk
罟	gusk
堌	gutk
古	guuk
鸪	guun
瞽	guuo
辜	guuu
故	guuw
毂	guuy
箍	guvj
酤	guyk
羖	guyy
孤	guzg
鳜	gvar
鲑	gvat
宄	gvbj
皈	gvby
氿	gvdj
刿	gved
规	gvfe
鬶	gvfl
轨	gvij
匦	gvkj
柜	gvmj
桧	gvms
闺	gvmt
妫	gvnw
炅	gvoh
晷	gvok
鬼	gvps
刽	gvrd
邽	gvte
圭	gvtt
硅	gvut
簋	gvvm
贵	gvvr
筀	gvvt
瑰	gvwg
珪	gvwt
给	gwsk
寡	gxbd
挂	gxft
呱	gxkg
胍	gxog
褂	gxpb
瓜	gxpn
刮	gxqd
鸹	gxqn
卦	gxtb
坬	gxtg
诖	gxyt
鲧	gyax
滚	gydy
辊	gyib
棍	gymb
绲	gysb
衮	gywy
觏	gzae
勾	gzbs
够	gzbx
苟	gzck
岣	gzek
钩	gzjs
购	gzks
耇	gzlk
构	gzms
姤	gznk
媾	gznr
狗	gzqk
佝	gzrk
缑	gzsu
垢	gztk
彀	gzuy
笱	gzvk
篝	gzvr
诟	gzyk
遘	gzzr
蛤	haik
铪	hajk
哈	hakk
蒿	hcck
浩	hcdk
灏	hcdr
淏	hcdt
蚝	hcim
镐	hcjk
嚎	hcku
好	hcnz
颢	hcor
昊	hcot
侴	hcrd
郝	hcte
壕	hctu
貉	hcvk
鄗	hcwe
毫	hcwm
海	hddm
嗐	hdkk
嗨	hdkm
咳	hdkr
骇	hdmr
胲	hdor
氦	hdqr
亥	hdwr
醢	hdym
孩	hdzr
翮	heax
菏	heck
隺	hedf
鹤	hedn
和	hehk
盉	hehm
呵	hekk
喝	hekv
吓	hekx
贺	helr
壑	helt
阖	hemm
阂	hemr
鹖	heon
曷	heov
禾	hepm
褐	hepv
禾	heqn
郃	here
龢	herh
何	herk
盒	herm
颌	herr
纥	hesq
赫	hetd
垎	hetk
盍	hetm
饸	heuk
貉	hevk
龁	hevq
劾	hewl
痕	hfbg
很	hfig
狠	hfqg
恨	hfxg
蘅	hgci
行	hgii
鸻	hgin
哼	hgkl
横	hgmb
桁	hgmi
姮	hgna
珩	hgwi
亨	hgwl
恒	hgxa
巷	hhcs
沆	hhdj
夯	hhdl
吭	hhkj
绗	hhsi
颃	hhwr
寒	hjbd
罕	hjbg
蔊	hjcg
菡	hjck
汗	hjdg
涵	hjdk
瀚	hjdx
汉	hjdy
嵅	hjek
撖	hjfw
撼	hjfx
邗	hjge
顸	hjgr
焊	hjhg
焓	hjhk
虷	hjig
喊	hjkk
㘎	hjkw
函	hjlk
旱	hjog
晗	hjok
暵	hjon
犴	hjqg
含	hjrk
颔	hjrr
垾	hjtg
韩	hjuw
翰	hjux
憨	hjvx
琀	hjwk
悍	hjxg
憾	hjxx
酣	hjyg
鼾	hjzg
淮	hkdf
槐	hkmg
坏	hktb
踝	hkzg
鳇	hlaw
癀	hlbb
黄	hlcb
荒	hlcv
潢	hldb
滉	hldw
蟥	hlib
徨	hliw
幌	hljw
喤	hlkw
媓	hlnw
晃	hlow
簧	hlvb
篁	hlvw
璜	hlwb
肓	hlwo
慌	hlxv
惶	hlxw
遑	hlzw
劐	hocd
藿	hocf
获	hocq
活	hodk
火	hodr
濩	hody
彟	hoey
攉	hoff
或	hoga
夥	hogx
㸌	hohf
和	hohk
蠖	hoiy
钬	hojh
镬	hojy
嚯	hokf
嚄	hoky
耠	holk
祸	hopn
伙	horh
佸	hork
货	horr
霍	hoyf
鲩	hrae
鬟	hray
痪	hrbd
郇	hrbe
宦	hrbi
寰	hrby
荁	hrca
萑	hrcf
洹	hrda
浣	hrde
漶	hrdx
澴	hrdy
峘	hrea
换	hrfd
擐	hrfy
焕	hrhd
患	hrix
锾	hrjy
唤	hrkd
圜	hrky
桓	hrma
嬛	hrny
㬊	hroy
獾	hrqf
鹮	hrsn
缳	hrsy
貆	hrva
环	hrwb
幻	hryv
还	hrzb
逭	hrzk
谼	hsbb
訇	hsbk
宏	hsbs
薨	hscb
荭	hscg
洪	hsdb
鸿	hsdn
弘	hsgs
烘	hshb
虹	hsig
轰	hsiy
哄	hskb
吽	hskn
闳	hsms
红	hssg
纮	hsss
硔	hsub
玒	hswg
讧	hsyg
互	huaa
鳠	huay
葫	huco
瓠	hudg
滹	hudh
湖	hudo
浒	hudw
淴	hudx
岵	huek
弧	hugg
鹘	hugn
扈	huhb
和	huhk
煳	huho
戽	huhu
轷	huih
蝴	huio
呼	hukh
唬	hukj
囫	hukw
唿	hukx
糊	humo
核	humr
槲	humu
嫭	hunh
鹄	hunn
鹱	huny
昈	huoh
昒	huow
祜	hupk
乎	hupl
狐	huqg
猢	huqo
鹕	huun
壶	huuy
笏	huvw
琥	huwj
瑚	huwo
忽	huwx
惚	huxx
鄠	huye
醐	huyo
惠	hvax
茴	hvck
荟	hvcs
蕙	hvcx
洄	hvdk
堕	hvet
隳	hvex
彗	hvfe
挥	hvfi
慧	hvfx
麾	hvgm
蛔	hvik
徽	hviw
蟪	hvix
毁	hvjy
咴	hvkh
回	hvkk
贿	hvko
喙	hvku
哕	hvkx
桧	hvms
橞	hvmx
晖	hvoi
晦	hvom
袆	hvpw
绘	hvss
恚	hvtx
卉	hvuc
硊	hvuv
虺	hvwi
恢	hvxh
辉	hvxi
诙	hvyh
诲	hvym
讳	hvyw
嘿	hwkh
黑	hwlh
画	hxak
花	hxcb
觟	hxdt
砉	hxfu
哗	hxku
婳	hxnk
猾	hxqg
化	hxrb
华	hxru
话	hxyk
荤	hyci
混	hydb
浑	hydi
溷	hydu
魂	hyeg
阍	hymo
婚	hyno
馄	hyub
昏	hyuo
惛	hyxo
诨	hyyi
鲘	hzak
骺	hzgk
厚	hziz
喉	hzku
吼	hzkv
郈	hzpe
后	hzpk
垕	hzpt
猴	hzqu
侯	hzru
堠	hztu
篌	hzvu
鲎	hzxa
齁	hzzk
岔	iabe
察	iabx
茶	iacm
茬	iact
汊	iadi
嵖	iaea
搽	iafm
锸	iajj
喳	iaka
嚓	iakx
楂	iama
槎	iamg
杈	iami
檫	iamx
姹	ianq
衩	iapi
猹	iaqa
侘	iarq
垞	iatq
刹	iaxd
叉	iayd
差	iayg
诧	iayq
蹅	iaza
弨	icgk
焯	ichu
钞	icju
嘲	icko
晁	icod
朝	icuo
剿	icvd
瘥	idbg
茝	idcl
拆	idfi
侪	idrl
豺	idvc
柴	idvm
虿	idwi
差	idyg
车	ieal
澈	iedw
扯	iefv
彻	ieid
㬚	ieow
掣	iepu
坼	ieti
疢	ifbh
宸	ifbn
沉	ifdj
陈	ifed
称	ifhx
辰	ifin
嗔	ifkb
臣	ifkl
郴	ifme
梣	ifmv
瞋	ifob
晨	ifon
伧	ifrv
趁	iftp
碜	ifup
龀	ifvb
琛	ifwm
尘	ifxt
忱	ifxv
谶	ifyj
谌	ifyv
宬	igbi
澄	igda
澂	igdw
庱	iggw
秤	ighp
程	ighw
称	ighx
盛	igim
蛏	igit
惩	igix
铛	igje
呈	igkw
丞	igla
橙	igma
枨	igmi
柽	igmt
骋	igmv
晟	igoi
塍	igot
裎	igpw
乘	igqn
偁	igrr
城	igti
赪	igtr
埕	igtw
承	igvn
珹	igwi
琤	igwl
成	igwv
憕	igxa
牚	igxy
酲	igyw
逞	igzw
鲳	ihao
厂	ihap
鲿	ihas
菖	ihco
唱	ihko
阊	ihmo
嫦	ihnj
娼	ihno
昌	ihoo
肠	ihop
猖	ihqo
伥	ihri
倡	ihro
偿	ihrs
场	ihtp
畅	ihup
鬯	ihxb
常	ihxj
惝	ihxk
尝	ihxs
敞	ihxw
裳	ihxy
昶	ihyo
豉	iiay
痴	iibk
痓	iibt
瘛	iibx
耻	iiev
持	iifc
摛	iifd
魑	iigd
弛	iigy
炽	iihb
螭	iiid
叱	iikb
哧	iikd
嗤	iiki
吃	iikq
驰	iimy
媸	iini
匙	iiob
眵	iiox
胣	iioy
斥	iipd
褫	iipj
彳	iipr
佁	iirk
傺	iirx
坻	iitd
墀	iitn
饬	iiul
尺	iiun
敕	iiuw
翅	iiux
篪	iivj
笞	iivk
啻	iiwk
瓻	iixw
踟	iizk
单	ijbl
冁	ijbn
蒇	ijcr
澶	ijda
瀍	ijdt
巉	ijed
搀	ijfd
掺	ijfp
韂	ijgk
廛	ijgt
蟾	ijik
蝉	ijil
镵	ijjd
镡	ijju
觇	ijle
产	ijlp
阐	ijml
骣	ijmz
婵	ijnl
旵	ijoe
儳	ijrd
缠	ijsl
羼	ijuy
孱	ijuz
颤	ijwr
忏	ijxq
谗	ijyd
辿	ijze
躔	ijzt
揣	ikfe
搋	ikfj
啜	ikky
踹	ikze
疮	ilbv
窗	ilbw
床	ilgm
幢	iljl
创	ilrd
怆	ilxv
辍	ioiy
啜	ioky
绰	iosu
龊	iovr
戳	ioxg
惙	ioxy
逴	iozu
钏	irji
圌	irke
串	irll
椽	irmu
川	irpl
传	irrv
堾	irto
船	irvk
舛	irxl
遄	irze
宠	isbl
㳘	isde
冲	isdv
漴	isdx
涌	isdy
崇	isex
铳	isje
重	ispa
虫	isvd
珫	iswe
翀	isxv
亍	iuad
刍	iude
雏	iudf
滁	iudh
濋	iudr
除	iueh
亍	iuel
摴	iufk
搐	iuft
黜	iuhi
厨	iuic
䢺	iuie
橱	iumc
柷	iume
楚	iumr
杵	iumw
褚	iupo
储	iuro
俶	iury
矗	iuuq
出	iuvk
䝙	iuvx
处	iuwb
畜	iuwt
琡	iuwy
憷	iuxr
蹰	iuzc
躇	iuzo
陲	ivei
捶	ivfi
炊	ivhr
锤	ivji
圌	ivke
吹	ivkr
椎	ivmf
棰	ivmi
垂	ivpa
倕	ivri
欻	ixhr
䲠	iyao
莼	iyct
蠢	iyfi
春	iyfo
唇	iyik
蝽	iyio
椿	iymo
纯	iyst
瑃	iywo
瘳	izbp
抽	izfy
稠	izhk
帱	izjc
椆	izmk
瞅	izoh
俦	izrc
仇	izrj
犨	izrn
绸	izsk
畴	iztc
丑	izva
筹	izvc
酬	izyv
踌	izzc
臭	izzq
荩	jbcd
殣	jbda
溍	jbdo
浸	jbdy
廑	jbga
靳	jbgj
烬	jbhd
噤	jbkx
卺	jblv
紧	jblx
槿	jbma
禁	jbmx
堇	jbna
觐	jbne
斤	jbpl
衿	jbpv
襟	jbpx
祲	jbpy
金	jbra
今	jbrv
仅	jbry
墐	jbta
馑	jbua
筋	jbvl
瑾	jbwa
珒	jbwy
晋	jbyo
进	jbzj
鲫	jiae
鱾	jiaj
髻	jiak
鲚	jial
棘	jian
瘠	jibo
疾	jibu
寂	jiby
蕺	jica
芨	jicj
荠	jicl
济	jidl
脊	jido
激	jidw
漈	jidx
洎	jidz
岌	jiej
嵴	jieo
际	jiex
掎	jifk
技	jify
暨	jiga
麂	jigj
堲	jigt
既	jigv
积	jihb
稷	jihw
季	jihz
虮	jiij
徛	jiik
墼	jiit
戢	jika
戢	jikd
叽	jikj
亟	jila
楫	jime
极	jimj
姬	jini
犄	jink
姬	jinl
妓	jiny
肌	jioj
几	jipv
祭	jipx
其	jiqb
期	jiqo
基	jiqt
惎	jiqx
佶	jirk
集	jirm
偈	jirv
伎	jiry
罽	jisd
缉	jise
纪	jisj
给	jisk
羁	jism
绩	jisr
畸	jitk
饥	jiuj
吉	jiuk
赍	jiur
屐	jiuy
箕	jivb
笄	jivk
籍	jivo
剂	jiwd
齑	jiwl
悸	jixz
讥	jiyj
诘	jiyk
霁	jiyl
鸡	jiyn
畿	jiyt
跻	jizl
蹐	jizo
跽	jizx
井	jkal
鲸	jkax
痉	jkbg
荆	jkcd
茎	jkcg
警	jkck
菁	jkco
敬	jkcw
泾	jkdg
汫	jkdj
净	jkdl
阱	jkej
靓	jkfe
静	jkfl
䴖	jkfn
旌	jkfu
麖	jkgx
镜	jkje
鼱	jkjo
竞	jkle
粳	jkmg
婧	jkno
胫	jkog
肼	jkoj
睛	jkoo
景	jkox
獍	jkqe
猄	jkqx
儆	jkrw
倞	jkrx
经	jksg
境	jkte
刭	jkvd
颈	jkvr
璟	jkwx
鳉	jlac
豇	jlag
蒋	jlcc
茳	jlcg
奖	jldd
江	jldg
洚	jldl
桨	jldm
浆	jldu
酱	jldy
降	jlel
疆	jlga
强	jlgi
犟	jlgn
弶	jlgx
匠	jlkj
耩	jllr
糨	jlmi
膙	jloi
僵	jlra
缰	jlsa
绛	jlsl
礓	jlua
姜	jlyn
戋	jmad
鳒	jman
鲣	jmat
剪	jmbd
鹣	jmbn
蹇	jmbr
翦	jmbx
茧	jmci
菅	jmck
蒹	jmcn
荐	jmcz
湔	jmdd
渐	jmdj
涧	jmdo
歼	jmdq
拣	jmfd
搛	jmfn
靬	jmgg
鞬	jmgz
锏	jmjo
键	jmjz
贱	jmkj
鉴	jmlj
枧	jmme
毽	jmmz
奸	jmng
犍	jmnz
睑	jmoa
暕	jmoj
腱	jmoz
裥	jmpo
俭	jmra
剑	jmrd
牮	jmrn
健	jmrz
缄	jmsk
缣	jmsn
饯	jmuj
碱	jmuk
箭	jmvd
舰	jmve
笺	jmvj
简	jmvo
尖	jmxd
谫	jmyd
艰	jmyg
践	jmzj
趼	jmzk
建	jmzy
踺	jmzz
斠	jnau
鲛	jnax
皭	jnbc
皎	jnbx
藠	jncb
艽	jncj
茭	jncx
湫	jndh
浇	jndw
角	jndy
峧	jnex
搅	jnfe
轿	jnil
徼	jniw
蛟	jnix
嚼	jnkc
噍	jnkh
教	jnlw
骄	jnml
校	jnmx
椒	jnmy
姣	jnnx
脚	jnoe
胶	jnox
狡	jnqx
鹪	jnrn
侥	jnrw
佼	jnrx
缴	jnsw
绞	jnsx
矫	jnul
饺	jnux
剿	jnvd
郊	jnwe
䴔	jnwn
交	jnwx
觉	jnxe
跤	jnzx
鲒	jpak
皆	jpbb
疖	jpbe
疥	jpbl
节	jpce
芥	jpcl
藉	jpco
湝	jpdb
解	jpdn
阶	jpel
拮	jpfk
㛃	jpfn
捷	jpfr
揭	jpfv
絜	jpfx
蚧	jpil
喈	jpkb
嗟	jpkg
楷	jpmb
杰	jpmh
桔	jpmk
檞	jpmn
姐	jpnq
婕	jpnr
睫	jpor
介	jprl
借	jpro
偈	jprv
结	jpsk
劫	jptl
截	jpuf
劼	jpul
颉	jpur
碣	jpuv
届	jpuy
孑	jpva
玠	jpwl
悈	jpxc
讦	jpyg
羯	jpyv
鬏	jqah
氿	jqdj
酒	jqdy
㠇	jqey
韭	jqfa
厩	jqiv
灸	jqjh
鸠	jqjn
啾	jqkh
旧	jqlo
桕	jqmj
阄	jqmv
臼	jqpa
久	jqpn
九	jqpv
救	jqqw
僦	jqry
纠	jqsl
赳	jqtl
咎	jqwk
鹫	jqwn
就	jqwy
蠲	jrbi
涓	jrdo
捐	jrfo
焆	jrho
桊	jrjm
镌	jrjn
鹃	jrkn
圈	jrkv
娟	jrno
狷	jrqo
隽	jrrn
倦	jrrv
鄄	jrxe
窘	jsbk
泂	jsdk
扃	jshk
冏	jskk
䐃	jsoh
䌹	jssk
坰	jstk
迥	jszk
蕨	jtcr
觖	jtdg
角	jtdy
崛	jtei
抉	jtfg
掘	jtfi
撅	jtfr
攫	jtfy
劂	jtid
厥	jtir
镢	jtjr
嚼	jtkc
噘	jtkr
噱	jtku
橛	jtmr
桷	jtmy
矍	jtoy
爵	jtpc
獗	jtqr
玃	jtqy
傕	jtrf
倔	jtri
孓	jtvn
珏	jtwy
觉	jtxe
诀	jtyg
谲	jtyk
蹶	jtzr
车	jual
窭	jubn
疽	jubq
莒	juck
菊	jucm
苴	jucq
泃	judk
岠	juej
崌	juek
聚	juen
岨	jueq
拘	jufk
掬	jufm
鞫	jugk
鞠	jugm
秬	juhj
焗	juhk
钜	jujj
锔	jujk
巨	juka
咀	jukq
且	jula
柜	jumj
桔	jumk
榉	juml
犋	junb
娵	juny
腒	juok
䴗	juon
裾	jupk
雎	juqf
狙	juqq
俱	jurb
倨	jurk
弆	jutc
剧	juud
矩	juuj
居	juuk
屦	juun
砠	juuq
筥	juvk
讵	juyj
踞	juzk
踽	juzy
戛	jxag
夹	jxan
痂	jxbk
茄	jxck
葭	jxcy
岬	jxej
恝	jxfx
郏	jxje
铗	jxjj
颊	jxjr
斝	jxku
甲	jxll
驾	jxlm
袈	jxly
槚	jxmr
胛	jxoj
伽	jxrk
价	jxrl
佳	jxrt
笳	jxvk
珈	jxwk
贾	jxxr
跏	jxzk
鲪	jyak
军	jybi
皲	jyby
菌	jych
莙	jyck
葰	jycw
浚	jydw
峻	jyew
捃	jyfk
钧	jyjd
晙	jyow
隽	jyrn
俊	jyrw
均	jytd
畯	jytw
筠	jyvd
珺	jywk
郡	jyye
咔	kakb
喀	kakk
胩	kaob
卡	kaub
洘	kcdv
拷	kcfv
㸆	kchf
烤	kchv
铐	kcjv
栲	kcmv
靠	kcnf
犒	kcnk
开	kdac
蒈	kdcb
剀	kded
凯	kdej
揩	kdfb
锴	kdjb
铠	kdjj
锎	kdjk
楷	kdmb
恺	kdxj
忾	kdxq
慨	kdxv
窠	kebg
疴	kebk
苛	keck
可	kedk
溘	kedm
岢	keek
髁	kegg
稞	kehg
炣	kehk
轲	keik
蝌	keiu
锞	kejg
呵	kekk
嗑	kekm
咳	kekr
骒	kemg
柯	kemk
瞌	keom
牁	kepk
氪	keqe
缂	kesg
克	keue
壳	keuj
磕	keum
珂	kewk
颏	kewr
课	keyg
垦	kfgt
恳	kfgx
啃	kfko
裉	kfpg
龈	kfvg
肯	kfvo
铿	kgjt
吭	kgkj
扛	khfg
抗	khfj
康	khgn
钪	khjj
闶	khmj
糠	khmn
伉	khrj
亢	khwj
慷	khxn
莰	kjcr
崁	kjer
嵁	kjev
刊	kjgd
衎	kjii
槛	kjmm
阚	kjmw
瞰	kjow
戡	kjqg
勘	kjql
龛	kjrl
侃	kjrv
墈	kjtl
坎	kjtr
堪	kjtv
磡	kjul
看	kjuo
砍	kjur
鲙	kkas
蒯	kkcd
浍	kkds
㧟	kkfk
哙	kkks
脍	kkos
狯	kkqs
郐	kkre
侩	kkrs
块	kktg
筷	kkvg
快	kkxg
况	klde
夼	kldi
洭	kldw
邝	klge
哐	klkw
框	klmw
旷	klog
眶	klow
狂	klqw
纩	klsg
圹	kltg
矿	klug
筐	klvw
诓	klyw
扩	kofg
括	kofk
廓	koge
蛞	koik
栝	komk
适	kozk
宽	krbe
髋	krge
款	krur
空	ksbg
崆	kseg
控	ksfg
恐	ksgx
倥	ksrg
埪	kstg
硿	ksug
箜	ksvg
孔	kszv
苦	kuck
库	kugi
骷	kugk
圐	kukf
哭	kukq
裤	kupi
绔	kusk
矻	kuuq
酷	kuyk
窥	kvbe
夔	kvbw
蒉	kvcr
葵	kvct
溃	kvdr
奎	kvdt
岿	kvee
隗	kveg
聩	kver
亏	kvev
揆	kvft
魁	kvgu
煃	kvht
蝰	kvit
喟	kvko
匮	kvkr
喹	kvkt
骙	kvmt
櫆	kvmu
暌	kvot
傀	kvrg
盔	kvum
馈	kvur
戣	kvvg
篑	kvvr
愧	kvxg
悝	kvxl
愦	kvxr
跬	kvzt
剋	kwud
夸	kxdk
挎	kxfk
姱	kxnk
胯	kxok
侉	kxrk
垮	kxtk
跨	kxzk
鲲	kyab
髡	kyaw
捆	kyfm
堃	kyft
焜	kyhb
锟	kyjb
困	kykm
阃	kymm
婫	kynb
昆	kyob
鹍	kyon
裈	kypi
坤	kytu
壸	kyuy
琨	kywb
悃	kyxm
醌	kyyb
寇	kzby
芤	kzcv
蔻	kzcy
扣	kzfk
抠	kzfx
口	kzla
眍	kzox
筘	kzvk
瘌	labd
落	lack
拉	lafl
鞡	lagl
蝲	laid
蜡	laio
镴	lajv
啦	lakl
辣	lalu
旯	laoj
腊	laoo
垃	latl
剌	laud
砬	laul
邋	lazv
鳞	lbal
蔺	lbcf
潾	lbdl
淋	lbdm
凛	lbdx
嶙	lbel
拎	lbfs
麟	lbgl
廪	lbgx
啉	lbkm
临	lbla
粼	lbmv
檩	lbmx
膦	lbol
邻	lbre
赁	lbrr
磷	lbul
箖	lbvm
吝	lbwk
璘	lbwl
琳	lbwm
懔	lbxx
霖	lbym
躏	lbzf
遴	lbzl
痨	lcbl
荖	lccb
落	lcck
劳	lccl
涝	lcdl
潦	lcdx
崂	lcel
捞	lcfl
烙	lchk
铑	lcjb
铹	lcjl
唠	lckl
老	lclb
耢	lcll
栳	lcmb
姥	lcnb
嫪	lcnp
佬	lcrb
络	lcsk
醪	lcyp
来	ldan
癞	ldbr
莱	ldcl
涞	lddl
崃	ldel
赉	ldlr
梾	ldml
睐	ldol
俫	ldrl
赖	ldur
籁	ldvr
鳓	leal
泐	ledl
勒	legl
叻	lekl
肋	leol
乐	lepd
仂	lerl
饹	leuk
了	levl
崚	lgew
棱	lgmw
塄	lgtf
堎	lgtw
愣	lgxf
蒗	lhcl
蓢	lhco
郎	lhde
浪	lhdl
㮾	lhdm
朗	lhdo
塱	lhdt
崀	lhel
廊	lhge
稂	lhhl
螂	lhie
锒	lhjl
啷	lhke
榔	lhme
阆	lhml
㫰	lhol
狼	lhql
埌	lhtl
筤	lhvl
琅	lhwl
鳢	liaa
丽	liad
鲤	lial
疬	libl
疠	libw
莅	licl
藜	licu
澧	lida
沥	lidl
溧	lidm
峛	lied
黧	lihh
梨	lihm
犁	lihn
戾	lihq
黎	lihu
蜊	liid
励	liil
厉	liiw
喱	likl
唳	likq
里	lila
粒	liml
㰀	limu
粝	limw
李	limz
娌	linl
礼	lipv
猁	liqd
狸	liql
俐	lird
俪	lirl
傈	lirm
缡	lisd
罹	lisf
詈	lisk
坜	litl
砺	liuw
篱	livd
笠	livl
篥	livm
隶	livn
力	livp
立	liwa
理	liwl
嫠	liwn
醴	liya
醨	liyd
雳	liyl
跞	lizl
兰	ljbs
蓝	ljcm
澜	ljdj
岚	ljex
揽	ljfe
拦	ljfs
烂	ljhs
镧	ljjj
榄	ljme
阑	ljmj
婪	ljmn
栏	ljms
襕	ljpj
罱	ljsg
篮	ljvm
斓	ljwj
懒	ljxr
鲮	lkaw
苓	lkcs
菱	lkcw
凌	lkdw
灵	lkeh
聆	lkes
陵	lkew
蛉	lkis
铃	lkjs
另	lkkl
棂	lkmh
柃	lkms
棱	lkmw
姈	lkns
昤	lkos
祾	lkpw
鸰	lkrn
领	lkrr
伶	lkrs
瓴	lkrw
翎	lkrx
绫	lksw
舲	lkvs
玲	lkws
㥄	lkxw
酃	lkye
两	llad
良	lldg
凉	lldx
靓	llfe
辆	llil
辌	llix
粮	llml
椋	llmx
量	llol
晾	llox
俍	llrl
踉	llzl
鲢	lmaz
蔹	lmcw
莲	lmcz
濂	lmdn
潋	lmdw
奁	lmdx
涟	lmdz
联	lmet
廉	lmgn
炼	lmhd
蠊	lmin
镰	lmjn
链	lmjz
梿	lmmz
脸	lmoa
裣	lmpa
裢	lmpz
敛	lmrw
磏	lmun
瑓	lmwj
恋	lmwx
琏	lmwz
怜	lmxs
鹩	lnan
寥	lnbp
寮	lnbx
蓼	lncp
鹩	lndn
漻	lndp
聊	lnee
撂	lnfk
撩	lnfx
髎	lngp
燎	lnhx
钌	lnjl
镣	lnjx
嘹	lnkx
料	lnmu
橑	lnmx
嫽	lnnx
瞭	lnox
獠	lnqx
僚	lnrx
缭	lnsx
尥	lnuu
了	lnvl
簝	lnvx
尥	lnyu
辽	lnzl
蹽	lnzx
瘰	lobx
蓏	locg
落	lock
荦	locn
萝	locx
泺	lodl
漯	lodx
捋	lofc
摞	lofx
烙	lohk
螺	loix
锣	lojx
咯	lokk
啰	lokx
骆	lomk
椤	lomx
脶	loon
裸	lopg
猡	loqx
倮	lorg
络	losk
罗	losx
硌	louk
箩	lovx
珞	lowk
跞	lozl
逻	lozx
冽	lpdd
烈	lpdh
䴕	lpdn
裂	lpdy
捩	lpfq
脟	lpoc
猎	lpqo
埒	lptc
趔	lptd
劣	lpul
瘤	lqbt
浏	lqdd
鎏	lqdj
溜	lqdt
瑬	lqdy
陆	lqej
旒	lqfv
熘	lqht
镠	lqjp
飗	lqjt
锍	lqjv
柳	lqme
榴	lqmt
鹠	lqpn
留	lqpt
绺	lqsk
罶	lqst
疁	lqtp
馏	lqut
六	lqwb
刘	lqwd
珋	lqwe
琉	lqwv
遛	lqzt
滦	lrdm
卵	lrpd
乱	lrqv
峦	lrwe
銮	lrwj
栾	lrwm
娈	lrwn
脔	lrwr
挛	lrwu
孪	lrwz
癃	lsbu
茏	lscl
泷	lsdl
漋	lsdu
陇	lsel
隆	lseu
拢	lsfl
哢	lskc
咙	lskl
垄	lslt
砻	lslu
栊	lsml
眬	lsol
龙	lsud
笼	lsvl
弄	lswc
珑	lswl
䂮	ltfu
掠	ltfx
锊	ltjc
圙	ltkm
略	lttk
鲁	luao
鲈	luau
蕗	luck
蓼	lucp
菉	lucu
漉	ludb
潞	ludk
澛	ludo
渌	ludu
陆	luej
录	lueu
掳	lufl
撸	lufo
鹿	lugb
庐	lugh
炉	luhh
虏	luhl
稑	luht
辘	luib
辂	luik
镥	lujo
噜	luko
鸬	luln
颅	lulr
卤	lulx
麓	lumb
氇	lumo
栌	lumu
胪	luou
禄	lupu
甪	lupy
僇	lurp
璐	luwk
琭	luwu
戮	luxg
路	luzk
鹭	luzn
逯	luzu
葎	lvcy
滤	lvdx
捋	lvfc
旅	lvfn
膂	lvfo
稆	lvhk
律	lviy
吕	lvkk
驴	lvmh
榈	lvmk
褛	lvpn
氯	lvqu
侣	lvrk
偻	lvrn
缕	lvsn
绿	lvsu
垏	lvty
屡	lvun
履	lvuw
率	lvwu
耒	lwan
癗	lwbt
藟	lwct
泪	lwdo
耒	lwfn
擂	lwft
镭	lwjt
类	lwmd
檑	lwmt
嫘	lwnx
肋	lwol
儡	lwrt
垒	lwst
缧	lwsx
罍	lwtf
累	lwtx
礌	lwut
磊	lwuu
羸	lwwf
酹	lwyc
诔	lwyl
雷	lwyt
俩	lxrl
沦	lydb
抡	lyfb
轮	lyib
囵	lykb
仑	lyrb
纶	lysb
论	lyyb
剅	lzad
瘘	lzbn
蒌	lzcn
嵝	lzen
陋	lzev
搂	lzfn
髅	lzgn
蝼	lzin
喽	lzkn
耧	lzln
楼	lzmn
䁖	lzon
篓	lzvn
露	lzyk
抹	mafm
麻	magm
摩	magu
蟆	maid
蚂	maim
骂	makm
杩	mamm
妈	manm
祃	mapm
么	maps
犸	maqm
码	maum
玛	mawm
孖	mazz
苠	mbcm
泯	mbdm
湣	mbdo
岷	mbem
抿	mbfm
黾	mbkd
皿	mbla
闽	mbmi
闵	mbmw
愍	mbmx
旻	mbow
鳘	mbpa
敏	mbpw
缗	mbso
碈	mbuo
民	mbvv
珉	mbwm
忞	mbwx
悯	mbxw
髦	mcam
茆	mcce
芼	mccm
茅	mccp
茂	mccw
泖	mcde
峁	mcee
旄	mcfm
铆	mcje
帽	mcjo
锚	mcjt
冒	mcko
耄	mclm
楙	mcmm
懋	mcmx
牦	mcnm
昴	mcoe
眊	mcom
冒	mcoo
卯	mcpe
贸	mcpr
毛	mcpv
猫	mcqt
蝥	mcsi
瞀	mcso
矛	mcsp
瑁	mcwo
袤	mcwy
麦	mdfw
鿏	mdjw
唛	mdkw
脉	mdoy
埋	mdtl
卖	mdud
买	mdvd
劢	mdwl
霾	mdyl
迈	mdzw
么	meps
门	mfdv
懑	mfdx
扪	mffm
焖	mfhx
钔	mfjm
闷	mfmx
们	mfrm
亹	mfwq
蒙	mgcn
瞢	mgco
蒙	mgcu
甍	mgcw
㠓	mgen
㠓	mgeu
蜢	mgim
蠓	mgin
蠓	mgiu
虻	mgiw
幪	mgjn
幪	mgju
檬	mgmn
檬	mgmu
梦	mgmx
盟	mgom
朦	mgon
朦	mgou
猛	mgqm
獴	mgqn
獴	mgqu
尨	mgud
礞	mgun
艋	mgvm
艨	mgvn
氓	mgwm
懵	mgxo
勐	mgzl
孟	mgzm
莽	mhcc
芒	mhcw
漭	mhdc
蟒	mhic
厖	mhid
杧	mhmw
牻	mhnd
牤	mhnw
尨	mhud
硭	mhuw
邙	mhwe
氓	mhwm
盲	mhwo
宓	mibb
密	mibe
幂	mibj
蘼	micf
泌	midb
洣	midm
汨	mido
弭	mige
靡	migf
糜	migm
縻	migx
秘	mihb
嘧	mike
咪	mikm
敉	mimw
脒	miom
祕	mipb
觅	mipe
祢	mipx
猕	miqx
谧	miym
醚	miyz
迷	mizm
鬘	mjay
颟	mjcr
蔓	mjcy
满	mjdl
漫	mjdy
鞔	mjgv
螨	mjil
镘	mjjy
嫚	mjny
瞒	mjol
曼	mjoy
埋	mjtl
墁	mjty
馒	mjuy
蛮	mjwi
慢	mjxy
谩	mjyy
冥	mkbb
蓂	mkcb
茗	mkck
溟	mkdb
洺	mkdk
螟	mkib
鸣	mkkn
瞑	mkob
明	mkoo
命	mkre
面	mmaa
渑	mmdd
勉	mmdl
黾	mmkd
冕	mmkv
棉	mmmj
勔	mmml
娩	mmnv
腼	mmom
冕	mmov
偭	mmrm
绵	mmsj
缅	mmsm
藐	mnce
鹋	mncn
苗	mnct
渺	mndu
描	mnft
喵	mnkt
杪	mnmu
妙	mnnu
瞄	mnot
眇	mnou
缪	mnsp
缈	mnsu
邈	mnze
末	moan
万	moap
无	moay
莫	mocd
蓦	mocm
摹	mocu
沫	modm
殁	mody
陌	moeb
摸	mofd
抹	mofm
魔	mogg
麽	mogm
秣	mohm
默	mohq
墨	moht
镆	mojd
冒	moko
模	momd
嫫	mond
膜	mood
冒	mooo
脉	mooy
馍	moud
貊	movb
貘	movd
貉	movk
谟	moyd
灭	mpah
蔑	mpcu
咩	mpky
篾	mpvu
乜	mpvv
缪	mqsp
谬	mqyp
木	muan
幕	mucj
募	mucl
暮	muco
墓	muct
慕	mucx
沐	mudm
拇	mufm
穆	muhp
钼	mujo
目	muka
模	mumd
毪	mumn
姥	munb
牡	munt
牧	munw
睦	muot
仫	murm
牟	musn
木	muun
母	muvd
亩	muwt
莓	mwcm
湄	mwdo
浼	mwdv
没	mwdy
嵋	mweo
糜	mwgm
煤	mwhm
镁	mwjd
镅	mwjo
梅	mwmm
楣	mwmo
媄	mwnd
媚	mwno
妹	mwnw
昧	mwow
鹛	mwvn
瑂	mwwo
美	mwyd
酶	mwym
某	mzgm
蛑	mzin
呣	mzkm
哞	mzkn
眸	mzon
侔	mzrn
鍪	mzsj
牟	mzsn
缪	mzsp
谋	mzym
捺	nafx
镎	naju
呐	nakn
娜	nane
肭	naon
衲	napn
纳	nasn
南	naug
乸	naym
您	nbrx
孬	ncbz
淖	ncdu
挠	ncfw
蛲	nciw
铙	ncjw
呶	ncky
闹	ncmj
臑	ncoe
脑	ncok
峱	ncqe
猱	ncqm
垴	nctk
硇	ncux
瑙	ncwx
艿	ndcn
萘	ndcx
奈	nddx
耐	ndec
耏	ndep
柰	ndmx
奶	ndnn
鼐	ndnv
氖	ndqn
乃	ndvp
迺	ndzx
呢	nekb
哪	neke
呐	nekn
讷	neyn
媆	nfnd
嫩	nfnw
恁	nfrx
能	ngsb
囊	nhay
攮	nhfy
囔	nhky
曩	nhoy
馕	nhuy
齉	nhzy
鲵	niae
薿	nicr
泥	nidb
溺	nidd
旎	nifb
拟	nifr
麑	nige
铌	nijb
呢	nikb
匿	nikk
妮	ninb
昵	niob
睨	nioe
腻	nior
猊	niqe
伲	nirb
倪	nire
你	nirx
坭	nitb
尼	niub
怩	nixb
逆	nizp
萳	njcg
喃	njkg
囡	njkn
楠	njmg
婻	njng
腩	njog
男	njtl
赧	njty
难	njyf
宁	nkbd
甯	nkby
苧	nkcd
泞	nkdd
凝	nkdr
聍	nked
拧	nkfd
柠	nkmd
狞	nkqd
佞	nkrn
酿	nlyl
廿	nmaa
鲇	nmak
廿	nmca
蔫	nmch
辇	nmfi
拈	nmfk
捻	nmfx
辗	nmin
粘	nmmk
年	nmpl
念	nmrx
埝	nmtx
碾	nmun
茑	nncn
溺	nndd
脲	nnou
鸟	nnpa
袅	nnpy
尿	nnuu
鸟	nnwd
搦	nofd
挪	nofe
锘	nojk
喏	nokk
糯	nome
娜	none
傩	norf
懦	noxe
诺	noyk
蘖	npcm
菍	npcx
孽	npcz
涅	npdt
嵲	npem
颞	nper
陧	npet
聂	npey
捏	npft
镍	npjm
镊	npjy
啮	npkk
嗫	npky
乜	npvv
臬	npzm
蹑	npzy
扭	nqfi
拗	nqfl
钮	nqji
杻	nqmi
牛	nqpl
纽	nqsi
忸	nqxi
暖	nroy
浓	nsdn
秾	nshn
哝	nskn
脓	nson
侬	nsrn
弄	nswc
疟	ntba
虐	ntha
弩	nung
努	nunl
驽	nunm
胬	nunr
砮	nunu
怒	nunx
奴	nuny
孥	nunz
傉	nurc
笯	nuvy
恧	nvex
钕	nvjn
女	nvva
衄	nvxi
内	nwld
馁	nwun
那	nwve
耨	nzlc
嗯	ogkx
呣	omkm
呒	omkw
嗯	onkx
噢	ookd
喔	ookt
哦	ookw
嚄	ooky
藕	oucy
沤	oudx
鸥	oukn
欧	oukr
瓯	oukw
区	oukx
殴	ouky
耦	ouly
偶	oury
怄	ouxx
讴	ouyx
葩	pacb
潖	padb
扒	pafb
帕	pajb
啪	pakb
耙	palb
杷	pamb
筢	pavb
琶	pawb
怕	paxb
趴	pazb
贫	pbbr
聘	pbev
拼	pbfk
品	pbkk
牝	pbnb
姘	pbnk
频	pbvr
颦	pbvu
玭	pbwb
刨	pcbd
疱	pcbs
抛	pcfl
庖	pcgs
脬	pcoz
狍	pcqs
跑	pczs
蒎	pdcn
湃	pddf
派	pddn
排	pdff
徘	pdif
哌	pdkn
牌	pdpu
迫	pdzb
盆	pfbm
湓	pfdm
喷	pfkr
芃	pgcf
蓬	pgcz
淜	pgdo
澎	pgdp
搒	pgff
捧	pgfl
抨	pgfp
弸	pggo
蟛	pgip
嘭	pgkp
棚	pgmo
椪	pgmy
鹏	pgon
朋	pgoo
膨	pgop
堋	pgto
硼	pguo
砰	pgup
碰	pguy
篷	pgvz
烹	pgwh
怦	pgxp
鳑	phaf
滂	phdf
彷	phif
耪	phlf
胖	phob
膀	phof
乓	phqd
磅	phuf
旁	phwf
雱	phyf
逄	phzl
鲏	piay
丕	piba
邳	pibe
痞	pibk
癖	pibu
疲	piby
芘	picb
苉	pice
澼	pidu
陴	pieu
陂	piey
批	pifb
披	pify
蚍	piib
蜱	piiu
铍	pijy
吡	pikb
匹	pike
噼	piku
媲	pinb
睥	piou
邳	pipe
裨	pipu
狉	piqa
狉	piqp
伾	pira
仳	pirb
伾	pirp
纰	pisb
罴	pish
毗	pitb
圮	pitj
坯	pitp
埤	pitu
砒	piub
劈	piud
譬	piuk
䴙	piun
辟	piuu
甓	piuw
貔	pivb
琵	piwb
判	pjbd
叛	pjby
泮	pjdb
潘	pjdt
蟠	pjit
攀	pjmu
胖	pjob
盼	pjod
袢	pjpb
番	pjpt
襻	pjpu
畔	pjtb
磻	pjut
槃	pjvm
爿	pjvp
磐	pjvu
蹒	pjzl
鲆	pkap
平	pkau
荓	pkck
苹	pkcp
泙	pkdp
涄	pkdv
蚲	pkip
枰	pkmp
娉	pknv
乒	pkqp
凭	pkrj
坪	pktp
屏	pkuk
玶	pkwp
评	pkyp
翩	pmhx
骗	pmmc
楩	pmmg
骈	pmmk
犏	pmnc
㛹	pmng
胼	pmok
片	pmpv
偏	pmrc
便	pmrg
篇	pmvc
蹁	pmzc
薸	pncx
漂	pndx
殍	pndz
螵	pnix
嘌	pnkx
朴	pnmb
骠	pnmx
嫖	pnnx
瞟	pnox
缥	pnsx
剽	pnxd
瓢	pnxg
飘	pnxx
魄	pobg
皤	pobt
泊	podb
泼	podd
婆	podn
陂	poey
䥽	pojd
钷	pojk
叵	pokk
朴	pomb
鄱	pope
繁	popx
坡	poty
破	pouy
笸	povk
颇	povr
珀	powb
酦	poyd
迫	pozb
苤	ppcp
瞥	ppdo
撇	ppfw
氕	ppqp
匍	pubf
普	pubo
葡	pucf
菩	puck
溥	pudc
浦	pudf
濮	pudn
潽	pudo
扑	pufb
穙	puhn
铺	pujf
镤	pujn
镨	pujo
圃	pukf
噗	pukn
朴	pumb
氆	pumo
脯	puof
暴	puou
仆	purb
堡	purt
埔	putf
墣	putn
璞	puwn
酺	puyf
谱	puyo
蹼	puzn
沛	pwdl
陪	pwek
旆	pwfj
旆	pwfl
裴	pwfy
锫	pwjk
帔	pwjy
呸	pwka
赔	pwkk
呸	pwkp
胚	pwop
佩	pwrj
辔	pwsk
培	pwtk
衃	pwxb
醅	pwyk
霈	pwyl
抔	pzfb
掊	pzfk
剖	pzld
裒	pzwy
寝	qbby
芹	qbcj
芩	qbcv
溱	qbdh
沁	qbdx
擒	qbfd
秦	qbfh
揿	qbfr
廑	qbga
锓	qbjy
噙	qbkd
嗪	qbkh
檎	qbmd
骎	qbmy
禽	qbrd
衾	qbry
琴	qbwv
慬	qbxa
覃	qbxu
鲯	qiab
戚	qiad
郪	qiae
妻	qian
鳍	qiao
七	qiav
萁	qicb
葺	qice
䓫	qick
荠	qicl
萋	qicn
芪	qicu
淇	qidb
奇	qidk
泣	qidl
凄	qidn
汽	qidq
屺	qiej
崎	qiek
亓	qiel
岐	qiey
旗	qifb
契	qifd
麒	qigb
棨	qihm
蜞	qiib
锜	qijk
颀	qijr
器	qikk
嘁	qikx
亟	qila
杞	qimj
栖	qimx
婍	qink
脐	qiol
祺	qipb
祁	qipe
乞	qipv
其	qiqb
期	qiqo
綦	qiqx
企	qirv
绮	qisk
圻	qitj
畦	qitt
碶	qiud
呇	qiuk
碛	qiur
磜	qiux
歧	qivy
琪	qiwb
弃	qiwc
玘	qiwj
琦	qiwk
齐	qiwl
戚	qiwx
愭	qixo
讫	qiyq
踦	qizk
迄	qizq
跂	qizy
鲭	qkao
顷	qkbr
苘	qkck
檠	qkcm
擎	qkcu
清	qkdo
青	qkfo
庆	qkgd
蜻	qkio
圊	qkko
晴	qkoo
卿	qkpe
氢	qkqg
氰	qkqo
倩	qkro
倾	qkrr
罄	qkuf
碃	qkuo
箐	qkvo
情	qkxo
请	qkyo
蔃	qlci
蔷	qlck
抢	qlfv
强	qlgi
炝	qlhv
蜣	qliq
锵	qljc
锖	qljo
呛	qlkv
樯	qlmk
枪	qlmv
嫱	qlnk
腔	qlog
戕	qlpg
襁	qlpi
戗	qlrg
墙	qltk
玱	qlwv
羟	qlyg
跄	qlzv
前	qmbd
歉	qmbr
搴	qmbu
荨	qmcc
蒨	qmco
芊	qmcq
芡	qmcr
茜	qmcx
牵	qmdn
潜	qmdo
欠	qmdr
岍	qmek
阡	qmeq
嵌	qmer
掮	qmfo
扦	qmfq
虔	qmhw
椠	qmim
堑	qmit
愆	qmix
钳	qmjg
钱	qmjj
钤	qmjv
杄	qmmq
犍	qmnz
肷	qmor
千	qmpu
佥	qmra
伣	qmre
倩	qmro
仟	qmrq
纤	qmsq
缱	qmsz
圲	qmtq
磏	qmun
乾	qmuq
签	qmva
悭	qmxt
谦	qmyn
谴	qmyz
遣	qmzk
迁	qmzq
翘	qnax
荞	qncl
峤	qnel
峭	qneo
撬	qnfm
鞒	qngl
鞘	qngo
巧	qngv
锹	qnjh
樵	qnmh
桥	qnml
瞧	qnoh
劁	qnrd
侨	qnrl
俏	qnro
缲	qnsm
雀	qnuf
壳	qnuj
硚	qnul
硗	qnuw
敲	qnwy
憔	qnxh
悄	qnxo
谯	qnyh
乔	qnyl
诮	qnyo
跷	qnzw
窃	qpbd
癿	qpbv
茄	qpck
锲	qpjd
且	qpla
妾	qpln
切	qpqd
伽	qprk
趄	qptq
砌	qpud
箧	qpvj
郄	qpxe
惬	qpxj
怯	qpxs
求	qqad
鳅	qqah
酋	qqby
萩	qqch
湫	qqdh
泅	qqdr
鞧	qqgy
鹙	qqhn
虬	qqiv
訄	qqjk
赇	qqkq
囚	qqkr
楸	qqmh
糗	qqmq
丘	qqpa
邱	qqqe
犰	qqqj
裘	qqqy
俅	qqrq
璆	qqwp
球	qqwq
鼽	qqzj
逑	qqzq
遒	qqzy
鳈	qrau
鬈	qrav
痊	qrbw
颧	qrcr
荃	qrcw
犬	qrdd
蜷	qriv
辁	qriw
券	qrjd
铨	qrjw
圈	qrkv
棬	qrmv
权	qrmy
婘	qrnv
全	qrrw
绻	qrsv
畎	qrtq
筌	qrvw
悛	qrxw
劝	qryl
诠	qryw
穹	qsbg
穷	qsbl
䓖	qscl
茕	qscu
邛	qsge
蛩	qsgi
銎	qsgj
筇	qsve
琼	qswx
鹊	qtcn
缺	qtfg
炔	qthg
榷	qtmf
棤	qtmo
阙	qtmr
阕	qtmt
却	qtte
埆	qtty
雀	qtuf
悫	qtux
确	qtuy
劬	qubl
鸲	qubn
䓛	quci
苣	qucj
蕖	qucm
蘧	qucz
灈	qudf
娶	quen
岖	quex
取	quey
麹	qufm
觑	quhe
黢	quhw
衢	quii
蛐	quiq
蠼	quiy
曲	qula
竘	qulk
阒	qumq
㭕	qums
瞿	quof
朐	quok
氍	quom
胠	quos
袪	qups
趋	qute
坥	qutq
趣	quty
磲	quum
躯	quux
龋	quvy
葜	qxcd
洽	qxdk
拤	qxfb
掐	qxfj
髂	qxgk
袷	qxpk
卡	qxub
恰	qxxk
麇	qygh
囷	qykh
裙	qypk
群	qyyy
逡	qyzw
荛	rccw
扰	rcfy
桡	rcmw
娆	rcnw
绕	rcsw
饶	rcuw
惹	recx
热	refh
喏	rekk
荏	rfcr
稔	rfhx
妊	rfnr
人	rfpn
衽	rfpr
壬	rfpu
壬	rfqa
仁	rfre
仞	rfrr
忍	rfrx
纴	rfsr
饪	rfur
韧	rfwr
扔	rgfn
仍	rgrn
蘘	rhcy
瀼	rhdy
攘	rhfy
穰	rhhy
嚷	rhky
禳	rhpy
儴	rhry
瓤	rhwg
日	rika
驲	rimo
髯	rjar
苒	rjcr
燃	rjhh
蚺	rjir
冉	rjla
然	rjph
䎃	rjrx
蒻	rocd
鄀	roce
爇	roch
若	rock
弱	rogd
婼	ronk
偌	rork
箬	rovk
阮	rree
软	rrir
媆	rrnd
堧	rrtd
瓀	rrwe
融	rsai
冗	rsbj
茸	rsce
蓉	rsck
荣	rscm
溶	rsdk
嵘	rsem
戎	rsgu
熔	rshk
蝾	rsim
镕	rsjk
榕	rsmk
狨	rsqu
绒	rssu
瑢	rswk
蓐	rucc
薷	ruce
茹	ruck
溽	rudc
濡	rude
洳	rudk
汝	rudn
蠕	ruie
嚅	ruke
嬬	rune
如	runk
褥	rupc
襦	rupe
入	rupn
乳	rupv
儒	rure
缛	rusc
孺	ruze
芮	rvcn
蕤	rvcu
蕊	rvcx
汭	rvdn
蚋	rvin
锐	rvje
睿	rvlo
枘	rvmn
瑞	rvwe
润	rydw
闰	rymw
揉	rzfm
鞣	rzgm
肉	rznr
柔	rzsm
蹂	rzzm
卅	saal
萨	saci
挲	sadu
潵	sadw
洒	sadx
撒	safw
靸	sagj
飒	salx
脎	saom
仨	sars
瘙	scbi
扫	scfe
搔	scfi
骚	scmi
梢	scmo
嫂	scny
臊	scom
缫	scsg
缲	scsm
埽	sctj
鳃	sdax
赛	sdbr
噻	sdkt
腮	sdox
思	sdtx
塞	sebt
色	sedb
涩	sedv
穑	sehk
铯	sejb
璱	sewb
森	sfmm
僧	sgro
搡	shfm
嗓	shkm
磉	shum
丧	shun
桑	shym
颡	shyr
兕	siae
肆	siay
死	sidb
泗	side
澌	sidj
汜	sids
涘	sidu
㟃	siek
撕	sifj
私	sihs
蛳	siij
咝	sika
四	sike
嗣	sikk
咝	siks
驷	sime
楒	simx
姒	sinr
虒	sipj
祀	sips
斯	siqj
伺	sirk
食	sirl
似	sirr
俟	siru
偲	sirx
鸶	sisn
缌	sisx
寺	sitc
思	sitx
饲	siuk
丝	siva
笥	sivk
鸶	sivn
巳	sivv
漦	siwu
三	sjae
散	sjcw
糁	sjmp
伞	sjru
毵	sjsm
叁	sjss
馓	sjuw
莎	socu
蓑	socy
娑	sodn
挲	sodu
溹	sodx
锁	sojr
嗍	soko
唢	sokr
唆	sokw
嗦	sokx
桫	somu
梭	somw
睃	soow
所	sopj
缩	sosb
索	soux
琐	sowr
羧	soyw
蒜	srcx
狻	srqw
算	srvc
酸	sryw
宋	ssbm
颂	ssbr
菘	sscs
嵩	ssek
崧	sses
㧐	ssfy
松	ssms
娀	ssnu
耸	ssre
怂	ssrx
忪	ssxs
悚	ssxu
诵	ssyy
送	sszt
稣	suah
宿	subb
塑	subt
窣	subu
苏	sucb
蔌	sucr
溯	sudo
素	sufx
甦	sugu
夙	sujd
嗉	sukx
骕	sums
俗	surk
僳	surm
傃	surx
鹔	susn
肃	suvd
簌	suvr
愫	suxx
诉	suyi
谡	suyw
蹜	suzb
速	suzu
荽	svcn
濉	svdf
隋	sveo
岁	svex
隧	svez
旞	svfz
髓	svgz
祟	svix
虽	svki
睢	svof
眭	svot
襚	svpz
绥	svsn
璲	svwz
谇	svyu
邃	svzu
荪	sycx
损	syfr
榫	symu
狲	syqx
隼	syru
笋	syvy
飧	syxl
孙	syzx
蒐	szcg
薮	szcw
溲	szdy
擞	szfw
搜	szfy
廋	szgy
螋	sziy
锼	szjy
嗽	szkr
嗾	szku
嗖	szky
瞍	szoy
叟	szpy
馊	szuy
艘	szvy
鳎	taax
它	tabb
漯	tadx
拓	tafu
挞	tafz
鞳	tagk
嗒	takk
阘	tamx
闼	tamz
她	tany
褟	tapx
獭	taqr
他	tary
塔	tatk
塌	tatx
鿎	tauz
趿	tazj
踏	tazo
蹋	tazx
萄	tccf
洮	tcdd
淘	tcdf
滔	tcdj
套	tcds
陶	tcef
鼗	tcey
焘	tcfh
弢	tcgy
叨	tckd
啕	tckf
饕	tckl
梼	tcmc
桃	tcmd
绹	tcsf
绦	tcsm
韬	tcwj
慆	tcxj
鲐	tdak
苔	tdck
薹	tdct
太	tddd
汰	tddt
抬	tdfk
泰	tdfu
钛	tdjt
呔	tdkt
骀	tdmk
胎	tdok
肽	tdot
邰	tdse
炱	tdsh
台	tdsk
态	tdtx
酞	tdyt
慝	tekx
特	tenc
忑	texx
忒	teyx
疼	tgbd
藤	tgcu
熥	tghz
誊	tgjk
䲢	tgoa
螣	tgoi
腾	tgom
滕	tgou
縢	tgox
烫	thdh
淌	thdk
汤	thdp
搪	thfk
唐	thgk
螗	thik
螳	thit
镋	thje
镗	thjt
嘡	thkt
耥	thlk
糖	thmk
樘	thmt
帑	thnj
膛	thot
傥	thre
倘	thrk
塘	thtk
躺	thuk
瑭	thwk
䣘	thxe
惝	thxk
棠	thxm
堂	thxt
蹚	thzt
鳀	tiar
剃	tibd
鹈	tibn
荑	ticy
涕	tidp
替	tifo
提	tifr
擿	tifz
啼	tikj
梯	timp
媞	tinr
剔	tiod
题	tior
䴘	tipn
裼	tipw
体	tirb
倜	tirk
俶	tiry
绨	tisp
缇	tisr
趯	titf
屉	tiuu
瑅	tiwr
惕	tixw
逖	tizh
蹄	tizj
踢	tizw
瘫	tjbf
痰	tjbh
菼	tjch
滩	tjdf
澹	tjdk
潭	tjdu
炭	tjeh
探	tjfm
弹	tjgl
钽	tjja
锬	tjjh
镡	tjju
啴	tjkl
叹	tjky
檀	tjma
毯	tjmh
榃	tjmt
昙	tjos
袒	tjpa
倓	tjrh
坍	tjtd
坛	tjts
磹	tjuu
忐	tjux
璮	tjwa
惔	tjxh
葶	tkcd
莛	tkcz
渟	tkdd
挺	tkfz
庭	tkgz
烃	tkhg
蜓	tkiz
铤	tkjz
桯	tkmw
梃	tkmz
婷	tknd
停	tkrd
颋	tkrr
侹	tkrz
圢	tktd
艇	tkvz
亭	tkwd
珽	tkwz
廷	tkzr
天	tmad
黇	tmck
淟	tmdb
湉	tmdk
殄	tmdp
沺	tmdt
添	tmdx
掭	tmfx
钿	tmjt
田	tmku
阗	tmmb
晪	tmob
盷	tmod
甜	tmqg
舔	tmqx
佃	tmrt
填	tmtb
畋	tmtw
忝	tmtx
髫	tnak
鲦	tnam
窕	tnbd
苕	tnck
挑	tnfd
蜩	tnik
粜	tnim
嬥	tnnf
朓	tnod
祧	tnpd
佻	tnrd
笤	tnvk
条	tnwm
调	tnyk
跳	tnzd
迢	tnzk
橐	toam
萚	tocl
沱	todb
陀	toeb
托	tofq
拖	tofy
庹	togi
鼍	tokd
唾	toki
柁	tomb
驮	tomd
柝	tomi
鸵	tonb
脱	tooe
妥	topn
佗	torb
侂	torq
坨	totb
圫	totq
砣	toub
箨	tovl
酡	toyb
跎	tozb
萜	tpck
餮	tpdl
帖	tpjk
铁	tpju
贴	tpkk
湍	trde
抟	trfv
煓	trhe
团	trkc
猯	trqe
疃	trtl
彖	trvu
鲖	tsak
痛	tsby
茼	tsck
潼	tsdl
峂	tsed
峒	tsek
捅	tsfy
烔	tshk
穜	tshl
嗵	tskz
童	tsll
橦	tsml
桶	tsmy
曈	tsol
佟	tsrd
仝	tsrg
侗	tsrk
僮	tsrl
垌	tstk
砼	tsug
筒	tsvk
通	tszy
突	tubq
菟	tucd
荼	tuch
葖	tucq
兔	tudd
稌	tuhh
秃	tuhj
徒	tuir
吐	tukt
凸	tula
梌	tumh
腯	tuoo
堍	tutd
屠	tuuo
㻬	tuwk
推	tvff
魋	tvgf
腿	tvoz
褪	tvpz
忒	tvyx
退	tvzg
忒	twyx
鲀	tyat
屯	tyav
焞	tyhz
囤	tykt
豚	tyou
暾	tyow
褪	typz
吞	tytk
坉	tytt
臀	tyuo
饨	tyut
投	tzfy
骰	tzgy
偷	tzrd
透	tzzn
莎	uacu
鲨	uada
煞	uadh
裟	uady
厦	uaiw
铩	uajm
啥	uakk
唼	uakn
嗄	uakw
歃	uaqr
傻	uarw
纱	uasu
砂	uauu
刹	uaxd
杀	uaxm
霎	uayn
苕	ucck
芍	uccu
邵	ucde
召	ucdk
劭	ucdl
潲	ucdo
捎	ucfo
烧	uchw
哨	ucko
韶	uclk
柖	ucmk
梢	ucmo
杓	ucmu
睄	ucoo
绍	ucsk
玿	ucwk
色	uddb
晒	udox
酾	udyl
奢	uedo
涉	uedp
滠	uedy
折	uefj
摄	uefy
麝	uegc
蛇	ueib
赊	uekx
阇	uemo
社	uept
猞	ueqk
舍	uerk
歙	uerr
畲	uert
佘	uerx
赦	uetw
射	ueuc
慑	uexy
设	ueyy
鲹	ufap
瘆	ufbp
审	ufbu
莘	ufcu
葚	ufcv
渗	ufdp
沈	ufdv
屾	ufee
燊	ufhm
呻	ufku
肾	uflo
糁	ufmp
椹	ufmv
娠	ufnn
婶	ufnu
瞫	ufou
身	ufpp
神	ufpu
侁	ufre
参	ufsp
矧	uful
谌	ufyv
陞	uget
盛	ugim
晟	ugoi
昇	ugou
升	ugpc
生	ugpf
剩	ugqd
乘	ugqn
绳	ugsd
甥	ugul
省	uguo
声	ugup
觞	uhdp
上	uhla
晌	uhok
伤	uhrl
绱	uhsk
垧	uhtk
商	uhwk
赏	uhxr
鲥	uiac
鲺	uiai
石	uiak
十	uial
豕	uian
世	uiav
室	uibt
莳	uicc
奭	uidb
殖	uidq
峙	uiec
示	uiex
拭	uifg
誓	uifk
势	uifl
施	uify
铈	uijj
噬	uika
嗜	uiko
噬	uikr
嘘	uiky
师	uilj
史	uiln
栻	uimg
柿	uimj
始	uink
匙	uiob
时	uioc
是	uior
䏡	uiox
视	uipe
失	uipf
释	uipl
矢	uipt
氏	uipv
狮	uiqj
侍	uirc
食	uirl
似	uirr
仕	uiru
埘	uitc
邿	uite
士	uiua
饰	uiuj
屎	uium
鸤	uiun
贳	uiur
尸	uivp
筮	uivr
恃	uixc
弑	uixg
识	uiyb
诗	uiyc
试	uiyg
酾	uiyl
谥	uiym
逝	uizj
适	uizk
鳝	ujak
疝	ujbe
删	ujcd
苫	ujck
汕	ujde
陕	ujej
嶦	ujek
擅	ujfa
掞	ujfh
掸	ujfl
掺	ujfp
剡	ujhd
煽	ujhx
蟮	ujik
赡	ujkk
栅	ujmc
杉	ujmp
骟	ujmx
嬗	ujna
姗	ujnc
膻	ujoa
晱	ujoh
膳	ujok
禅	ujpl
衫	ujpp
缮	ujsk
墡	ujtk
珊	ujwc
讪	ujye
跚	ujzc
摔	ukfu
甩	ukkv
率	ukwu
衰	ukwy
爽	ulan
泷	uldl
漴	uldx
骦	ulmo
孀	ulno
礵	uluo
鹴	ulyn
霜	ulyo
双	ulyy
槊	uobm
朔	uobo
搠	uofo
铄	uojl
妁	uonu
硕	uour
说	uoye
涮	urdd
拴	urfw
闩	urma
栓	urmw
腨	uroe
戍	uuad
薯	uuco
蔬	uucv
菽	uucy
漱	uudr
沭	uudu
殊	uudv
淑	uudy
陎	uuev
抒	uufl
摅	uufx
庶	uugh
鼠	uujv
赎	uukd
墅	uult
树	uumc
术	uumd
梳	uumv
枢	uumx
恕	uunx
婌	uuny
腧	uuod
曙	uuoo
舒	uurl
毹	uurm
蜀	uusi
纾	uusl
署	uuso
叔	uuuy
疏	uuvv
戍	uuwd
熟	uuwh
塾	uuwt
孰	uuww
税	uvhe
帨	uvje
睡	uvoi
说	uvye
谁	uwyf
耍	uxen
唰	uxkd
刷	uxud
顺	uyir
吮	uyke
楯	uymo
瞬	uyol
舜	uypl
守	uzbc
兽	uzbk
瘦	uzby
首	uzbz
寿	uzfc
授	uzfy
手	uzpl
受	uzpy
狩	uzqc
售	uzrk
收	uzvw
鲊	vaav
痄	vabv
溠	vadg
奓	vadx
揸	vafa
挓	vafq
拃	vafv
蚱	vaiv
铡	vajd
喳	vaka
哳	vakj
喋	vakm
吒	vakq
咋	vakv
查	vama
栅	vamc
闸	vamj
札	vamv
眨	vaof
乍	vapa
砟	vauv
䃎	vaux
劄	vavd
鲝	vaya
诈	vayv
齇	vazq
沼	vcdk
兆	vced
旐	vcfd
招	vcfk
钊	vcjd
啁	vckk
嘲	vcko
曌	vcog
照	vcoh
昭	vcok
爪	vcpn
罩	vcsu
赵	vctx
着	vcyo
寨	vdbm
宅	vdbq
瘵	vdbx
摘	vdfk
择	vdfl
祭	vdpx
侧	vdrd
债	vdrr
斋	vdwe
翟	vdxf
蔗	vech
蛰	vefi
哲	vefk
晢	vefo
䗪	vegi
鹧	vegn
辄	veiv
辙	veiw
锗	vejo
啫	veko
詟	velk
者	velo
柘	vemu
褶	vepb
赭	veto
喆	veuk
磔	veum
谪	veyk
着	veyo
遮	vezh
这	vezw
鬒	vfab
臻	vfah
葴	vfck
鸩	vfdn
阵	vfei
振	vffn
揕	vffv
稹	vfhb
轸	vfip
帧	vfjr
针	vfju
赈	vfkn
榛	vfmh
桢	vfmr
椹	vfmv
胗	vfop
朕	vfot
禛	vfpb
袗	vfpp
祯	vfpr
斟	vfqu
侦	vfrr
缜	vfsb
纼	vfsl
圳	vfti
畛	vftp
真	vfub
箴	vfvk
瑱	vfwb
珍	vfwp
甄	vfxw
震	vfyn
诊	vfyp
丁	vgal
正	vgav
郑	vgbe
症	vgbv
蒸	vgch
争	vgdl
峥	vgel
挣	vgfl
征	vgiv
铮	vgjl
钲	vgjv
烝	vglh
睁	vgol
政	vgvw
怔	vgxv
诤	vgyl
证	vgyv
丈	vhan
涨	vhdi
漳	vhdu
嶂	vheu
张	vhgi
帐	vhji
幛	vhju
账	vhki
彰	vhlp
杖	vhmv
嫜	vhnu
胀	vhoi
暲	vhou
长	vhpn
獐	vhqu
仉	vhrj
仗	vhrv
郅	viae
至	viat
致	viaw
痔	vibc
窒	vibt
痣	vibx
芷	vicv
滞	vidj
觯	vidl
之	vidn
殖	vidq
沚	vidv
职	vieb
峙	viec
骘	viem
陟	viep
掷	vife
鸷	vifn
指	vifo
贽	vifr
絷	vifx
擿	vifz
庤	vigc
稚	vihf
稙	vihq
轵	viib
蜘	viik
蛭	viit
徵	viiw
锧	vijr
只	vikb
吱	viky
止	vila
栉	vime
榰	vimo
植	vimq
桎	vimt
栀	vimv
梽	vimx
枝	vimy
胝	viod
脂	vioo
晊	viot
肢	vioy
炙	viph
豸	vipp
质	vipr
祉	vipv
值	virq
侄	virt
织	visb
置	visq
纸	visu
畤	vitc
埴	vitq
址	vitv
雉	viuf
直	viuq
疐	viur
志	viux
支	viuy
彘	vivb
酯	viyo
踬	vizr
趾	vizv
鳣	vjaa
詹	vjdk
崭	vjej
旃	vjfd
搌	vjfn
斩	vjij
辗	vjin
飐	vjjk
战	vjlg
栴	vjmd
栈	vjmj
毡	vjmk
瞻	vjok
偡	vjrv
绽	vjsr
展	vjun
鹯	vjwn
颤	vjwr
谵	vjyk
拽	vkfy
妆	vldn
状	vldq
装	vldy
撞	vlfl
庄	vlgt
幢	vljl
戆	vllx
桩	vlmt
奘	vlpd
僮	vlrl
茁	voci
著	voco
䓬	vocu
濯	vodf
涿	vodn
浞	vodr
汋	vodu
擢	voff
拙	vofi
捉	vofr
焯	vohu
镯	voji
䦃	vojo
啄	vokn
桌	volm
棁	vome
椓	vomn
晫	voou
禚	voph
倬	voru
缴	vosw
斫	vouj
琢	vown
诼	voyn
着	voyo
酌	voyu
叕	voyy
专	vrad
沌	vrdt
撰	vrfb
转	vriv
赚	vrkn
啭	vrkv
䏝	vrov
僎	vrrb
传	vrrv
馔	vrub
砖	vruv
瑑	vrwu
茽	vscv
穜	vshl
种	vshv
锺	vsjv
柊	vsmd
肿	vsov
重	vspa
众	vsrr
仲	vsrv
终	vssd
盅	vsvm
忠	vsvx
螽	vswi
衷	vswy
忪	vsxs
瘃	vubn
疰	vubv
苎	vuca
著	vuco
茱	vucv
洙	vudv
拄	vufv
麈	vugv
烛	vuhi
炷	vuhv
蛀	vuiv
铸	vujc
铢	vujv
贮	vuka
嘱	vuky
煮	vulh
翥	vulx
术	vumd
柷	vume
杼	vuml
槠	vumo
驻	vumv
朱	vunn
瞩	vuoy
祝	vupe
竹	vupl
褚	vupo
朱	vupw
助	vuql
猪	vuqo
伫	vura
侏	vurv
纻	vusa
砫	vuuv
属	vuuy
竺	vuve
箸	vuvo
舳	vuvy
珠	vuwv
诸	vuyo
诛	vuyv
躅	vuzi
坠	vvet
赘	vvfr
锥	vvjf
骓	vvmf
缀	vvsy
缒	vvsz
惴	vvxe
追	vvzk
这	vwzw
髽	vxat
抓	vxfv
挝	vxfz
爪	vxpn
屯	vyav
窀	vybt
准	vydf
肫	vyot
谆	vyyz
宙	vzby
荮	vzcc
洲	vzdl
洲	vzdv
皱	vzdy
帚	vzej
粥	vzgg
昼	vzia
辀	vziv
轴	vziy
啁	vzkk
骤	vzmn
婤	vznk
妯	vzny
肘	vzoc
舟	vzpd
繇	vzpx
㑇	vzre
纣	vzsc
绉	vzse
碡	vzum
鸼	vzvn
籀	vzvt
酎	vzyc
胄	vzyo
瓦	waad
窊	wabg
洼	wadt
挖	wafv
蛙	wait
哇	wakt
娲	wann
娃	want
腽	waom
佤	warw
畖	watg
歪	wdbv
崴	wden
鳁	wfam
蕰	wfcm
芠	wfcw
温	wfdm
汶	wfdw
炆	wfhw
辒	wfim
蚊	wfiw
吻	wfkw
闻	wfme
榅	wfmm
阌	wfmy
璺	wfpy
纹	wfsw
刎	wfwd
玟	wfww
紊	wfwx
雯	wfyw
鹟	wgbn
瓮	wgbw
翁	wgbx
蕹	wgcf
蓊	wgcx
滃	wgdx
嗡	wgkx
王	what
汪	whdw
魍	whgw
往	whiv
辋	whiw
罔	whkw
网	whkx
枉	whmw
旺	whow
尪	whuw
妄	whwn
亡	whwv
忘	whwx
惘	whxw
尪	whyw
万	wjap
豌	wjav
剜	wjbd
皖	wjbe
宛	wjbv
莞	wjce
菀	wjcv
芄	wjcw
蔓	wjcy
湾	wjdg
挽	wjfv
烷	wjhe
蜿	wjiv
椀	wjmv
妧	wjne
婠	wjnk
婉	wjnv
脘	wjoe
腕	wjov
绾	wjsk
纨	wjsw
塆	wjtg
畹	wjtv
玩	wjwe
弯	wjwg
琬	wjwv
惋	wjxv
窝	wobn
莴	wocn
涡	wodn
渥	wodt
涴	wodv
沃	wody
握	woft
挝	wofz
卧	woib
蜗	woin
幄	wojt
喔	wokt
肟	wook
我	wopd
倭	worn
偓	wort
斡	wouu
硪	wouw
龌	wovt
踒	wozn
五	wuaa
戊	wuad
兀	wuae
鹉	wuan
武	wuav
无	wuay
寤	wubk
勿	wubp
芴	wucw
峿	wuek
屼	wuew
於	wufd
捂	wufk
鹀	wugn
戊	wugp
庑	wugw
焐	wuhk
蜈	wuit
钨	wujw
唔	wukk
吴	wukt
呜	wukw
牾	wunk
妩	wunw
晤	wuok
旿	wuow
乌	wupa
午	wupg
舞	wupl
侮	wurm
仵	wurw
骛	wusm
鹜	wusn
坞	wutw
屋	wuut
毋	wuva
邬	wuwe
吾	wuwk
务	wuwl
珷	wuwv
忤	wuxw
雾	wuyl
恶	wuyx
鳚	wwac
威	wwad
韦	wwal
鲔	wwao
蔚	wwcc
萎	wwcn
苇	wwcw
薳	wwcz
潍	wwdf
渭	wwdo
洈	wwdv
涠	wwdw
卫	wwea
隗	wweg
崴	wwen
㧑	wwfw
廆	wwgg
魏	wwhg
煨	wwhn
炜	wwhw
微	wwiw
帷	wwjf
帏	wwjw
唯	wwkf
喂	wwkn
围	wwkw
桅	wwmv
猬	wwqo
位	wwrl
偎	wwrn
伪	wwrw
维	wwsf
纬	wwsw
圩	wwty
尉	wwuc
尾	wwum
碨	wwun
慰	wwux
卫	wwva
艉	wwvm
威	wwwn
玮	wwww
惟	wwxf
霨	wwyc
诿	wwyn
谓	wwyo
逶	wwzn
遗	wwzr
违	wwzw
薪	xbcj
莘	xbcu
芯	xbcx
鑫	xbjj
欣	xbjr
新	xblj
歆	xblr
昕	xboj
囟	xbpx
信	xbrk
伈	xbrx
忻	xbxj
西	xiaa
鳛	xiab
郤	xibe
兮	xibv
窸	xibx
昔	xico
蓰	xicr
茜	xicx
溪	xidd
潟	xidh
淅	xidj
觿	xidk
汐	xidx
玺	xidy
嶍	xieb
巇	xieg
隰	xieh
嶲	xiev
隙	xiex
觋	xige
爔	xihd
蜥	xiij
徙	xiir
蟋	xiix
鼷	xijd
铣	xije
锡	xijw
熙	xikh
唏	xikj
嘻	xikk
咥	xikt
袭	xily
皙	ximb
阋	xime
析	ximj
樨	ximn
檄	ximw
栖	ximx
牺	xinx
曦	xiod
晰	xioj
暿	xiok
腊	xioo
禧	xipk
裼	xipw
悉	xipx
傒	xird
僖	xirk
绤	xisk
枲	xism
细	xist
熹	xiuh
犀	xiun
饩	xiuq
屣	xiur
习	xivd
舾	xivx
釐	xiwl
郗	xixe
希	xixj
惜	xixo
羲	xiyd
戏	xiyg
醯	xiym
蹊	xizd
息	xizx
荥	xkcu
陉	xkeg
擤	xkfl
煋	xkhu
行	xkii
铏	xkjd
刑	xkkd
邢	xkke
形	xkkp
型	xkkt
姓	xknu
腥	xkou
幸	xktg
硎	xkud
省	xkuo
饧	xkup
兴	xkxb
悻	xkxg
惺	xkxu
葙	xlco
巷	xlcs
芗	xlcx
象	xldn
湘	xldo
降	xlel
厢	xlio
鲞	xlja
镶	xljy
响	xlkk
橡	xlmn
想	xlmx
骧	xlmy
向	xlpk
祥	xlpy
像	xlrn
缃	xlso
饷	xluk
箱	xlvo
乡	xlvp
珦	xlwk
襄	xlwy
享	xlwz
翔	xlyx
咸	xmad
鲜	xmay
宪	xmbe
痫	xmbm
莶	xmca
苋	xmce
涎	xmdz
险	xmea
限	xmeg
陷	xmej
挦	xmfc
掀	xmfr
弦	xmgy
铣	xmje
锨	xmjr
见	xmke
贤	xmlr
籼	xmme
闲	xmmm
鹇	xmmn
先	xmne
孅	xmnj
嫌	xmnn
㬎	xmoh
腺	xmou
显	xmoy
祆	xmpt
禒	xmpu
猃	xmqa
氙	xmqe
县	xmqs
狝	xmqx
仙	xmre
伭	xmry
纤	xmsq
馅	xmuj
献	xmuq
现	xmwe
咸	xmwk
玹	xmwy
忺	xmxr
酰	xmye
羡	xmyr
霰	xmyw
跣	xmze
暹	xmzf
皛	xnbb
宵	xnbo
淆	xndo
潇	xnds
洨	xndx
涍	xndz
崤	xneo
蛸	xnio
蟏	xnis
虓	xnjj
销	xnjo
嚣	xnkk
鸮	xnkn
哓	xnkw
哮	xnkz
小	xnld
孝	xnlz
枵	xnmv
校	xnmx
晓	xnow
猇	xnqj
翛	xnrx
筱	xnvw
笑	xnvy
削	xnxd
肖	xnxo
敩	xnxw
恔	xnxx
霄	xnyo
逍	xnzo
鲑	xpat
写	xpby
薤	xpcj
薢	xpcn
瀣	xpdj
泻	xpdy
契	xpfd
挟	xpfj
携	xpfn
撷	xpfr
絜	xpfx
廨	xpgn
鞋	xpgt
燮	xphy
蝎	xpiv
叶	xpku
勰	xplx
榭	xpmc
楔	xpmd
胁	xpob
歇	xpor
卸	xppe
血	xppm
獬	xpqn
偕	xprb
偰	xprd
㙦	xprt
缬	xpsr
协	xpub
屑	xpuo
颉	xpur
卸	xpwe
亵	xpwy
懈	xpxn
邪	xpye
邂	xpzn
躞	xpzy
髹	xqam
宿	xqbb
滫	xqdo
溴	xqdq
岫	xqey
庥	xqgm
秀	xqhn
䗛	xqio
锈	xqjn
咻	xqkm
嗅	xqkq
朽	xqmv
袖	xqpy
休	xqrm
鸺	xqrn
脩	xqro
修	xqrp
绣	xqsn
貅	xqvm
琇	xqwn
珛	xqwo
臭	xqzq
癣	xrby
萱	xrca
渲	xrda
漩	xrdr
泫	xrdy
旋	xrfr
煊	xrha
炫	xrhy
衒	xrii
券	xrjd
铉	xrjy
咺	xrka
楦	xrma
暄	xroa
暶	xror
昡	xroy
禤	xrpx
悬	xrqx
伭	xrry
绚	xrso
翾	xrsx
碹	xrua
瑄	xrwa
璇	xrwr
玹	xrwy
愃	xrxa
芎	xscg
汹	xsdk
夐	xsdw
兄	xske
胸	xsok
熊	xssh
鳕	xtae
穴	xtbb
茓	xtcb
薛	xtcu
踅	xtfr
靴	xtgb
峃	xtxe
敩	xtxw
学	xtxz
戌	xuad
蓿	xucb
蓄	xuct
浒	xudw
洫	xudx
溆	xudy
序	xugl
魆	xugv
旭	xujo
勖	xukl
吁	xuky
糈	xumo
栩	xumx
絮	xunx
煦	xuoh
昫	xuok
勖	xuol
盱	xuoy
媭	xupn
叙	xury
续	xusd
绪	xuso
垿	xutl
圩	xuty
胥	xuvo
戌	xuwa
顼	xuwr
珝	xuwx
需	xuye
酗	xuyk
谞	xuyo
许	xuyw
诩	xuyx
下	xxab
夏	xxaw
峡	xxej
辖	xxik
厦	xxiw
虾	xxix
匣	xxkj
吓	xxkx
柙	xxmj
瞎	xxok
暇	xxoy
狎	xxqj
侠	xxrj
瑕	xxwy
遐	xxzy
鲟	xyac
郇	xybe
窨	xybo
荨	xycc
薰	xych
荀	xyco
蕈	xycu
浔	xydc
洵	xydo
汛	xydu
浚	xydw
寻	xyec
峋	xyeo
徇	xyio
噀	xykb
勋	xykl
栒	xymo
曛	xyoh
熏	xyph
獯	xyqh
巽	xysb
埙	xytr
珣	xywo
恂	xyxo
训	xyyi
询	xyyo
讯	xyyu
巡	xyzv
逊	xyzx
牙	yaap
亚	yaay
丫	yabl
芽	yacy
涯	yadt
崖	yaet
岈	yaey
押	yafj
揠	yafn
压	yaid
轧	yaiv
蚜	yaiy
鸭	yajn
哑	yaky
桠	yamy
娅	yany
睚	yaot
猰	yaqd
氩	yaqy
伢	yary
堐	yatt
垭	yaty
砑	yauy
琊	yawe
玡	yawy
雅	yayf
鸦	yayn
迓	yazy
䲟	ybae
寅	ybbb
窨	ybbo
瘾	ybbx
茵	ybcd
茚	ybce
洇	ybdd
淫	ybdr
溵	ybdy
崟	ybej
阴	ybeo
隐	ybex
铟	ybjd
银	ybjg
嚚	ybkk
吲	ybkl
喑	ybko
音	yblo
慭	yblx
訚	ybmk
姻	ybnd
鄞	ybne
印	ybpe
禋	ybpt
胤	ybpv
殷	ybpy
氤	ybqd
垠	ybtg
圻	ybtj
硍	ybug
饮	ybur
尹	ybvp
珢	ybwg
愔	ybxo
歅	ybxr
鳐	ycaf
尧	ycaw
疟	ycba
窑	ycbf
窈	ycbl
窅	ycbo
药	yccu
滧	ycdw
崾	ycen
峣	ycew
靿	ycgl
徭	ycif
轺	ycik
铫	ycjd
钥	ycjo
咬	yckx
吆	ycky
姚	ycnd
媱	ycnf
妖	ycny
曜	ycof
腰	ycon
夭	ycpd
舀	ycpj
鹞	ycpn
么	ycps
繇	ycpx
猺	ycqf
侥	ycrw
垚	yctt
幺	ycvs
珧	ycwd
耀	ycxf
肴	ycxo
爻	ycxx
谣	ycyf
遥	yczf
邀	yczw
页	year
爷	yebe
冶	yedk
液	yedn
耶	yeee
揶	yefe
掖	yefn
靥	yeim
铘	yeje
噎	yeka
咽	yekd
叶	yeku
业	yela
野	yell
曳	yelp
椰	yeme
腋	yeon
晔	yeou
倻	yere
馌	yeum
也	yevv
夜	yewn
谒	yeyv
羊	yhbl
疡	yhbp
泱	yhdy
阳	yheo
扬	yhfp
鞅	yhgy
炀	yhhp
烊	yhhy
钖	yhjp
咉	yhky
央	yhlg
样	yhmy
旸	yhop
仰	yhre
佯	yhry
垟	yhty
玚	yhwp
怏	yhxy
养	yhyl
鸯	yhyn
恙	yhyx
羕	yhyy
一	yiaa
弋	yiad
宧	yibl
宜	yibq
疑	yibr
瘗	yibt
癔	yibx
疫	yiby
苡	yicr
艺	yicv
薏	yicx
荑	yicy
殪	yida
浥	yidb
漪	yidk
义	yidx
峄	yiel
嶷	yier
挹	yifb
揖	yife
旖	yifk
廙	yigb
熠	yihb
黟	yihx
蛇	yiib
螠	yiim
轶	yiiu
蜴	yiiw
蚁	yiiy
钇	yijv
铱	yijy
邑	yikb
嗌	yikm
颐	yikr
医	yiku
呓	yikv
噫	yikx
咿	yiky
意	yilx
驿	yiml
杙	yimy
嫕	yinx
姨	yiny
眙	yiok
昳	yiou
易	yiow
臆	yiox
胰	yioy
乂	yipn
祎	yipw
㑊	yird
倚	yirk
食	yirl
佾	yiro
仡	yirq
佚	yiru
亿	yirv
仪	yiry
绎	yisl
缢	yism
矣	yisu
埸	yitw
饴	yiuk
尾	yium
懿	yiux
以	yivr
乙	yivv
簃	yivx
舣	yivy
弈	yiwc
裔	yiwk
衣	yiwy
羿	yixc
忆	yixv
诒	yiyk
译	yiyl
诣	yiyo
谊	yiyq
逸	yizd
遗	yizr
迤	yizy
戭	yjbg
宴	yjbn
芫	yjce
滟	yjdb
渰	yjdc
沇	yjde
漹	yjdh
沿	yjdk
湮	yjdt
崦	yjed
岩	yjeu
掩	yjfd
炎	yjhh
甗	yjhw
雁	yjif
餍	yjil
蝘	yjin
彦	yjip
厌	yjiq
赝	yjir
蜒	yjiz
咽	yjkd
唁	yjkk
觃	yjkz
䶮	yjlt
验	yjma
阉	yjmd
棪	yjmh
阎	yjmj
闫	yjms
嫣	yjnh
妍	yjnk
胭	yjod
眼	yjog
晏	yjon
殷	yjpy
弇	yjrc
偃	yjrn
罨	yjsd
墕	yjth
盐	yjtm
堰	yjtn
砚	yjue
焉	yjvh
兖	yjwe
言	yjwk
谚	yjyp
瘿	ykbn
颍	ykbr
䓨	ykcf
荧	ykch
萤	ykci
蓥	ykcj
营	ykck
莺	ykcn
茔	ykct
荥	ykcu
萦	ykcx
瀛	ykdf
溁	ykdm
滢	ykdy
撄	ykfn
应	ykga
鹰	ykgn
蝇	ykid
郢	ykke
罂	ykkf
嘤	ykkn
盈	yknm
媵	ykon
影	ykop
映	ykoy
缨	yksn
璎	ykwn
瑛	ykwy
迎	ykze
唷	yoko
哟	yoku
芫	yrce
苑	yrcv
渊	yrdl
源	yrdx
湲	yrdy
鼋	yred
元	yree
掾	yrfu
援	yrfy
蜎	yrio
愿	yrix
辕	yriy
园	yrke
圆	yrkr
圜	yrky
妧	yrne
嫄	yrnx
媛	yrny
爰	yrpy
猿	yrqy
垣	yrta
垸	yrte
塬	yrtx
袁	yrty
眢	yrxo
怨	yrxx
鸢	yryn
鳙	ysal
鲬	ysay
痈	ysby
澭	ysdf
涌	ysdy
拥	ysfy
鄘	ysge
㶲	yshy
镛	ysjl
用	yskl
喁	ysky
栐	ysmy
臃	ysof
俑	ysry
勇	yssl
恿	yssx
甬	yssy
墉	ystl
埇	ysty
邕	ysvb
饔	yswl
壅	yswt
踊	yszy
彟	ytey
钥	ytjo
月	ytka
哕	ytkx
阅	ytme
栎	ytml
樾	ytmv
刖	ytod
乐	ytpd
粤	ytpv
岳	ytqe
龠	ytrc
越	yttv
籥	ytvc
玥	ytwo
悦	ytxe
跃	ytzy
与	yuaa
雨	yuad
于	yual
瘀	yubd
窳	yubg
鹆	yubn
欲	yubr
寓	yuby
蔚	yucc
薁	yucd
蓣	yucr
菀	yucv
渔	yuda
渝	yudd
淯	yudo
滪	yudr
嵛	yued
峪	yuek
隅	yuey
於	yufd
粥	yugg
燏	yuhk
煜	yuhl
蜮	yuia
御	yuie
舁	yujc
钰	yujy
喻	yukd
圉	yukg
吁	yuky
阈	yuma
榆	yumd
驭	yumy
妤	yunl
娱	yunt
妪	yunx
昱	yuol
腴	yuoy
舆	yupb
褕	yupd
裕	yupk
臾	yupn
毓	yupv
㺄	yuqd
狳	yuqh
俞	yurd
余	yurh
俣	yurt
愈	yurx
予	yusl
豫	yusn
域	yuta
堉	yuto
尉	yuuc
饫	yuuy
龉	yuvk
竽	yuvy
瑜	yuwd
育	yuwo
玙	yuwy
愉	yuxd
誉	yuxk
谕	yuyd
雩	yuyk
盂	yuym
欤	yuyr
愚	yuyx
逾	yuzd
遹	yuzk
迂	yuzy
郓	yybe
蕴	yycm
芸	yycs
云	yyes
煴	yyhm
郧	yyke
员	yykr
韵	yyld
耘	yyls
妘	yyns
孕	yynz
昀	yyod
晕	yyoi
狁	yyqe
氲	yyqm
缊	yysm
鋆	yytj
赟	yywr
恽	yyxi
愠	yyxm
运	yyzs
酉	yzaa
鲉	yzay
宥	yzbo
猷	yzbq
疣	yzby
莠	yzcn
莜	yzcw
莸	yzcy
油	yzdy
游	yzdz
幽	yzey
麀	yzgb
黝	yzhl
蚴	yzil
铕	yzjo
鼬	yzjy
呦	yzkl
囿	yzko
卣	yzla
耰	yzlw
槱	yzmh
柚	yzmy
牖	yzpf
繇	yzpx
釉	yzpy
犹	yzqy
佑	yzrk
侑	yzro
攸	yzrw
悠	yzrx
优	yzry
尤	yzud
右	yzuk
友	yzuy
又	yzvn
酉	yzxa
忧	yzxy
尤	yzyd
邮	yzye
幼	yzyl
诱	yzyn
扎	zafv
拶	zafx
匝	zakj
咋	zakv
咱	zakz
臜	zaor
砸	zauj
枣	zcad
皂	zcbq
藻	zccm
燥	zchm
灶	zcht
蚤	zcii
噪	zckm
唣	zckq
糟	zcmo
早	zcou
簉	zcvz
璪	zcwm
慥	zcxz
造	zczk
躁	zczm
遭	zczo
再	zdar
灾	zdbh
宰	zdbu
崽	zdex
仔	zdrz
哉	zduk
栽	zdum
在	zdut
甾	zdvt
泽	zedl
择	zefl
责	zefr
仄	zeir
帻	zejr
则	zekd
赜	zekr
咋	zekv
昃	zeor
箦	zevr
舴	zevv
迮	zezv
怎	zfvx
谮	zfyo
鄫	zgbe
曾	zgbo
甑	zgbw
锃	zgjw
赠	zgko
罾	zgso
综	zgsx
增	zgto
矰	zguo
憎	zgxo
臧	zhad
葬	zhcc
藏	zhci
赃	zhkt
驵	zhmq
脏	zhot
奘	zhpd
牂	zhpy
奘	zhvd
臧	zhwi
髭	ziab
鲻	ziat
兹	ziby
孳	zibz
茈	zicb
鼒	zicv
咨	zidk
姿	zidn
淄	zidt
滓	zidu
恣	zidx
滋	zidy
嵫	ziey
秭	zihp
辎	ziit
镃	zijy
呲	zikb
嗞	ziky
耔	zilz
籽	zimz
姊	zinp
眦	ziob
自	zipo
仔	zirz
缁	zist
趑	zitr
子	ziva
龇	zivb
訾	zivk
笫	zivp
紫	zivx
觜	zivy
孜	zizw
寁	zjbr
攒	zjfr
拶	zjfx
錾	zjij
暂	zjio
糌	zjmo
酂	zjne
赞	zjnr
趱	zjtr
簪	zjvo
昝	zjwo
瓒	zjwr
岞	zoev
捽	zofu
撮	zofy
座	zogt
唑	zokt
嘬	zoky
柞	zomv
胙	zoov
祚	zopv
佐	zorg
坐	zort
作	zorv
做	zorw
笮	zovv
琢	zown
怍	zoxv
酢	zoyv
攥	zrfx
缵	zrsr
纂	zrvx
躜	zrzr
鬷	zsaw
鬃	zsax
疭	zsbr
枞	zsmr
粽	zsmx
腙	zsox
倧	zsrx
综	zssx
踪	zszx
菹	zucq
阻	zueq
崒	zueu
租	zuhq
足	zukr
祖	zupq
俎	zurq
组	zusq
珇	zuwq
诅	zuyq
蕞	zvcy
咀	zvkq
嘴	zvky
槜	zvmn
最	zvoy
罪	zvsf
觜	zvvy
醉	zvyu
鲗	zwad
贼	zwku
鳟	zyac
尊	zybc
嶟	zyec
噂	zykc
樽	zymc
僔	zyrc
遵	zyzc
鲰	zzay
鄹	zzee
陬	zzey
揍	zzft
驺	zzme
走	zztr
荜	bicu
辟	biuu
蕃	fjct
麸	fuff
抚	fufw
蝠	fuit
赙	fukc
佛	furf
汲	jidj
矶	jiuj
蛎	liiw
栎	liml
洌	lpdd
闾	lvmk
暝	mkob
湎	mmdm
茉	mocm
沏	qidd
骐	qimb
钎	qmjq
醛	qryw
什	uiru
挚	vifu
嵬	wweg
烯	xihj
解	xpdn
呷	xxkj
殃	yhdy
痍	yiby
艾	yicx
翳	yikx
翌	yixl
奄	yjdd
焱	yjhh
焰	yjhj
魇	yjig
淤	yudd
