啊	aakk
不	buad
才	cdap
的	debu
二	eraa
非	fwla
个	gerl
和	hehk
出	iuvk
就	jqwy
可	kedk
了	levl
没	mwdy
你	nirx
哦	ookw
平	pkau
去	quts
人	rfpn
三	sjae
他	tary
是	uior
这	vezw
我	wopd
小	xnld
一	yiaa
在	zdut
阿	aaek
昂	ahoe
爱	aipy
安	anbn
奥	aopd
把	bafb
滨	bbdb
报	bcfy
白	bdpo
本	bfaa
蹦	bgzo
帮	bhfj
比	bibb
办	bjld
并	bkbk
边	bmzl
表	bnfy
拨	bofd
别	bpkd
部	bule
被	bwpy
擦	cafx
草	cccu
菜	cdcm
测	cedd
岑	cfev
曾	cgbo
藏	chci
次	cidr
参	cjsp
错	cojo
窜	crbi
从	csrr
粗	cumq
催	cvrf
村	cymc
凑	czdt
大	daun
到	dcad
代	ddry
得	deic
等	dgvc
当	dhxe
地	dity
但	djrd
定	dkbr
点	dmlh
调	dnyk
多	doxx
跌	dpzu
丢	dqps
段	drpy
动	dsel
读	duyd
对	dvyc
得	dwic
顿	dytr
都	dzle
额	eebr
鹤	ehdn
欸	eisr
恩	enkx
而	eral
法	fads
分	ffbd
风	fgjx
放	fhfw
反	fjpy
佛	forf
副	fuad
费	fwfr
否	fzbk
嘎	gakg
高	gcwk
该	gdyr
各	gewk
跟	gfzg
更	ggan
刚	ghkd
干	gjau
怪	gkxt
光	glxw
过	gozc
关	grbt
共	gscb
古	guuk
贵	gvvr
给	gwsk
挂	gxft
滚	gydy
够	gzbx
哈	hakk
好	hcnz
还	hdzb
何	herk
很	hfig
横	hgmb
行	hhii
含	hjrk
坏	hktb
黄	hlcb
或	hoga
换	hrfd
红	hssg
户	hudu
会	hvrs
黑	hwlh
话	hxyk
混	hydb
后	hzpk
差	iayg
超	ictk
拆	idfi
车	ieal
陈	ifed
成	igwv
长	ihpn
吃	iikq
产	ijlp
揣	ikfe
窗	ilbw
戳	ioxg
传	irrv
冲	isdv
处	iuwb
吹	ivkr
纯	iyst
抽	izfy
进	jbzj
几	jipv
经	jksg
将	jldc
间	jmmo
叫	jnkl
接	jpfn
久	jqpn
卷	jrjv
据	jufk
加	jxlk
均	jytd
卡	kaub
靠	kcnf
开	kdac
克	keue
肯	kfvo
坑	kgtj
抗	khfj
看	kjuo
快	kkxg
况	klde
扩	kofg
宽	krbe
空	ksbg
酷	kuyk
亏	kvev
剋	kwud
夸	kxdk
困	kykm
口	kzla
拉	lafl
林	lbmm
老	lclb
来	ldan
乐	lepd
冷	lgds
浪	lhdl
里	lila
另	lkkl
两	llad
连	lmzi
料	lnmu
落	lock
列	lpdd
刘	lqwd
乱	lrqv
龙	lsud
路	luzk
率	lvwu
类	lwmd
论	lyyb
楼	lzmn
吗	makm
民	mbvv
毛	mcpv
买	mdvd
么	meps
们	mfrm
梦	mgmx
忙	mhxw
米	midm
慢	mjxy
名	mkxk
面	mmaa
秒	mnhu
末	moan
灭	mpah
目	muka
每	mwpm
某	mzgm
那	nave
您	nbrx
闹	ncmj
呢	nekb
嫩	nfnw
能	ngsb
囊	nhay
泥	nidb
难	njyf
宁	nkbd
年	nmpl
鸟	nnwd
挪	nofe
捏	npft
牛	nqpl
暖	nroy
弄	nswc
虐	ntha
怒	nunx
女	nvva
内	nwld
嗯	ogkx
喔	ookt
欧	oukr
怕	paxb
品	pbkk
跑	pczs
排	pdff
盆	pfbm
碰	pguy
旁	phwf
批	pifb
盘	pjvm
凭	pkrj
片	pmpv
票	pnxx
破	pouy
撇	ppfw
普	pubo
配	pwyj
剖	pzld
亲	qblm
其	qiqb
请	qkyo
强	qlgi
前	qmbd
桥	qnml
且	qpla
求	qqad
全	qrrw
穷	qsbl
却	qtte
区	qukx
恰	qxxk
群	qyyy
绕	rcsw
热	refh
任	rfrr
仍	rgrn
让	rhyu
日	rika
然	rjph
若	rock
软	rrir
容	rsbk
如	runk
肉	rznr
撒	safw
扫	scfe
赛	sdbr
色	sedb
森	sfmm
僧	sgro
四	sike
散	sjcw
所	sopj
算	srvc
送	sszt
苏	sucb
岁	svex
搜	szfy
她	tany
套	tcds
太	tddd
特	tenc
疼	tgbd
汤	thdp
体	tirb
谈	tjyh
听	tkkj
天	tmad
调	tnyk
托	tofq
贴	tpkk
团	trkc
同	tskk
图	tukd
推	tvff
头	tzdd
啥	uakk
少	ucxp
晒	udox
设	ueyy
深	ufdm
生	ugpf
上	uhla
事	uial
山	ujlk
帅	uklj
双	ulyy
说	uoye
拴	urfw
数	uumw
水	uvln
谁	uwyf
顺	uyir
受	uzpy
扎	vafv
找	vcfg
着	veyo
真	vfub
正	vgav
长	vhpn
只	vikb
占	vjlk
拽	vkfy
装	vldy
桌	volm
转	vriv
中	vsll
主	vudw
追	vvzk
抓	vxfv
周	vzkk
挖	wafv
外	wdxb
问	wfmk
翁	wgbx
王	what
完	wjbe
握	woft
无	wuay
为	wwdd
新	xblj
系	xipx
行	xkii
想	xlmx
先	xmne
笑	xnvy
些	xpve
修	xqrp
选	xrze
熊	xssh
学	xtxz
需	xuye
下	xxab
亚	yaay
因	ybkd
要	ycxn
也	yevv
样	yhmy
以	yivr
眼	yjog
应	ykga
哟	yoku
元	yree
用	yskl
月	ytka
与	yuaa
云	yyes
有	yzuo
咋	zakv
早	zcou
再	zdar
则	zekd
怎	zfvx
增	zgto
藏	zhci
字	zibz
做	zorw
总	zsbx
组	zusq
最	zvoy
贼	zwku
走	zztr
阿	aaek
锕	aajk
吖	aaky
腌	aaod
肮	ahoj
卬	ahpe
盎	ahym
癌	aibe
艾	aicx
隘	aiem
挨	aifu
锿	aijy
唉	aiku
嫒	ainy
暧	aioy
爱	aipy
欸	aisr
埃	aitu
矮	aiun
哀	aiwy
霭	aiyv
案	anbm
鹌	andn
岸	aneg
按	anfn
庵	angd
黯	anho
铵	anjn
唵	ankd
桉	anmn
暗	anoo
氨	anqn
俺	anrd
埯	antd
谙	anyo
奡	aoal
翱	aobx
澳	aodd
隩	aoed
熬	aofh
鏖	aogj
嗷	aokw
凹	aola
媪	aonm
袄	aopy
傲	aorw
坳	aotl
璈	aoww
懊	aoxd
岙	aoye
遨	aozw
鲅	baad
爸	babb
芭	bacb
灞	bado
岜	baeb
拔	bafd
靶	bagb
钯	bajb
吧	bakb
耙	balb
粑	bamb
妭	band
胈	baod
八	bapn
罢	bass
坝	batr
巴	basl
霸	bayo
跋	bazd
鬓	bbab
宾	bbbb
殡	bbdb
豳	bbeu
摈	bbfb
髌	bbgb
镔	bbjb
彬	bbmp
膑	bbob
傧	bbrb
缤	bbsb
斌	bbwv
鲍	bcas
包	bcbs
薄	bccc
瀑	bcdu
剥	bced
抱	bcfs
爆	bchu
暴	bcou
褓	bcpm
保	bcrm
饱	bcus
豹	bcvu
褒	bcwy
雹	bcys
趵	bczu
百	bdab
摆	bdfs
稗	bdhu
败	bdkw
柏	bdmb
佰	bdrb
拜	bduf
本	bfaa
坌	bfbt
苯	bfcb
奔	bfdc
锛	bfjc
栟	bfmk
犇	bfnn
畚	bfst
笨	bfvb
甭	bgby
崩	bgeo
蚌	bgif
镚	bgjo
嘣	bgko
祊	bgpf
绷	bgso
泵	bguu
琫	bgwl
迸	bgzk
蒡	bhcf
浜	bhdb
邦	bhfe
蚌	bhif
镑	bhjf
棒	bhml
膀	bhof
傍	bhrf
绑	bhse
塝	bhtf
磅	bhuf
玤	bhwf
谤	bhyf
鲾	biat
毙	bibb
蔽	bicw
必	bidd
陛	biet
庇	bigb
秕	bihb
彼	biiy
铋	bijb
哔	biku
闭	bimc
婢	binu
币	bipj
狴	biqt
俾	biru
畀	bitl
壁	biut
笔	bivm
碧	biwu
愎	bixw
诐	biyy
避	bizu
颁	bjbr
半	bjdl
阪	bjey
搬	bjfy
瓣	bjlu
板	bjmy
版	bjpy
伴	bjrb
绊	bjsb
坂	bjty
般	bjvy
班	bjww
丙	bkan
病	bkbb
冰	bkdu
摒	bkfk
炳	bkhb
蛃	bkib
柄	bkmb
昺	bkob
秉	bkpn
兵	bkqb
饼	bkuk
禀	bkwx
鳊	bmac
苄	bmcb
汴	bmdb
抃	bmfb
鞭	bmgg
扁	bmhc
贬	bmkf
辩	bmlu
昪	bmoc
褊	bmpc
便	bmrg
编	bmsc
砭	bmuf
变	bmwy
忭	bmxb
遍	bmzc
鳔	bnax
瘭	bnbx
蔈	bncx
彪	bnhp
镖	bnjx
标	bnmx
婊	bnny
膘	bnox
裱	bnpy
飙	bnqx
俵	bnry
鲌	boab
帛	bobj
薄	bocc
波	body
剥	boed
播	boft
馞	bohz
铂	bojb
啵	boky
卜	bold
柏	bomb
膊	booc
伯	borb
博	bouc
箔	bovb
玻	bowy
跛	bozy
瘪	bpbb
憋	bpdx
别	bpkd
不	buad
蔀	buce
捕	buff
钚	bujb
哺	bukf
卜	buld
晡	buof
补	bupb
堡	burt
埠	butu
布	buuj
步	buvp
怖	buxj
逋	buzf
蓓	bwck
陂	bwey
悲	bwfx
焙	bwhk
钡	bwjr
呗	bwkr
北	bwlb
杯	bwmb
卑	bwpu
狈	bwqr
倍	bwrk
碑	bwuu
备	bwwt
悖	bwxz
擦	cafx
嚓	cakx
曹	ccao
漕	ccdo
操	ccfm
螬	ccio
嘈	ccko
槽	ccmo
艚	ccvo
才	cdap
蔡	cdcx
财	cdkc
材	cdmc
睬	cdom
采	cdpm
猜	cdqo
偲	cdrx
裁	cduy
踩	cdzm
测	cedd
厕	ceid
册	cepa
侧	cerd
策	cevn
恻	cexd
涔	cfdv
岑	cfev
参	cfsp
曾	cgbo
嶒	cgeo
噌	cgko
层	cgus
蹭	cgzo
苍	chcv
沧	chdv
仓	chrv
舱	chvv
刺	ciad
慈	cibx
茨	cicr
瓷	cidw
赐	cikw
糍	cimy
祠	cipk
辞	ciqu
伺	cirk
磁	ciuy
此	civb
词	ciyk
跐	cizb
残	cjdj
掺	cjfp
灿	cjhe
餐	cjll
骖	cjmp
蚕	cjti
孱	cjuz
璨	cjwm
惨	cjxp
痤	cobt
莝	coct
嵯	coeg
搓	cofg
厝	coio
锉	cojt
鹾	colg
酂	cone
脞	coot
矬	cout
蹉	cozg
窜	crbi
攒	crfr
镩	crji
爨	crph
汆	crru
篡	crvs
蹿	crzi
匆	csbd
葱	cscx
淙	csdx
聪	csex
熜	cshx
骢	csmx
囱	cspw
丛	csra
琮	cswx
悰	csxx
蹙	cuwr
蔟	cucu
殂	cudq
徂	cuiq
粗	cumq
猝	cuqu
促	curr
簇	cuvu
卒	cuwu
醋	cuyo
蹴	cuzy
瘁	cvbu
萃	cvcu
淬	cvdu
崔	cvef
摧	cvff
啐	cvku
粹	cvmu
脆	cvov
催	cvrf
缞	cvsy
璀	cvwf
翠	cvxu
寸	cyad
皴	cysy
邨	cyte
存	cyuz
忖	cyxc
辏	czit
腠	czot
瘩	dabk
荙	dacz
耷	dade
打	dafd
鞑	dagz
炟	dahd
哒	dakz
妲	dand
褡	dapk
垯	datz
沓	dauo
答	davk
怛	daxd
达	dazd
鱽	dcad
盗	dcdm
捣	dcfe
稻	dchj
帱	dcjc
叨	dckd
岛	dcpe
氘	dcql
倒	dcrd
导	dcsc
刀	dcvp
悼	dcxu
道	dczz
歹	ddax
殆	dddk
叇	ddez
带	ddfj
待	ddic
呆	ddkm
贷	ddrr
怠	ddsx
戴	ddub
玳	ddwy
逮	ddzn
德	deix
锝	dejc
嘚	dekc
地	dety
扽	dfft
澄	dgda
嶝	dgea
灯	dghd
噔	dgka
瞪	dgoa
磴	dgua
登	dgva
璒	dgwa
邓	dgye
蹬	dgza
宕	dhbu
荡	dhcp
挡	dhfe
铛	dhje
档	dhme
裆	dhpe
垱	dhte
凼	dhuk
珰	dhwe
党	dhxe
谠	dhye
髢	diay
弟	dibp
蒂	dicj
涤	didm
抵	difd
底	digd
䗖	diij
镝	dijk
嘀	dikk
棣	dimn
嫡	dink
睇	diop
敌	diqw
低	dird
缔	disj
堤	ditr
氐	diud
第	divp
帝	diwj
谛	diyj
递	dizp
石	djak
单	djbl
萏	djcj
淡	djdh
耽	djev
担	djfd
弹	djgl
啖	djkh
胆	djod
丹	djpa
氮	djqh
儋	djrk
蛋	djvi
惮	djxl
诞	djyz
丁	dkal
疔	dkbd
顶	dkdr
耵	dked
钉	dkjd
叮	dkkd
盯	dkod
仃	dkrd
町	dktd
碇	dkur
玎	dkwd
订	dkyd
癫	dmbr
滇	dmdb
巅	dmer
垫	dmft
店	dmgk
扂	dmhk
钿	dmjt
电	dmlv
佃	dmrt
殿	dmuy
玷	dmwk
惦	dmxk
踮	dmzk
鲷	dnak
窎	dnbn
凋	dndk
掉	dnfu
钓	dnju
吊	dnkj
鸟	dnwd
刁	dnva
鸟	dnwd
夺	dodc
堕	doet
掇	dofy
度	dogy
朵	dojm
咄	doki
驮	domd
裰	dopy
垛	dotm
躲	doum
舵	dovb
惰	doxo
跺	dozm
鲽	dpam
爹	dpbx
瓞	dpgu
蝶	dpim
喋	dpkm
耋	dplt
昳	dpou
牒	dppm
绖	dpst
垤	dptt
碟	dpum
叠	dpyq
迭	dpzu
铥	dqjs
丢	dqps
耑	dree
煅	drhy
锻	drjy
端	drle
断	drmj
缎	drsy
塅	drty
短	drua
簖	drvj
东	dsad
董	dscv
洞	dsdk
岽	dsed
咚	dskd
栋	dsmd
胴	dsok
氡	dsqd
侗	dsrk
垌	dstk
硐	dsuk
冬	dswd
懂	dsxv
蠹	duai
渡	dudy
毒	dufm
度	dugy
黩	duhd
镀	dujy
赌	duko
都	dule
杜	dumt
妒	dunh
肚	duot
牍	dupd
独	duqi
堵	duto
督	duuo
笃	duvm
读	duyd
兑	dvbe
队	dver
镦	dvjw
祋	dvpy
堆	dvtf
碓	dvuf
敦	dvww
怼	dvyx
得	dwic
嗲	dxkx
沌	dydt
炖	dyht
钝	dyjt
吨	dykt
盹	dyot
盾	dypo
墩	dytw
敦	dyww
蹲	dyzc
豆	dzaa
痘	dzba
蔸	dzce
斗	dzdu
陡	dzer
抖	dzfu
蚪	dziu
钭	dzju
兜	dzbe
篼	dzve
逗	dzza
鳄	eeak
额	eebr
萼	eeck
峨	eeew
扼	eefv
厄	eeiv
锷	eejk
呃	eekv
阏	eemd
娥	eenw
腭	eeok
俄	eerw
饿	eeuw
鹅	eewn
愕	eexk
恶	eeyx
遏	eezv
欸	eisr
蒽	encx
摁	enfx
嗯	enkx
耳	eraa
尔	erdx
鸸	eren
铒	erje
咡	erke
儿	erpv
佴	erre
饵	erue
珥	erwe
贰	eryr
迩	erzx
阀	famg
乏	fapv
伐	farg
罚	fasd
砝	faus
发	favd
珐	faws
鲼	ffar
忿	ffbx
芬	ffcd
奋	ffdt
吩	ffkd
粉	ffmd
氛	ffqd
份	ffrd
纷	ffsd
坟	fftw
玢	ffwd
愤	ffxr
酚	ffyd
丰	fgal
疯	fgbx
葑	fgcc
冯	fgdm
峰	fgef
奉	fgfl
烽	fghf
蜂	fgif
锋	fgjf
唪	fgkl
枫	fgmx
俸	fgrl
缝	fgsz
封	fgtc
砜	fgux
讽	fgyx
逢	fgzf
鲂	fhaf
芳	fhcf
方	fhdw
防	fhef
邡	fhfe
房	fhhf
彷	fhif
钫	fhjf
枋	fhmf
妨	fhnf
肪	fhof
仿	fhrf
纺	fhsf
坊	fhtf
舫	fhvf
访	fhyf
范	fjcv
泛	fjdf
烦	fjhr
凡	fjjd
贩	fjky
樊	fjmd
翻	fjpx
犯	fjqv
畈	fjty
饭	fjuy
璠	fjwt
返	fjzy
佛	forf
夫	fuan
富	fubt
芙	fucf
负	fudr
附	fuec
扶	fuff
府	fugc
馥	fuhw
辅	fuif
幅	fujt
赋	fukv
孵	fulz
驸	fumc
妇	fune
服	fuoy
福	fupt
氟	fuqf
付	furc
缚	fusc
赴	futb
砆	fuuf
符	fuvc
覆	fuxw
讣	fuyb
跗	fuzc
鲱	fwaf
痱	fwbf
菲	fwcf
沸	fwdf
斐	fwfw
废	fwgd
扉	fwhf
镄	fwjr
匪	fwkf
榧	fwmf
妃	fwnj
肥	fwob
狒	fwqf
绯	fwsf
飞	fwvd
诽	fwyf
否	fzbk
缶	fzwk
夹	gaan
轧	gaiv
噶	gakv
尕	ganx
胳	gaok
伽	gark
尬	gayl
尜	gaxx
尬	gayl
皋	gcbu
藁	gccm
搞	gcfk
稿	gchk
镐	gcjk
糕	gcmh
告	gcnk
杲	gcom
睾	gcpg
篙	gcvk
膏	gcwo
羔	gcyh
丐	gdav
荄	gdcr
溉	gddv
陔	gder
改	gdjw
赅	gdkr
概	gdmv
戤	gdng
晐	gdor
垓	gdtr
盖	gdym
歌	gear
割	gebd
葛	gecv
歌	gear
隔	geel
搁	gefk
骼	gegk
蛤	geik
铬	gejk
嗝	gekl
哿	gelk
格	gemk
革	genl
胳	geok
袼	gepk
鸽	gern
纥	gesq
圪	getq
硌	geuk
舸	gevk
盖	geym
亘	gfad
茛	gfcg
艮	gfen
哏	gfkg
根	gfmg
艮	gfen
鲠	ggag
浭	ggdg
耿	ggeh
庚	gggn
哽	ggkg
耕	gglj
梗	ggmg
暅	ggog
绠	ggsg
埂	ggtg
颈	ggvr
羹	ggyd
港	ghds
岗	ghex
缸	ghfg
钢	ghjx
冈	ghkx
戆	ghlx
杠	ghmg
肛	ghog
纲	ghsx
堽	ghtv
矼	ghug
筻	ghvg
甘	gjna
疳	gjbg
苷	gjcg
淦	gjdj
擀	gjfg
秆	gjhg
赣	gjlr
杆	gjmg
甘	gjna
肝	gjog
绀	gjsg
赶	gjtg
尴	gjym
敢	gjvw
感	gjxx
感	gjxx
尴	gjym
拐	gkfl
乖	gkqb
夬	gkvn
广	gldi
咣	glkw
胱	glow
犷	glqg
广	gldi
逛	glzw
馘	goba
聒	goek
掴	gofy
蜾	goig
锅	gojn
国	goky
果	goln
腘	gooy
虢	gopj
埚	gotn
郭	gowe
鳏	grad
官	grbk
莞	grce
灌	grdf
罐	grff
贯	grvr
爟	grhf
棺	grmk
盥	grpm
倌	grrk
纶	grsb
馆	gruk
管	grvk
惯	grxr
观	grye
工	gsaa
公	gsbs
恭	gscx
觥	gsdw
拱	gsfb
贡	gsgr
蚣	gsis
唝	gskr
龚	gslb
肱	gsos
供	gsrb
躬	gsug
弓	gsvv
珙	gswb
鲴	guak
谷	gubk
菇	guck
沽	gudk
崮	guek
鹘	gugn
雇	guhf
顾	guir
钴	gujk
固	gukk
骨	gulo
梏	gumk
姑	gunk
股	guoy
估	gurk
罟	gusk
鼓	guuy
箍	guvj
贾	guxr
诂	guyk
孤	guzg
鲑	gvat
皈	gvby
龟	gvdv
刿	gved
规	gvfe
庋	gvgy
轨	gvij
匦	gvkj
归	gvle
桂	gvmt
妫	gvnw
晷	gvok
鬼	gvps
刽	gvrd
圭	gvtt
硅	gvut
癸	gvvt
瑰	gvwg
诡	gvyv
跪	gvzv
给	gwsk
寡	gxbd
挂	gxft
剐	gxkd
栝	gxmk
胍	gxog
瓜	gxpn
刮	gxqd
卦	gxtb
鲧	gyax
辊	gyib
棍	gymb
绲	gysb
磙	gyuy
衮	gywy
觏	gzae
勾	gzbs
苟	gzck
沟	gzds
岣	gzek
鞲	gzgr
钩	gzjs
购	gzks
构	gzms
媾	gznr
狗	gzqk
佝	gzrk
缑	gzsu
垢	gztk
篝	gzvr
诟	gzyk
遘	gzzr
蛤	haik
铪	hajk
哈	hakk
皓	hcbk
薅	hccc
浩	hcdk
蚝	hcim
镐	hcjk
号	hckv
耗	hclm
昊	hcot
郝	hcte
貉	hcvk
豪	hcwu
害	hdbk
海	hddm
骸	hdgr
嗨	hdkm
骇	hdmr
胲	hdor
氦	hdqr
亥	hdwr
醢	hdym
孩	hdzr
翮	heax
荷	heck
河	hedk
鞨	hegv
熇	hehk
喝	hekv
贺	helr
核	hemr
曷	heov
褐	hepv
禾	hepm
合	herk
纥	hesq
赫	hetd
貉	hevk
劾	hewl
翯	hexk
诃	heyk
痕	hfbg
狠	hfqg
恨	hfxg
蘅	hgci
衡	hgii
哼	hgkl
桁	hgmi
姮	hgng
亨	hgwl
恒	hgxg
巷	hhcs
夯	hhdl
行	hhii
吭	hhkj
杭	hhmj
绗	hhsi
航	hhvj
颃	hhwr
寒	hjbd
菡	hjck
汉	hjdy
崡	hjek
捍	hjfg
邯	hjge
焊	hjhg
蚶	hjig
喊	hjkk
函	hjlk
阚	hjmw
旱	hjog
犴	hjqg
颔	hjrr
韩	hjuw
憨	hjvx
憾	hjxx
酣	hjyg
鼾	hjzg
淮	hkdf
徊	hkik
槐	hkmg
坏	hktb
怀	hkxb
踝	hkzg
鳇	hlaw
皇	hlbw
荒	hlcv
湟	hldw
隍	hlew
煌	hlhw
蝗	hliw
凰	hljw
媓	hlnw
晃	hlow
簧	hlvb
慌	hlxv
谎	hlyv
遑	hlzw
豁	hobk
获	hocq
活	hodk
彟	hoey
攉	hoff
惑	hogx
和	hohk
蠖	hoiy
镬	hojy
嚯	hokf
耠	holk
祸	hopn
货	horr
霍	hoyf
鲩	hrae
痪	hrbd
萑	hrcf
涣	hrdd
峘	hreg
擐	hrfy
焕	hrhd
患	hrix
豢	hrju
唤	hrkd
桓	hrmg
嬛	hrny
㬊	hroy
獾	hrqf
缓	hrsy
貆	hrvg
环	hrwb
欢	hryr
还	hrzb
宏	hsbs
蕻	hscb
洪	hsdb
弘	hsgs
烘	hshb
虹	hsig
哄	hskb
竑	hsls
闳	hsms
翃	hsux
黉	hsxb
讧	hsyg
互	huaa
葫	huco
沪	hudh
岵	huek
护	hufh
弧	hugg
虎	huhj
蝴	huio
呼	hukh
糊	humo
鹄	hunn
昒	huow
乎	hupl
狐	huqg
胡	huuo
笏	huvw
忽	huwx
怙	huxk
醐	huyo
惠	hvax
荟	hvcs
汇	hvdk
堕	hvet
挥	hvfi
麾	hvgm
秽	hvhx
徽	hviw
毁	hvjy
回	hvkk
桧	hvms
晖	hvoi
会	hvrs
绘	hvss
灰	hvuh
珲	hvwi
悔	hvxm
讳	hvyw
嘿	hwkh
画	hxak
花	hxcb
滑	hxdg
划	hxgd
铧	hxju
哗	hxku
桦	hxmu
婳	hxnk
猾	hxqg
化	hxrb
荤	hyci
浑	hydi
魂	hyeg
阍	hymo
婚	hyno
昏	hyuo
珲	hywi
诨	hyyi
鲘	hzak
瘊	hzbu
骺	hzgk
厚	hziz
吼	hzkv
糇	hzmu
垕	hzpt
猴	hzqu
候	hzru
篌	hzvu
鲎	hzxa
逅	hzzk
察	iabx
茶	iacm
汊	iadi
嵖	iaed
插	iafj
镲	iajx
喳	iakd
查	iamd
姹	ianq
衩	iapi
猹	iaqd
侘	iarq
碴	iaud
刹	iaxd
叉	iayd
蹅	iazd
潮	icdo
抄	icfu
弨	icgk
炒	ichu
钞	icju
吵	icku
耖	iclu
晁	icod
绰	icsu
超	ictk
朝	icuo
巢	icvg
怊	icxk
瘥	idbg
茝	idcl
钗	idji
侪	idrl
柴	idvm
虿	idwi
差	idyg
车	ieal
澈	iedw
撤	iefw
彻	ieid
㬚	ieow
掣	iepu
坼	ieti
砗	ieui
宸	ifbn
沉	ifdj
陈	ifed
抻	iffu
称	ifhx
辰	ifin
臣	ifkl
郴	ifme
晨	ifon
衬	ifpc
伧	ifrv
趁	iftp
碜	ifup
龀	ifvb
琛	ifwm
尘	ifxt
谶	ifyj
澄	igda
撑	igfu
称	ighx
惩	igix
铖	igji
呈	igkw
丞	igla
橙	igma
瞠	igot
裎	igpw
乘	igqn
城	igti
承	igvn
珵	igww
诚	igyi
逞	igzw
厂	ihap
苌	ihci
徜	ihik
唱	ihko
阊	ihmo
娼	ihno
肠	ihop
猖	ihqo
偿	ihrs
场	ihtp
畅	ihup
常	ihxj
昶	ihyo
豉	iiay
痴	iibk
茌	iicu
池	iidy
耻	iiev
持	iifc
弛	iigy
炽	iihb
螭	iiid
嗤	iiki
驰	iimy
媸	iini
匙	iiob
斥	iipd
侈	iirx
赤	iitd
尺	iiun
齿	iivk
啻	iiwk
迟	iizi
单	ijbl
蒇	ijcr
潺	ijdz
巉	ijed
搀	ijfd
蝉	ijil
铲	ijji
啴	ijkl
阐	ijml
婵	ijnl
旵	ijoe
禅	ijpl
缠	ijsl
馋	ijud
颤	ijwr
忏	ijxq
谄	ijyj
躔	ijzt
搋	ikfj
啜	ikky
踹	ikze
疮	ilbv
床	ilgm
幢	iljl
噇	ilkl
闯	ilmm
创	ilrd
怆	ilxv
辍	ioiy
啜	ioky
绰	iosu
龊	iovr
惙	ioxy
踔	iozu
穿	irby
钏	irji
喘	irke
串	irll
椽	irmu
川	irpl
氚	irqi
船	irvk
舛	irxl
遄	irze
宠	isbl
茺	isce
崇	isex
舂	isfj
种	ishv
铳	isje
重	ispa
虫	isvd
充	iswe
憧	isxl
亍	iuad
触	iudi
除	iueh
搐	iuft
黜	iuhi
厨	iuic
锄	iujl
楚	iumr
初	iupd
储	iuro
绌	iusi
础	iuui
畜	iuwt
怵	iuxu
躇	iuzo
陲	ivei
捶	ivfi
炊	ivhr
锤	ivji
圌	ivke
槌	ivmz
垂	ivpa
倕	ivri
䲠	iyao
莼	iyct
淳	iydz
春	iyfo
唇	iyik
椿	iymo
鹑	iywn
醇	iyyz
瘳	izbp
愁	izhx
帱	izjc
杻	izmi
瞅	izoh
仇	izrj
绸	izsk
畴	iztc
丑	izva
惆	izxk
酬	izyv
臭	izzq
荩	jbcd
津	jbdy
靳	jbgj
烬	jbhd
尽	jbid
锦	jbjj
噤	jbkx
紧	jblx
禁	jbmx
妗	jbnv
斤	jbpl
金	jbra
缙	jbso
劲	jbvl
瑾	jbwa
谨	jbya
近	jbzj
击	jiak
寄	jibk
藉	jico
急	jidx
际	jiex
挤	jifl
即	jige
稽	jiho
辑	jiie
忌	jijx
唧	jike
冀	jilb
机	jimj
嫉	jinu
肌	jioj
及	jipn
基	jiqt
集	jirm
级	jisj
圾	jitj
吉	jiuk
己	jivv
剂	jiwd
悸	jixz
记	jiyj
迹	jizd
井	jkal
痉	jkbg
敬	jkcw
净	jkdl
阱	jkej
静	jkfl
径	jkig
镜	jkje
竟	jkle
精	jkmo
婧	jkno
晶	jkoo
獍	jkqe
儆	jkrw
经	jksg
境	jkte
兢	jkue
劲	jkvl
京	jkwx
惊	jkxx
迳	jkzg
豇	jlag
蒋	jlcc
江	jldg
降	jlel
疆	jlga
匠	jlkj
耩	jllr
糨	jlmi
膙	jloi
僵	jlra
缰	jlsa
礓	jlua
讲	jlyj
柬	jman
兼	jmbn
荐	jmcz
减	jmdk
捡	jmfa
鞯	jmgz
肩	jmho
键	jmjz
见	jmke
坚	jmlt
检	jmma
奸	jmng
腱	jmoz
裥	jmpo
件	jmrn
缄	jmsk
碱	jmuk
简	jmvo
尖	jmxd
谏	jmyj
建	jmzy
鲛	jnax
窖	jnbk
蕉	jnch
角	jndy
峤	jnel
搅	jnfe
较	jnix
铰	jnjx
嚼	jnkc
教	jnlw
椒	jnmy
娇	jnnl
脚	jnoe
狡	jnqx
焦	jnrh
缴	jnsw
礁	jnuh
剿	jnvd
交	jnwx
觉	jnxe
酵	jnyz
跤	jnzx
鲒	jpak
皆	jpbb
节	jpce
洁	jpdk
阶	jpel
揭	jpfv
戒	jpgc
秸	jphk
街	jpii
竭	jplv
杰	jpmh
姐	jpnq
睫	jpor
借	jpro
结	jpsk
界	jptl
截	jpuf
孑	jpva
桀	jpxm
诫	jpyc
鬏	jqah
究	jqbj
酒	jqdy
㠇	jqey
揪	jqfh
厩	jqiv
舅	jqjl
啾	jqkh
旧	jqlo
柩	jqmj
九	jqpv
救	jqqw
纠	jqsl
赳	jqtl
玖	jqwj
蠲	jrbi
涓	jrdo
捐	jrfo
眷	jrjo
鹃	jrkn
娟	jrno
狷	jrqo
倦	jrrv
绢	jrso
窘	jsbk
炯	jshk
炅	jsoh
䌹	jssk
坰	jstk
迥	jszk
蕨	jtcr
决	jtdg
崛	jtei
掘	jtfi
爝	jthc
厥	jtir
嚼	jtkc
桷	jtmy
矍	jtoy
爵	jtpc
獗	jtqr
倔	jtri
绝	jtsb
砄	jtug
孓	jtvn
玦	jtwg
觉	jtxe
诀	jtyg
蹶	jtzr
车	jual
句	jubk
菊	jucm
沮	judq
聚	juen
拒	jufj
鞠	jugm
炬	juhj
锯	jujk
巨	juka
且	jula
橘	jumk
裾	jupk
具	juqb
俱	jurb
趄	jutq
局	juuk
龃	juvq
琚	juwk
举	juxl
醵	juyu
距	juzj
夹	jxan
家	jxbu
荚	jxcj
浃	jxdj
岬	jxej
恝	jxfx
稼	jxhu
蛱	jxij
钾	jxjj
架	jxlm
枷	jxmk
嫁	jxnu
胛	jxoj
假	jxry
嘉	jxuk
笳	jxvk
珈	jxwk
贾	jxxr
迦	jxzk
军	jybi
菌	jych
龟	jydv
峻	jyew
麇	jygh
焌	jyhw
钧	jyjd
竣	jylw
骏	jymw
晙	jyow
俊	jyrw
鋆	jytj
筠	jyvd
君	jyyk
咖	kakk
胩	kaob
卡	kaub
洘	kcdv
拷	kcfv
烤	kchv
铐	kcjv
考	kclv
栲	kcmv
犒	kcnk
尻	kcuj
开	kdac
蒈	kdcb
凯	kdej
揩	kdfb
炌	kdhl
楷	kdmb
垲	kdtj
慨	kdxv
客	kebk
苛	keck
渴	kedv
岢	keek
颗	kegr
科	kehu
轲	keik
锞	kejg
咳	kekr
棵	kemg
瞌	keom
牁	kepk
氪	keqe
缂	kesg
坷	ketk
壳	keuj
刻	kewd
恪	kexk
课	keyg
恳	kfgx
啃	kfko
裉	kfpg
龈	kfvg
铿	kgjt
吭	kgkj
坑	kgtj
硁	kgug
扛	khfg
康	khgn
炕	khhj
钪	khjj
糠	khmn
伉	khrj
亢	khwj
慷	khxn
莰	kjcr
崁	kjer
刊	kjgd
槛	kjmm
瞰	kjow
勘	kjql
侃	kjrv
坎	kjtr
砍	kjur
鲙	kkas
蒯	kkcd
浍	kkds
㧟	kkfk
哙	kkks
脍	kkos
狯	kkqs
会	kkrs
块	kktg
筷	kkvg
夼	kldi
邝	klge
匡	klkw
框	klmw
旷	klog
狂	klqw
纩	klsg
圹	kltg
矿	klug
筐	klvw
诳	klyw
括	kofk
廓	koge
蛞	koik
阔	komk
适	kozk
宽	krbe
髋	krge
款	krur
崆	kseg
控	ksfg
恐	ksgx
倥	ksrg
硿	ksug
箜	ksvg
孔	kszv
窟	kubi
苦	kuck
刳	kudd
库	kugi
哭	kukq
枯	kumk
裤	kupi
绔	kusk
矻	kuuq
喾	kuxk
酷	kuyk
窥	kvbe
葵	kvct
溃	kvdr
岿	kvee
揆	kvft
魁	kvgu
煃	kvht
蝰	kvit
馗	kvjz
匮	kvkr
睽	kvot
傀	kvrg
盔	kvum
篑	kvvr
愧	kvxg
逵	kvzt
挎	kxfk
姱	kxnk
胯	kxok
侉	kxrk
垮	kxtk
跨	kxzk
鲲	kyab
捆	kyfm
焜	kyhb
锟	kyjb
昆	kyob
坤	kytu
壸	kyuy
琨	kywb
寇	kzby
蔻	kzcy
扣	kzfk
叩	kzke
口	kzla
眍	kzox
筘	kzvk
瘌	labd
落	lack
鞡	lagl
蜡	laio
镴	lajv
啦	lakl
辣	lalu
腊	laoo
垃	latl
剌	laud
邋	lazv
鳞	lbal
蔺	lbcf
淋	lbdm
嶙	lbel
拎	lbfs
麟	lbgl
辚	lbil
啉	lbkm
临	lbla
粼	lbmv
瞵	lbol
邻	lbre
磷	lbul
琳	lbwm
霖	lbym
躏	lbzf
牢	lcbn
劳	lccl
涝	lcdl
崂	lcel
捞	lcfl
烙	lchk
铑	lcjb
唠	lckl
耢	lcll
栳	lcmb
姥	lcnb
乐	lcpd
佬	lcrb
络	lcsk
酪	lcyk
来	ldan
癞	ldbr
莱	ldcl
濑	lddr
崃	ldel
徕	ldil
梾	ldml
睐	ldol
赖	ldur
籁	ldvr
鳓	leal
泐	ledl
勒	legl
嘞	lekl
肋	leol
乐	lepd
仂	lerl
饹	leuk
簕	levl
崚	lgew
楞	lgmf
塄	lgtf
愣	lgxf
莨	lhcl
郎	lhde
崀	lhel
廊	lhge
烺	lhhl
螂	lhie
啷	lhke
榔	lhme
㫰	lhol
狼	lhql
琅	lhwl
丽	liad
痢	libd
莉	licd
漓	lidd
峛	li0
利	lihd
历	liil
锂	lijl
哩	likl
郦	lile
李	limz
娌	linl
礼	lipv
狸	liql
例	lird
罹	lisf
坜	litl
砾	liul
力	livp
离	liwd
栗	lixm
雳	liyl
逦	lizl
兰	ljbs
蓝	ljcm
滥	ljdm
岚	ljex
拦	ljfs
烂	ljhs
镧	ljjj
览	ljle
栏	ljms
褴	ljpm
缆	ljse
篮	ljvm
斓	ljwj
懒	ljxr
谰	ljyj
鲮	lkaw
菱	lkcw
凌	lkdw
岭	lkes
蛉	lkis
铃	lkjs
呤	lkks
棱	lkmw
姈	lkns
祾	lkpw
令	lkrs
绫	lksw
坽	lkts
龄	lkvs
玲	lkws
零	lkys
两	llad
莨	llcl
梁	lldm
靓	llfe
魉	llgl
辆	llil
粮	llml
量	lldl
俩	llrl
墚	lltm
亮	llwj
悢	llxl
谅	llyx
踉	llzl
鲢	lmaz
帘	lmbj
莲	lmcz
殓	lmda
联	lmet
廉	lmgn
炼	lmhd
蠊	lmin
链	lmjz
楝	lmmj
脸	lmoa
裢	lmpz
敛	lmrw
练	lmsd
恋	lmwx
怜	lmxs
鹩	lnan
疗	lnbl
蓼	lncp
潦	lndx
聊	lnee
撩	lnfx
廖	lngp
燎	lnhx
镣	lnjx
嘹	lnkx
料	lnmu
瞭	lnox
獠	lnqx
僚	lnrx
缭	lnsx
尥	lnyu
了	lnvl
憭	lnxx
尥	lnyu
辽	lnzl
瘰	lobx
萝	locx
洛	lodk
摞	lofx
烙	lohk
螺	loix
锣	lojx
咯	lokk
骡	lomx
脶	loon
裸	lopg
猡	loqx
倮	lorg
罗	losx
硌	louk
箩	lovx
雒	lowf
逻	lozx
鬣	lpav
裂	lpdy
捩	lpfq
咧	lpkd
脟	lpoc
猎	lpqo
趔	lptd
劣	lpul
躐	lpzv
瘤	lqbt
流	lqdv
陆	lqej
旒	lqfv
熘	lqht
镏	lqjt
柳	lqme
留	lqpt
绺	lqsk
硫	lquv
六	lqwb
鹨	lqxn
遛	lqzt
滦	lrdm
卵	lrpd
乱	lrqv
鸾	lrwn
窿	lsbu
泷	lsdl
隆	lseu
拢	lsfl
咙	lskl
聋	lsle
栊	lsml
胧	lsol
龙	lsud
笼	lsvl
弄	lswc
掠	ltfx
圙	ltkm
略	lttk
鲁	luao
芦	luch
泸	ludu
录	lueu
撸	lufo
鹿	lugb
炉	luhh
轳	luiu
镥	lujo
赂	lukk
卢	lulu
橹	lumo
胪	luou
禄	lupu
绿	lusu
垆	lutu
碌	luuu
箓	luvu
璐	luwk
勠	luxl
露	luyk
鹭	luzn
葎	lvcy
滤	lvdx
旅	lvfn
虑	lvhx
律	lviy
铝	lvjk
吕	lvkk
驴	lvmh
褛	lvpn
氯	lvqu
侣	lvrk
绿	lvsu
屡	lvun
率	lvwu
耒	lwfn
蕾	lwct
泪	lwdo
擂	lwft
勒	lwgl
镭	lwjt
嘞	lwkl
檑	lwmt
嫘	lwnx
肋	lwol
儡	lwrt
垒	lwst
累	lwtx
磊	lwuu
羸	lwwf
雷	lwyt
俩	lxrl
沦	lydb
抡	lyfb
轮	lyib
囵	lykb
伦	lyrb
纶	lysb
剅	lzad
瘘	lzbn
蒌	lzcn
漏	lzdy
陋	lzev
搂	lzfn
髅	lzgn
蝼	lzin
镂	lzjn
喽	lzkn
耧	lzln
娄	lzmn
䁖	lzon
偻	lzrn
篓	lzvn
露	lzyk
抹	mafm
麻	magm
蚂	maim
嘛	makm
杩	mamm
妈	manm
祃	mapm
犸	maqm
码	maum
马	mava
玛	mawm
孖	mazz
苠	mbcm
泯	mbdm
岷	mbem
抿	mbfm
黾	mbkd
皿	mbla
闽	mbmi
旻	mbow
敏	mbpw
缗	mbso
玟	mbww
悯	mbxw
髦	mcam
茂	mccw
泖	mcde
峁	mcee
旄	mcfm
帽	mcjo
冒	mcko
耄	mclm
懋	mcmx
牦	mcnm
冒	mcko
贸	mcpr
猫	mcqt
矛	mcsp
貌	mcve
袤	mcwy
荬	mdcd
麦	mdfw
唛	mdkw
脉	mdoy
埋	mdtl
卖	mdud
劢	mdwl
霾	mdyl
迈	mdzw
么	meps
门	mfdv
扪	mffm
焖	mfhx
钔	mfjm
闷	mfmx
萌	mgco
㠓	mgeu
蜢	mgim
锰	mgjm
檬	mgmu
盟	mgom
猛	mgqm
礞	mguu
艋	mgvm
氓	mgwm
懵	mgxo
茫	mhcw
漭	mhdc
蟒	mhic
牤	mhnw
硭	mhuw
盲	mhwo
忙	mhxw
蜜	mibi
蘼	micf
泌	midb
弥	migx
秘	mihb
咪	mikm
芈	mill
敉	mimw
眯	miom
觅	mipe
猕	miqx
谜	miyz
迷	mizm
鳗	mjay
蔓	mjcy
满	mjdl
鞔	mjgv
螨	mjil
幔	mjjy
嫚	mjny
瞒	mjol
缦	mjsy
馒	mjuy
蛮	mjwi
慢	mjxy
谩	mjyy
冥	mkbb
茗	mkck
溟	mkdb
螟	mkib
铭	mkjk
鸣	mkkn
明	mkoo
命	mkre
酩	mkyk
丏	mmav
免	mmdv
冕	mmkv
棉	mmmj
娩	mmnv
眠	mmom
绵	mmsj
愐	mmxm
苗	mnct
渺	mndu
描	mnft
庙	mngy
喵	mnkt
杪	mnmu
妙	mnnu
瞄	mnot
缈	mnsu
淼	mnuu
邈	mnze
万	moap
寞	mobd
莫	mocd
漠	modd
陌	moeb
摸	mofd
磨	mogu
墨	moht
镆	mojd
耱	molu
模	momd
嬷	monm
膜	mood
馍	moud
貊	movb
谟	moyd
灭	mpah
蔑	mpcu
咩	mpky
篾	mpvu
缪	mqsp
谬	mqyp
木	muun
幕	mucj
沐	mudm
拇	mufm
穆	muhp
钼	mujo
目	muka
模	mumd
姆	munm
睦	muot
牟	musn
木	muun
母	muvd
亩	muwt
寐	mwbw
莓	mwcm
湄	mwdo
嵋	mweo
魅	mwgw
煤	mwhm
镁	mwjd
枚	mwmw
妹	mwnw
昧	mwow
袂	mwpg
眉	mwvo
玫	mwww
霉	mwym
蛑	mzin
哞	mzkn
眸	mzon
侔	mzrn
牟	mzsn
谋	mzym
捺	nafx
钠	najn
哪	nake
娜	nane
肭	naon
衲	napn
拿	naru
纳	nasn
南	naug
您	nbrx
孬	ncbz
淖	ncdu
挠	ncfw
蛲	nciw
铙	ncjw
呶	ncky
闹	ncmj
脑	ncok
猱	ncqm
垴	nctk
硇	ncux
瑙	ncwx
恼	ncxk
萘	ndcx
奈	nddx
耐	ndec
柰	ndmx
奶	ndnn
氖	ndqn
佴	ndre
乃	ndvp
呐	nekn
讷	neyn
恁	nf0
能	ngsb
囊	nhay
攮	nhfy
囔	nhky
曩	nhoy
鲵	niae
薿	nicr
溺	nidd
拟	nifr
铌	nijb
匿	nikk
妮	ninb
腻	nior
猊	niqe
倪	nire
坭	nitb
尼	niub
怩	nixb
霓	niye
逆	nizp
南	njug
萳	njcg
蝻	njig
喃	njkg
楠	njmg
婻	njng
腩	njog
男	njtl
南	njug
甯	nkby
凝	nkdr
聍	nked
拧	nkfd
咛	nkkd
柠	nkmd
狞	nkqd
佞	nkrn
娘	nlnl
酿	nlyl
廿	nmca
蔫	nmch
撵	nmfi
黏	nmhk
辗	nmin
粘	nmmk
年	nmpl
念	nmrx
埝	nmtx
碾	nmun
茑	nncn
溺	nndd
脲	nnou
袅	nnpy
尿	nnuu
鸟	nnwd
挪	nofe
锘	nojk
喏	nokk
糯	nome
娜	none
傩	norf
懦	noxe
诺	noyk
孽	npcz
涅	npdt
聂	npey
捏	npft
镍	npjm
啮	npkk
乜	npvv
蹑	npzy
扭	nqfi
钮	nqji
杻	nqmi
妞	nqni
狃	nqqi
纽	nqsi
忸	nqxi
暖	nroy
农	nsdn
秾	nshn
哝	nskn
脓	nson
侬	nsrn
弄	nswc
疟	ntba
虐	ntha
奴	nuny
钕	nvjn
女	nvva
衄	nvxi
哪	nwke
馁	nwun
那	nwve
呣	omkm
嗯	onkx
噢	ookd
藕	oucy
沤	oudx
呕	oukx
耦	ouly
偶	oury
怄	ouxx
讴	ouyx
葩	pacb
扒	pafb
帕	pajb
啪	pakb
耙	palb
杷	pamb
爬	pavb
琶	pawb
趴	pazb
贫	pbbr
聘	pbev
拼	pbfk
品	pbkk
嫔	pbnb
频	pbvr
玭	pbwb
刨	pcbd
泡	pcds
抛	pcfl
庖	pcgs
炮	pchs
咆	pcks
脬	pcoz
袍	pcps
狍	pcqs
跑	pczs
蒎	pdcn
派	pddn
拍	pdfb
徘	pdif
哌	pdkn
牌	pdpu
俳	pdrf
迫	pdzb
湓	pfdm
喷	pfkr
蓬	pgcz
澎	pgdp
捧	pgfl
蟛	pgip
嘭	pgkp
棚	pgmo
朋	pgoo
堋	pgto
彭	pgup
篷	pgvz
烹	pgwh
怦	pgxp
鳑	phaf
滂	phdf
庞	phgl
螃	phif
耪	phlf
胖	phob
乓	phqd
磅	phuf
旁	phwf
雱	phyf
逄	phzl
鲏	piay
疲	piby
芘	picb
淠	pidl
陂	piey
披	pify
蜱	piiu
铍	pijy
啤	piku
枇	pimb
媲	pinb
脾	piou
郫	pipe
僻	piru
纰	pisb
坯	pitp
屁	piub
皮	pivy
琵	piwb
霹	piyu
判	pjbd
潘	pjdt
蟠	pjit
攀	pjmu
盼	pjod
襻	pjpu
畔	pjtb
磐	pjvu
蹒	pjzl
平	pkau
瓶	pkbw
萍	pkcp
洴	pkdk
枰	pkmp
娉	pknv
乒	pkqp
俜	pkrv
坪	pktp
屏	pkuk
玶	pkwp
评	pkyp
扁	pmhc
骗	pmmc
犏	pmnc
胼	pmok
偏	pmrc
篇	pmvc
谝	pmyc
蹁	pmzc
薸	pncx
漂	pndx
螵	pnix
嘌	pnkx
朴	pnmb
嫖	pnnx
瞟	pnox
缥	pnsx
飘	pnxx
魄	pobg
泼	podd
陂	poey
钋	pojb
叵	pokk
粕	pomb
鄱	pope
坡	poty
破	pouy
颇	povr
珀	powb
迫	pozb
苤	ppcp
瞥	ppdo
撇	ppfw
氕	ppqp
匍	pubf
蒲	pucf
瀑	pudu
扑	pufb
穙	puhn
铺	pujf
噗	pukn
朴	pumb
曝	puou
仆	purb
埔	putf
璞	puwn
谱	puyo
蹼	puzn
沛	pwdl
陪	pwek
裴	pwfy
帔	pwjy
赔	pwkk
胚	pwop
佩	pwrj
辔	pwsk
培	pwtk
霈	pwyl
抔	pzfb
剖	pzld
裒	pzwy
寝	qbby
芹	qbcj
沁	qbdx
嵚	qber
秦	qbfh
钦	qbjr
噙	qbkd
檎	qbmd
勤	qbnl
侵	qbry
矜	qbsv
琴	qbwv
覃	qbxu
七	qiav
蕲	qicj
柒	qidm
岂	qiej
旗	qifb
麒	qigb
启	qihk
蛴	qiil
颀	qijr
器	qikk
耆	qilo
骑	qimk
婍	qink
脐	qiol
气	qipv
欺	qiqr
企	qirv
绮	qisk
起	qitj
砌	qiud
歧	qivy
齐	qiwl
愭	qixo
讫	qiyq
蹊	qizd
鲭	qkao
顷	qkbr
擎	qkcu
清	qkdo
青	qkfo
庆	qkgd
黥	qkhx
轻	qkig
亲	qklm
晴	qkoo
卿	qkpe
氢	qkqg
倾	qkrr
磬	qkuu
箐	qkvo
勍	qkwl
情	qkxo
蔷	qlck
抢	qlfv
炝	qlhv
蜣	qliv
镪	qlji
呛	qlkv
枪	qlmv
嫱	qlnk
腔	qlog
襁	qlpi
戗	qlrg
墙	qltk
玱	qlwv
羌	qlyv
跄	qlzv
歉	qmbr
茜	qmcx
浅	qmdj
嵌	qmer
扦	qmfq
黔	qmhv
堑	qmit
钱	qmjj
犍	qmnz
肷	qmor
千	qmpu
仟	qmrq
缱	qmsz
乾	qmuq
签	qmva
慊	qmxn
谦	qmyn
迁	qmzq
翘	qnax
窍	qnbv
荞	qncl
峭	qneo
撬	qnfm
巧	qngv
锹	qnjh
橇	qnmm
瞧	qnoh
俏	qnro
缲	qnsm
壳	qnuj
敲	qnwy
悄	qnxo
乔	qnyl
跷	qnzw
窃	qpbd
茄	qpck
挈	qpfu
锲	qpjd
妾	qpln
切	qpqd
伽	qprk
趄	qptq
砌	qpud
怯	qpxs
鳅	qqah
酋	qqby
萩	qqch
龟	qqdv
鞧	qqgy
秋	qqhh
蚯	qqiq
丘	qqpa
囚	qqkr
糗	qqmq
丘	qqpa
邱	qqqe
仇	qqrj
巯	qqvv
球	qqwq
逑	qqzq
鬈	qrav
泉	qrbu
颧	qrcr
犬	qrdd
蜷	qriv
拳	qrju
圈	qrkv
权	qrmy
婘	qrnv
佺	qrrw
绻	qrsv
筌	qrvw
瑔	qrwu
悛	qrxw
劝	qryl
穹	qsbg
茕	qscu
邛	qsge
筇	qsve
琼	qswx
瘸	qtbr
鹊	qtcn
缺	qtfg
炔	qthg
阙	qtmr
埆	qtty
确	qtuy
癯	qubf
苣	qucj
渠	qudm
取	quey
觑	quhe
蛆	quiq
鼩	qujk
区	qukx
曲	qula
驱	qumx
瞿	quof
祛	qups
趣	quty
屈	quui
龋	quvy
璩	quwu
诎	quyi
葜	qxcd
洽	qxdk
掐	qxfj
髂	qxgk
袷	qxpk
卡	qxub
恰	qxxk
麇	qygh
囷	qykh
裙	qypk
逡	qyzw
荛	rccw
扰	rcfy
桡	rcmw
娆	rcnw
绕	rcsw
饶	rcuw
惹	recx
热	refh
喏	rekk
荏	rfcr
刃	rfdd
稔	rfhx
轫	rfir
妊	rfnr
壬	rfqa
壬	rfqa
忍	rfrx
纫	rfsr
饪	rfur
韧	rfwr
认	rfyr
扔	rgfn
仍	rgrn
蘘	rhcy
瀼	rhdy
攘	rhfy
穰	rhhy
嚷	rhky
禳	rhpy
壤	rhty
瓤	rhwg
让	rhyu
日	rika
髯	rjar
苒	rjcr
染	rjdm
燃	rjhh
蚺	rjir
冉	rjla
䎃	rjrx
鄀	roce
弱	rogd
婼	ronk
偌	rork
箬	rovk
阮	rree
软	rrir
媆	rrnd
堧	rrtd
瓀	rrwe
融	rsai
冗	rsbj
荣	rscm
溶	rsdk
嵘	rsem
戎	rsgu
熔	rshk
蝾	rsim
镕	rsjk
榕	rsmk
狨	rsqu
绒	rssu
瑢	rswk
茹	ruck
汝	rudn
辱	ruic
铷	rujk
嚅	ruke
嬬	rune
入	rupn
儒	rure
缛	rusc
孺	ruze
蕊	rvcx
汭	rvdn
蚋	rvin
锐	rvje
睿	rvlo
枘	rvmn
瑞	rvwe
润	rydw
闰	rymw
揉	rzfm
鞣	rzgm
糅	rzmm
柔	rzsm
蹂	rzzm
卅	saal
萨	saci
洒	sadx
撒	safw
靸	sagj
飒	salx
脎	saom
仨	sars
瘙	scbi
溞	scdi
搔	scfi
骚	scmi
嫂	scny
臊	scom
缫	scsg
埽	sctj
鳃	sdax
塞	sdbt
噻	sdkt
腮	sdox
塞	sebt
涩	sedv
穑	sehk
铯	sejb
啬	seuk
瑟	sewb
搡	shfm
嗓	shkm
丧	shun
桑	shym
肆	siay
死	sidb
㟃	siek
撕	sifj
私	sihs
厮	siij
锶	sijx
嘶	sikj
耜	silk
驷	sime
姒	sinr
祀	sips
斯	siqj
似	sirr
缌	sisx
思	sitx
饲	siuk
司	sivk
漦	siwu
三	sjae
糁	sjmp
伞	sjru
叁	sjss
馓	sjuw
蓑	socy
挲	sodu
锁	sojr
唆	sokw
梭	somw
睃	soow
缩	sosb
索	soux
琐	sowr
羧	soyw
蒜	srcx
狻	srqw
算	srvc
酸	sryw
宋	ssbm
菘	sscs
淞	ssds
嵩	ssek
㧐	ssfy
竦	sslu
松	ssms
怂	ssrx
忪	ssxs
讼	ssys
送	sszt
稣	suah
宿	subb
蔌	sucr
涑	sudu
素	sufx
甦	sugu
夙	sujd
嗉	sukx
俗	surk
肃	suvd
粟	suxm
酥	suyh
速	suzu
荽	svcn
濉	svdf
随	svez
髓	svgz
穗	svhx
祟	svix
虽	svki
眭	svot
绥	svsn
碎	svuu
璲	svwz
遂	svzu
荪	sycx
损	syfr
榫	symu
狲	syqx
隼	syru
笋	syvy
飧	syxl
孙	syzx
薮	szcw
溲	szdy
擞	szfw
螋	sziy
飕	szjy
嗖	szky
瞍	szoy
叟	szpy
馊	szuy
艘	szvy
鳎	taax
它	tabb
溻	tadx
拓	tafu
鞳	tagk
铊	tajb
嗒	takk
榻	tamx
她	tany
褟	tapx
獭	taqr
塌	tatx
沓	tauo
踏	tazo
萄	tccf
涛	tcdc
陶	tcef
掏	tcff
弢	tcgy
啕	tckf
桃	tcmd
绦	tcsm
韬	tcwj
慆	tcxj
讨	tcyc
逃	tczd
鲐	tdak
苔	tdck
汰	tddt
抬	tdfk
钛	tdjt
呔	tdkt
骀	tdmk
胎	tdok
台	tdsk
态	tdtx
酞	tdyt
跆	tdzk
铽	tejx
慝	tekx
特	tenc
忑	texx
忒	teyx
疼	tgbd
藤	tgcu
熥	tghz
誊	tgjk
腾	tgom
烫	thdh
搪	thfk
唐	thgk
螳	thit
镗	thjt
嘡	thkt
糖	thmk
帑	thnj
膛	thot
倘	thrk
趟	thtk
躺	thuk
瑭	thwk
堂	thxt
羰	thyh
蹚	thzt
鳀	tiar
剃	tibd
荑	ticy
涕	tidp
提	tifr
趯	titf
锑	tijp
啼	tikj
梯	timp
媞	tinr
题	tior
裼	tipw
倜	tirk
缇	tisr
屉	tiuu
悌	tixp
醍	tiyr
踢	tizw
瘫	tjbf
滩	tjdf
炭	tjeh
摊	tjff
弹	tjgl
郯	tjhe
叹	tjky
毯	tjmh
昙	tjos
袒	tjpd
贪	tjrr
坦	tjtd
碳	tjuh
璮	tjwd
覃	tjxu
谭	tjyu
葶	tkcd
汀	tkdd
挺	tkfz
庭	tkgz
烃	tkhg
厅	tkid
铤	tkjz
梃	tkmz
婷	tknd
停	tkrd
町	tktd
艇	tkvz
亭	tkwd
霆	tkyz
廷	tkzr
添	tmdx
掭	tmfx
钿	tmjt
田	tmku
阗	tmmb
腆	tmob
甜	tmqg
佃	tmrt
填	tmtb
恬	tmxk
鲦	tnam
窕	tnbd
苕	tnck
挑	tnfd
蜩	tnik
嬥	tnnf
眺	tnod
祧	tnpd
佻	tnrd
龆	tnvk
条	tnwm
跳	tnzd
橐	toam
萚	tocl
沱	todb
陀	toeb
拖	tofy
庹	togi
铊	tojb
唾	toki
驼	tomb
鸵	tonb
脱	tooe
妥	topn
佗	torb
坨	totb
砣	toub
箨	tovl
酡	toyb
跎	tozb
萜	tpck
餮	tpdl
铁	tpju
湍	trde
抟	trfv
煓	trhe
团	trkc
疃	trtl
彖	trvu
鲖	tsak
痛	tsby
茼	tsck
彤	tsdp
峂	tsed
捅	tsfy
铜	tsjk
嗵	tskz
童	tsll
桶	tsmy
㛚	tsny
瞳	tsol
侗	tsrk
统	tsse
垌	tstk
筒	tsvk
恸	tsxl
酮	tsyk
通	tszy
突	tubq
荼	tuch
涂	tudh
秃	tuhj
徒	tuir
钍	tujt
吐	tukt
凸	tula
腯	tuoo
堍	tutd
土	tuua
㻬	tuwk
酴	tuyh
途	tuzh
魋	tvgf
颓	tvhr
蜕	tvie
腿	tvoz
褪	tvpz
忒	tvyx
退	tvzg
忒	twyx
屯	tyav
囤	tykt
豚	tyou
吞	tytk
臀	tyuo
投	tzfy
骰	tzgy
偷	tzrd
透	tzzn
痧	uabu
莎	uacu
沙	uadu
厦	uaiw
铩	uajm
嗄	uakw
杉	uamp
歃	uaqr
傻	uarw
纱	uasu
砂	uauu
杀	uaxm
霎	uayn
勺	ucbd
苕	ucck
邵	ucde
捎	ucfo
鞘	ucgo
稍	ucho
哨	ucko
韶	uclk
梢	ucmo
睄	ucoo
绍	ucsk
艄	ucvo
少	ucxp
色	uddb
晒	udox
筛	udvj
酾	udyl
涉	uedp
摄	uefy
麝	uegc
蛇	ueib
赊	uekx
阇	uemo
社	uept
舌	ueqk
舍	uerk
赦	uetw
射	ueuc
慑	uexy
鲹	ufap
审	ufbu
莘	ufcu
沈	ufdv
蜃	ufii
哂	ufkx
申	ufll
糁	ufmp
婶	ufnu
胂	ufou
身	ufpp
甚	ufqv
什	ufru
参	ufsp
砷	ufuu
珅	ufwu
慎	ufxb
谂	ufyx
渑	ugdd
嵊	ugen
盛	ugim
牲	ugnu
胜	ugou
升	ugpc
剩	ugqd
绳	ugsd
声	ugup
笙	ugvu
圣	ugyt
殇	uhdp
熵	uhhk
晌	uhok
伤	uhrl
绱	uhsk
墒	uhtk
商	uhwk
尚	uhxk
十	uial
实	uibd
蓍	uico
湿	uidy
示	uiex
拾	uifk
轼	uiig
嗜	uiko
师	uilj
驶	uimu
始	uink
时	uioc
视	uipe
狮	uiqj
使	uirl
螫	uiti
蚀	uiui
尸	uivp
市	uiwj
恃	uixc
式	uiyg
适	uizk
鳝	ujak
单	ujbl
删	ujcd
汕	ujde
陕	ujej
擅	ujfd
扇	ujhx
蟮	ujik
赡	ujkk
闪	ujmr
姗	ujnc
膳	ujok
衫	ujpp
缮	ujsk
埏	ujtz
舢	ujve
珊	ujwc
善	ujyk
跚	ujzc
摔	ukfu
蟀	ukiu
甩	ukkv
衰	ukwy
爽	uldx
爽	uldx
孀	ulno
霜	ulyo
朔	uobo
蒴	uoco
搠	uofo
烁	uohl
铄	uojl
妁	uonu
硕	uour
说	uoye
涮	urdd
闩	urma
腨	uroe
束	uuan
薯	uuco
澍	uudc
隃	uued
抒	uufl
庶	uugh
黍	uuhu
输	uuid
鼠	uujv
赎	uukd
竖	uull
树	uumc
恕	uunx
暑	uuoo
舒	uurl
署	uuso
属	uuuy
书	uuvd
熟	uuwh
述	uuzu
税	uvhe
睡	uvoi
谁	uvyf
耍	uxen
唰	uxkd
刷	uxud
顺	uyir
吮	uyke
楯	uymo
瞬	uyol
舜	uypl
首	uzbz
授	uzfy
手	uzpl
狩	uzqc
售	uzrk
绶	uzsy
收	uzvw
熟	uzwh
鲊	vaav
痄	vabv
渣	vadd
揸	vafd
炸	vahv
轧	vaiv
铡	vajd
喳	vakd
榨	vamv
眨	vaof
乍	vapa
砟	vauv
劄	vavd
诈	vayv
齇	vazq
召	vcdk
兆	vced
招	vc0
肇	vchy
钊	vcjd
嘲	vcko
棹	vcmu
照	vcoh
爪	vcpn
罩	vcsu
赵	vctx
朝	vcuo
笊	vcvv
诏	vcyk
窄	vdbv
摘	vdfk
祭	vdpx
债	vdrr
斋	vdwe
翟	vdxf
蔗	vech
浙	vedj
折	vefj
鹧	vegn
辙	veiw
锗	vejo
啫	veko
者	velo
柘	vemu
褶	vepb
赭	veto
喆	veuk
谪	veyk
遮	vezh
臻	vfah
疹	vfbp
蓁	vfch
溱	vfdh
阵	vfei
振	vffn
稹	vfhb
轸	vfip
镇	vfjb
赈	vfkn
贞	vflr
枕	vfmv
朕	vfot
祯	vfpr
斟	vfqu
侦	vfrr
缜	vfsb
圳	vfti
砧	vfuk
箴	vfvk
珍	vfwp
甄	vfxw
震	vfyn
丁	vgal
郑	vgbe
蒸	vgch
争	vgdl
峥	vgel
挣	vgfl
征	vgiv
铮	vgjl
烝	vglh
睁	vgol
狰	vgql
整	vguv
政	vgvw
怔	vgxv
证	vgyv
丈	vhan
瘴	vhbu
涨	vhdi
障	vheu
张	vhgi
蟑	vhiu
帐	vhji
账	vhki
章	vhlu
樟	vhmu
嫜	vhnu
胀	vhoi
獐	vhqu
仗	vhrv
璋	vhwu
掌	vhxu
至	viat
旨	vibo
芝	vicv
治	vidk
职	vieb
指	vifo
秩	vihu
咫	viib
帜	vijb
吱	viky
止	vila
枝	vimy
脂	vioo
制	vipd
值	virq
纸	visu
址	vitv
知	viuk
彘	vivb
忮	vixy
识	viyb
踯	vize
鳣	vjad
蘸	vjch
沾	vjdk
崭	vjej
搌	vjfn
斩	vjij
盏	vjjm
站	vjlk
粘	vjmk
瞻	vjok
偡	vjrv
绽	vjsr
展	vjun
颤	vjwr
谵	vjyk
拽	vkfy
壮	vldu
撞	vlfl
庄	vlgt
幢	vljl
桩	vlmt
奘	vlpd
僮	vlrl
奘	vlpd
茁	voci
浊	vodi
捉	vofr
灼	vohu
镯	voji
啄	vokn
卓	volu
椓	vomn
晫	voou
禚	voph
倬	voru
缴	vosw
斫	vouj
琢	vown
酌	voyu
专	vrad
沌	vrdt
颛	vrer
撰	vrfb
转	vriv
赚	vrkn
䏝	vrov
传	vrrv
砖	vruv
篆	vrvu
冢	vsbn
种	vshv
钟	vsjv
柊	vsmd
肿	vsov
重	vspa
众	vsrr
终	vssd
忠	vsvx
衷	vswy
踵	vszv
著	vuco
注	vudv
拄	vufv
竹	vupl
烛	vuhi
蛛	vuiv
铸	vujc
嘱	vuky
煮	vulh
柱	vumv
朱	vupw
瞩	vuoy
祝	vupe
猪	vuqo
住	vurv
纻	vusa
筑	vuvf
珠	vuwv
诸	vuyo
逐	vuzu
坠	vvet
赘	vvfr
锥	vvjf
椎	vvmf
隹	vvrf
缀	vvsy
惴	vvxe
追	vvzk
这	vwzw
髽	vxat
爪	vxpn
屯	vyav
准	vydf
衠	vyii
肫	vyot
谆	vyyz
宙	vzby
荮	vzcc
州	vzdl
帚	vzej
粥	vzgg
轴	vziy
咒	vzkj
骤	vzmn
妯	vzny
肘	vzoc
舟	vzpd
㑇	vzre
绉	vzse
碡	vzum
籀	vzvt
㤘	vzxe
诌	vzye
瓦	waad
窊	wabg
洼	wadt
蛙	wait
哇	wakt
凹	wala
娃	want
腽	waom
袜	wapm
佤	warw
畖	watg
歪	wdbv
崴	wden
鳁	wfam
瘟	wfbm
芠	wfcw
温	wfdm
稳	wfhx
蚊	wfiw
吻	wfkw
闻	wfme
璺	wfpy
纹	wfsw
文	wfwx
雯	wfyw
瓮	wgbw
蓊	wgcx
嗡	wgkx
王	what
汪	whdw
魍	whgw
往	whiv
网	whkx
枉	whmw
旺	whow
望	whww
惘	whxw
万	wjap
皖	wjbe
莞	wjce
湾	wjdg
顽	wjer
挽	wjfv
烷	wjhe
蜿	wjiv
婉	wjnv
晚	wjov
丸	wjpd
纨	wjsw
畹	wjtv
碗	wjuv
玩	wjwe
惋	wjxv
窝	wobn
莴	wocn
沃	wody
挝	wofz
卧	woib
幄	wojt
喔	wokt
肟	wook
我	wopd
倭	worn
斡	wouu
龌	wovt
踒	wozn
五	wuaa
勿	wubp
芜	wucw
污	wudk
屼	wuew
捂	wufk
巫	wugr
焐	wuhk
蜈	wuit
钨	wujw
吴	wukt
梧	wumk
物	wunw
晤	wuok
舞	wupl
伍	wurw
婺	wusn
圬	wutk
屋	wuut
毋	wuva
务	wuwl
悟	wuxk
误	wuyt
迕	wuzw
未	wwan
痿	wwbn
薇	wwcw
危	wwdv
巍	wweg
委	wwhn
微	wwiw
帷	wwjf
味	wwkw
闱	wwmw
娓	wwnm
韪	wwow
猥	wwqn
伟	wwrw
维	wwsf
胃	wwto
尾	wwum
卫	wwea
威	wwxn
威	wwxn
谓	wwyo
违	wwzw
芯	xbcx
心	xbdd
炘	xbhj
锌	xbju
辛	xblu
昕	xboj
囟	xbpx
信	xbrk
馨	xbuo
衅	xbxb
䜣	xbyj
西	xiaa
兮	xibv
昔	xico
洗	xide
隙	xiex
席	xigj
稀	xihj
徙	xiir
锡	xijw
吸	xikj
袭	xily
析	ximj
媳	xinx
膝	xiou
夕	xipd
翕	xirx
细	xist
喜	xiuk
习	xivd
希	xixj
戏	xiyg
息	xizx
荇	xkci
陉	xkeg
擤	xkfl
形	xkkp
杏	xkmk
姓	xknu
星	xkou
猩	xkqu
幸	xktg
省	xkuo
性	xkxu
醒	xkyu
巷	xlcs
象	xldn
降	xlel
项	xlgr
香	xlho
厢	xlio
镶	xljy
响	xlkk
相	xlmo
向	xlpk
像	xlrn
饷	xluk
乡	xlvp
享	xlwz
飨	xlxl
详	xlyy
鲜	xmay
宪	xmbe
藓	xmcy
冼	xmde
限	xmeg
掀	xmfr
弦	xmgy
衔	xmii
铣	xmje
见	xmke
贤	xmlr
闲	xmmm
嫌	xmnn
显	xmoy
祆	xmpt
县	xmqs
仙	xmre
线	xmsj
献	xmuq
舷	xmvy
现	xmwe
咸	xmxk
羡	xmyr
跹	xmzz
宵	xnbo
萧	xncs
消	xndo
崤	xneo
魈	xngo
蛸	xnio
销	xnjo
啸	xnks
孝	xnlz
校	xnmx
晓	xnow
枭	xnpm
绡	xnso
硝	xnuo
箫	xnvs
效	xnww
肖	xnxo
霄	xnyo
逍	xnzo
鲑	xpat
写	xpby
薤	xpcj
泄	xpdu
携	xpfn
鞋	xpgt
燮	xphy
蝎	xpiv
叶	xpku
械	xpmc
歇	xpor
血	xppm
獬	xpqn
斜	xpru
绁	xpsu
协	xpub
卸	xppe
懈	xpxn
谢	xpyc
邂	xpzn
髹	xqam
宿	xqbb
溴	xqdq
岫	xqey
庥	xqgm
秀	xqhn
锈	xqjn
嗅	xqkq
朽	xqmv
袖	xqpy
休	xqrm
绣	xqsn
馐	xqui
貅	xqvm
琇	xqwn
羞	xqyi
臭	xqzq
宣	xrbg
萱	xrcg
渲	xrdg
旋	xrfr
炫	xrhy
轩	xrig
铉	xrjy
喧	xrkg
楦	xrmg
眩	xroy
禤	xrpx
悬	xrqx
儇	xrry
绚	xrso
碹	xrug
玄	xrwy
愃	xrxg
匈	xsbk
芎	xscg
汹	xsdk
兄	xske
胸	xsok
熊	xssh
雄	xsuf
凶	xsxk
讻	xsyk
鳕	xtae
穴	xtbb
薛	xtcu
踅	xtfr
靴	xtgb
噱	xtku
血	xtpm
削	xtxd
雪	xtye
戌	xuwa
蓄	xuct
溆	xudy
砉	xufu
序	xugl
虚	xuhy
徐	xuih
旭	xujo
嘘	xuky
栩	xumx
婿	xuno
煦	xuoh
须	xupr
叙	xury
续	xusd
墟	xuty
胥	xuvo
畜	xuwt
恤	xuxx
许	xuyw
夏	xxaw
峡	xxej
罅	xxfh
黠	xxhk
虾	xxix
吓	xxkx
瞎	xxok
狭	xxqj
侠	xxrj
硖	xxuj
叚	xxvy
瑕	xxwy
霞	xxyy
遐	xxzy
鲟	xyac
旬	xybo
薰	xych
殉	xydo
寻	xyec
循	xyio
勋	xykl
驯	xymi
曛	xyoh
熏	xyph
獯	xyqh
巽	xysb
埙	xytr
珣	xywo
讯	xyyu
迅	xyzu
牙	yaap
丫	yabl
芽	yacy
涯	yadt
崖	yaet
押	yafj
压	yaid
鸭	yajn
呀	yaky
桠	yamy
娅	yany
睚	yaot
氩	yaqy
伢	yary
垭	yaty
砑	yauy
琊	yawe
雅	yayf
迓	yazy
䲟	ybae
瘾	ybbx
荫	ybco
淫	ybdr
阴	ybeo
引	ybgl
蚓	ybiy
银	ybjg
吟	ybkv
音	yblo
訚	ybmk
姻	ybnd
印	ybpe
狺	ybqk
垠	ybtg
饮	ybur
尹	ybvp
珢	ybwg
夤	ybxb
霪	ybyr
尧	ycaw
窑	ycbf
药	yccu
崾	ycen
摇	ycff
靿	ycgl
徭	ycif
钥	ycjo
咬	yckx
杳	ycmo
妖	ycny
腰	ycon
夭	ycpd
侥	ycrw
约	ycsu
幺	ycvs
瑶	ycwf
耀	ycxf
谣	ycyf
邀	yczw
页	year
爷	yebe
液	yedn
耶	yeee
揶	yefe
烨	yehu
靥	yeim
铘	yeje
叶	yeku
业	yela
椰	yeme
腋	yeon
馌	yeum
也	yevv
夜	yewn
邺	yeye
痒	yhby
洋	yhdy
阳	yheo
扬	yhfp
鞅	yhgy
秧	yhhy
徉	yhiy
飏	yhjp
咉	yhky
央	yhlg
杨	yhmp
旸	yhop
氧	yhqy
仰	yhre
玚	yhwp
怏	yhxy
养	yhyl
夷	yian
益	yibm
艺	yicv
溢	yidm
屹	yieq
抑	yife
移	yihx
役	yiiy
镒	yijm
咦	yiky
毅	yily
椅	yimk
姨	yiny
易	yiow
祎	yipw
猗	yiqk
依	yiry
异	yisc
圯	yits
壹	yiua
已	yivv
亦	yiwd
翼	yixb
议	yiyy
遗	yizr
宴	yjbn
芫	yjce
演	yjdb
岩	yjeu
艳	yjfb
烟	yjhd
颜	yjir
鼹	yjjn
咽	yjkd
验	yjma
燕	yjnh
腌	yjod
殷	yjpy
俨	yjry
罨	yjsd
盐	yjtm
研	yjuk
筵	yjvz
言	yjwk
恹	yjxq
严	yjyp
延	yjzv
颖	ykbr
英	ykcy
瀛	ykdf
撄	ykfn
鹰	ykgn
蝇	ykid
婴	ykkn
樱	ykmn
盈	yknm
影	ykop
缨	yksn
硬	ykug
赢	ykwf
迎	ykze
哟	yoku
冤	yrbd
苑	yrcv
源	yrdx
院	yree
援	yrfy
原	yrix
员	yrkr
橼	yrmu
媛	yrny
爰	yrpy
猿	yrqy
缘	yrsu
袁	yrty
箢	yrvv
瑗	yrwy
怨	yrxx
鸢	yryn
远	yrze
鳙	ysal
痈	ysby
永	ysdn
拥	ysfy
庸	ysgl
蛹	ysiy
镛	ysjl
咏	ysky
栐	ysmy
臃	ysof
佣	ysry
勇	yssl
墉	ystl
邕	ysvb
雍	yswf
慵	ysxl
颙	ysyr
踊	yszy
瀹	ytdc
爚	ythc
钺	ytjv
曰	ytka
阅	ytme
刖	ytod
乐	ytpd
岳	ytqe
龠	ytrc
约	ytsu
越	yttv
籥	ytvc
玥	ytwo
悦	ytxe
说	ytye
跃	ytzy
于	yual
宇	yuby
芋	yucy
鱼	yuda
屿	yuey
揄	yufd
庾	yugy
虞	yuht
御	yuie
喻	yukd
禺	yuld
驭	yumy
娱	yunt
昱	yuol
禹	yupd
狱	yuqq
余	yurh
预	yusr
域	yuta
郁	yuue
聿	yuvl
玉	yuwd
羽	yuxx
语	yuyk
遇	yuzy
匀	yybd
芸	yycs
殒	yydr
陨	yyer
郧	yyke
韵	yyld
孕	yynz
晕	yyoi
氲	yyqm
允	yyse
熨	yyuh
筠	yyvd
韫	yywm
酝	yyys
运	yyzs
鱿	yzay
疣	yzby
莜	yzcw
游	yzdz
幽	yzey
黝	yzhl
蝣	yziz
铀	yzjy
呦	yzkl
由	yzla
柚	yzmy
祐	yzpk
犹	yzqy
优	yzry
右	yzuk
又	yzvn
忧	yzxy
诱	yzyn
扎	zafv
杂	zajm
咂	zakj
臜	zaor
砸	zauj
枣	zcad
皂	zcbq
藻	zccm
澡	zcdm
灶	zcht
蚤	zcii
噪	zckm
糟	zcmo
早	zcou
璪	zcwm
凿	zcyk
造	zczk
再	zdar
灾	zdbh
崽	zdex
仔	zdrz
载	zdui
甾	zdvt
泽	zedl
责	zefr
仄	zeir
帻	zejr
啧	zekr
昃	zeor
笮	zevv
迮	zezv
怎	zfvx
谮	zfyo
曾	zgbo
锃	zgjw
赠	zgko
缯	zgso
矰	zguo
憎	zgxo
臧	zhwi
葬	zhcc
赃	zhkt
驵	zhmq
脏	zhot
奘	zhpd
奘	zhpd
臧	zhwi
鲻	ziat
兹	ziby
茈	zicb
资	zidr
嵫	ziey
秭	zihp
辎	ziit
锱	zijt
吱	ziky
耔	zilz
梓	zimu
姊	zinp
眦	ziob
自	zipo
仔	zirz
缁	zist
趑	zitr
子	ziva
鄑	ziye
孜	zizw
寁	zjbr
攒	zjfr
暂	zjio
咱	zjkz
糌	zjmo
赞	zjnr
趱	zjtr
簪	zjvo
瓒	zjwr
阼	zoev
撮	zofy
座	zogt
嘬	zoky
柞	zomv
昨	zoov
祚	zopv
作	zorv
左	zoug
笮	zovv
琢	zown
怍	zoxv
酢	zoyv
攥	zrfx
钻	zrjk
赚	zrkn
缵	zrsr
纂	zrvx
躜	zrzr
鬃	zsax
宗	zsbx
棕	zsmx
腙	zsox
偬	zsrx
纵	zssr
踪	zszx
菹	zucq
阻	zueq
族	zufu
租	zuhq
足	zukr
祖	zupq
俎	zurq
组	zusq
卒	zuwu
诅	zuyq
蕞	zvcy
嘴	zvky
槜	zvmn
最	zvoy
罪	zvsf
觜	zvvy
醉	zvyu
鲗	zwad
贼	zwku
鳟	zyac
尊	zybc
嶟	zyec
撙	zyfc
噂	zykc
樽	zymc
遵	zyzc
鲰	zzay
邹	zzde
陬	zzey
奏	zzft
驺	zzme
诹	zzyy
鸨	bcbn
龅	bcvs
璧	biuy
槟	bkmb
煸	bmhc
辨	bmlu
膻	djod
箪	djvl
簟	dmvu
汾	ffdd
钒	fjjf
梵	fjmf
矾	fjuf
敷	fufw
蜉	fuiz
脯	fuof
凫	fupj
俯	furc
弗	fu0
槁	gcmk
阁	gemk
汞	gsgu
枸	gzmk
濠	hcdu
涸	hedk
嗬	hekk
恍	hlxw
奂	hrdd
泓	hsds
斛	hudu
烩	hvhs
骅	hxmu
馇	iaud
怅	ihxi
蚩	iivi
忡	isxv
蜍	iuih
巾	jbll
矜	jbsv
蓟	jicd
奇	jidk
觊	jiee
嵇	jihe
骥	jimb
系	jipx
继	jisv
戟	jiug
笈	jivj
玑	jiwj
计	jiyu
靖	jklo
腈	jkoo
憬	jkxx
煎	jmbh
溅	jmdj
监	jmlm
槛	jmmm
僭	jmro
戬	jmyg
醮	jnyh
诘	jpyk
疚	jqbj
苣	jucj
飓	jujb
驹	jumk
惧	juxb
遽	juzu
镓	jxju
咯	kakk
贶	klke
喇	lakd
吏	lian
荔	licl
厘	liil
鹂	liln
骊	liml
俚	lirl
蠡	livi
璃	liwd
泠	lkds
囹	lkks
羚	lkys
粱	lldm
骝	lqmt
麋	migm
沔	mmdm
眄	mmom
蘑	mocu
摩	mogu
苜	muco
媒	mwnm
匏	pcds
莆	pucf
芑	qicj
漆	qidu
棋	qimb
祈	qipj
憩	qiqx
骞	qmbm
铅	qmjk
觫	sudu
燧	svhz
遢	tazx
嚏	tikr
拓	tofu
椭	tomo
桐	tsmk
厍	ueii
伸	ufru
绅	ufsu
裳	uhxy
舐	uiqu
虱	uivi
潸	ujdo
姝	uunv
倏	uurq
楂	vamd
蜇	vefi
拯	vgfa
筝	vgvl
汁	vidu
执	vifw
帙	viju
枳	vimb
祗	vipd
智	viuo
湛	vjdv
渚	vudo
株	vumv
诬	wuyr
葳	wwcn
畏	wwtn
浠	xidj
熄	xihx
嬉	xink
晞	xioj
奚	xipd
硒	xiux
庠	xlgy
岘	xmee
蚬	xmie
娴	xmnm
骁	xnmw
蟹	xpdi
谐	xpyb
谑	xtya
醺	xyyh
衙	yaii
讶	yayy
龈	ybvg
漾	yhdy
肄	yiby
沂	yidj
贻	yikk
翊	yilx
伊	yiry
彝	yivc
奕	yiwd
怡	yixk
淹	yjdd
衍	yjii
檐	yjmk
鄢	yjve
琰	yjwh
酽	yjyy
莹	ykcy
膺	ykgo
鹦	ykkn
楹	ykmm
嬴	ykwf
沅	yrde
鸳	yrxn
泳	ysdy
彧	yuad
萸	yucy
浴	yudk
鬻	yugl
圄	yukk
觎	yure
鹬	yusn
谀	yuyy
纭	yyss
尢	yzuv
渍	zidr
镞	zuju
阿	aaek
锕	aajk
啊	aakk
嗄	aakw
吖	aaky
腌	aaod
昂	ahoe
肮	ahoj
卬	ahpe
盎	ahym
癌	aibe
皑	aibj
蔼	aicv
艾	aicx
隘	aiem
叆	aiey
锿	aijy
嗌	aikm
哎	aikx
嗳	aiky
嫒	ainy
暧	aioy
爱	aipy
欸	aisr
埃	aitu
毐	aiuw
碍	aiuc
矮	aiun
毐	aiuw
砹	aiux
瑷	aiwy
霭	aiyv
安	anbn
鹌	andn
岸	aneg
按	anfn
庵	angd
鞍	angn
黯	anho
唵	ankd
桉	anmn
胺	anon
暗	anoo
犴	anqg
氨	anqn
俺	anrd
盦	anrm
垵	antn
谙	anyo
奡	aoal
翱	aobx
澳	aodd
隩	aoed
鳌	aofa
聱	aofe
熬	aofh
螯	aofi
鏊	aofj
拗	aofl
骜	aofm
獒	aofq
敖	aofw
鏖	aogj
廒	aogw
嗷	aokw
凹	aola
媪	aonm
奥	aopd
袄	aopy
傲	aorw
坳	aotl
璈	aoww
懊	aoxd
遨	aozw
鲃	baab
鲅	baad
疤	babb
芭	bacb
菝	bacd
灞	bado
岜	baeb
扒	bafb
捌	bafd
靶	bagb
魃	bagd
蚆	baib
钯	bajb
叭	bakb
朳	bamb
妭	band
胈	baod
八	bapn
巴	basl
罢	bass
坝	batr
笆	bavb
巴	basl
羓	bayb
霸	bayo
跋	bazd
鬓	bbab
宾	bbbb
邠	bbbe
殡	bbdb
濒	bbdr
豳	bbeu
摈	bbfb
髌	bbgb
槟	bbmb
彬	bbmp
膑	bbob
傧	bbrb
缤	bbsb
玢	bbwd
斌	bbwv
鲍	bcas
刨	bcbd
包	bcbs
宝	bcby
薄	bccc
葆	bccm
苞	bccs
剥	bced
抱	bcfs
炮	bchs
枹	bcms
胞	bcos
曝	bcou
煲	bcrh
保	bcrm
堡	bcrt
饱	bcus
褒	bcwy
雹	bcys
孢	bczs
百	bdab
摆	bdfs
捭	bdfu
呗	bdkr
败	bdkw
柏	bdmb
白	bdpo
伯	bdrb
掰	bduu
本	bfaa
坌	bfbt
苯	bfcb
奔	bfdc
锛	bfjc
倴	bfrc
坋	bftd
贲	bfur
甭	bgby
崩	bgeo
蚌	bgif
镚	bgjo
嘣	bgko
祊	bgpf
绷	bgso
泵	bguu
甏	bguw
琫	bgwl
迸	bgzk
蹦	bgzo
蒡	bhcf
浜	bhdb
邦	bhfe
搒	bhff
帮	bhfj
镑	bhjf
梆	bhme
榜	bhmf
棓	bhmk
膀	bhof
绑	bhse
塝	bhtf
磅	bhuf
玤	bhwf
谤	bhyf
鲾	biat
觱	bixy
毖	bibb
邲	bibe
痹	bibl
坒	bibt
毕	bibu
蓖	bicb
薜	bicu
蔽	bicw
荸	bicz
泌	bidb
弊	bidc
濞	bidl
滗	bidm
敝	bidw
陛	biet
弼	bigg
髀	bigu
秘	bihb
彼	biiy
吡	bikb
鄙	bike
赑	bikr
哔	biku
妣	binb
婢	binu
币	bipj
裨	bipu
匕	bipv
狴	biqt
佖	birb
畀	bitl
嬖	biun
臂	biuo
贲	biur
壁	biut
篦	bivb
箅	bivl
筚	bivu
珌	biwb
觱	bixy
觱	bixy
鼻	bizl
逼	bizt
颁	bjbr
癍	bjbw
瘢	bjby
湴	bjdy
拌	bjfb
扮	bjfd
扳	bjfy
靽	bjgb
钣	bjjy
办	bjld
柈	bjmb
昄	bjoy
版	bjpy
伴	bjrb
绊	bjsb
斑	bjww
病	bkbb
邴	bkbe
摒	bkfk
炳	bkhb
蛃	bkib
昺	bkob
秉	bkpn
兵	bkqb
屏	bkuk
禀	bkwx
鳊	bmac
苄	bmcb
萹	bmcc
汴	bmdb
卞	bmdx
抃	bmfb
蝙	bmic
匾	bmkc
贬	bmkf
辫	bmlu
昪	bmoc
便	bmrg
弁	bmsc
碥	bmuc
变	bmwy
边	bmzl
鳔	bnax
瘭	bnbx
藨	bnch
蔈	bncx
瀌	bndh
摽	bnfx
表	bnfy
彪	bnhp
熛	bnhx
镳	bnjh
飑	bnjs
杓	bnmu
骠	bnmx
膘	bnox
脿	bnoy
裱	bnpy
飙	bnqx
儦	bnrh
俵	bnry
鲌	boab
僰	boar
帛	bobj
薄	bocc
蕃	boct
菠	bocy
泊	bodb
渤	bodl
波	body
剥	boed
嶓	boet
搏	bofc
拨	bofd
播	boft
馞	bohz
钵	bojb
镈	bojc
钹	bojd
啵	boky
哱	bokz
卜	bold
柏	bomb
欂	bomc
驳	bomx
桲	bomz
膊	booc
脖	booz
袯	bopd
伯	borb
砵	boub
礴	bouc
勃	boul
檗	boum
鹁	boun
擘	bouu
饽	bouz
舶	bovb
簿	bovc
簸	bovy
亳	bowq
玻	bowy
踣	bozk
跛	bozy
瘪	bpbb
鳖	bpda
蹩	bpdr
憋	bpdx
别	bpkd
不	buad
卟	bukb
晡	buof
堡	burt
埔	butf
簿	buvc
步	buvp
怖	buxj
醭	buyn
逋	buzf
蓓	bwck
陂	bwey
辈	bwfi
悲	bwfx
庳	bwgu
鞴	bwgy
焙	bwhk
钡	bwjr
贝	bwkr
北	bwlb
背	bwlo
杯	bwmb
椑	bwmu
糒	bwmy
卑	bwpu
被	bwpy
倍	bwrk
鐾	bwuj
碚	bwuk
臂	bwuo
备	bwwt
惫	bwwx
擦	cafx
嚓	cakx
曹	ccao
草	cccu
操	ccfm
螬	ccio
嘈	ccko
槽	ccmo
糙	ccmz
艚	ccvo
才	cdap
菜	cdcm
蔡	cdcx
财	cdkc
睬	cdom
采	cdpm
彩	cdpp
猜	cdqo
偲	cdrx
裁	cduy
踩	cdzm
测	cedd
厕	ceid
册	cepa
侧	cerd
策	cevn
恻	cexd
涔	cfdv
岑	cfev
参	cfsp
曾	cgbo
嶒	cgeo
噌	cgko
层	cgus
蹭	cgzo
藏	chci
沧	chdv
鸧	chrn
伧	chrv
舱	chvv
刺	ciad
疵	cibb
鹚	cibn
慈	cibx
兹	ciby
茈	cicb
莿	cicd
茨	cicr
泚	cidb
瓷	cidw
呲	cikb
赐	cikw
糍	cimy
伺	cirk
佽	cirr
磁	ciuy
此	civb
雌	civf
玼	ciwb
差	ciyg
跐	cizb
掺	cjfp
黪	cjhp
餐	cjll
粲	cjlm
骖	cjmp
参	cjsp
蚕	cjti
孱	cjuz
璨	cjwm
惭	cjxj
瘥	cobg
痤	cobt
莝	coct
嵯	coeg
措	cofo
挫	coft
撮	cofy
厝	coio
错	cojo
鹾	colg
酂	cone
脞	coot
磋	coug
矬	cout
瑳	cowg
蹉	cozg
窜	crbi
撺	crfi
攒	crfr
酂	crne
爨	crph
篡	crvs
蹿	crzi
苁	cscr
葱	cscx
淙	csdx
聪	csex
枞	csmr
骢	csmx
囱	cspw
丛	csra
从	csrr
璁	cswx
悰	csxx
蹙	cuwr
殂	cudq
徂	cuiq
粗	cumq
猝	cuqu
促	curr
簇	cuvu
蹙	cuwr
醋	cuyo
酢	cuyv
蹴	cuzy
瘁	cvbu
漼	cvdf
淬	cvdu
崔	cvef
摧	cvff
啐	cvku
粹	cvmu
榱	cvmy
脆	cvov
催	cvrf
缞	cvsy
衰	cvwy
悴	cvxu
寸	cyad
村	cymc
皴	cysy
邨	cyte
存	cyuz
忖	cyxc
凑	czdt
辏	czit
腠	czot
荙	dacz
耷	dade
打	dafd
搭	dafk
靼	dagd
炟	dahd
嗒	dakk
大	daun
沓	dauo
笪	davd
答	davk
怛	daxd
跶	dazz
到	dcad
捯	dcfd
捣	dcfe
焘	dcfh
纛	dcfx
帱	dcjc
叨	dckd
祷	dcpc
岛	dcpe
倒	dcrd
导	dcsc
舠	dcvd
刀	dcvp
忉	dcxd
蹈	dczj
歹	ddax
叇	ddez
待	ddic
轪	ddid
呆	ddkm
呔	ddkt
岱	ddre
黛	ddrh
贷	ddrr
垈	ddrt
傣	ddru
袋	ddry
绐	ddsk
怠	ddsx
埭	ddtn
戴	ddub
大	ddun
玳	ddwy
迨	ddzk
逮	ddzn
得	deic
德	deix
锝	dejc
嘚	dekc
地	dety
扽	dfft
嶝	dgea
灯	dghd
镫	dgja
噔	dgka
瞪	dgoa
戥	dgog
磴	dgua
登	dgva
凳	dgvj
璒	dgwa
邓	dgye
蹬	dgza
荡	dhcp
菪	dhcu
挡	dhfe
铛	dhje
裆	dhpe
垱	dhte
凼	dhuk
砀	dhup
珰	dhwe
当	dhxe
髢	diay
弟	dibp
荻	dich
蒂	dicj
菂	dicu
邸	dide
滴	didk
抵	difd
提	difr
骶	digd
鞮	digr
镝	dijk
嘀	dikk
柢	dimd
棣	dimn
媂	dinj
嫡	dink
娣	dinp
睇	diop
狄	diqh
敌	diqw
低	dird
籴	dirm
坻	ditd
堤	ditr
地	dity
砥	diud
觌	diue
碲	diuj
䃅	diul
第	divp
笛	divy
翟	dixf
诋	diyd
蹢	dizk
递	dizp
踶	dizr
迪	dizy
石	djak
疸	djbd
郸	djbe
瘅	djbl
萏	djcj
殚	djdl
聃	djer
耽	djev
担	djfd
掸	djfl
赕	djkh
旦	djoa
眈	djov
丹	djpa
氮	djqh
但	djrd
儋	djrk
疍	djvd
亶	djwd
憺	djxk
丁	dkal
疔	dkbd
定	dkbr
萣	dkcr
耵	dked
钉	dkjd
锭	dkjr
铤	dkjz
叮	dkkd
啶	dkkr
盯	dkod
腚	dkor
鼎	dkov
仃	dkrd
町	dktd
碇	dkur
玎	dkwd
酊	dkyd
奠	dmbd
癫	dmbr
甸	dmbt
癜	dmby
滇	dmdb
淀	dmdr
阽	dmek
巅	dmer
掂	dmfk
靛	dmfr
垫	dmft
店	dmgk
扂	dmhk
钿	dmjt
典	dmlb
点	dmlh
电	dmlv
佃	dmrt
坫	dmtk
碘	dmub
颠	dmur
玷	dmwk
琔	dmwr
踮	dmzk
鲷	dnak
窎	dnbn
掉	dnfu
铫	dnjd
铞	dnjj
叼	dnkd
雕	dnkf
吊	dnkj
鸟	dnwd
碉	dnuk
貂	dnvk
鸟	dnwd
调	dnyk
堕	doet
掇	dofy
度	dogy
剁	dojd
铎	dojl
咄	doki
哚	dokm
哆	dokx
柁	domb
杕	domd
裰	dopy
埵	doti
㙍	doty
躲	doum
舵	dovb
亸	dowl
惰	doxo
剟	doyd
跺	dozm
踱	dozy
鲽	dpam
爹	dpbx
瓞	dpgu
蝶	dpim
喋	dpkm
耋	dplt
楪	dpmm
䏲	dpop
昳	dpou
绖	dpst
堞	dptm
垤	dptt
碟	dpum
谍	dpym
叠	dpyq
蹀	dpzm
跌	dpzu
铥	dqjs
丢	dqps
耑	dree
锻	drjy
椴	drmy
段	drpy
缎	drsy
塅	drty
短	drua
簖	drvj
瑖	drwy
东	dsad
董	dscv
冻	dsdd
洞	dsdk
鸫	dsdn
岽	dsed
峒	dsek
动	dsel
胨	dsod
胴	dsok
氡	dsqd
侗	dsrk
硐	dsuk
冬	dswd
恫	dsxk
懂	dsxv
芏	duct
渎	dudd
毒	dufm
髑	dugi
镀	dujy
嘟	duke
赌	duko
椟	dumd
杜	dumt
犊	dund
睹	duoo
肚	duot
堵	duto
顿	dutr
督	duuo
笃	duvm
厾	duvs
兑	dvbe
队	dver
镦	dvjw
祋	dvpy
堆	dvtf
碓	dvuf
对	dvyc
得	dwic
嘚	dwkc
嗲	dxkx
沌	dydt
炖	dyht
囤	dykt
楯	dymo
盹	dyot
盾	dypo
顿	dytr
墩	dytw
砘	dyut
礅	dyuw
趸	dywr
惇	dyxz
蹲	dyzc
遁	dyzo
豆	dzaa
痘	dzba
窦	dzbd
兜	dzbe
蔸	dzce
陡	dzer
蚪	dziu
钭	dzju
兜	dzbe
篼	dzve
读	dzyd
逗	dzza
鳄	eeak
额	eebr
萼	eeck
苊	eecv
莪	eecw
涐	eedw
阿	eeek
峨	eeew
扼	eefv
轭	eeiv
蛾	eeiw
锷	eejk
锇	eejw
鄂	eeke
鹗	eekn
颚	eekr
呃	eekv
哦	eekw
阏	eemd
婀	eenk
娥	eenw
腭	eeok
俄	eerw
堨	eetv
屙	eeuk
饿	eeuw
噩	eewk
鹅	eewn
讹	eeyb
谔	eeyk
垩	eeyt
恶	eeyx
遏	eezv
欸	eisr
蒽	encx
摁	enfx
恩	enkx
二	eraa
鲕	erae
而	eral
洱	erde
尔	erdx
陑	eree
鸸	eren
耏	erep
铒	erje
儿	erpv
佴	erre
饵	erue
珥	erwe
迩	erzx
乏	fapv
伐	farg
垡	fart
罚	fasd
砝	faus
发	favd
筏	favg
珐	faws
鲼	ffar
忿	ffbx
棻	ffcm
瀵	ffdb
奋	ffdt
鼢	ffjd
粪	ffmb
棼	ffmd
焚	ffmh
氛	ffqd
份	ffrd
坋	fftd
坟	fftw
豮	ffur
翂	ffxd
愤	ffxr
酚	ffyd
丰	fgal
疯	fgbx
葑	fgcc
沣	fgdf
沨	fgdx
崶	fgec
酆	fgee
峰	fgef
酆	fgee
烽	fghf
锋	fgjf
风	fgjx
凤	fgjy
赗	fgko
枫	fgmx
俸	fgrl
缝	fgsz
封	fgtc
堼	fgtt
砜	fgux
讽	fgyx
逢	fgzf
鲂	fhaf
芳	fhcf
方	fhdw
防	fhef
邡	fhfe
房	fhhf
钫	fhjf
牥	fhnf
昉	fhof
纺	fhsf
坊	fhtf
藩	fjct
范	fjcv
蘩	fjcx
泛	fjdf
燔	fjht
帆	fjjf
幡	fjjt
番	fjpt
繁	fjpx
反	fjpy
犯	fjqv
墦	fjtt
畈	fjty
饭	fjuy
璠	fjwt
蹯	fjzt
返	fjzy
佛	forf
鲋	fuac
甫	fuad
釜	fuba
宓	fubb
斧	fubj
匐	fubt
父	fubx
芣	fucb
苻	fucc
茀	fucf
芾	fucl
芾	fucl
茯	fucq
菔	fucy
莩	fucz
滏	fuda
涪	fudk
洑	fudq
负	fudr
㳇	fudx
浮	fudz
附	fuec
艴	fufb
拊	fufc
拂	fuff
鄜	fuge
腐	fugr
稃	fuhz
蚨	fuif
辐	fuit
蝮	fuiw
幞	fujn
幅	fujt
咐	fukc
呋	fukf
呒	fukw
孵	fulz
榑	fumc
桴	fumz
妇	fune
腑	fuoc
肤	fuof
腹	fuow
服	fuoy
郛	fupe
袱	fupq
福	fupt
阜	fupu
复	fupw
孚	fupz
氟	fuqf
傅	furc
伏	furq
俘	furz
罘	fusb
缚	fusc
绂	fusd
绋	fusf
赴	futb
符	fuvc
簠	fuvm
韨	fuwd
玞	fuwf
琈	fuwz
怫	fuxf
覆	fuxw
黻	fuyd
黼	fuyf
趺	fuzf
鲱	fwaf
菲	fwcf
芾	fwcl
芾	fwcl
淝	fwdb
沸	fwdf
剕	fwfd
蜚	fwfi
棐	fwfm
费	fwfr
翡	fwfx
扉	fwhf
镄	fwjr
啡	fwkf
吠	fwkq
非	fwla
肥	fwob
腓	fwof
朏	fwoi
肺	fwol
肺	fwol
狒	fwqf
绯	fwsf
飞	fwvd
篚	fwvf
悱	fwxf
霏	fwyf
否	fzbk
缶	fzwk
戛	gaag
夹	gaan
轧	gaiv
旮	gajo
钆	gajv
嘎	gakg
呷	gakj
咖	gakk
噶	gakv
尕	ganx
胳	gaok
伽	gark
尬	gayl
尜	gaxx
尬	gayl
皋	gcbu
藁	gccm
搞	gcfk
锆	gcjk
糕	gcmh
槔	gcmu
郜	gcne
告	gcnk
杲	gcom
睾	gcpg
缟	gcsk
筶	gcvk
高	gcwk
膏	gcwo
诰	gcyk
丐	gdav
荄	gdcr
溉	gddv
陔	gder
钙	gdjg
改	gdjw
赅	gdkr
概	gdmv
晐	gdor
垓	gdtr
该	gdyr
戈	gead
哥	geak
鬲	geal
歌	gear
割	gebd
疙	gebq
葛	gecv
哥	geak
滆	gedl
隔	geel
搁	gefk
骼	gegk
蛤	geik
虼	geiq
镉	gejl
咯	gekk
嗝	gekl
哿	gelk
革	genl
胳	geok
膈	geol
袼	gepk
合	gerk
个	gerl
鸽	gern
仡	gerq
颌	gerr
纥	gesq
塥	getl
圪	getq
饹	geuk
舸	gevk
各	gewk
盖	geym
亘	gfad
茛	gfcg
艮	gfen
哏	gfkg
根	gfmg
艮	gfen
跟	gfzg
鲠	ggag
更	ggan
浭	ggdg
耿	ggeh
鹒	gggn
赓	gggr
哽	ggkg
耕	gglj
梗	ggmg
暅	ggog
绠	ggsg
埂	ggtg
颈	ggvr
羹	ggyd
冮	ghdg
港	ghds
岗	ghex
扛	ghfg
刚	ghkd
冈	ghkx
戆	ghlx
㭎	ghmx
肛	ghog
罡	ghsv
纲	ghsx
鿍	ghtl
堽	ghtv
矼	ghug
甘	gjna
干	gjau
鳡	gjax
苷	gjcg
泔	gjdg
澉	gjdw
擀	gjfg
秆	gjhg
赣	gjlr
柑	gjmg
橄	gjmw
甘	gjna
旰	gjog
绀	gjsg
坩	gjtg
矸	gjug
尴	gjym
竿	gjvg
玕	gjwg
感	gjxx
感	gjxx
酐	gjyg
尴	gjym
拐	gkfl
乖	gkqb
夬	gkvn
怪	gkxt
广	gldi
洸	gldw
咣	glkw
桄	glmw
胱	glow
犷	glqg
垙	gltw
广	gldi
光	glxw
逛	glzw
涡	godn
聒	goek
崞	goez
掴	gofy
蝈	goiy
帼	gojy
呙	gokn
国	goky
果	goln
粿	gomg
椁	gomz
腘	gooy
埚	gotn
郭	gowe
裹	gowy
鳏	grad
鳤	grak
冠	grbc
关	grbt
蒄	grcc
鹳	grcn
灌	grdf
涫	grdk
掼	grfr
爟	grhf
贯	grvr
祼	grpg
盥	grpm
倌	grrk
纶	grsb
矜	grsv
馆	gruk
毌	grva
管	grvk
贯	grvr
瓘	grwf
琯	grwk
惯	grxr
观	grye
工	gsaa
宫	gsbk
公	gsbs
共	gscb
恭	gscx
觥	gsdw
拱	gsfb
巩	gsgf
功	gsgl
攻	gsgw
蚣	gsis
肱	gsos
供	gsrb
红	gssg
弓	gsvv
珙	gswb
鲴	guak
痼	gubk
菰	gucg
菇	guck
汩	gudo
瀔	gudy
崮	guek
鹘	gugn
雇	guhf
轱	guik
蛊	guim
顾	guir
锢	gujk
呱	gukg
咕	gukk
骨	gulo
梏	gumk
牯	gunk
臌	guoy
估	gurk
罟	gusk
堌	gutk
古	guuk
鸪	guun
瞽	guuo
辜	guuu
故	guuw
毂	guuy
箍	guvj
酤	guyk
羖	guyy
孤	guzg
鳜	gvar
鲑	gvat
宄	gvbj
皈	gvby
氿	gvdj
刿	gved
规	gvfe
鬶	gvfl
轨	gvij
匦	gvkj
柜	gvmj
桧	gvms
闺	gvmt
妫	gvnw
炅	gvoh
晷	gvok
鬼	gvps
刽	gvrd
邽	gvte
圭	gvtt
硅	gvut
簋	gvvm
贵	gvvr
筀	gvvt
瑰	gvwg
珪	gvwt
给	gwsk
寡	gxbd
挂	gxft
呱	gxkg
胍	gxog
褂	gxpb
瓜	gxpn
刮	gxqd
鸹	gxqn
卦	gxtb
坬	gxtg
诖	gxyt
鲧	gyax
滚	gydy
辊	gyib
棍	gymb
绲	gysb
衮	gywy
觏	gzae
勾	gzbs
够	gzbx
苟	gzck
岣	gzek
钩	gzjs
购	gzks
耇	gzlk
构	gzms
姤	gznk
媾	gznr
狗	gzqk
佝	gzrk
缑	gzsu
垢	gztk
彀	gzuy
笱	gzvk
篝	gzvr
诟	gzyk
遘	gzzr
蛤	haik
铪	hajk
哈	hakk
蒿	hcck
浩	hcdk
灏	hcdr
淏	hcdt
蚝	hcim
镐	hcjk
嚎	hcku
好	hcnz
颢	hcor
昊	hcot
侴	hcrd
郝	hcte
壕	hctu
貉	hcvk
鄗	hcwe
毫	hcwm
海	hddm
嗐	hdkk
嗨	hdkm
咳	hdkr
骇	hdmr
胲	hdor
氦	hdqr
亥	hdwr
醢	hdym
孩	hdzr
翮	heax
菏	heck
隺	hedf
鹤	hedn
和	hehk
盉	hehm
呵	hekk
喝	hekv
吓	hekx
贺	helr
壑	helt
阖	hemm
阂	hemr
鹖	heon
曷	heov
禾	hepm
褐	hepv
禾	hepm
郃	here
龢	herh
何	herk
盒	herm
颌	herr
纥	hesq
赫	hetd
垎	hetk
盍	hetm
饸	heuk
貉	hevk
龁	hevq
劾	hewl
痕	hfbg
很	hfig
狠	hfqg
恨	hfxg
蘅	hgci
行	hgii
鸻	hgin
哼	hgkl
横	hgmb
桁	hgmi
姮	hgng
珩	hgwi
亨	hgwl
恒	hgxg
巷	hhcs
沆	hhdj
夯	hhdl
吭	hhkj
绗	hhsi
颃	hhwr
寒	hjbd
罕	hjbg
蔊	hjcg
菡	hjck
汗	hjdg
涵	hjdk
瀚	hjdx
汉	hjdy
嵅	hjek
撖	hjfw
撼	hjfx
邗	hjge
顸	hjgr
焊	hjhg
焓	hjhk
虷	hjig
喊	hjkk
㘎	hjkw
函	hjlk
旱	hjog
晗	hjok
暵	hjon
犴	hjqg
含	hjrk
颔	hjrr
垾	hjtg
韩	hjuw
翰	hjux
憨	hjvx
琀	hjwk
悍	hjxg
憾	hjxx
酣	hjyg
鼾	hjzg
淮	hkdf
槐	hkmg
坏	hktb
踝	hkzg
鳇	hlaw
癀	hlbb
黄	hlcb
荒	hlcv
潢	hldb
滉	hldw
蟥	hlib
徨	hliw
幌	hljw
喤	hlkw
媓	hlnw
晃	hlow
簧	hlvb
篁	hlvw
璜	hlwb
肓	hlwo
慌	hlxv
惶	hlxw
遑	hlzw
劐	hocd
藿	hocf
获	hocq
活	hodk
火	hodr
濩	hody
彟	hoey
攉	hoff
或	hoga
夥	hogx
㸌	hohf
和	hohk
蠖	hoiy
钬	hojh
镬	hojy
嚯	hokf
嚄	hoky
耠	holk
祸	hopn
伙	horh
佸	hork
货	horr
霍	hoyf
鲩	hrae
鬟	hray
痪	hrbd
郇	hrbe
宦	hrbi
寰	hrby
荁	hrcg
萑	hrcf
洹	hrdg
浣	hrde
漶	hrdx
澴	hrdy
峘	hreg
换	hrfd
擐	hrfy
焕	hrhd
患	hrix
锾	hrjy
唤	hrkd
圜	hrky
桓	hrmg
嬛	hrny
㬊	hroy
獾	hrqf
鹮	hrsn
缳	hrsy
貆	hrvg
环	hrwb
幻	hryv
还	hrzb
逭	hrzk
谼	hsbb
訇	hsbk
宏	hsbs
薨	hscb
荭	hscg
洪	hsdb
鸿	hsdn
弘	hsgs
烘	hshb
虹	hsig
轰	hsiy
哄	hskb
吽	hskn
闳	hsms
红	hssg
纮	hsss
硔	hsub
玒	hswg
讧	hsyg
互	huaa
鳠	huay
葫	huco
瓠	hudg
滹	hudh
湖	hudo
浒	hudw
淴	hudx
岵	huek
弧	hugg
鹘	hugn
扈	huhb
和	huhk
煳	huho
戽	huhu
轷	huih
蝴	huio
呼	hukh
唬	hukj
囫	hukw
唿	hukx
糊	humo
核	humr
槲	humu
嫭	hunh
鹄	hunn
鹱	huny
昈	huoh
昒	huow
祜	hupk
乎	hupl
狐	huqg
猢	huqo
鹕	huun
壶	huuy
笏	huvw
琥	huwj
瑚	huwo
忽	huwx
惚	huxx
鄠	huye
醐	huyo
惠	hvax
茴	hvck
荟	hvcs
蕙	hvcx
洄	hvdk
堕	hvet
隳	hvex
彗	hvfe
挥	hvfi
慧	hvfx
麾	hvgm
蛔	hvik
徽	hviw
蟪	hvix
毁	hvjy
咴	hvkh
回	hvkk
贿	hvko
喙	hvku
哕	hvkx
桧	hvms
橞	hvmx
晖	hvoi
晦	hvom
袆	hvpw
绘	hvss
恚	hvtx
卉	hvuc
硊	hvuv
虺	hvwi
恢	hvxh
辉	hvxi
诙	hvyh
诲	hvym
讳	hvyw
嘿	hwkh
黑	hwlh
画	hxak
花	hxcb
觟	hxdt
砉	hxfu
哗	hxku
婳	hxnk
猾	hxqg
化	hxrb
华	hxru
话	hxyk
荤	hyci
混	hydb
浑	hydi
溷	hydu
魂	hyeg
阍	hymo
婚	hyno
馄	hyub
昏	hyuo
惛	hyxo
诨	hyyi
鲘	hzak
骺	hzgk
厚	hziz
喉	hzku
吼	hzkv
郈	hzpe
后	hzpk
垕	hzpt
猴	hzqu
侯	hzru
堠	hztu
篌	hzvu
鲎	hzxa
齁	hzzk
岔	iabe
察	iabx
茶	iacm
茬	iact
汊	iadi
嵖	iaed
搽	iafm
锸	iajj
喳	iakd
嚓	iakx
楂	iamd
槎	iamg
杈	iami
檫	iamx
姹	ianq
衩	iapi
猹	iaqd
侘	iarq
垞	iatq
刹	iaxd
叉	iayd
差	iayg
诧	iayq
蹅	iazd
弨	icgk
焯	ichu
钞	icju
嘲	icko
晁	icod
朝	icuo
剿	icvd
瘥	idbg
茝	idcl
拆	idfi
侪	idrl
豺	idvc
柴	idvm
虿	idwi
差	idyg
车	ieal
澈	iedw
扯	iefv
彻	ieid
㬚	ieow
掣	iepu
坼	ieti
疢	ifbh
宸	ifbn
沉	ifdj
陈	ifed
称	ifhx
辰	ifin
嗔	ifkb
臣	ifkl
郴	ifme
梣	ifmv
瞋	ifob
晨	ifon
伧	ifrv
趁	iftp
碜	ifup
龀	ifvb
琛	ifwm
尘	ifxt
忱	ifxv
谶	ifyj
谌	ifyv
宬	igbi
澄	igda
澂	igdw
庱	iggw
秤	ighp
程	ighw
称	ighx
盛	igim
蛏	igit
惩	igix
铛	igje
呈	igkw
丞	igla
橙	igma
枨	igmi
柽	igmt
骋	igmv
晟	igoi
塍	igot
裎	igpw
乘	igqn
偁	igrr
城	igti
赪	igtr
埕	igtw
承	igvn
珹	igwi
琤	igwl
成	igwv
憕	igxa
牚	igxy
酲	igyw
逞	igzw
鲳	ihao
厂	ihap
鲿	ihas
菖	ihco
唱	ihko
阊	ihmo
嫦	ihnj
娼	ihno
昌	ihoo
肠	ihop
猖	ihqo
伥	ihri
倡	ihro
偿	ihrs
场	ihtp
畅	ihup
鬯	ihxb
常	ihxj
惝	ihxk
尝	ihxs
敞	ihxw
裳	ihxy
昶	ihyo
豉	iiay
痴	iibk
痓	iibt
瘛	iibx
耻	iiev
持	iifc
摛	iifd
魑	iigd
弛	iigy
炽	iihb
螭	iiid
叱	iikb
哧	iikd
嗤	iiki
吃	iikq
驰	iimy
媸	iini
匙	iiob
眵	iiox
胣	iioy
斥	iipd
褫	iipj
彳	iipr
佁	iirk
傺	iirx
坻	iitd
墀	iitn
饬	iiul
尺	iiun
敕	iiuw
翅	iiux
篪	iivj
笞	iivk
啻	iiwk
瓻	iixw
踟	iizk
单	ijbl
冁	ijbn
蒇	ijcr
澶	ijdd
瀍	ijdt
巉	ijed
搀	ijfd
掺	ijfp
韂	ijgk
廛	ijgt
蟾	ijik
蝉	ijil
镵	ijjd
镡	ijju
觇	ijle
产	ijlp
阐	ijml
骣	ijmz
婵	ijnl
旵	ijoe
儳	ijrd
缠	ijsl
羼	ijuy
孱	ijuz
颤	ijwr
忏	ijxq
谗	ijyd
辿	ijze
躔	ijzt
揣	ikfe
搋	ikfj
啜	ikky
踹	ikze
疮	ilbv
窗	ilbw
床	ilgm
幢	iljl
创	ilrd
怆	ilxv
辍	ioiy
啜	ioky
绰	iosu
龊	iovr
戳	ioxg
惙	ioxy
逴	iozu
钏	irji
圌	irke
串	irll
椽	irmu
川	irpl
传	irrv
堾	irto
船	irvk
舛	irxl
遄	irze
宠	isbl
㳘	isde
冲	isdv
漴	isdx
涌	isdy
崇	isex
铳	isje
重	ispa
虫	isvd
珫	iswe
翀	isxv
亍	iuad
刍	iude
雏	iudf
滁	iudh
濋	iudr
除	iueh
亍	iuad
摴	iufk
搐	iuft
黜	iuhi
厨	iuic
䢺	iuie
橱	iumc
柷	iume
楚	iumr
杵	iumw
褚	iupo
储	iuro
俶	iury
矗	iuuq
出	iuvk
䝙	iuvx
处	iuwb
畜	iuwt
琡	iuwy
憷	iuxr
蹰	iuzc
躇	iuzo
陲	ivei
捶	ivfi
炊	ivhr
锤	ivji
圌	ivke
吹	ivkr
椎	ivmf
棰	ivmi
垂	ivpa
倕	ivri
欻	ixhr
䲠	iyao
莼	iyct
蠢	iyfi
春	iyfo
唇	iyik
蝽	iyio
椿	iymo
纯	iyst
瑃	iywo
瘳	izbp
抽	izfy
稠	izhk
帱	izjc
椆	izmk
瞅	izoh
俦	izrc
仇	izrj
犨	izrn
绸	izsk
畴	iztc
丑	izva
筹	izvc
酬	izyv
踌	izzc
臭	izzq
荩	jbcd
殣	jbda
溍	jbdo
浸	jbdy
廑	jbga
靳	jbgj
烬	jbhd
噤	jbkx
卺	jblv
紧	jblx
槿	jbma
禁	jbmx
堇	jbna
觐	jbne
斤	jbpl
衿	jbpv
襟	jbpx
祲	jbpy
金	jbra
今	jbrv
仅	jbry
墐	jbta
馑	jbua
筋	jbvl
瑾	jbwa
珒	jbwy
晋	jbyo
进	jbzj
鲫	jiae
鱾	jiaj
髻	jiak
鲚	jial
棘	jian
瘠	jibo
疾	jibu
寂	jiby
蕺	jica
芨	jicj
荠	jicl
济	jidl
脊	ji0
激	jidw
漈	jidx
洎	jidz
岌	jiej
嵴	jieo
际	jiex
掎	jifk
技	jify
暨	jigd
麂	jigj
堲	jigt
既	jigv
积	jihb
稷	jihw
季	jihz
虮	jiij
徛	jiik
墼	jiit
戢	jikd
戢	jikd
叽	jikj
亟	jila
楫	jime
极	jimj
姬	jinl
犄	jink
姬	jinl
妓	jiny
肌	jioj
几	jipv
祭	jipx
其	jiqb
期	jiqo
基	jiqt
惎	jiqx
佶	jirk
集	jirm
偈	jirv
伎	jiry
罽	jisd
缉	jise
纪	jisj
给	jisk
羁	jism
绩	jisr
畸	jitk
饥	jiuj
吉	jiuk
赍	jiur
屐	jiuy
箕	jivb
笄	jivk
籍	jivo
剂	jiwd
齑	jiwl
悸	jixz
讥	jiyj
诘	jiyk
霁	jiyl
鸡	jiyn
畿	jiyt
跻	jizl
蹐	jizo
跽	jizx
井	jkal
鲸	jkax
痉	jkbg
荆	jkcd
茎	jkcg
警	jkck
菁	jkco
敬	jkcw
泾	jkdg
汫	jkdj
净	jkdl
阱	jkej
靓	jkfe
静	jkfl
䴖	jkfn
旌	jkfu
麖	jkgx
镜	jkje
鼱	jkjo
竞	jkle
粳	jkmg
婧	jkno
胫	jkog
肼	jkoj
睛	jkoo
景	jkox
獍	jkqe
猄	jkqx
儆	jkrw
倞	jkrx
经	jksg
境	jkte
刭	jkvd
颈	jkvr
璟	jkwx
鳉	jlac
豇	jlag
蒋	jlcc
茳	jlcg
奖	jldd
江	jldg
洚	jldl
桨	jldm
浆	jldu
酱	jldy
降	jlel
疆	jlga
强	jlgi
犟	jlgn
弶	jlgx
匠	jlkj
耩	jllr
糨	jlmi
膙	jloi
僵	jlra
缰	jlsa
绛	jlsl
礓	jlua
姜	jlyn
戋	jmad
鳒	jman
鲣	jmat
剪	jmbd
鹣	jmbn
蹇	jmbr
翦	jmbx
茧	jmci
菅	jmck
蒹	jmcn
荐	jmcz
湔	jmdd
渐	jmdj
涧	jmdo
歼	jmdq
拣	jmfd
搛	jmfn
靬	jmgg
鞬	jmgz
锏	jmjo
键	jmjz
贱	jmkj
鉴	jmlj
枧	jmme
毽	jmmz
奸	jmng
犍	jmnz
睑	jmoa
暕	jmoj
腱	jmoz
裥	jmpo
俭	jmra
剑	jmrd
牮	jmrn
健	jmrz
缄	jmsk
缣	jmsn
饯	jmuj
碱	jmuk
箭	jmvd
舰	jmve
笺	jmvj
简	jmvo
尖	jmxd
谫	jmyd
艰	jmyg
践	jmzj
趼	jmzk
建	jmzy
踺	jmzz
斠	jnau
鲛	jnax
皭	jnbc
皎	jnbx
藠	jncb
艽	jncj
茭	jncx
湫	jndh
浇	jndw
角	jndy
峧	jnex
搅	jnfe
轿	jnil
徼	jniw
蛟	jnix
嚼	jnkc
噍	jnkh
教	jnlw
骄	jnml
校	jnmx
椒	jnmy
姣	jnnx
脚	jnoe
胶	jnox
狡	jnqx
鹪	jnrn
侥	jnrw
佼	jnrx
缴	jnsw
绞	jnsx
矫	jnul
饺	jnux
剿	jnvd
郊	jnwe
䴔	jnwn
交	jnwx
觉	jnxe
跤	jnzx
鲒	jpak
皆	jpbb
疖	jpbe
疥	jpbl
节	jpce
芥	jpcl
藉	jpco
湝	jpdb
解	jpdn
阶	jpel
拮	jpfk
㛃	jpfn
捷	jpfr
揭	jpfv
絜	jpfx
蚧	jpil
喈	jpkb
嗟	jpkg
楷	jpmb
杰	jpmh
桔	jpmk
檞	jpmn
姐	jpnq
婕	jpnr
睫	jpor
介	jprl
借	jpro
偈	jprv
结	jpsk
劫	jptl
截	jpuf
劼	jpul
颉	jpur
碣	jpuv
届	jpuy
孑	jpva
玠	jpwl
悈	jpxc
讦	jpyg
羯	jpyv
鬏	jqah
氿	jqdj
酒	jqdy
㠇	jqey
韭	jqfa
厩	jqiv
灸	jqjh
鸠	jqjn
啾	jqkh
旧	jqlo
桕	jqmj
阄	jqmv
臼	jqpa
久	jqpn
九	jqpv
救	jqqw
僦	jqry
纠	jqsl
赳	jqtl
咎	jqwk
鹫	jqwn
就	jqwy
蠲	jrbi
涓	jrdo
捐	jrfo
焆	jrho
桊	jrjm
镌	jrjn
鹃	jrkn
圈	jrkv
娟	jrno
狷	jrqo
隽	jrrn
倦	jrrv
鄄	jrxe
窘	jsbk
泂	jsdk
扃	jshk
冏	jskk
䐃	jsoh
䌹	jssk
坰	jstk
迥	jszk
蕨	jtcr
觖	jtdg
角	jtdy
崛	jtei
抉	jtfg
掘	jtfi
撅	jtfr
攫	jtfy
劂	jtid
厥	jtir
镢	jtjr
嚼	jtkc
噘	jtkr
噱	jtku
橛	jtmr
桷	jtmy
矍	jtoy
爵	jtpc
獗	jtqr
玃	jtqy
傕	jtrf
倔	jtri
孓	jtvn
珏	jtwy
觉	jtxe
诀	jtyg
谲	jtyk
蹶	jtzr
车	jual
窭	jubn
疽	jubq
莒	juck
菊	jucm
苴	jucq
泃	judk
岠	ju0
崌	juek
聚	juen
岨	jueq
拘	jufk
掬	jufm
鞫	jugk
鞠	jugm
秬	juhj
焗	juhk
钜	jujj
锔	jujk
巨	juka
咀	jukq
且	jula
柜	jumj
桔	jumk
榉	juml
犋	junb
娵	juny
腒	juok
䴗	juon
裾	jupk
雎	juqf
狙	juqq
俱	jurb
倨	jurk
弆	jutc
剧	juud
矩	juuj
居	juuk
屦	juun
砠	juuq
筥	juvk
讵	juyj
踞	juzk
踽	juzy
戛	jxag
夹	jxan
痂	jxbk
茄	jxck
葭	jxcy
岬	jxej
恝	jxfx
郏	jxje
铗	jxjj
颊	jxjr
斝	jxku
甲	jxll
驾	jxlm
袈	jxly
槚	jxmr
胛	jxoj
伽	jxrk
价	jxrl
佳	jxrt
笳	jxvk
珈	jxwk
贾	jxxr
跏	jxzk
鲪	jyak
军	jybi
皲	jyby
菌	jych
莙	jyck
葰	jycw
浚	jydw
峻	jyew
捃	jyfk
钧	jyjd
晙	jyow
隽	jyrn
俊	jyrw
均	jytd
畯	jytw
筠	jyvd
珺	jywk
郡	jyye
咔	kakb
喀	kakk
胩	kaob
卡	kaub
洘	kcdv
拷	kcfv
㸆	kchf
烤	kchv
铐	kcjv
栲	kcmv
靠	kcnf
犒	kcnk
开	kdac
蒈	kdcb
剀	kded
凯	kdej
揩	kdfb
锴	kdjb
铠	kdjj
锎	kdjk
楷	kdmb
恺	kdxj
忾	kdxq
慨	kdxv
窠	kebg
疴	kebk
苛	keck
可	kedk
溘	kedm
岢	keek
髁	kegg
稞	kehg
炣	kehk
轲	keik
蝌	keiu
锞	kejg
呵	kekk
嗑	kekm
咳	kekr
骒	kemg
柯	kemk
瞌	keom
牁	kepk
氪	keqe
缂	kesg
克	keue
壳	keuj
磕	keum
珂	kewk
颏	kewr
课	keyg
垦	kfgt
恳	kfgx
啃	kfko
裉	kfpg
龈	kfvg
肯	kfvo
铿	kgjt
吭	kgkj
扛	khfg
抗	khfj
康	khgn
钪	khjj
闶	khmj
糠	khmn
伉	khrj
亢	khwj
慷	khxn
莰	kjcr
崁	kjer
嵁	kjev
刊	kjgd
衎	kjii
槛	kjmm
阚	kjmw
瞰	kjow
戡	kjqg
勘	kjql
龛	kjrl
侃	kjrv
墈	kjtl
坎	kjtr
堪	kjtv
磡	kjul
看	kjuo
砍	kjur
鲙	kkas
蒯	kkcd
浍	kkds
㧟	kkfk
哙	kkks
脍	kkos
狯	kkqs
郐	kkre
侩	kkrs
块	kktg
筷	kkvg
快	kkxg
况	klde
夼	kldi
洭	kldw
邝	klge
哐	klkw
框	klmw
旷	klog
眶	klow
狂	klqw
纩	klsg
圹	kltg
矿	klug
筐	klvw
诓	klyw
扩	kofg
括	kofk
廓	koge
蛞	koik
栝	komk
适	kozk
宽	krbe
髋	krge
款	krur
空	ksbg
崆	kseg
控	ksfg
恐	ksgx
倥	ksrg
埪	kstg
硿	ksug
箜	ksvg
孔	kszv
苦	kuck
库	kugi
骷	kugk
圐	kukf
哭	kukq
裤	kupi
绔	kusk
矻	kuuq
酷	kuyk
窥	kvbe
夔	kvbw
蒉	kvcr
葵	kvct
溃	kvdr
奎	kvdt
岿	kvee
隗	kveg
聩	kver
亏	kvev
揆	kvft
魁	kvgu
煃	kvht
蝰	kvit
喟	kvko
匮	kvkr
喹	kvkt
骙	kvmt
櫆	kvmu
暌	kvot
傀	kvrg
盔	kvum
馈	kvur
戣	kvvg
篑	kvvr
愧	kvxg
悝	kvxl
愦	kvxr
跬	kvzt
剋	kwud
夸	kxdk
挎	kxfk
姱	kxnk
胯	kxok
侉	kxrk
垮	kxtk
跨	kxzk
鲲	kyab
髡	kyaw
捆	kyfm
堃	kyft
焜	kyhb
锟	kyjb
困	kykm
阃	kymm
婫	kynb
昆	kyob
鹍	kyon
裈	kypi
坤	kytu
壸	kyuy
琨	kywb
悃	kyxm
醌	kyyb
寇	kzby
芤	kzcv
蔻	kzcy
扣	kzfk
抠	kzfx
口	kzla
眍	kzox
筘	kzvk
瘌	labd
落	lack
拉	lafl
鞡	lagl
蝲	laid
蜡	laio
镴	lajv
啦	lakl
辣	lalu
旯	laoj
腊	laoo
垃	latl
剌	laud
砬	laul
邋	lazv
鳞	lbal
蔺	lbcf
潾	lbdl
淋	lbdm
凛	lbdx
嶙	lbel
拎	lbfs
麟	lbgl
廪	lbgx
啉	lbkm
临	lbla
粼	lbmv
檩	lbmx
膦	lbol
邻	lbre
赁	lbrr
磷	lbul
箖	lbvm
吝	lbwk
璘	lbwl
琳	lbwm
懔	lbxx
霖	lbym
躏	lbzf
遴	lbzl
痨	lcbl
荖	lccb
落	lcck
劳	lccl
涝	lcdl
潦	lcdx
崂	lcel
捞	lcfl
烙	lchk
铑	lcjb
铹	lcjl
唠	lckl
老	lclb
耢	lcll
栳	lcmb
姥	lcnb
嫪	lcnp
佬	lcrb
络	lcsk
醪	lcyp
来	ldan
癞	ldbr
莱	ldcl
涞	lddl
崃	ldel
赉	ldlr
梾	ldml
睐	ldol
俫	ldrl
赖	ldur
籁	ldvr
鳓	leal
泐	ledl
勒	legl
叻	lekl
肋	leol
乐	lepd
仂	lerl
饹	leuk
了	levl
崚	lgew
棱	lgmw
塄	lgtf
堎	lgtw
愣	lgxf
蒗	lhcl
蓢	lhco
郎	lhde
浪	lhdl
㮾	lhdm
朗	lhdo
塱	lhdt
崀	lhel
廊	lhge
稂	lhhl
螂	lhie
锒	lhjl
啷	lhke
榔	lhme
阆	lhml
㫰	lhol
狼	lhql
埌	lhtl
筤	lhvl
琅	lhwl
鳢	liaa
丽	liad
鲤	lial
疬	libl
疠	libw
莅	licl
藜	licu
澧	lida
沥	lidl
溧	lidm
峛	li0
黧	lihh
梨	lihm
犁	lihn
戾	lihq
黎	lihu
蜊	liid
励	liil
厉	liiw
喱	likl
唳	likq
里	lila
粒	liml
㰀	limu
粝	limw
李	limz
娌	linl
礼	lipv
猁	liqd
狸	liql
俐	lird
俪	lirl
傈	lirm
缡	lisd
罹	lisf
詈	lisk
坜	litl
砺	liuw
篱	livd
笠	livl
篥	livm
隶	livn
力	livp
立	liwa
理	liwl
嫠	liwn
醴	liya
醨	liyd
雳	liyl
跞	lizl
兰	ljbs
蓝	ljcm
澜	ljdj
岚	ljex
揽	ljfe
拦	ljfs
烂	ljhs
镧	ljjj
榄	ljme
阑	ljmj
婪	ljmn
栏	ljms
襕	ljpj
罱	ljsg
篮	ljvm
斓	ljwj
懒	ljxr
鲮	lkaw
苓	lkcs
菱	lkcw
凌	lkdw
灵	lkeh
聆	lkes
陵	lkew
蛉	lkis
铃	lkjs
另	lkkl
棂	lkmh
柃	lkms
棱	lkmw
姈	lkns
昤	lkos
祾	lkpw
鸰	lkrn
领	lkrr
伶	lkrs
瓴	lkrw
翎	lkrx
绫	lksw
舲	lkvs
玲	lkws
㥄	lkxw
酃	lkye
两	llad
良	lldg
凉	lldx
靓	llfe
辆	llil
辌	llix
粮	llml
椋	llmx
量	lldl
晾	llox
俍	llrl
踉	llzl
鲢	lmaz
蔹	lmcw
莲	lmcz
濂	lmdn
潋	lmdw
奁	lmdx
涟	lmdz
联	lmet
廉	lmgn
炼	lmhd
蠊	lmin
镰	lmjn
链	lmjz
梿	lmmz
脸	lmoa
裣	lmpa
裢	lmpz
敛	lmrw
磏	lmun
瑓	lmwj
恋	lmwx
琏	lmwz
怜	lmxs
鹩	lnan
寥	lnbp
寮	lnbx
蓼	lncp
鹩	lnan
漻	lndp
聊	lnee
撂	lnfk
撩	lnfx
髎	lngp
燎	lnhx
钌	lnjl
镣	lnjx
嘹	lnkx
料	lnmu
橑	lnmx
嫽	lnnx
瞭	lnox
獠	lnqx
僚	lnrx
缭	lnsx
尥	lnyu
了	lnvl
簝	lnvx
尥	lnyu
辽	lnzl
蹽	lnzx
瘰	lobx
蓏	locg
落	lock
荦	locn
萝	locx
泺	lodl
漯	lodx
捋	lofc
摞	lofx
烙	lohk
螺	loix
锣	lojx
咯	lokk
啰	lokx
骆	lomk
椤	lomx
脶	loon
裸	lopg
猡	loqx
倮	lorg
络	losk
罗	losx
硌	louk
箩	lovx
珞	lowk
跞	lozl
逻	lozx
冽	lpdd
烈	lpdh
䴕	lpdn
裂	lpdy
捩	lpfq
脟	lpoc
猎	lpqo
埒	lptc
趔	lptd
劣	lpul
瘤	lqbt
浏	lqdd
鎏	lqdj
溜	lqdt
瑬	lqdy
陆	lqej
旒	lqfv
熘	lqht
镠	lqjp
飗	lqjt
锍	lqjv
柳	lqme
榴	lqmt
鹠	lqpn
留	lqpt
绺	lqsk
罶	lqst
疁	lqtp
馏	lqut
六	lqwb
刘	lqwd
珋	lqwe
琉	lqwv
遛	lqzt
滦	lrdm
卵	lrpd
乱	lrqv
峦	lrwe
銮	lrwj
栾	lrwm
娈	lrwn
脔	lrwr
挛	lrwu
孪	lrwz
癃	lsbu
茏	lscl
泷	lsdl
漋	lsdu
陇	lsel
隆	lseu
拢	lsfl
哢	lskc
咙	lskl
垄	lslt
砻	lslu
栊	lsml
眬	lsol
龙	lsud
笼	lsvl
弄	lswc
珑	lswl
䂮	ltfu
掠	ltfx
锊	ltjc
圙	ltkm
略	lttk
鲁	luao
鲈	luau
蕗	luck
蓼	lucp
菉	lucu
漉	ludb
潞	ludk
澛	ludo
渌	ludu
陆	luej
录	lueu
掳	lufl
撸	lufo
鹿	lugb
庐	lugh
炉	luhh
虏	luhl
稑	luht
辘	luib
辂	luik
镥	lujo
噜	luko
鸬	luln
颅	lulr
卤	lulx
麓	lumb
氇	lumo
栌	lumu
胪	luou
禄	lupu
甪	lupy
僇	lurp
璐	luwk
琭	luwu
戮	luxg
路	luzk
鹭	luzn
逯	luzu
葎	lvcy
滤	lvdx
捋	lvfc
旅	lvfn
膂	lvfo
稆	lvhk
律	lviy
吕	lvkk
驴	lvmh
榈	lvmk
褛	lvpn
氯	lvqu
侣	lvrk
偻	lvrn
缕	lvsn
绿	lvsu
垏	lvty
屡	lvun
履	lvuw
率	lvwu
耒	lwfn
癗	lwbt
藟	lwct
泪	lwdo
耒	lwfn
擂	lwft
镭	lwjt
类	lwmd
檑	lwmt
嫘	lwnx
肋	lwol
儡	lwrt
垒	lwst
缧	lwsx
罍	lwtf
累	lwtx
礌	lwut
磊	lwuu
羸	lwwf
酹	lwyc
诔	lwyl
雷	lwyt
俩	lxrl
沦	lydb
抡	lyfb
轮	lyib
囵	lykb
仑	lyrb
纶	lysb
论	lyyb
剅	lzad
瘘	lzbn
蒌	lzcn
嵝	lzen
陋	lzev
搂	lzfn
髅	lzgn
蝼	lzin
喽	lzkn
耧	lzln
楼	lzmn
䁖	lzon
篓	lzvn
露	lzyk
抹	mafm
麻	magm
摩	magu
蟆	maid
蚂	maim
骂	makm
杩	mamm
妈	manm
祃	mapm
么	maps
犸	maqm
码	maum
玛	mawm
孖	mazz
苠	mbcm
泯	mbdm
湣	mbdo
岷	mbem
抿	mbfm
黾	mbkd
皿	mbla
闽	mbmi
闵	mbmw
愍	mbmx
旻	mbow
鳘	mbpa
敏	mbpw
缗	mbso
碈	mbuo
民	mbvv
珉	mbwm
忞	mbwx
悯	mbxw
髦	mcam
茆	mcce
芼	mccm
茅	mccp
茂	mccw
泖	mcde
峁	mcee
旄	mcfm
铆	mcje
帽	mcjo
锚	mcjt
冒	mcko
耄	mclm
楙	mcmm
懋	mcmx
牦	mcnm
昴	mcoe
眊	mcom
冒	mcko
卯	mcpe
贸	mcpr
毛	mcpv
猫	mcqt
蝥	mcsi
瞀	mcso
矛	mcsp
瑁	mcwo
袤	mcwy
麦	mdfw
鿏	mdtl
唛	mdkw
脉	mdoy
埋	mdtl
卖	mdud
买	mdvd
劢	mdwl
霾	mdyl
迈	mdzw
么	meps
门	mfdv
懑	mfdx
扪	mffm
焖	mfhx
钔	mfjm
闷	mfmx
们	mfrm
亹	mfwq
蒙	mgcn
瞢	mgco
蒙	mgcn
甍	mgcw
㠓	mgeu
㠓	mgeu
蜢	mgim
蠓	mgiu
蠓	mgiu
虻	mgiw
幪	mgju
幪	mgju
檬	mgmu
檬	mgmu
梦	mgmx
盟	mgom
朦	mgou
朦	mgou
猛	mgqm
獴	mgqu
獴	mgqu
尨	mgud
礞	mguu
艋	mgvm
艨	mgvu
氓	mgwm
懵	mgxo
勐	mgzl
孟	mgzm
莽	mhcc
芒	mhcw
漭	mhdc
蟒	mhic
厖	mhid
杧	mhmw
牻	mhnd
牤	mhnw
尨	mhud
硭	mhuw
邙	mhwe
氓	mhwm
盲	mhwo
宓	mibb
密	mibe
幂	mibj
蘼	micf
泌	midb
洣	midm
汨	mido
弭	mige
靡	migf
糜	migm
縻	migx
秘	mihb
嘧	mike
咪	mikm
敉	mimw
脒	miom
祕	mipb
觅	mipe
祢	mipx
猕	miqx
谧	miym
醚	miyz
迷	mizm
鬘	mjay
颟	mjcr
蔓	mjcy
满	mjdl
漫	mjdy
鞔	mjgv
螨	mjil
镘	mjjy
嫚	mjny
瞒	mjol
曼	mjoy
埋	mjtl
墁	mjty
馒	mjuy
蛮	mjwi
慢	mjxy
谩	mjyy
冥	mkbb
蓂	mkcb
茗	mkck
溟	mkdb
洺	mkdk
螟	mkib
鸣	mkkn
瞑	mkob
明	mkoo
命	mkre
面	mmaa
渑	mmdd
勉	mmdl
黾	mmkd
冕	mmkv
棉	mmmj
勔	mmml
娩	mmnv
腼	mmom
冕	mmkv
偭	mmrm
绵	mmsj
缅	mmsm
藐	mnce
鹋	mncn
苗	mnct
渺	mndu
描	mnft
喵	mnkt
杪	mnmu
妙	mnnu
瞄	mnot
眇	mnou
缪	mnsp
缈	mnsu
邈	mnze
末	moan
万	moap
无	moay
莫	mocd
蓦	mocm
摹	mocu
沫	modm
殁	mody
陌	moeb
摸	mofd
抹	mofm
魔	mogg
麽	mogm
秣	mohm
默	mohq
墨	moht
镆	mojd
冒	moko
模	momd
嫫	mond
膜	mood
冒	moko
脉	mooy
馍	moud
貊	movb
貘	movd
貉	movk
谟	moyd
灭	mpah
蔑	mpcu
咩	mpky
篾	mpvu
乜	mpvv
缪	mqsp
谬	mqyp
木	muun
幕	mucj
募	mucl
暮	muco
墓	muct
慕	mucx
沐	mudm
拇	mufm
穆	muhp
钼	mujo
目	muka
模	mumd
毪	mumn
姥	munb
牡	munt
牧	munw
睦	muot
仫	murm
牟	musn
木	muun
母	muvd
亩	muwt
莓	mwcm
湄	mwdo
浼	mwdv
没	mwdy
嵋	mweo
糜	mwgm
煤	mwhm
镁	mwjd
镅	mwjo
梅	mwmm
楣	mwmo
媄	mwnd
媚	mwno
妹	mwnw
昧	mwow
鹛	mwvn
瑂	mwwo
美	mwyd
酶	mwym
某	mzgm
蛑	mzin
呣	mzkm
哞	mzkn
眸	mzon
侔	mzrn
鍪	mzsj
牟	mzsn
缪	mzsp
谋	mzym
捺	nafx
镎	naju
呐	nakn
娜	nane
肭	naon
衲	napn
纳	nasn
南	naug
乸	naym
您	nbrx
孬	ncbz
淖	ncdu
挠	ncfw
蛲	nciw
铙	ncjw
呶	ncky
闹	ncmj
臑	ncoe
脑	ncok
峱	ncqe
猱	ncqm
垴	nctk
硇	ncux
瑙	ncwx
艿	ndcn
萘	ndcx
奈	nddx
耐	ndec
耏	ndep
柰	ndmx
奶	ndnn
鼐	ndnv
氖	ndqn
乃	ndvp
迺	ndzx
呢	nekb
哪	neke
呐	nekn
讷	neyn
媆	nfnd
嫩	nfnw
恁	nf0
能	ngsb
囊	nhay
攮	nhfy
囔	nhky
曩	nhoy
馕	nhuy
齉	nhzy
鲵	niae
薿	nicr
泥	nidb
溺	nidd
旎	nifb
拟	nifr
麑	nige
铌	nijb
呢	nikb
匿	nikk
妮	ninb
昵	niob
睨	nioe
腻	nior
猊	niqe
伲	nirb
倪	nire
你	nirx
坭	nitb
尼	niub
怩	nixb
逆	nizp
萳	njcg
喃	njkg
囡	njkn
楠	njmg
婻	njng
腩	njog
男	njtl
赧	njty
难	njyf
宁	nkbd
甯	nkby
苧	nkcd
泞	nkdd
凝	nkdr
聍	nked
拧	nkfd
柠	nkmd
狞	nkqd
佞	nkrn
酿	nlyl
廿	nmca
鲇	nmak
廿	nmca
蔫	nmch
辇	nmfi
拈	nmfk
捻	nmfx
辗	nmin
粘	nmmk
年	nmpl
念	nmrx
埝	nmtx
碾	nmun
茑	nncn
溺	nndd
脲	nnou
鸟	nnwd
袅	nnpy
尿	nnuu
鸟	nnwd
搦	nofd
挪	nofe
锘	nojk
喏	nokk
糯	nome
娜	none
傩	norf
懦	noxe
诺	noyk
蘖	npcm
菍	npcx
孽	npcz
涅	npdt
嵲	npem
颞	nper
陧	npet
聂	npey
捏	npft
镍	npjm
镊	npjy
啮	npkk
嗫	npky
乜	npvv
臬	npzm
蹑	npzy
扭	nqfi
拗	nqfl
钮	nqji
杻	nqmi
牛	nqpl
纽	nqsi
忸	nqxi
暖	nroy
浓	nsdn
秾	nshn
哝	nskn
脓	nson
侬	nsrn
弄	nswc
疟	ntba
虐	ntha
弩	nung
努	nunl
驽	nunm
胬	nunr
砮	nunu
怒	nunx
奴	nuny
孥	nunz
傉	nurc
笯	nuvy
恧	nvex
钕	nvjn
女	nvva
衄	nvxi
内	nwld
馁	nwun
那	nwve
耨	nzlc
嗯	ogkx
呣	omkm
呒	omkw
嗯	onkx
噢	ookd
喔	ookt
哦	ookw
嚄	ooky
藕	oucy
沤	oudx
鸥	oukn
欧	oukr
瓯	oukw
区	oukx
殴	ouky
耦	ouly
偶	oury
怄	ouxx
讴	ouyx
葩	pacb
潖	padb
扒	pafb
帕	pajb
啪	pakb
耙	palb
杷	pamb
筢	pavb
琶	pawb
怕	paxb
趴	pazb
贫	pbbr
聘	pbev
拼	pbfk
品	pbkk
牝	pbnb
姘	pbnk
频	pbvr
颦	pbvu
玭	pbwb
刨	pcbd
疱	pcbs
抛	pcfl
庖	pcgs
脬	pcoz
狍	pcqs
跑	pczs
蒎	pdcn
湃	pddf
派	pddn
排	pdff
徘	pdif
哌	pdkn
牌	pdpu
迫	pdzb
盆	pfbm
湓	pfdm
喷	pfkr
芃	pgcf
蓬	pgcz
淜	pgdo
澎	pgdp
搒	pgff
捧	pgfl
抨	pgfp
弸	pggo
蟛	pgip
嘭	pgkp
棚	pgmo
椪	pgmy
鹏	pgon
朋	pgoo
膨	pgop
堋	pgto
硼	pguo
砰	pgup
碰	pguy
篷	pgvz
烹	pgwh
怦	pgxp
鳑	phaf
滂	phdf
彷	phif
耪	phlf
胖	phob
膀	phof
乓	phqd
磅	phuf
旁	phwf
雱	phyf
逄	phzl
鲏	piay
丕	piba
邳	pipe
痞	pibk
癖	pibu
疲	piby
芘	picb
苉	pice
澼	pidu
陴	pieu
陂	piey
批	pifb
披	pify
蚍	piib
蜱	piiu
铍	pijy
吡	pikb
匹	pike
噼	piku
媲	pinb
睥	piou
邳	pipe
裨	pipu
狉	piqp
狉	piqp
伾	pirp
仳	pirb
伾	pirp
纰	pisb
罴	pish
毗	pitb
圮	pitj
坯	pitp
埤	pitu
砒	piub
劈	piud
譬	piuk
䴙	piun
辟	piuu
甓	piuw
貔	pivb
琵	piwb
判	pjbd
叛	pjby
泮	pjdb
潘	pjdt
蟠	pjit
攀	pjmu
胖	pjob
盼	pjod
袢	pjpb
番	pjpt
襻	pjpu
畔	pjtb
磻	pjut
槃	pjvm
爿	pjvp
磐	pjvu
蹒	pjzl
鲆	pkap
平	pkau
荓	pkck
苹	pkcp
泙	pkdp
涄	pkdv
蚲	pkip
枰	pkmp
娉	pknv
乒	pkqp
凭	pkrj
坪	pktp
屏	pkuk
玶	pkwp
评	pkyp
翩	pmhx
骗	pmmc
楩	pmmg
骈	pmmk
犏	pmnc
㛹	pmng
胼	pmok
片	pmpv
偏	pmrc
便	pmrg
篇	pmvc
蹁	pmzc
薸	pncx
漂	pndx
殍	pndz
螵	pnix
嘌	pnkx
朴	pnmb
骠	pnmx
嫖	pnnx
瞟	pnox
缥	pnsx
剽	pnxd
瓢	pnxg
飘	pnxx
魄	pobg
皤	pobt
泊	podb
泼	podd
婆	podn
陂	poey
䥽	pojd
钷	pojk
叵	pokk
朴	pomb
鄱	pope
繁	popx
坡	poty
破	pouy
笸	povk
颇	povr
珀	powb
酦	poyd
迫	pozb
苤	ppcp
瞥	ppdo
撇	ppfw
氕	ppqp
匍	pubf
普	pubo
葡	pucf
菩	puck
溥	pudc
浦	pudf
濮	pudn
潽	pudo
扑	pufb
穙	puhn
铺	pujf
镤	pujn
镨	pujo
圃	pukf
噗	pukn
朴	pumb
氆	pumo
脯	puof
暴	puou
仆	purb
堡	purt
埔	putf
墣	putn
璞	puwn
酺	puyf
谱	puyo
蹼	puzn
沛	pwdl
陪	pwek
旆	pwfl
旆	pwfl
裴	pwfy
锫	pwjk
帔	pwjy
呸	pwkp
赔	pwkk
呸	pwkp
胚	pwop
佩	pwrj
辔	pwsk
培	pwtk
衃	pwxb
醅	pwyk
霈	pwyl
抔	pzfb
掊	pzfk
剖	pzld
裒	pzwy
寝	qbby
芹	qbcj
芩	qbcv
溱	qbdh
沁	qbdx
擒	qbfd
秦	qbfh
揿	qbfr
廑	qbga
锓	qbjy
噙	qbkd
嗪	qbkh
檎	qbmd
骎	qbmy
禽	qbrd
衾	qbry
琴	qbwv
慬	qbxa
覃	qbxu
鲯	qiab
戚	qiwx
郪	qiae
妻	qian
鳍	qiao
七	qiav
萁	qicb
葺	qice
䓫	qick
荠	qicl
萋	qicn
芪	qicu
淇	qidb
奇	qidk
泣	qidl
凄	qidn
汽	qidq
屺	qiej
崎	qiek
亓	qiel
岐	qiey
旗	qifb
契	qifd
麒	qigb
棨	qihm
蜞	qiib
锜	qijk
颀	qijr
器	qikk
嘁	qikx
亟	qila
杞	qimj
栖	qimx
婍	qink
脐	qiol
祺	qipb
祁	qipe
乞	qipv
其	qiqb
期	qiqo
綦	qiqx
企	qirv
绮	qisk
圻	qitj
畦	qitt
碶	qiud
呇	qiuk
碛	qiur
磜	qiux
歧	qivy
琪	qiwb
弃	qiwc
玘	qiwj
琦	qiwk
齐	qiwl
戚	qiwx
愭	qixo
讫	qiyq
踦	qizk
迄	qizq
跂	qizy
鲭	qkao
顷	qkbr
苘	qkck
檠	qkcm
擎	qkcu
清	qkdo
青	qkfo
庆	qkgd
蜻	qkio
圊	qkko
晴	qkoo
卿	qkpe
氢	qkqg
氰	qkqo
倩	qkro
倾	qkrr
罄	qkuf
碃	qkuo
箐	qkvo
情	qkxo
请	qkyo
蔃	qlci
蔷	qlck
抢	qlfv
强	qlgi
炝	qlhv
蜣	qliv
锵	qljc
锖	qljo
呛	qlkv
樯	qlmk
枪	qlmv
嫱	qlnk
腔	qlog
戕	qlpg
襁	qlpi
戗	qlrg
墙	qltk
玱	qlwv
羟	qlyg
跄	qlzv
前	qmbd
歉	qmbr
搴	qmbu
荨	qmcc
蒨	qmco
芊	qmcq
芡	qmcr
茜	qmcx
牵	qmdn
潜	qmdo
欠	qmdr
岍	qmek
阡	qmeq
嵌	qmer
掮	qmfo
扦	qmfq
虔	qmhw
椠	qmim
堑	qmit
愆	qmix
钳	qmjg
钱	qmjj
钤	qmjv
杄	qmmq
犍	qmnz
肷	qmor
千	qmpu
佥	qmra
伣	qmre
倩	qmro
仟	qmrq
纤	qmsq
缱	qmsz
圲	qmtq
磏	qmun
乾	qmuq
签	qmva
悭	qmxt
谦	qmyn
谴	qmyz
遣	qmzk
迁	qmzq
翘	qnax
荞	qncl
峤	qnel
峭	qneo
撬	qnfm
鞒	qngl
鞘	qngo
巧	qngv
锹	qnjh
樵	qnmh
桥	qnml
瞧	qnoh
劁	qnrd
侨	qnrl
俏	qnro
缲	qnsm
雀	qnuf
壳	qnuj
硚	qnul
硗	qnuw
敲	qnwy
憔	qnxh
悄	qnxo
谯	qnyh
乔	qnyl
诮	qnyo
跷	qnzw
窃	qpbd
癿	qpbv
茄	qpck
锲	qpjd
且	qpla
妾	qpln
切	qpqd
伽	qprk
趄	qptq
砌	qpud
箧	qpvj
郄	qpxe
惬	qpxj
怯	qpxs
求	qqad
鳅	qqah
酋	qqby
萩	qqch
湫	qqdh
泅	qqdr
鞧	qqgy
鹙	qqhn
虬	qqiv
訄	qqjk
赇	qqkq
囚	qqkr
楸	qqmh
糗	qqmq
丘	qqpa
邱	qqqe
犰	qqqj
裘	qqqy
俅	qqrq
璆	qqwp
球	qqwq
鼽	qqzj
逑	qqzq
遒	qqzy
鳈	qrau
鬈	qrav
痊	qrbw
颧	qrcr
荃	qrcw
犬	qrdd
蜷	qriv
辁	qriw
券	qrjd
铨	qrjw
圈	qrkv
棬	qrmv
权	qrmy
婘	qrnv
全	qrrw
绻	qrsv
畎	qrtq
筌	qrvw
悛	qrxw
劝	qryl
诠	qryw
穹	qsbg
穷	qsbl
䓖	qscl
茕	qscu
邛	qsge
蛩	qsgi
銎	qsgj
筇	qsve
琼	qswx
鹊	qtcn
缺	qtfg
炔	qthg
榷	qtmf
棤	qtmo
阙	qtmr
阕	qtmt
却	qtte
埆	qtty
雀	qtuf
悫	qtux
确	qtuy
劬	qubl
鸲	qubn
䓛	quci
苣	qucj
蕖	qucm
蘧	qucz
灈	qudf
娶	quen
岖	quex
取	quey
麹	qufm
觑	quhe
黢	quhw
衢	quii
蛐	quiq
蠼	quiy
曲	qula
竘	qulk
阒	qumq
㭕	qums
瞿	quof
朐	quok
氍	quom
胠	quos
袪	qups
趋	qute
坥	qutq
趣	quty
磲	quum
躯	quux
龋	quvy
葜	qxcd
洽	qxdk
拤	qxfb
掐	qxfj
髂	qxgk
袷	qxpk
卡	qxub
恰	qxxk
麇	qygh
囷	qykh
裙	qypk
群	qyyy
逡	qyzw
荛	rccw
扰	rcfy
桡	rcmw
娆	rcnw
绕	rcsw
饶	rcuw
惹	recx
热	refh
喏	rekk
荏	rfcr
稔	rfhx
妊	rfnr
人	rfpn
衽	rfpr
壬	rfqa
壬	rfqa
仁	rfre
仞	rfrr
忍	rfrx
纴	rfsr
饪	rfur
韧	rfwr
扔	rgfn
仍	rgrn
蘘	rhcy
瀼	rhdy
攘	rhfy
穰	rhhy
嚷	rhky
禳	rhpy
儴	rhry
瓤	rhwg
日	rika
驲	rimo
髯	rjar
苒	rjcr
燃	rjhh
蚺	rjir
冉	rjla
然	rjph
䎃	rjrx
蒻	rocd
鄀	roce
爇	roch
若	rock
弱	rogd
婼	ronk
偌	rork
箬	rovk
阮	rree
软	rrir
媆	rrnd
堧	rrtd
瓀	rrwe
融	rsai
冗	rsbj
茸	rsce
蓉	rsck
荣	rscm
溶	rsdk
嵘	rsem
戎	rsgu
熔	rshk
蝾	rsim
镕	rsjk
榕	rsmk
狨	rsqu
绒	rssu
瑢	rswk
蓐	rucc
薷	ruce
茹	ruck
溽	rudc
濡	rude
洳	rudk
汝	rudn
蠕	ruie
嚅	ruke
嬬	rune
如	runk
褥	rupc
襦	rupe
入	rupn
乳	rupv
儒	rure
缛	rusc
孺	ruze
芮	rvcn
蕤	rvcu
蕊	rvcx
汭	rvdn
蚋	rvin
锐	rvje
睿	rvlo
枘	rvmn
瑞	rvwe
润	rydw
闰	rymw
揉	rzfm
鞣	rzgm
肉	rznr
柔	rzsm
蹂	rzzm
卅	saal
萨	saci
挲	sadu
潵	sadw
洒	sadx
撒	safw
靸	sagj
飒	salx
脎	saom
仨	sars
瘙	scbi
扫	scfe
搔	scfi
骚	scmi
梢	scmo
嫂	scny
臊	scom
缫	scsg
缲	scsm
埽	sctj
鳃	sdax
赛	sdbr
噻	sdkt
腮	sdox
思	sdtx
塞	sebt
色	sedb
涩	sedv
穑	sehk
铯	sejb
璱	sewb
森	sfmm
僧	sgro
搡	shfm
嗓	shkm
磉	shum
丧	shun
桑	shym
颡	shyr
兕	siae
肆	siay
死	sidb
泗	side
澌	sidj
汜	sids
涘	sidu
㟃	siek
撕	sifj
私	sihs
蛳	siij
咝	siks
四	sike
嗣	sikk
咝	siks
驷	sime
楒	simx
姒	sinr
虒	sipj
祀	sips
斯	siqj
伺	sirk
食	sirl
似	sirr
俟	siru
偲	sirx
鸶	sisn
缌	sisx
寺	sitc
思	sitx
饲	siuk
丝	siva
笥	sivk
鸶	sisn
巳	sivv
漦	siwu
三	sjae
散	sjcw
糁	sjmp
伞	sjru
毵	sjsm
叁	sjss
馓	sjuw
莎	socu
蓑	socy
娑	sodn
挲	sodu
溹	sodx
锁	sojr
嗍	soko
唢	sokr
唆	sokw
嗦	sokx
桫	somu
梭	somw
睃	soow
所	sopj
缩	sosb
索	soux
琐	sowr
羧	soyw
蒜	srcx
狻	srqw
算	srvc
酸	sryw
宋	ssbm
颂	ssbr
菘	sscs
嵩	ssek
崧	sses
㧐	ssfy
松	ssms
娀	ssnu
耸	ssre
怂	ssrx
忪	ssxs
悚	ssxu
诵	ssyy
送	sszt
稣	suah
宿	subb
塑	subt
窣	subu
苏	sucb
蔌	sucr
溯	sudo
素	sufx
甦	sugu
夙	sujd
嗉	sukx
骕	sums
俗	surk
僳	surm
傃	surx
鹔	susn
肃	suvd
簌	suvr
愫	suxx
诉	suyi
谡	suyw
蹜	suzb
速	suzu
荽	svcn
濉	svdf
隋	sveo
岁	svex
隧	svez
旞	svfz
髓	svgz
祟	svix
虽	svki
睢	svof
眭	svot
襚	svpz
绥	svsn
璲	svwz
谇	svyu
邃	svzu
荪	sycx
损	syfr
榫	symu
狲	syqx
隼	syru
笋	syvy
飧	syxl
孙	syzx
蒐	szcg
薮	szcw
溲	szdy
擞	szfw
搜	szfy
廋	szgy
螋	sziy
锼	szjy
嗽	szkr
嗾	szku
嗖	szky
瞍	szoy
叟	szpy
馊	szuy
艘	szvy
鳎	taax
它	tabb
漯	tadx
拓	tafu
挞	tafz
鞳	tagk
嗒	takk
阘	tamx
闼	tamz
她	tany
褟	tapx
獭	taqr
他	tary
塔	tatk
塌	tatx
鿎	tatl
趿	tazj
踏	tazo
蹋	tazx
萄	tccf
洮	tcdd
淘	tcdf
滔	tcdj
套	tcds
陶	tcef
鼗	tcey
焘	tcfh
弢	tcgy
叨	tckd
啕	tckf
饕	tckl
梼	tcmc
桃	tcmd
绹	tcsf
绦	tcsm
韬	tcwj
慆	tcxj
鲐	tdak
苔	tdck
薹	tdct
太	tddd
汰	tddt
抬	tdfk
泰	tdfu
钛	tdjt
呔	tdkt
骀	tdmk
胎	tdok
肽	tdot
邰	tdse
炱	tdsh
台	tdsk
态	tdtx
酞	tdyt
慝	tekx
特	tenc
忑	texx
忒	teyx
疼	tgbd
藤	tgcu
熥	tghz
誊	tgjk
䲢	tgoa
螣	tgoi
腾	tgom
滕	tgou
縢	tgox
烫	thdh
淌	thdk
汤	thdp
搪	thfk
唐	thgk
螗	thik
螳	thit
镋	thje
镗	thjt
嘡	thkt
耥	thlk
糖	thmk
樘	thmt
帑	thnj
膛	thot
傥	thre
倘	thrk
塘	thtk
躺	thuk
瑭	thwk
䣘	thxe
惝	thxk
棠	thxm
堂	thxt
蹚	thzt
鳀	tiar
剃	tibd
鹈	tibn
荑	ticy
涕	tidp
替	tifo
提	tifr
擿	tifz
啼	tikj
梯	timp
媞	tinr
剔	tiod
题	tior
䴘	tipn
裼	tipw
体	tirb
倜	tirk
俶	tiry
绨	tisp
缇	tisr
趯	titf
屉	tiuu
瑅	tiwr
惕	tixw
逖	tizh
蹄	tizj
踢	tizw
瘫	tjbf
痰	tjbh
菼	tjch
滩	tjdf
澹	tjdk
潭	tjdu
炭	tjeh
探	tjfm
弹	tjgl
钽	tjjd
锬	tjjh
镡	tjju
啴	tjkl
叹	tjky
檀	tjmd
毯	tjmh
榃	tjmt
昙	tjos
袒	tjpd
倓	tjrh
坍	tjtd
坛	tjts
磹	tjuu
忐	tjux
璮	tjwd
惔	tjxh
葶	tkcd
莛	tkcz
渟	tkdd
挺	tkfz
庭	tkgz
烃	tkhg
蜓	tkiz
铤	tkjz
桯	tkmw
梃	tkmz
婷	tknd
停	tkrd
颋	tkrr
侹	tkrz
圢	tktd
艇	tkvz
亭	tkwd
珽	tkwz
廷	tkzr
天	tmad
黇	tmck
淟	tmdb
湉	tmdk
殄	tmdp
沺	tmdt
添	tmdx
掭	tmfx
钿	tmjt
田	tmku
阗	tmmb
晪	tmob
盷	tmod
甜	tmqg
舔	tmqx
佃	tmrt
填	tmtb
畋	tmtw
忝	tmtx
髫	tnak
鲦	tnam
窕	tnbd
苕	tnck
挑	tnfd
蜩	tnik
粜	tnim
嬥	tnnf
朓	tnod
祧	tnpd
佻	tnrd
笤	tnvk
条	tnwm
调	tnyk
跳	tnzd
迢	tnzk
橐	toam
萚	tocl
沱	todb
陀	toeb
托	tofq
拖	tofy
庹	togi
鼍	tokd
唾	toki
柁	tomb
驮	tomd
柝	tomi
鸵	tonb
脱	tooe
妥	topn
佗	torb
侂	torq
坨	totb
圫	totq
砣	toub
箨	tovl
酡	toyb
跎	tozb
萜	tpck
餮	tpdl
帖	tpjk
铁	tpju
贴	tpkk
湍	trde
抟	trfv
煓	trhe
团	trkc
猯	trqe
疃	trtl
彖	trvu
鲖	tsak
痛	tsby
茼	tsck
潼	tsdl
峂	tsed
峒	tsek
捅	tsfy
烔	tshk
穜	tshl
嗵	tskz
童	tsll
橦	tsml
桶	tsmy
曈	tsol
佟	tsrd
仝	tsrg
侗	tsrk
僮	tsrl
垌	tstk
砼	tsug
筒	tsvk
通	tszy
突	tubq
菟	tucd
荼	tuch
葖	tucq
兔	tudd
稌	tuhh
秃	tuhj
徒	tuir
吐	tukt
凸	tula
梌	tumh
腯	tuoo
堍	tutd
屠	tuuo
㻬	tuwk
推	tvff
魋	tvgf
腿	tvoz
褪	tvpz
忒	tvyx
退	tvzg
忒	twyx
鲀	tyat
屯	tyav
焞	tyhz
囤	tykt
豚	tyou
暾	tyow
褪	typz
吞	tytk
坉	tytt
臀	tyuo
饨	tyut
投	tzfy
骰	tzgy
偷	tzrd
透	tzzn
莎	uacu
鲨	uada
煞	uadh
裟	uady
厦	uaiw
铩	uajm
啥	uakk
唼	uakn
嗄	uakw
歃	uaqr
傻	uarw
纱	uasu
砂	uauu
刹	uaxd
杀	uaxm
霎	uayn
苕	ucck
芍	uccu
邵	ucde
召	ucdk
劭	ucdl
潲	ucdo
捎	ucfo
烧	uchw
哨	ucko
韶	uclk
柖	ucmk
梢	ucmo
杓	ucmu
睄	ucoo
绍	ucsk
玿	ucwk
色	uddb
晒	udox
酾	udyl
奢	uedo
涉	uedp
滠	uedy
折	uefj
摄	uefy
麝	uegc
蛇	ueib
赊	uekx
阇	uemo
社	uept
猞	ueqk
舍	uerk
歙	uerr
畲	uert
佘	uerx
赦	uetw
射	ueuc
慑	uexy
设	ueyy
鲹	ufap
瘆	ufbp
审	ufbu
莘	ufcu
葚	ufcv
渗	ufdp
沈	ufdv
屾	ufee
燊	ufhm
呻	ufku
肾	uflo
糁	ufmp
椹	ufmv
娠	ufnn
婶	ufnu
瞫	ufou
身	ufpp
神	ufpu
侁	ufre
参	ufsp
矧	ufuy
谌	ufyv
陞	uget
盛	ugim
晟	ugoi
昇	ugou
升	ugpc
生	ugpf
剩	ugqd
乘	ugqn
绳	ugsd
甥	ugul
省	uguo
声	ugup
觞	uhdp
上	uhla
晌	uhok
伤	uhrl
绱	uhsk
垧	uhtk
商	uhwk
赏	uhxr
鲥	uiac
鲺	uiai
石	uiak
十	uial
豕	uian
世	uiav
室	uibt
莳	uicc
奭	uidb
殖	uidq
峙	uiec
示	uiex
拭	uifg
誓	uifk
势	uifl
施	uify
铈	uijj
噬	uikr
嗜	uiko
噬	uikr
嘘	uiky
师	uilj
史	uiln
栻	uimg
柿	uimj
始	uink
匙	uiob
时	uioc
是	uior
䏡	uiox
视	uipe
失	uipf
释	uipl
矢	uipt
氏	uipv
狮	uiqj
侍	uirc
食	uirl
似	uirr
仕	uiru
埘	uitc
邿	uite
士	uiua
饰	uiuj
屎	uium
鸤	uiun
贳	uiur
尸	uivp
筮	uivr
恃	uixc
弑	uixg
识	uiyb
诗	uiyc
试	uiyg
酾	uiyl
谥	uiym
逝	uizj
适	uizk
鳝	ujak
疝	ujbe
删	ujcd
苫	ujck
汕	ujde
陕	ujej
嶦	ujek
擅	ujfd
掞	ujfh
掸	ujfl
掺	ujfp
剡	ujhd
煽	ujhx
蟮	ujik
赡	ujkk
栅	ujmc
杉	ujmp
骟	ujmx
嬗	ujnd
姗	ujnc
膻	ujod
晱	ujoh
膳	ujok
禅	ujpl
衫	ujpp
缮	ujsk
墡	ujtk
珊	ujwc
讪	ujye
跚	ujzc
摔	ukfu
甩	ukkv
率	ukwu
衰	ukwy
爽	uldx
泷	uldl
漴	uldx
骦	ulmo
孀	ulno
礵	uluo
鹴	ulyn
霜	ulyo
双	ulyy
槊	uobm
朔	uobo
搠	uofo
铄	uojl
妁	uonu
硕	uour
说	uoye
涮	urdd
拴	urfw
闩	urma
栓	urmw
腨	uroe
戍	uuwd
薯	uuco
蔬	uucv
菽	uucy
漱	uudr
沭	uudu
殊	uudv
淑	uudy
陎	uuev
抒	uufl
摅	uufx
庶	uugh
鼠	uujv
赎	uukd
墅	uult
树	uumc
术	uumd
梳	uumv
枢	uumx
恕	uunx
婌	uuny
腧	uuod
曙	uuoo
舒	uurl
毹	uurm
蜀	uusi
纾	uusl
署	uuso
叔	uuuy
疏	uuvv
戍	uuwd
熟	uuwh
塾	uuwt
孰	uuww
税	uvhe
帨	uvje
睡	uvoi
说	uvye
谁	uwyf
耍	uxen
唰	uxkd
刷	uxud
顺	uyir
吮	uyke
楯	uymo
瞬	uyol
舜	uypl
守	uzbc
兽	uzbk
瘦	uzby
首	uzbz
寿	uzfc
授	uzfy
手	uzpl
受	uzpy
狩	uzqc
售	uzrk
收	uzvw
鲊	vaav
痄	vabv
溠	vadg
奓	vadx
揸	vafd
挓	vafq
拃	vafv
蚱	vaiv
铡	vajd
喳	vakd
哳	vakj
喋	vakm
吒	vakq
咋	vakv
查	vamd
栅	vamc
闸	vamj
札	vamv
眨	vaof
乍	vapa
砟	vauv
䃎	vaux
劄	vavd
鲝	vaya
诈	vayv
齇	vazq
沼	vcdk
兆	vced
旐	vcfd
招	vc0
钊	vcjd
啁	vckk
嘲	vcko
曌	vcog
照	vcoh
昭	vcok
爪	vcpn
罩	vcsu
赵	vctx
着	vcyo
寨	vdbm
宅	vdbq
瘵	vdbx
摘	vdfk
择	vdfl
祭	vdpx
侧	vdrd
债	vdrr
斋	vdwe
翟	vdxf
蔗	vech
蛰	vefi
哲	vefk
晢	vefo
䗪	vegi
鹧	vegn
辄	veiv
辙	veiw
锗	vejo
啫	veko
詟	velk
者	velo
柘	vemu
褶	vepb
赭	veto
喆	veuk
磔	veum
谪	veyk
着	veyo
遮	vezh
这	vezw
鬒	vfab
臻	vfah
葴	vfck
鸩	vfdn
阵	vfei
振	vffn
揕	vffv
稹	vfhb
轸	vfip
帧	vfjr
针	vfju
赈	vfkn
榛	vfmh
桢	vfmr
椹	vfmv
胗	vfop
朕	vfot
禛	vfpb
袗	vfpp
祯	vfpr
斟	vfqu
侦	vfrr
缜	vfsb
纼	vfsy
圳	vfti
畛	vftp
真	vfub
箴	vfvk
瑱	vfwb
珍	vfwp
甄	vfxw
震	vfyn
诊	vfyp
丁	vgal
正	vgav
郑	vgbe
症	vgbv
蒸	vgch
争	vgdl
峥	vgel
挣	vgfl
征	vgiv
铮	vgjl
钲	vgjv
烝	vglh
睁	vgol
政	vgvw
怔	vgxv
诤	vgyl
证	vgyv
丈	vhan
涨	vhdi
漳	vhdu
嶂	vheu
张	vhgi
帐	vhji
幛	vhju
账	vhki
彰	vhlp
杖	vhmv
嫜	vhnu
胀	vhoi
暲	vhou
长	vhpn
獐	vhqu
仉	vhrj
仗	vhrv
郅	viae
至	viat
致	viaw
痔	vibc
窒	vibt
痣	vibx
芷	vicv
滞	vidj
觯	vidl
之	vidn
殖	vidq
沚	vidv
职	vieb
峙	viec
骘	viem
陟	viep
掷	vife
鸷	vifn
指	vifo
贽	vifr
絷	vifx
擿	vifz
庤	vigc
稚	vihf
稙	vihq
轵	viib
蜘	viik
蛭	viit
徵	viiw
锧	vijr
只	vikb
吱	viky
止	vila
栉	vime
榰	vimo
植	vimq
桎	vimt
栀	vimv
梽	vimx
枝	vimy
胝	viod
脂	vioo
晊	viot
肢	vioy
炙	viph
豸	vipp
质	vipr
祉	vipv
值	virq
侄	virt
织	visb
置	visq
纸	visu
畤	vitc
埴	vitq
址	vitv
雉	viuf
直	viuq
疐	viur
志	viux
支	viuy
彘	vivb
酯	viyo
踬	vizr
趾	vizv
鳣	vjad
詹	vjdk
崭	vjej
旃	vjfd
搌	vjfn
斩	vjij
辗	vjin
飐	vjjk
战	vjlg
栴	vjmd
栈	vjmj
毡	vjmk
瞻	vjok
偡	vjrv
绽	vjsr
展	vjun
鹯	vjwn
颤	vjwr
谵	vjyk
拽	vkfy
妆	vldn
状	vldq
装	vldy
撞	vlfl
庄	vlgt
幢	vljl
戆	vllx
桩	vlmt
奘	vlpd
僮	vlrl
茁	voci
著	voco
䓬	vocu
濯	vodf
涿	vodn
浞	vodr
汋	vodu
擢	voff
拙	vofi
捉	vofr
焯	vohu
镯	voji
䦃	vojo
啄	vokn
桌	volm
棁	vome
椓	vomn
晫	voou
禚	voph
倬	voru
缴	vosw
斫	vouj
琢	vown
诼	voyn
着	voyo
酌	voyu
叕	voyy
专	vrad
沌	vrdt
撰	vrfb
转	vriv
赚	vrkn
啭	vrkv
䏝	vrov
僎	vrrb
传	vrrv
馔	vrub
砖	vruv
瑑	vrwu
茽	vscv
穜	vshl
种	vshv
锺	vsjv
柊	vsmd
肿	vsov
重	vspa
众	vsrr
仲	vsrv
终	vssd
盅	vsvm
忠	vsvx
螽	vswi
衷	vswy
忪	vsxs
瘃	vubn
疰	vubv
苎	vuca
著	vuco
茱	vucv
洙	vudv
拄	vufv
麈	vugv
烛	vuhi
炷	vuhv
蛀	vuiv
铸	vujc
铢	vujv
贮	vuka
嘱	vuky
煮	vulh
翥	vulx
术	vumd
柷	vume
杼	vuml
槠	vumo
驻	vumv
朱	vupw
瞩	vuoy
祝	vupe
竹	vupl
褚	vupo
朱	vupw
助	vuql
猪	vuqo
伫	vura
侏	vurv
纻	vusa
砫	vuuv
属	vuuy
竺	vuve
箸	vuvo
舳	vuvy
珠	vuwv
诸	vuyo
诛	vuyv
躅	vuzi
坠	vvet
赘	vvfr
锥	vvjf
骓	vvmf
缀	vvsy
缒	vvsz
惴	vvxe
追	vvzk
这	vwzw
髽	vxat
抓	vxfv
挝	vxfz
爪	vxpn
屯	vyav
窀	vybt
准	vydf
肫	vyot
谆	vyyz
宙	vzby
荮	vzcc
洲	vzdv
洲	vzdv
皱	vzdy
帚	vzej
粥	vzgg
昼	vzid
辀	vziv
轴	vziy
啁	vzkk
骤	vzmn
婤	vznk
妯	vzny
肘	vzoc
舟	vzpd
繇	vzpx
㑇	vzre
纣	vzsc
绉	vzse
碡	vzum
鸼	vzvn
籀	vzvt
酎	vzyc
胄	vzyo
瓦	waad
窊	wabg
洼	wadt
挖	wafv
蛙	wait
哇	wakt
娲	wann
娃	want
腽	waom
佤	warw
畖	watg
歪	wdbv
崴	wden
鳁	wfam
蕰	wfcm
芠	wfcw
温	wfdm
汶	wfdw
炆	wfhw
辒	wfim
蚊	wfiw
吻	wfkw
闻	wfme
榅	wfmm
阌	wfmy
璺	wfpy
纹	wfsw
刎	wfwd
玟	wfww
紊	wfwx
雯	wfyw
鹟	wgbn
瓮	wgbw
翁	wgbx
蕹	wgcf
蓊	wgcx
滃	wgdx
嗡	wgkx
王	what
汪	whdw
魍	whgw
往	whiv
辋	whiw
罔	whkw
网	whkx
枉	whmw
旺	whow
尪	whyw
妄	whwn
亡	whwv
忘	whwx
惘	whxw
尪	whyw
万	wjap
豌	wjav
剜	wjbd
皖	wjbe
宛	wjbv
莞	wjce
菀	wjcv
芄	wjcw
蔓	wjcy
湾	wjdg
挽	wjfv
烷	wjhe
蜿	wjiv
椀	wjmv
妧	wjne
婠	wjnk
婉	wjnv
脘	wjoe
腕	wjov
绾	wjsk
纨	wjsw
塆	wjtg
畹	wjtv
玩	wjwe
弯	wjwg
琬	wjwv
惋	wjxv
窝	wobn
莴	wocn
涡	wodn
渥	wodt
涴	wodv
沃	wody
握	woft
挝	wofz
卧	woib
蜗	woin
幄	wojt
喔	wokt
肟	wook
我	wopd
倭	worn
偓	wort
斡	wouu
硪	wouw
龌	wovt
踒	wozn
五	wuaa
戊	wuad
兀	wuae
鹉	wuan
武	wuav
无	wuay
寤	wubk
勿	wubp
芴	wucw
峿	wuek
屼	wuew
於	wufd
捂	wufk
鹀	wugn
戊	wuad
庑	wugw
焐	wuhk
蜈	wuit
钨	wujw
唔	wukk
吴	wukt
呜	wukw
牾	wunk
妩	wunw
晤	wuok
旿	wuow
乌	wupa
午	wupg
舞	wupl
侮	wurm
仵	wurw
骛	wusm
鹜	wusn
坞	wutw
屋	wuut
毋	wuva
邬	wuwe
吾	wuwk
务	wuwl
珷	wuwv
忤	wuxw
雾	wuyl
恶	wuyx
鳚	wwac
威	wwxn
韦	wwal
鲔	wwao
蔚	wwcc
萎	wwcn
苇	wwcw
薳	wwcz
潍	wwdf
渭	wwdo
洈	wwdv
涠	wwdw
卫	wwea
隗	wweg
崴	wwen
㧑	wwfw
廆	wwgg
魏	wwhg
煨	wwhn
炜	wwhw
微	wwiw
帷	wwjf
帏	wwjw
唯	wwkf
喂	wwkn
围	wwkw
桅	wwmv
猬	wwqo
位	wwrl
偎	wwrn
伪	wwrw
维	wwsf
纬	wwsw
圩	wwty
尉	wwuc
尾	wwum
碨	wwun
慰	wwux
卫	wwea
艉	wwvm
威	wwxn
玮	wwww
惟	wwxf
霨	wwyc
诿	wwyn
谓	wwyo
逶	wwzn
遗	wwzr
违	wwzw
薪	xbcj
莘	xbcu
芯	xbcx
鑫	xbjj
欣	xbjr
新	xblj
歆	xblr
昕	xboj
囟	xbpx
信	xbrk
伈	xbrx
忻	xbxj
西	xiaa
鳛	xiab
郤	xibe
兮	xibv
窸	xibx
昔	xico
蓰	xicr
茜	xicx
溪	xidd
潟	xidh
淅	xidj
觿	xidk
汐	xidx
玺	xidy
嶍	xieb
巇	xieg
隰	xieh
嶲	xiev
隙	xiex
觋	xige
爔	xihd
蜥	xiij
徙	xiir
蟋	xiix
鼷	xijd
铣	xije
锡	xijw
熙	xikh
唏	xikj
嘻	xikk
咥	xikt
袭	xily
皙	ximb
阋	xime
析	ximj
樨	ximn
檄	ximw
栖	ximx
牺	xinx
曦	xiod
晰	xioj
暿	xiok
腊	xioo
禧	xipk
裼	xipw
悉	xipx
傒	xird
僖	xirk
绤	xisk
枲	xism
细	xist
熹	xiuh
犀	xiun
饩	xiuq
屣	xiur
习	xivd
舾	xivx
釐	xiwl
郗	xixe
希	xixj
惜	xixo
羲	xiyd
戏	xiyg
醯	xiym
蹊	xizd
息	xizx
荥	xkcu
陉	xkeg
擤	xkfl
煋	xkhu
行	xkii
铏	xkjd
刑	xkkd
邢	xkke
形	xkkp
型	xkkt
姓	xknu
腥	xkou
幸	xktg
硎	xkud
省	xkuo
饧	xkup
兴	xkxb
悻	xkxg
惺	xkxu
葙	xlco
巷	xlcs
芗	xlcx
象	xldn
湘	xldo
降	xlel
厢	xlio
鲞	xlja
镶	xljy
响	xlkk
橡	xlmn
想	xlmx
骧	xlmy
向	xlpk
祥	xlpy
像	xlrn
缃	xlso
饷	xluk
箱	xlvo
乡	xlvp
珦	xlwk
襄	xlwy
享	xlwz
翔	xlyx
咸	xmxk
鲜	xmay
宪	xmbe
痫	xmbm
莶	xmca
苋	xmce
涎	xmdz
险	xmea
限	xmeg
陷	xmej
挦	xmfc
掀	xmfr
弦	xmgy
铣	xmje
锨	xmjr
见	xmke
贤	xmlr
籼	xmme
闲	xmmm
鹇	xmmn
先	xmne
孅	xmnj
嫌	xmnn
㬎	xmoh
腺	xmou
显	xmoy
祆	xmpt
禒	xmpu
猃	xmqa
氙	xmqe
县	xmqs
狝	xmqx
仙	xmre
伭	xmry
纤	xmsq
馅	xmuj
献	xmuq
现	xmwe
咸	xmxk
玹	xmwy
忺	xmxr
酰	xmye
羡	xmyr
霰	xmyw
跣	xmze
暹	xmzf
皛	xnbb
宵	xnbo
淆	xndo
潇	xnds
洨	xndx
涍	xndz
崤	xneo
蛸	xnio
蟏	xnis
虓	xnjj
销	xnjo
嚣	xnkk
鸮	xnkn
哓	xnkw
哮	xnkz
小	xnld
孝	xnlz
枵	xnmv
校	xnmx
晓	xnow
猇	xnqj
翛	xnrx
筱	xnvw
笑	xnvy
削	xnxd
肖	xnxo
敩	xnxw
恔	xnxx
霄	xnyo
逍	xnzo
鲑	xpat
写	xpby
薤	xpcj
薢	xpcn
瀣	xpdj
泻	xpdy
契	xpfd
挟	xpfj
携	xpfn
撷	xpfr
絜	xpfx
廨	xpgn
鞋	xpgt
燮	xphy
蝎	xpiv
叶	xpku
勰	xplx
榭	xpmc
楔	xpmd
胁	xpob
歇	xpor
卸	xppe
血	xppm
獬	xpqn
偕	xprb
偰	xprd
㙦	xprt
缬	xpsr
协	xpub
屑	xpuo
颉	xpur
卸	xppe
亵	xpwy
懈	xpxn
邪	xpye
邂	xpzn
躞	xpzy
髹	xqam
宿	xqbb
滫	xqdo
溴	xqdq
岫	xqey
庥	xqgm
秀	xqhn
䗛	xqio
锈	xqjn
咻	xqkm
嗅	xqkq
朽	xqmv
袖	xqpy
休	xqrm
鸺	xqrn
脩	xqro
修	xqrp
绣	xqsn
貅	xqvm
琇	xqwn
珛	xqwo
臭	xqzq
癣	xrby
萱	xrcg
渲	xrdg
漩	xrdr
泫	xrdy
旋	xrfr
煊	xrhg
炫	xrhy
衒	xrii
券	xrjd
铉	xrjy
咺	xrkg
楦	xrmg
暄	xrog
暶	xror
昡	xroy
禤	xrpx
悬	xrqx
伭	xrry
绚	xrso
翾	xrsx
碹	xrug
瑄	xrwg
璇	xrwr
玹	xrwy
愃	xrxg
芎	xscg
汹	xsdk
夐	xsdw
兄	xske
胸	xsok
熊	xssh
鳕	xtae
穴	xtbb
茓	xtcb
薛	xtcu
踅	xtfr
靴	xtgb
峃	xtxe
敩	xtxw
学	xtxz
戌	xuwa
蓿	xucb
蓄	xuct
浒	xudw
洫	xudx
溆	xudy
序	xugl
魆	xugv
旭	xujo
勖	xukl
吁	xuky
糈	xumo
栩	xumx
絮	xunx
煦	xuoh
昫	xuok
勖	xukl
盱	xuoy
媭	xupn
叙	xury
续	xusd
绪	xuso
垿	xutl
圩	xuty
胥	xuvo
戌	xuwa
顼	xuwr
珝	xuwx
需	xuye
酗	xuyk
谞	xuyo
许	xuyw
诩	xuyx
下	xxab
夏	xxaw
峡	xxej
辖	xxik
厦	xxiw
虾	xxix
匣	xxkj
吓	xxkx
柙	xxmj
瞎	xxok
暇	xxoy
狎	xxqj
侠	xxrj
瑕	xxwy
遐	xxzy
鲟	xyac
郇	xybe
窨	xybo
荨	xycc
薰	xych
荀	xyco
蕈	xycu
浔	xydc
洵	xydo
汛	xydu
浚	xydw
寻	xyec
峋	xyeo
徇	xyio
噀	xykb
勋	xykl
栒	xymo
曛	xyoh
熏	xyph
獯	xyqh
巽	xysb
埙	xytr
珣	xywo
恂	xyxo
训	xyyi
询	xyyo
讯	xyyu
巡	xyzv
逊	xyzx
牙	yaap
亚	yaay
丫	yabl
芽	yacy
涯	yadt
崖	yaet
岈	yaey
押	yafj
揠	yafn
压	yaid
轧	yaiv
蚜	yaiy
鸭	yajn
哑	yaky
桠	yamy
娅	yany
睚	yaot
猰	yaqd
氩	yaqy
伢	yary
堐	yatt
垭	yaty
砑	yauy
琊	yawe
玡	yawy
雅	yayf
鸦	yayn
迓	yazy
䲟	ybae
寅	ybbb
窨	ybbo
瘾	ybbx
茵	ybcd
茚	ybce
洇	ybdd
淫	ybdr
溵	ybdy
崟	ybej
阴	ybeo
隐	ybex
铟	ybjd
银	ybjg
嚚	ybkk
吲	ybky
喑	ybko
音	yblo
慭	yblx
訚	ybmk
姻	ybnd
鄞	ybne
印	ybpe
禋	ybpt
胤	ybpv
殷	ybpy
氤	ybqd
垠	ybtg
圻	ybtj
硍	ybug
饮	ybur
尹	ybvp
珢	ybwg
愔	ybxo
歅	ybxr
鳐	ycaf
尧	ycaw
疟	ycba
窑	ycbf
窈	ycbl
窅	ycbo
药	yccu
滧	ycdw
崾	ycen
峣	ycew
靿	ycgl
徭	ycif
轺	ycik
铫	ycjd
钥	ycjo
咬	yckx
吆	ycky
姚	ycnd
媱	ycnf
妖	ycny
曜	ycof
腰	ycon
夭	ycpd
舀	ycpj
鹞	ycpn
么	ycps
繇	ycpx
猺	ycqf
侥	ycrw
垚	yctt
幺	ycvs
珧	ycwd
耀	ycxf
肴	ycxo
爻	ycxx
谣	ycyf
遥	yczf
邀	yczw
页	year
爷	yebe
冶	yedk
液	yedn
耶	yeee
揶	yefe
掖	yefn
靥	yeim
铘	yeje
噎	yeka
咽	yekd
叶	yeku
业	yela
野	yell
曳	yelp
椰	yeme
腋	yeon
晔	yeou
倻	yere
馌	yeum
也	yevv
夜	yewn
谒	yeyv
羊	yhbl
疡	yhbp
泱	yhdy
阳	yheo
扬	yhfp
鞅	yhgy
炀	yhhp
烊	yhhy
钖	yhjp
咉	yhky
央	yhlg
样	yhmy
旸	yhop
仰	yhre
佯	yhry
垟	yhty
玚	yhwp
怏	yhxy
养	yhyl
鸯	yhyn
恙	yhyx
羕	yhyy
一	yiaa
弋	yiad
宧	yibl
宜	yibq
疑	yibr
瘗	yibt
癔	yibx
疫	yiby
苡	yicr
艺	yicv
薏	yicx
荑	yicy
殪	yida
浥	yidb
漪	yidk
义	yidx
峄	yiel
嶷	yier
挹	yifb
揖	yife
旖	yifk
廙	yigb
熠	yihb
黟	yihx
蛇	yiib
螠	yiim
轶	yiiu
蜴	yiiw
蚁	yiiy
钇	yijv
铱	yijy
邑	yikb
嗌	yikm
颐	yikr
医	yiku
呓	yikv
噫	yikx
咿	yiky
意	yilx
驿	yiml
杙	yimy
嫕	yinx
姨	yiny
眙	yiok
昳	yiou
易	yiow
臆	yiox
胰	yioy
乂	yipn
祎	yipw
㑊	yird
倚	yirk
食	yirl
佾	yiro
仡	yirq
佚	yiru
亿	yirv
仪	yiry
绎	yisl
缢	yism
矣	yisu
埸	yitw
饴	yiuk
尾	yium
懿	yiux
以	yivr
乙	yivv
簃	yivx
舣	yivy
弈	yiwc
裔	yiwk
衣	yiwy
羿	yixc
忆	yixv
诒	yiyk
译	yiyl
诣	yiyo
谊	yiyq
逸	yizd
遗	yizr
迤	yizy
戭	yjbg
宴	yjbn
芫	yjce
滟	yjdb
渰	yjdc
沇	yjde
漹	yjdh
沿	yjdk
湮	yjdt
崦	yjed
岩	yjeu
掩	yjfd
炎	yjhh
甗	yjhw
雁	yjif
餍	yjil
蝘	yjin
彦	yjip
厌	yjiq
赝	yjir
蜒	yjiz
咽	yjkd
唁	yjkk
觃	yjkz
䶮	yjlt
验	yjma
阉	yjmd
棪	yjmh
阎	yjmj
闫	yjms
嫣	yjnh
妍	yjnk
胭	yjod
眼	yjog
晏	yjon
殷	yjpy
弇	yjrc
偃	yjrn
罨	yjsd
墕	yjth
盐	yjtm
堰	yjtn
砚	yjue
焉	yjvh
兖	yjwe
言	yjwk
谚	yjyp
瘿	ykbn
颍	ykbr
䓨	ykcf
荧	ykch
萤	ykci
蓥	ykcj
营	ykck
莺	ykcn
茔	ykct
荥	ykcu
萦	ykcx
瀛	ykdf
溁	ykdm
滢	ykdy
撄	ykfn
应	ykga
鹰	ykgn
蝇	ykid
郢	ykke
罂	ykkf
嘤	ykkn
盈	yknm
媵	ykon
影	ykop
映	ykoy
缨	yksn
璎	ykwn
瑛	ykwy
迎	ykze
唷	yoko
哟	yoku
芫	yrce
苑	yrcv
渊	yrdl
源	yrdx
湲	yrdy
鼋	yred
元	yree
掾	yrfu
援	yrfy
蜎	yrio
愿	yrix
辕	yriy
园	yrke
圆	yrkr
圜	yrky
妧	yrne
嫄	yrnx
媛	yrny
爰	yrpy
猿	yrqy
垣	yrtg
垸	yrte
塬	yrtx
袁	yrty
眢	yrxo
怨	yrxx
鸢	yryn
鳙	ysal
鲬	ysay
痈	ysby
澭	ysdf
涌	ysdy
拥	ysfy
鄘	ysge
㶲	yshy
镛	ysjl
用	yskl
喁	ysky
栐	ysmy
臃	ysof
俑	ysry
勇	yssl
恿	yssx
甬	yssy
墉	ystl
埇	ysty
邕	ysvb
饔	yswl
壅	yswt
踊	yszy
彟	ytey
钥	ytjo
月	ytka
哕	ytkx
阅	ytme
栎	ytml
樾	ytmv
刖	ytod
乐	ytpd
粤	ytpv
岳	ytqe
龠	ytrc
越	yttv
籥	ytvc
玥	ytwo
悦	ytxe
跃	ytzy
与	yuaa
雨	yuad
于	yual
瘀	yubd
窳	yubg
鹆	yubn
欲	yubr
寓	yuby
蔚	yucc
薁	yucd
蓣	yucr
菀	yucv
渔	yuda
渝	yudd
淯	yudo
滪	yudr
嵛	yued
峪	yuek
隅	yuey
於	yufd
粥	yugg
燏	yuhk
煜	yuhl
蜮	yuia
御	yuie
舁	yujc
钰	yujy
喻	yukd
圉	yukg
吁	yuky
阈	yuma
榆	yumd
驭	yumy
妤	yunl
娱	yunt
妪	yunx
昱	yuol
腴	yuoy
舆	yupb
褕	yupd
裕	yupk
臾	yupn
毓	yupv
㺄	yuqd
狳	yuqh
俞	yurd
余	yurh
俣	yurt
愈	yurx
予	yusl
豫	yusn
域	yuta
堉	yuto
尉	yuuc
饫	yuuy
龉	yuvk
竽	yuvy
瑜	yuwd
育	yuwo
玙	yuwy
愉	yuxd
誉	yuxk
谕	yuyd
雩	yuyk
盂	yuym
欤	yuyr
愚	yuyx
逾	yuzd
遹	yuzk
迂	yuzy
郓	yybe
蕴	yycm
芸	yycs
云	yyes
煴	yyhm
郧	yyke
员	yykr
韵	yyld
耘	yyls
妘	yyns
孕	yynz
昀	yyod
晕	yyoi
狁	yyqe
氲	yyqm
缊	yysm
鋆	yytj
赟	yywr
恽	yyxi
愠	yyxm
运	yyzs
酉	yzxa
鲉	yzay
宥	yzbo
猷	yzbq
疣	yzby
莠	yzcn
莜	yzcw
莸	yzcy
油	yzdy
游	yzdz
幽	yzey
麀	yzgb
黝	yzhl
蚴	yzil
铕	yzjo
鼬	yzjy
呦	yzkl
囿	yzko
卣	yzla
耰	yzlw
槱	yzmh
柚	yzmy
牖	yzpf
繇	yzpx
釉	yzpy
犹	yzqy
佑	yzrk
侑	yzro
攸	yzrw
悠	yzrx
优	yzry
尤	yzyd
右	yzuk
友	yzuy
又	yzvn
酉	yzxa
忧	yzxy
尤	yzyd
邮	yzye
幼	yzyl
诱	yzyn
扎	zafv
拶	zafx
匝	zakj
咋	zakv
咱	zakz
臜	zaor
砸	zauj
枣	zcad
皂	zcbq
藻	zccm
燥	zchm
灶	zcht
蚤	zcii
噪	zckm
唣	zckq
糟	zcmo
早	zcou
簉	zcvz
璪	zcwm
慥	zcxz
造	zczk
躁	zczm
遭	zczo
再	zdar
灾	zdbh
宰	zdbu
崽	zdex
仔	zdrz
哉	zduk
栽	zdum
在	zdut
甾	zdvt
泽	zedl
择	zefl
责	zefr
仄	zeir
帻	zejr
则	zekd
赜	zekr
咋	zekv
昃	zeor
箦	zevr
舴	zevv
迮	zezv
怎	zfvx
谮	zfyo
鄫	zgbe
曾	zgbo
甑	zgbw
锃	zgjw
赠	zgko
罾	zgso
综	zgsx
增	zgto
矰	zguo
憎	zgxo
臧	zhwi
葬	zhcc
藏	zhci
赃	zhkt
驵	zhmq
脏	zhot
奘	zhpd
牂	zhpy
奘	zhpd
臧	zhwi
髭	ziab
鲻	ziat
兹	ziby
孳	zibz
茈	zicb
鼒	zicv
咨	zidk
姿	zidn
淄	zidt
滓	zidu
恣	zidx
滋	zidy
嵫	ziey
秭	zihp
辎	ziit
镃	zijy
呲	zikb
嗞	ziky
耔	zilz
籽	zimz
姊	zinp
眦	ziob
自	zipo
仔	zirz
缁	zist
趑	zitr
子	ziva
龇	zivb
訾	zivk
笫	zivp
紫	zivx
觜	zivy
孜	zizw
寁	zjbr
攒	zjfr
拶	zjfx
錾	zjij
暂	zjio
糌	zjmo
酂	zjne
赞	zjnr
趱	zjtr
簪	zjvo
昝	zjwo
瓒	zjwr
岞	zoev
捽	zofu
撮	zofy
座	zogt
唑	zokt
嘬	zoky
柞	zomv
胙	zoov
祚	zopv
佐	zorg
坐	zort
作	zorv
做	zorw
笮	zovv
琢	zown
怍	zoxv
酢	zoyv
攥	zrfx
缵	zrsr
纂	zrvx
躜	zrzr
鬷	zsaw
鬃	zsax
疭	zsbr
枞	zsmr
粽	zsmx
腙	zsox
倧	zsrx
综	zssx
踪	zszx
菹	zucq
阻	zueq
崒	zueu
租	zuhq
足	zukr
祖	zupq
俎	zurq
组	zusq
珇	zuwq
诅	zuyq
蕞	zvcy
咀	zvkq
嘴	zvky
槜	zvmn
最	zvoy
罪	zvsf
觜	zvvy
醉	zvyu
鲗	zwad
贼	zwku
鳟	zyac
尊	zybc
嶟	zyec
噂	zykc
樽	zymc
僔	zyrc
遵	zyzc
鲰	zzay
鄹	zzee
陬	zzey
揍	zzft
驺	zzme
走	zztr
荜	bicu
辟	biuu
蕃	fjct
麸	fuff
抚	fufw
蝠	fuit
赙	fukc
佛	furf
汲	jidj
矶	jiuj
蛎	liiw
栎	liml
洌	lpdd
闾	lvmk
暝	mkob
湎	mmdm
茉	mocm
沏	qidd
骐	qimb
钎	qmjq
醛	qryw
什	uiru
挚	vifu
嵬	wweg
烯	xihj
解	xpdn
呷	xxkj
殃	yhdy
痍	yiby
艾	yicx
翳	yikx
翌	yixl
奄	yjdd
焱	yjhh
焰	yjhj
魇	yjig
淤	yudd
