啊	q
拍	w
就	e
哦	r
是	t
你	y
吧	i
他	o
吗	p
取	a
出	s
了	d
人	f
我	g
的	h
有	j
这	k
个	l
才	x
非	v
二	b
在	n
好	m
像	c
看	u
一	jg
不	ii
来	dj
说	ts
上	tu
到	hw
着	kk
大	hr
们	pq
道	hwn
那	yr
么	pk
也	jr
地	hl
子	nf
下	cy
时	tn
要	jw
她	oe
中	kv
没	ph
然	fq
里	df
为	gd
过	lx
自	nl
得	hd
去	ah
可	ur
会	me
天	ox
还	mj
心	cv
后	mk
以	jf
小	cz
都	hx
和	md
对	he
想	cn
能	yo
起	af
之	kg
手	td
而	bj
只	kf
生	th
什	ty
身	tq
头	ot
样	ju
事	tl
多	hs
己	ef
家	eo
面	pu
知	kgt
开	ua
如	fm
无	gm
现	cu
很	mg
点	hq
前	ab
发	ve
经	ej
情	ak
把	iv
老	dt
些	ch
话	mf
乙	jfk
又	jk
声	tht
意	jl
于	jb
回	mb
笑	cp
所	zp
但	hsf
眼	jn
成	so
方	vy
年	yb
见	eu
当	hy
女	ys
真	kq
两	dn
力	dl
气	al
从	xa
用	jz
长	sz
动	hz
间	ex
国	ls
走	nd
让	fu
被	id
给	lg
正	kw
问	gw
打	hv
明	pkr
儿	bjw
法	vv
几	efw
行	ck
三	zo
定	ha
此	xf
进	er
再	nb
种	kqm
将	em
实	tnl
同	oa
最	ne
本	ig
向	cw
分	vq
十	tnq
学	ci
高	lu
第	hlk
感	ln
怎	ng
神	tyw
听	oj
边	ix
作	nx
七	ag
其	an
却	ao
口	ud
觉	ei
因	jv
白	ij
次	xl
军	es
做	nxf
外	gb
门	py
光	la
风	vh
主	kc
住	ki
果	lp
与	js
全	ai
候	mkf
公	lv
相	cm
等	hm
别	ik
色	zr
死	zf
张	ky
部	iid
太	ob
日	fl
少	tt
战	ks
理	dfg
直	kn
重	kz
王	gz
脸	dq
比	if
快	uo
何	mdf
水	tz
名	pkc
体	of
呢	yk
东	hvq
叫	ep
西	cg
应	jj
便	iu
放	vu
马	pv
难	yq
轻	aj
更	lw
美	pg
位	gdf
关	lf
机	eg
接	eh
先	cx
文	gy
处	si
并	ia
忘	gu
望	gug
常	szb
完	gq
四	zl
飞	vx
师	tg
者	kr
安	qo
清	ajh
刚	ly
跟	lq
月	jo
信	cr
山	to
爱	qb
内	yd
龙	da
空	uv
带	hb
找	kt
原	ji
入	fi
李	dfd
连	db
吃	sg
场	sp
平	wk
思	zg
林	ds
变	iug
使	tf
由	jt
受	tk
亲	av
命	pa
目	pi
强	aq
男	yqo
任	fw
该	laj
路	di
车	sk
今	ev
海	mr
加	eod
远	jbn
活	ms
特	or
解	ew
电	hu
世	tlq
性	ca
表	iz
许	cs
它	oel
立	dlg
黑	mx
金	evf
红	ma
花	mz
转	kb
总	nq
算	zc
城	soo
队	heb
孩	mjn
反	vn
工	lvq
始	tfy
满	pn
新	cvd
兵	ija
物	gi
离	dng
虽	zlu
云	jh
似	zlf
万	gs
至	kl
干	lsq
通	ov
认	fwj
失	tgw
火	mp
哥	lk
士	tlt
五	gc
惊	ejc
魔	pql
竟	ea
姐	ewy
乎	mjw
件	euf
往	gp
量	dw
早	nt
结	ek
怕	wr
流	dy
突	ojl
坐	nxfo
斯	zga
音	jvd
紧	ey
指	kfv
拉	de
杀	te
半	is
记	el
且	aw
利	dlm
合	mdfu
倒	ht
书	tj
度	hi
微	gx
步	iik
教	ept
喜	cf
越	joo
影	jq
谁	tb
冷	dm
深	tqh
告	lww
落	dx
象	cwb
容	fa
怪	lo
传	sif
钱	abe
提	on
言	jqg
随	zb
每	pgw
双	ta
服	vm
击	egq
武	gck
哪	yv
数	ti
站	ksd
奇	anh
房	vz
管	lb
灵	dk
刻	urg
题	onr
衣	jgg
周	kx
静	eaa
伤	tyf
百	ir
拿	ya
妈	pe
办	isd
星	cj
化	mff
功	lvl
绝	eiz
系	cl
般	io
必	il
业	jrq
尔	bp
剑	eufh
血	co
代	hbf
精	ejp
弟	hlb
终	kvz
近	ern
条	oo
青	ajq
界	epo
司	zgk
整	km
欢	mfj
字	nll
晚	gn
民	ps
帮	iy
切	aha
即	en
忙	pz
交	ed
或	mxq
暗	qs
夫	vj
员	jiu
根	lqd
石	tnqu
哈	meu
夜	jrg
父	vi
制	klw
友	jd
阿	qe
息	cgn
冲	sv
酒	ez
保	it
片	wu
形	cku
阵	kwb
南	yqt
决	eih
请	aqj
各	lr
报	iw
兴	cab
阳	jzb
急	enb
语	jsj
令	daf
错	xx
及	enw
刘	dyg
极	end
试	tlj
备	idg
慢	psc
雪	cb
苦	uc
若	fx
领	dqf
收	tx
底	hf
尽	ers
准	kmh
华	mq
答	hak
众	kzf
千	ax
消	cd
视	tlw
罗	dsz
敢	lnk
留	dyw
克	urt
乐	dr
够	lke
跑	wt
显	cq
嘴	nz
官	lfl
断	hc
未	gdq
势	tlv
句	ehw
求	ay
计	elj
论	dxj
达	han
则	ndi
害	mbl
八	ie
单	ho
九	ezw
久	ezwy
脚	ezr
德	hdf
元	jib
脑	yt
楚	sc
雨	jsq
睛	ejpr
响	cnu
刀	huk
确	aot
玉	jhg
沉	sy
北	igq
格	ld
停	ok
陈	syb
市	tlg
朝	sr
喝	mku
族	nm
江	emh
团	oi
母	pc
章	kyd
装	ka
亮	dwg
客	url
照	kwr
乱	dc
易	jlr
足	nmu
依	jgf
黄	mgx
修	cof
破	wf
台	ojk
球	ayg
呀	je
院	jc
送	zz
包	iuw
义	jlh
诉	zi
攻	lvlg
丝	zgz
围	gh
玩	gqg
待	hbfx
复	viw
况	ub
楼	dtd
丽	dlq
痛	oz
梦	pw
呼	mju
摇	jrv
期	aga
英	jjx
低	hg
帝	hlg
兄	csu
背	idi
持	sn
爷	jdi
皇	mgi
六	deg
穿	sf
杨	jzd
政	kwk
运	jx
居	ee
叶	jru
热	fr
校	cpd
谢	cpj
曾	nh
古	lc
细	clz
产	sng
睡	tep
希	cgc
速	zin
室	tll
旁	wz
另	dau
怀	mv
露	dij
异	jlk
写	cwl
鬼	lz
娘	yqy
式	tlll
除	sm
级	enz
考	ut
建	eun
愿	jcs
招	ku
饭	vs
布	iiq
续	chz
程	som
首	tdb
观	lfj
朋	wo
务	gig
掉	hp
赶	lno
忽	mjg
注	kih
术	tid
甚	tw
差	srb
呵	mkuu
展	knt
争	kh
品	wy
兰	dqb
宝	itl
香	cmm
斗	hk
故	li
雷	dh
念	yu
段	hcw
顿	hxo
角	ezb
疑	jni
护	mi
闪	tnp
木	pit
需	ce
调	ooj
类	dd
妹	pd
爸	iri
线	cuz
左	np
游	jth
派	wb
谈	oq
激	egh
冰	ijh
敌	hn
跳	op
支	kgtj
约	jy
巴	iek
您	ysf
顾	lis
肯	ug
醒	cqj
铁	ow
抱	iwv
淡	hsh
造	nw
货	mxf
资	ngh
群	ahj
集	enf
联	dbb
商	tyg
号	mw
节	ekx
讲	enj
掌	kp
赵	kwo
密	pl
病	iai
卫	gdb
米	pf
威	gxy
继	elz
渐	euh
统	oqz
追	kln
亚	jrqj
简	eq
练	du
基	ega
选	cbn
推	ol
改	lre
退	oen
味	gdu
份	vw
举	esb
示	tlb
忍	fg
历	dls
器	alu
恐	uq
引	jyl
识	tnj
皮	wn
习	cnk
靠	uw
导	htk
存	xh
莫	pfx
志	klt
区	ae
汉	msh
右	jkq
严	jqq
态	obo
买	pr
幸	cao
社	tr
佛	vqf
议	jlj
树	tidx
止	kft
块	uoo
守	tdl
毛	prw
挥	ml
胡	mm
散	zs
板	in
仅	eyf
隐	jyb
怒	yi
床	sgl
苏	zj
料	dp
股	lcr
局	eb
班	iog
图	om
岁	ze
礼	dfw
独	hma
初	sj
福	vmw
顺	txs
狂	uga
默	pfm
巨	ehu
既	elk
松	zv
证	kwj
烈	dph
否	vd
恶	br
治	klh
缓	mbz
排	wj
费	vdv
耳	bpq
医	jgu
寒	mql
哭	uj
温	gqh
府	vc
担	hov
称	sh
余	jbf
钟	kve
泪	ddh
烟	jom
仍	fo
具	ehq
恩	bq
毕	ili
警	eqx
蓝	dqx
宫	lvlu
吸	cgu
陆	dib
究	eol
抓	kzv
压	jes
沙	teh
救	eea
呆	hau
河	mdh
迷	pnn
枪	am
组	nc
权	aid
叹	os
孙	zsn
卷	ebh
查	sa
毫	mrg
春	ss
察	sal
圣	twj
草	xt
较	eps
胜	twr
遇	jhn
充	svg
史	tfq
堂	ozb
防	vzb
据	ehv
猛	pm
骑	anp
土	oc
卡	uvt
助	kia
京	ejg
银	jse
贵	le
永	jqh
质	klwf
屋	gj
须	cew
副	viq
换	mc
刺	xlq
属	tc
闻	gyp
境	eao
禁	erd
阴	jvb
共	lzx
负	vib
弄	yz
翻	vo
虎	mcq
层	xo
喊	mn
逃	orn
晓	czr
座	nxl
雅	jvj
参	xok
射	trt
婚	msy
险	cqb
君	esj
划	mqlh
坚	exq
价	eyfe
柔	ft
超	su
扬	jzv
科	uk
按	qsv
狠	mga
野	jrd
秦	as
秘	plm
熟	tm
置	klz
仙	cxf
模	pqd
伸	tqf
波	ith
肉	fk
假	eaf
齐	ang
舞	gcw
脱	osr
广	leg
姑	lj
麻	pal
投	otv
顶	hqh
致	klk
责	ndq
景	eqr
营	jkx
维	ghz
设	trj
坏	mo
啦	deu
秀	cem
败	ib
眉	phk
州	kxh
药	jwx
承	sok
案	qsl
狼	dz
专	kfq
偷	oxf
画	mfq
吴	gmu
店	hul
弹	oql
食	tnf
欲	jhi
抬	ojv
标	idd
秋	aom
厉	dlsg
良	dqh
际	elb
状	kbh
烦	vqm
午	gcwl
摆	irv
戏	clj
桌	ksq
船	sik
短	hbt
村	xs
某	pdl
摸	pt
付	vif
演	jnh
规	ll
萧	cdx
封	vho
握	gf
田	obg
唐	ozl
藏	xz
震	kwjm
混	mxh
虚	ceq
透	okn
纪	elze
凌	dkh
休	cofd
嘛	peu
梅	phd
紫	nfk
歌	lkl
临	dsq
毒	hmq
宗	nv
著	kix
索	zpt
印	jrw
寻	chk
湖	mmh
劲	erk
职	knb
技	elv
恨	mwc
婆	wq
杰	ekd
羽	jsc
咱	nqu
素	ziq
凡	vqe
值	knf
飘	wd
养	jp
嘿	mxu
普	wc
宁	ykl
吓	cyu
兽	tkb
夏	cyq
读	hmj
街	ehf
牛	yy
仿	vp
胸	csr
浪	duh
富	vil
尚	tub
宇	jsl
骨	lcq
智	kltr
纷	vqz
升	thw
叔	tjt
善	tsb
弱	fxl
架	eyd
卖	pb
袋	hbfm
网	gpq
朱	kj
骂	pru
雄	cvq
赛	zbl
略	do
杯	ixd
施	tgv
墙	aqo
环	mig
罪	nez
牙	ja
窗	salg
柳	dzd
厅	ojs
搞	lt
端	hfd
洞	hzh
适	tln
拥	jvv
释	tlwq
洋	jzh
肩	exm
魂	mh
闹	yw
蒙	po
洗	cfh
灯	hh
借	epf
伯	iq
免	pqb
菜	xb
验	jsp
凤	vwe
鱼	jbb
徐	cbf
型	ckuo
娜	yry
暴	iwr
亡	gzg
讨	otj
辈	idv
懂	hqc
腿	ozr
灭	pp
妙	ppy
效	cpg
危	gxb
优	jxf
盘	wqk
套	owh
丁	hj
趣	aho
妖	juy
束	tiq
杂	na
诗	tgj
迎	jkn
舍	trf
旧	eeq
彩	xr
委	gg
挂	lfv
笔	ifk
狗	lda
鲜	cxb
纸	kfz
抗	uu
探	osv
韩	mqt
尼	yn
控	uz
惜	cgcr
珠	kjg
抽	sx
创	sb
归	llq
挺	oqv
奋	vwh
陪	wh
硬	jat
避	iln
园	jig
托	osva
训	cxj
勇	jqk
聊	dob
奶	yryy
庄	kal
奔	iqh
镇	kwe
拳	aih
采	xrw
研	jqt
配	wdj
介	epfq
尊	ns
冒	pwq
虑	dhq
敬	eax
丹	how
舒	tjf
蛋	hsk
哼	mhu
宋	zzl
济	elh
妇	viy
箭	euk
择	ndv
犯	vsa
欣	cve
甲	eaq
欧	rx
课	urj
扑	wjv
菲	vg
燕	jsx
曲	aeq
躲	hpt
玄	cig
幻	mcz
茶	sax
折	kd
亿	jlf
傻	tv
姓	cay
源	jih
洛	dxh
遍	iun
臣	syu
弃	alg
犹	jta
占	ksqu
漂	wdh
挑	od
获	mxx
绿	dhz
峰	vhz
俊	exf
疯	vhi
列	dphh
森	zq
妻	agq
恋	dug
误	gij
拜	ibw
伟	ggf
移	jnm
纳	yrz
党	hpb
罢	irz
腰	jur
巧	az
孤	ljn
闭	ilp
圆	jigf
碰	ww
镜	eae
软	fb
厚	mks
累	ddo
昨	nsr
幽	jxz
悲	ixv
丈	kuq
牌	wjw
降	ewb
颜	jqgf
劳	drx
偏	wx
省	tmt
糊	mmp
馆	lbt
烧	tum
谓	gdj
财	xj
舰	euke
汗	mshl
奈	ybh
操	xu
迹	eln
尸	tgk
悄	ad
残	xq
尖	exqh
鲁	dcb
锋	vhe
圈	afg
油	jthj
俩	dafd
项	cwlf
撞	kbv
瞬	txp
忆	jlc
盖	lbb
尤	jtq
徒	omf
乡	cmk
概	lbd
户	mih
荡	hux
艺	jlx
增	nho
祖	ncw
困	ux
殿	hut
迅	cxn
横	mod
范	vsx
律	dhf
番	vow
企	aff
惨	xn
限	cub
聚	ehb
含	mqf
凭	wkf
剧	eht
碎	zet
躺	opt
缘	jiz
凉	dqhc
腾	oor
织	kgz
抢	anv
预	jhk
沈	tgh
替	olv
孔	uqn
批	wg
康	uy
惑	mxm
唯	ghu
率	dhg
惯	lcc
登	hhk
互	miq
盯	hjp
稍	tumr
宣	cfl
唱	suu
诚	soj
剩	twa
咬	jtu
育	jhgr
诸	kjj
触	sib
晨	syr
策	xrk
疼	ooi
漫	psh
材	xjd
补	ic
私	zgm
吐	ocu
纯	shz
艾	qbx
贝	idq
谷	lci
庭	okl
挡	hpv
晃	mbr
吉	ent
吹	sl
仔	nff
仇	st
凝	ykh
鼓	lct
农	yah
席	cnl
征	khf
帅	toq
附	vibx
缺	ayv
塞	za
豪	mrgy
亦	jlg
杜	hid
努	yc
判	ws
谋	ptj
胆	hnr
尘	syq
扎	ke
滚	lm
闷	pqp
迟	snn
稳	ggm
翼	jlci
诺	yx
闲	cbp
灰	mlq
朵	hpe
盛	tws
梁	dqhd
晶	ejr
餐	xoq
爆	iwm
伦	dhfi
娇	edy
侧	xrf
愣	dwc
鼻	inn
轮	dhs
昏	mst
抖	hdv
陷	cube
敏	pyp
词	xnj
慌	mac
愤	vwc
怜	dbc
颤	ssg
阶	ehbe
苍	xy
距	ehn
郑	kwbb
川	sfw
扫	zt
逼	ign
县	cua
忧	jxc
童	oad
执	knv
丢	howk
荣	fax
臂	ilt
逐	kmn
傲	qw
戴	hbi
芒	pzx
庆	aa
伴	isf
袭	cnd
供	lvf
积	egm
测	xrh
遥	jrn
阻	ncb
例	dlf
睁	khp
岛	htw
遗	jnn
瞪	hwp
慕	pix
皱	kkb
博	iqt
幕	pixe
猜	xaa
益	jlb
净	eah
泽	ndh
炼	dum
监	exqp
鸡	egj
珍	kqg
伏	vmf
绍	twz
曹	xrq
爬	wa
丫	jeb
炸	krm
壁	ilto
泳	jqhj
凶	csc
郎	dzh
宿	zil
怨	jcc
醉	nej
拼	wv
迫	wfn
革	ldx
瞧	aop
奥	qww
输	tjs
莉	dlx
忠	kvk
颗	ukl
嗯	bw
佳	eof
旅	dsv
仁	fy
鸟	yzw
骗	wup
浩	mwh
塔	ovo
胖	wur
绪	chzr
枫	vhd
拔	iav
赞	nsc
炮	wwm
傅	vifx
凯	urz
邪	ckj
芳	vyx
浑	mhh
夺	hshx
宽	uf
堆	hlo
裂	dphm
遭	nu
赤	slo
旋	civ
扭	yzv
洁	ekh
浮	vmh
悉	cgw
擦	xe
慧	mev
典	hqq
赏	tp
匆	xv
评	wkj
纵	nzz
莲	dbx
雾	gijd
乌	gjw
跃	jon
壮	kbht
贴	oh
丰	vhq
隔	ldb
健	eufe
辛	cvdt
抵	hfv
竹	kmw
彻	srf
摩	pqlt
轰	mvs
编	ixz
肚	hir
插	se
磨	pqlu
哎	qa
御	jhf
耐	ybb
惧	ehc
氏	tlwk
辉	mlb
扶	vmv
恢	mlc
貌	pww
额	bd
述	tin
票	wp
录	dik
拖	osvj
膀	ip
鹰	jjl
孟	pwn
递	hln
瑞	fe
唇	shs
暂	nss
伙	mpf
琴	asg
踪	nvn
码	pvt
尾	ggt
慰	gdt
蛇	tds
玲	dkg
晕	jsr
损	zm
轩	cfs
粗	xjp
掩	jnv
屁	wl
悠	jxfc
仰	jpf
零	dkj
盟	por
途	omn
贼	nhi
洪	mah
悟	gic
固	lig
讶	jrj
冬	hvg
滑	mqh
甜	oba
郁	jhj
琳	dsg
辆	dws
乃	yrk
猪	kja
暖	ybr
妮	yg
挣	kwv
旦	hsr
估	ljf
坦	ono
甘	loq
佩	wdf
莱	djx
享	cng
吼	mdu
构	lkd
粉	vgp
萨	zrx
吻	ggu
潜	abh
瓶	wkb
偶	rd
戒	epq
浓	yahm
毁	mze
销	cde
迪	hnn
拒	ehve
绕	fwz
勒	drxd
朗	dphr
嘻	cguu
帐	kue
废	vdl
延	jqn
敲	adg
烂	dsm
曼	psr
厌	jss
宜	jnl
羞	cob
喂	gdum
吟	jsu
滴	hgh
洲	kxhk
爹	hhi
艳	jsv
晴	akr
抚	vcv
缩	zsz
协	ckt
央	jyq
悔	mzc
肖	cpb
缠	sq
脆	xer
痕	my
伍	gcf
寂	ell
启	afm
翔	cqbc
薄	irx
侯	mt
劝	ac
郭	lsg
奴	ym
鸣	pku
倾	ajf
彼	iff
扔	fh
撒	zvv
豫	jhkc
检	eqd
针	kqe
耀	jwb
痴	sgi
姆	pcy
篇	wxk
椅	jfd
厂	spq
董	hqx
熊	cvk
埋	pj
乖	lh
狐	mma
蒋	enx
踏	ornr
隆	dab
括	uxv
潮	srh
唉	qbu
穷	avl
聪	xvb
唤	mcu
泰	obq
版	inw
末	pfq
旗	anvi
伊	jgfj
焦	edf
猫	pua
盗	hwh
侍	tlf
挤	efv
款	ubt
拾	tnv
荒	max
姿	nghy
域	jho
搭	hev
脉	pbr
授	tkv
俗	zmf
融	faq
狱	jha
欺	agaf
访	vpj
桥	aod
锁	zpe
霸	irj
牵	axh
池	snh
钻	nfe
港	lph
喃	yqu
廷	oknf
乘	soa
玛	pvg
奉	vwq
扯	srv
岳	joa
减	eqh
弯	go
夹	eoq
辞	xna
岸	qsz
岂	afz
屈	aet
恼	ytc
哲	kdv
季	elm
召	kwh
丧	zu
尝	szbk
恭	lvx
载	nbs
瘦	tki
皆	ehi
颇	wtw
茫	pzxg
染	fn
肃	zik
爽	teq
亏	ul
吞	oso
惹	frx
哀	qag
乔	aoj
趁	sw
铺	wje
脏	ny
吕	dsu
奖	enh
倍	idf
汤	oy
振	kwvm
婷	oky
牢	drl
扰	ftv
溜	doh
庞	wzl
臭	skn
悦	joc
赫	mro
赢	jkg
跪	len
麦	pbq
枝	kgd
侠	cdf
泉	aii
劫	eko
炎	jqm
泥	ynh
赌	hci
弓	lvk
魏	gdm
罩	kwz
疾	eni
饰	tlte
符	vmk
垂	sbw
映	jar
漠	pfh
脖	iqr
饮	jyt
沿	jqhu
懒	dnc
肤	vjr
桑	zy
堪	uoot
燃	fqm
卓	ksqt
祝	kiw
赖	dbt
宾	ivl
贾	eac
喘	sbu
焰	jsm
吵	stu
冥	pkl
鞋	ckx
逸	jln
均	eso
库	ui
裤	uiw
碗	gnt
航	mzk
踢	og
姨	jny
酸	zfj
啸	cpu
龄	dkk
阁	ldp
舌	tda
箱	cmkp
冯	voh
邦	iyq
钢	lye
霞	cdj
促	xi
泡	wwh
盾	hxw
羊	jzbq
碧	ilg
援	jiv
忌	ele
抹	pjv
倩	au
锐	fee
喷	wqu
拦	dqv
嘉	eot
袖	cewj
殊	tjh
辰	sys
繁	vqp
络	dxz
抛	wuv
嫁	eyy
咒	kku
撤	srvg
键	eue
湿	tghj
恰	ayc
虫	sak
审	tgl
献	cut
媚	pdy
贤	cbq
葛	lrx
刹	tec
袁	jio
摔	thv
序	chl
筑	kik
斜	ckf
瓦	gv
涂	omh
湾	goh
莎	tex
崇	saz
猎	dpa
刑	ckuh
墨	pfmo
娃	ga
梯	ogd
桃	ord
豆	hkq
驾	eydp
浅	aqh
径	eafl
饿	brt
疲	wni
搬	iov
瓜	lzw
莹	jkxj
滋	nghz
润	fxh
铃	dke
蛮	pqg
蒂	hlx
拨	itv
涛	ou
予	jsk
勾	lxw
惠	meq
析	cgd
砍	un
撑	shv
截	ekq
措	xxv
币	ilw
薇	gxx
愈	jhfc
督	hjt
酷	uij
祥	cqw
怖	iic
侵	avf
岩	jqz
扮	isv
糟	nup
盈	jky
腹	vir
斩	kns
尺	sft
签	axk
稀	cgm
掏	ouv
夸	uzh
汽	alh
液	jrh
姬	egy
愧	ue
汇	meh
柱	kid
粮	dqp
堡	itf
仗	kuf
笨	iwk
奏	nk
歉	aub
甩	tjw
怔	khc
允	jm
竞	ead
祸	mxw
耶	jkb
爵	eiw
绩	elzf
诱	jkj
呜	gju
穴	cil
黎	dnm
租	nj
培	who
砸	nat
麽	pqlp
井	eqq
窝	gt
弥	pnl
返	vnn
匹	wfu
啥	tau
凑	xk
奸	exy
陌	pfb
叛	wsh
核	mdd
卧	gfu
幅	vme
眨	kvp
耗	mwv
洒	zvh
怡	jnc
详	cqjj
卢	dmq
扣	ukv
哇	ge
丑	sd
勉	pqbd
孝	cpt
矛	prk
氛	vqa
衡	mof
陶	orb
购	lki
汪	gyh
僵	emf
疗	doi
妃	vxy
罚	va
棋	and
缝	vwz
咐	viu
躯	aetc
泛	vsh
愁	stm
搜	zx
慈	xnb
肥	vhr
笼	dak
篮	dqk
俱	ehfi
惟	ghc
柜	led
捉	ksv
悬	cia
霍	mxj
泄	cph
咽	jou
齿	sfk
秒	pzm
勤	asx
扩	uxvl
屏	wkt
霜	taj
袍	wrw
蝶	hks
祭	elw
厨	sms
胁	ckr
璃	dngd
劈	wgt
赚	kci
锦	eye
尬	lrq
尴	loqp
熙	cgub
寺	zlo
昌	syrr
贺	mrd
巾	evq
描	pov
捕	icv
陵	dkb
咳	udu
扇	tsm
虹	mas
绵	pbz
撕	zgv
蔡	xbx
催	xlf
彭	wot
宠	sql
贪	oof
辱	fc
誓	tlvu
盒	mdfp
寸	xxq
披	wgv
搂	ddv
饶	frt
跌	hhn
欠	aubf
肌	egr
售	tkf
巡	chn
抑	jlv
纹	gyz
宏	mal
幼	jkz
萍	wkx
驻	kip
丛	xaf
仪	jnf
播	itvo
俄	bdf
刃	fwh
蕾	dg
挨	qav
仲	kzfk
迈	pbn
违	ghn
辩	iud
埃	qao
艘	zxk
琪	angi
灾	nal
僧	zh
渡	hih
卑	ixw
雕	hdk
鼠	tce
讯	cxjt
辣	drd
刷	tzt
艰	exj
斥	slw
裙	ahw
翠	xec
饱	itt
掠	dov
询	chj
勃	iqtd
夕	cgwh
矮	qr
瑶	jrgv
赐	xli
捏	yh
闯	sep
姚	jry
瑟	zrg
渴	urh
谅	dwj
昂	qz
串	scq
沟	lxh
涉	trh
咕	lju
驶	tfp
摄	trv
贫	wsi
辕	jis
婉	gny
鹏	wor
姜	emb
碍	qbt
荷	mrx
冠	lcl
魅	pdlg
玫	phg
裁	xjm
坡	wto
鸿	mahy
邓	hwj
歪	gai
乏	vaw
申	tqq
割	lklh
巫	gjq
衫	tow
棒	iudv
阔	uxp
泣	alhd
韦	ghq
恍	mec
贯	lck
魄	wfi
柄	iqd
患	mcs
覆	vic
蜜	pll
婴	jji
励	dlsd
锅	lse
陛	ilb
遮	kkn
帕	wre
咖	ueu
嫌	cby
胳	lkr
挖	gev
啪	we
矿	ubtl
凄	agh
爪	kfw
眠	pbp
穆	pim
啡	vxu
吾	gmg
坛	oqo
脾	wnr
恒	moc
屠	omt
玻	itg
蓉	faxu
础	sct
曰	jyg
耸	zqf
膊	iqrx
逆	yl
寿	tkq
驱	aep
猴	mta
佣	jvf
毅	jld
舅	eee
铜	oae
娟	efy
眯	pgp
淫	jsh
吩	vqu
匪	vgu
牧	piy
役	jlfj
寄	ellu
诡	lzj
纤	cxz
腐	vcl
姻	jvy
晰	cgr
渊	jfh
亭	okg
邀	jun
哄	mqu
骚	zup
墓	pixo
棵	ukd
筋	evk
崔	xlz
灿	xsm
捷	ekv
淋	dsh
弗	vmkq
辑	ens
棍	lxd
绳	toz
频	wsk
廊	dzl
畏	gdo
歇	chr
裹	lpg
苗	pox
盼	wsp
咯	uvu
耍	tfb
煞	trb
寝	ayl
瞒	pqpd
添	oxh
嫂	zty
纠	eoz
慨	urc
嚷	fp
驰	snp
拐	ljv
宴	jsly
津	evh
岚	dqz
浴	jhh
耻	sfb
挽	gnv
页	jrqf
誉	jhb
牲	thy
乳	fcw
仓	xyf
逝	tlne
喉	mtu
逛	lbn
樱	jjd
兼	exb
戈	lkq
哗	mqut
涯	jah
捧	wm
铭	pke
障	kub
摊	oov
跨	ufn
妥	opw
揉	ftvd
晋	erj
寞	pfl
寨	kbl
漆	aght
污	gjh
嘲	sru
枚	phdg
吊	hpu
乾	abt
馨	cvt
伪	ggfg
嗓	zpu
呈	sou
卿	ajw
楠	yqd
籍	enk
裸	dpw
链	due
灌	lch
昆	us
畅	sut
逍	cdn
帽	pwe
阅	jop
逗	hkn
蹲	hsn
踩	xrn
窜	xc
哑	jvu
趴	wen
逢	von
植	knd
媒	phy
韵	jxd
昭	kur
尹	jyk
谦	axj
档	hud
趟	ouo
沾	ko
兔	oib
订	haj
朴	wcd
瞎	cop
鞭	ixx
俺	qn
斤	evw
翅	slt
肠	szr
雀	aotq
慎	twc
盆	wyi
迁	axn
镖	ide
芬	vqx
崖	jaz
丘	aow
蠢	smss
庙	ppl
潘	woh
颖	jqi
拓	oxv
娶	asb
纱	tez
漏	dkhj
谨	eyj
珊	tog
仆	wmf
宙	kkl
尉	gdtx
屑	cptr
叮	hju
捂	gcv
涩	zrh
诧	srj
柴	sjk
杆	lod
涵	mqhm
坠	keb
赔	whi
涨	kph
嘟	hjub
崩	ih
薛	cyx
藤	oox
税	tem
枯	ujd
译	jljq
帘	dbl
糖	ozp
愉	jbc
骄	edp
羡	cubf
糕	lup
彬	ivd
愚	jbq
疏	tjk
翰	mstc
堵	hco
腕	gsr
眸	ptp
芸	jhx
溪	cgh
殷	jvw
谎	mej
鼎	hqp
稿	ltm
哟	jtut
冤	jfl
症	kwi
柯	ukdu
狄	hna
咧	dwu
湘	cmh
宛	gnl
嫩	ywy
肆	zls
宰	nr
憾	msc
偿	szf
腔	amr
哩	dgu
豹	iww
瑰	llg
鉴	euq
绑	ipz
潇	cdh
戚	agc
郡	exjb
澡	nth
桂	ledo
兮	cgi
雯	gyj
颠	hxt
狮	tga
邻	dsf
契	alv
骇	mbp
卜	icq
揭	ehvk
妄	gugy
坑	uh
伐	vaf
矩	est
烁	txm
葬	nux
诀	eij
鄙	ifu
鹿	dil
柏	ird
溃	ueh
朕	kwrh
舟	kxw
妆	kah
躁	nwn
霉	phj
侦	kqf
冻	hzhh
娅	jryj
庸	jvl
筹	stk
削	cdb
砰	wht
耿	lmb
牺	cgy
筒	oqk
遂	zen
旭	che
胎	oar
惶	mgc
淑	tjhj
叉	sej
痒	jpi
竖	tiqd
龟	llb
斑	iogg
儒	fmf
嫣	joy
宅	kjl
押	jev
胃	gdor
旨	kfi
册	xrwq
膝	cgrt
浸	erh
弦	cbl
栏	dqd
衷	kvg
刮	lza
艇	oqkf
岗	lpz
赴	vio
囊	yzq
斧	vci
颊	ede
疆	eml
炉	dmm
塌	oeo
乞	afw
旺	gur
烤	utm
黛	hbfb
逊	cxnc
贱	eui
辨	iudt
狸	dna
叙	chf
愕	brc
叠	hkj
遣	aqn
晌	tpr
麟	dsl
腥	cjr
粒	dlp
拟	yf
俏	ap
杖	kud
芝	kgx
夷	jnq
衬	sww
佐	npf
巷	cwx
捡	eqv
遵	nsn
塑	zib
桶	oqd
泼	wth
滩	ooh
琼	avg
昊	mwr
帆	voe
搏	iqv
颈	eqk
噢	rt
蹦	iwn
寡	lflh
贞	kqq
凰	mge
哨	twu
拆	sav
茹	fmx
劣	dpt
嘱	kcu
沃	gfh
厢	cms
摘	kav
咋	keu
坤	uso
俯	vcf
媳	cny
赋	vii
嘶	zgu
贡	lzl
碌	dit
匙	snr
拢	dqvi
谭	oqj
翁	ghi
辜	ljt
竭	ekdk
廉	dble
械	cpdl
贸	pwwf
辅	vcs
讽	vmj
呐	yru
斌	ivg
辽	don
填	oboi
窃	apl
抄	suv
溢	jlhp
妒	hiy
吁	jhu
嗦	zsu
掀	cxv
芙	vmx
祈	anw
栋	hzd
吱	kgu
撇	wwv
胞	iur
轿	epsa
禅	sqw
妨	vzy
拂	vmvv
倦	ec
衰	thg
靖	eadr
循	chfp
挪	ysv
蓬	wox
惩	sof
垃	deo
账	kui
驳	iqp
署	tcz
甫	vcq
顽	gqb
姥	dty
圾	ego
熬	qrq
枕	kgdk
丐	lbq
茜	aux
咦	jnu
厕	xrs
攀	wod
彤	oah
妍	jqy
拽	kov
荆	ejx
妓	ely
壶	mmt
於	jbv
寇	uklj
鹤	mrh
钥	joe
骤	kkp
渺	pzh
刊	uol
肢	kgr
烛	kmm
孕	jxy
绽	ksz
彦	jsg
棉	pbd
俘	vmfn
盔	ulm
剪	eqb
诞	hsj
兜	hxwb
凛	dyh
岭	dqzk
嚣	cdu
溅	euhl
笛	hnk
舱	xyk
罕	mnl
鸭	jee
债	kbf
噬	tlu
钉	hje
躬	lvt
倚	jff
缕	dszy
咚	hvu
撼	msv
蕊	fz
侄	knfo
佑	jkf
雁	jssq
隶	dlk
践	eunl
拱	lqv
沐	pih
菊	ebx
蜂	vhs
裕	jhw
兆	kwbh
搅	ezv
尿	yp
黯	qsm
歹	hrq
蓄	chx
朦	porp
嘀	hnu
怯	apc
叨	huu
纽	yzz
聘	wrb
腻	ylr
剥	iudh
彪	idm
沸	vdh
氓	pzg
榜	ipd
逻	dsn
壳	udt
储	scf
憋	ihi
啤	wnu
匠	ewu
悍	mscl
昧	pdr
泊	wthi
篷	wok
烫	ouh
狡	eza
轨	lzs
汹	csh
携	ckv
磊	dgt
隙	clb
仑	dhfi
摧	xlv
瞄	pop
胧	dar
趋	aeo
挠	yrv
煌	mgm
擅	tsv
卒	nmg
饼	iqtu
狭	cda
丸	gqw
惫	idgc
瞅	sdp
犬	abhh
砖	kftk
矣	jfkh
楞	dod
昔	cgx
裳	tyb
骆	dxp
雇	lim
阎	jqp
骷	ujl
鸦	jej
妞	yoy
墅	tido
焚	vyd
谱	wcj
绘	mez
梳	tjd
肿	kqr
魁	ubl
耽	hob
擒	asv
陡	hdb
璋	kyg
茂	pwx
蹄	onn
瞥	whip
瞳	oap
髅	dtl
绣	cez
硕	txt
肺	vdr
兹	ngb
炒	stmt
邮	jtj
弘	malk
嫉	eny
届	eptj
嗡	ghuc
娱	jby
喧	cfu
脂	kgrr
膛	ozro
沧	xyh
疚	eei
盐	jqo
扁	iqm
搁	lkv
茅	prx
滔	ouhe
坟	vyo
掐	aov
瑜	jbg
邱	aoa
桐	oadu
茵	jvx
苹	wkxt
旷	ubr
翘	aplc
郝	mto
蓦	pfxp
诈	krj
沫	pfhp
菁	ejxr
粹	xep
琢	ksg
腊	drr
钦	ave
喻	jhuh
宪	cul
锻	hce
睹	hcp
郊	edg
饥	egt
侃	unf
粘	kop
媛	jiy
谊	jlja
恳	ugk
厮	zgs
锤	sbe
凳	hwhe
淮	mvh
蔽	ilx
聂	ypb
贩	vsi
潭	oqh
翩	wxm
呻	tqu
枉	gpd
拘	eev
煮	kct
焉	jok
址	kfo
匕	ifw
渗	twh
览	dnq
敦	hsg
厦	cys
蕴	jxx
冉	fnq
薪	cvx
呃	bru
峻	exz
荐	eux
栽	nad
嚎	mru
汁	kgh
傍	iuf
秃	ojm
磕	ukt
禀	iqg
珑	dag
坎	uno
邵	twhb
萌	poxr
窄	krl
阮	fbb
蹈	htn
碑	ixt
婶	tgy
煤	phm
寓	jhl
栈	ksdl
滞	klhe
倘	opf
杭	mzd
暇	cdr
狈	ida
峡	cdz
侣	dsfu
芦	dmx
蔓	psx
蒸	khx
禄	diw
胀	kurs
醋	xij
淌	oph
伞	zn
姊	nfy
钩	lxe
衍	jnfh
妾	apd
嘎	leu
蜀	tczs
蝴	mms
萝	dsx
莽	ppx
弩	ycy
祷	htwx
稚	klm
圳	kwos
徽	mlf
衙	jaf
咸	cbu
陋	dkbi
奢	tkh
罐	lcv
霄	cdjr
毙	ilii
汝	fch
敞	spb
暮	pixr
嘘	ceu
灼	ksm
澜	dqhe
姗	toy
倪	ynf
挫	xxvo
咪	pgu
钧	ese
捣	htv
燥	nwm
涌	jqhj
已	jfkk
眶	ubp
澈	srhg
焕	mcm
酬	stj
筷	uok
宵	cdl
缚	viz
揪	eov
蚁	jfs
喇	dv
丞	sod
拎	dvv
棠	ozbd
咙	daui
梭	zsd
哧	sgu
棺	lfd
璇	cigf
瀚	mshc
肝	lor
敛	dqfg
剂	elg
疤	iei
渔	jbh
嗔	squ
沮	esh
廖	dpl
虏	dcq
皓	mwi
勋	csud
恕	tiy
虐	yoq
虞	jbqo
综	nvz
瘾	jyi
驴	dbp
晒	tbr
卦	lfo
迦	eon
陀	osb
窥	ull
堕	hxb
哆	hsu
葡	wmx
帖	ohe
垫	huv
屡	dst
鹅	bdg
蛛	kjs
盲	pzgp
碟	hkt
狞	yka
囚	aygf
诊	kgj
揽	dnv
裴	whv
捞	duv
吏	dlqy
铮	khe
萄	orx
盏	knl
霆	okj
喔	gtu
贷	hbff
勿	giw
吭	uhu
淘	orh
辟	iltt
蔑	ppxl
淹	joh
麒	anl
喽	dxu
栗	dlc
绷	ihz
惚	mjc
桓	mid
坊	vzo
桩	kad
嗽	zk
履	dstg
璐	dig
菩	wmxu
巢	srk
畜	chg
兀	giq
樊	vqd
锡	cge
棚	wodr
仕	tlft
倏	tjfa
芹	asxe
僻	wlf
絮	chy
杏	cad
浆	emht
瘫	ooiy
啧	ndu
磁	xnt
冈	lyq
逮	hrn
搓	xsv
赠	nwi
胶	edr
脊	efh
噩	brq
绰	sxz
呕	rdu
嚼	eou
谐	ckji
歼	exh
揣	shvb
殖	knh
拧	yqv
伺	zlfu
霖	dsj
驼	osp
襄	cmg
衔	cbfh
惕	olc
掷	klv
卸	cpgb
炽	slm
敖	qrqg
惭	xqc
框	ubd
捆	um
眩	cc
蝉	sqs
谜	pnj
炫	ccm
塘	ozo
阱	eqbe
膜	pqr
亨	mhg
奕	jlgh
蚂	pvs
猩	cja
滨	ivh
沁	ar
跋	ian
藩	vox
舔	oqa
捐	efvr
歧	ank
隋	zbb
蹭	xw
甄	kqc
蜡	drs
嗤	sgus
缸	lyv
嬉	cgyu
哮	cpun
熄	cgmc
窍	apla
俞	jbfh
豁	mxl
垒	dgk
掘	eiv
琦	angu
屎	tft
乍	krw
孽	ypx
毯	onp
弧	mml
槐	mvd
铠	ure
挟	ckve
襟	evwc
梨	dnmd
嗅	ceua
祁	anwb
纲	lyz
渠	abhd
矢	tfw
捅	oqvj
扛	uzv
朽	czd
忖	xm
匈	csw
扒	iev
雍	jvg
莺	jjxy
侮	gcfp
闺	llp
霓	ynj
稽	egmr
斋	kag
夭	juw
沦	dhh
揍	nkv
瞟	wzp
苟	ldxu
琉	dygk
漪	jgh
暑	tcr
窟	ujls
钓	hpet
鳞	dsb
瓷	xnh
萱	cfx
株	kjd
倭	gtf
鞘	apx
沛	wdhq
噜	dju
绞	ezz
颓	obm
睿	feq
噗	wju
唔	gmuu
幢	sge
喀	ueuu
诅	ncj
涕	olh
拣	eqvh
谣	jrjv
叽	egu
葱	xvx
拭	tlvl
婢	ily
铸	kie
绮	afzu
剿	ezs
胤	jrwk
秩	klmt
畔	wso
粥	kxl
奎	ubh
绸	stz
茨	xnx
熏	cswb
蹬	hhnh
诏	kwju
岔	sri
叭	ieu
咆	wru
滥	dshp
梧	gmd
垮	ufo
澳	qwh
浙	krh
甸	huw
绯	vxz
诛	kjjk
鲍	iwb
刁	hdkq
厥	eis
蚊	gys
鞠	eex
歆	cvdf
拙	ksvs
茗	pkx
眷	ech
戮	dic
唬	mcue
骏	exp
扳	iovj
踹	son
漓	dnh
蝇	jks
擂	ddvo
涡	gth
沌	hxh
凸	ojq
蚩	sgk
酿	ywj
唾	oxu
琐	zpg
犀	cgt
澄	soh
哉	nau
猾	mqa
煎	exbb
窒	kll
虾	cos
蝠	vms
钞	sue
瓣	isdt
唧	egub
觑	aec
哽	lmu
娥	bdy
婿	chyr
讪	tsj
耕	lhv
葫	mmx
暧	qbr
浇	edh
嗨	mau
诵	zzj
疫	jli
兢	ejt
箫	cdk
颅	dmd
啼	onu
绅	tqz
杉	tod
嗜	tlur
券	ach
遁	hxn
炯	evm
霎	trjy
讥	egje
迭	hknt
彷	wzf
觅	plw
娴	cbyd
抿	pyv
剔	ogr
稻	hwm
敷	vjv
泻	cphj
怠	hbk
龚	lvd
绒	faz
讳	mejg
勺	trw
函	mqd
喳	keuh
颂	zzi
搀	sov
撩	ddvc
擎	akx
巍	gxz
脯	vcr
镶	cme
寥	dol
漾	juh
缴	ezzg
藉	epx
弊	iliq
逞	smn
膏	lug
戳	ssc
呛	awu
凹	qu
叩	uku
禽	asf
懊	qwc
懈	cpc
蛟	eds
亢	uug
呸	wxu
芊	axx
慑	trc
跺	hxnd
跄	awn
蚀	tnt
栖	agd
蔚	gdx
铲	sne
坪	wko
筝	khk
顷	aqi
腮	zar
踉	dwn
狰	kha
踱	hsnj
嗖	zxu
苑	jcx
秉	iqw
猿	jia
堤	hgo
佟	oaf
悯	pyc
唠	dru
憨	mol
肘	kdr
拇	pcv
僚	dof
霹	wgj
婕	eky
禹	jsw
啃	ugu
匀	jhwh
晖	mlr
怅	suc
聋	dad
拯	kmv
忿	vwi
韧	fwg
邹	nxb
梢	tud
肋	ddr
窘	evl
嵌	auz
婪	dqdy
辖	cds
浦	wch
炭	osz
曦	cgrl
簇	xik
螺	dss
酱	ewh
屯	ohq
悴	xect
匡	uau
冀	eli
橙	sodh
倔	eofs
陕	tnb
筱	czk
叱	slu
髓	zzlr
淳	shh
矜	evke
詹	kob
菱	dkx
芷	kfx
惺	cjc
浊	ksh
囔	yyu
朔	txb
憔	aoc
睫	ekp
睬	xrp
鸽	lkf
臀	oht
吨	hsuo
笙	thk
戟	eft
沼	kth
谍	hkjd
昕	cvr
蛊	lcs
煜	jhm
祀	zlw
罡	lyzk
伶	dkf
荫	jrx
酥	zjj
懦	yxc
厄	brs
峨	bdz
轴	kts
伽	eofu
雳	dlj
卵	dbw
捶	sbv
檐	jqd
棘	enq
嗣	zluu
钗	sae
袜	gr
妩	gcy
炕	uum
偎	gxf
窦	hkl
蝎	chs
溶	fah
幺	juk
膨	worw
峙	klzx
缉	egz
徊	mvf
呗	ixu
衅	crc
砂	tet
舵	hxk
昼	kks
迸	iwnu
斟	kqt
舆	jbw
椒	edd
靓	ewa
旬	chw
厘	dns
窑	jrl
萎	ggx
涟	dbh
疙	lkij
瘩	hai
梵	vsd
靴	cyxi
侥	ezf
匿	ylu
挚	klvt
镯	kse
兑	hebb
尧	jrlb
徘	wjf
芽	jax
狙	eeaa
闵	pypc
辫	iudt
瀑	wi
嗷	qru
庐	dml
芯	cvxc
禾	mda
澎	wohw
邢	ckub
绊	isz
蜘	kgs
憎	nhc
靡	pnlv
褚	scw
湛	ksht
蒲	wmxv
嚓	xeu
珂	ukg
崽	nrz
贬	iqi
惮	hsc
婵	sqy
嗒	oru
悸	elc
晦	mer
涅	yph
恬	obc
慷	uyc
穹	avll
渣	keh
屉	olt
缭	doz
绢	ecz
嬴	jkgv
袱	vmwa
黝	jdm
袅	yzwm
淇	anhi
茄	akxu
寅	jsli
赦	tro
悻	cac
祟	zes
榻	ordc
蛙	ges
苇	ggxg
嵩	zvz
茉	pfxp
唰	tzu
咏	jqu
凿	nrj
粪	vwp
噪	nwu
菌	esx
蝙	ixs
庶	til
邸	hft
晟	twrl
禧	cfw
攒	nn
旱	msr
虔	abq
琛	sqg
榴	dyd
漱	tih
忑	orc
匣	cdue
忐	ont
谬	pej
蟒	pps
棱	dodg
钝	hxe
悚	zqc
廓	uxl
惘	gpc
漉	dih
蟹	cpbs
佬	dtf
曳	jrqw
赎	tmi
壤	fpo
忡	svc
倡	suf
冶	jrhu
姝	tjy
筠	jhkh
竿	lok
蜷	ais
癌	qj
嘈	xru
蚕	xqo
剖	wxd
颁	ioi
缀	kez
汀	ojh
谕	jhjh
牡	pcyo
斐	vgv
懵	pmc
皙	cgdi
缪	ppz
蔷	aqx
诫	epj
恤	chc
咄	hsus
馒	pqt
矫	ezt
痞	wfiu
橘	ebd
氧	jpa
贿	mei
肮	qy
瑾	eyg
璧	iltj
烙	dwm
攘	fpv
攥	ncv
汰	obh
溺	ylh
铅	axe
咔	ueui
芭	iex
戎	faw
褐	mrw
巩	lql
吆	juu
彰	kydw
漩	cih
聆	dkbk
蒜	zcx
棕	nvd
鹃	efu
帜	kle
鄂	brub
搐	siv
蔼	qrx
怦	whc
穗	zem
亩	pcg
撰	kcv
绎	jlz
牟	ptk
咨	nghu
奄	jnhh
梓	nfd
绚	ccz
阀	vap
烘	mvm
炙	klwm
翎	dkfc
惋	gnc
驯	cxp
栩	csd
逾	jbnh
墟	ceo
鬟	mis
茬	saxo
褪	oew
鑫	cvf
骸	mjl
峭	apz
缅	pqz
灶	nwmo
洽	ayh
祯	kqw
暄	cfr
裔	jlgu
韶	trd
缎	hcz
砚	jst
锥	kleq
辙	kds
惦	huc
铛	she
枣	ntq
桦	mfd
邃	zeny
橱	smd
搔	zuv
腑	vcrx
萤	jkxs
枢	tjdc
遏	brn
募	pixd
憬	eqc
庵	qol
叼	hdu
嫖	woy
苛	ukx
锣	dse
蹑	ypn
拌	isvi
奠	hub
秽	mem
殴	rxu
喋	hku
糙	xup
貂	hdw
揖	jgv
葵	ubx
榆	jbd
颐	jnuf
皂	nwia
眈	hop
扼	brv
眺	opp
孜	ngn
簌	zikf
玺	cfb
偌	fxf
蹿	xfn
蓓	idx
弛	snl
庇	ill
檀	oqdh
枭	cdw
螂	dzs
趾	kfn
崭	knz
妲	hay
掂	hxv
醇	shj
掺	sovw
驿	jlp
槽	xrd
惬	apce
镰	dbe
抡	dsvi
憧	svcd
删	tox
鸳	jfc
酣	moj
宦	mcl
筐	uak
琅	dzg
瞻	kopu
焱	jsmm
飙	idac
湃	wbh
俨	jnfs
跷	adn
栅	krd
撅	eyv
煽	tom
呱	lzu
缰	emz
猝	xia
衮	lmg
肴	jrc
殆	hbh
谴	aqja
蔬	tjx
飒	zrd
婧	eay
阐	snph
荧	jkxm
侈	sff
霏	vxj
瘟	gqi
芜	gmx
俭	eqf
崎	anz
亥	mbg
俐	dlfh
屿	jsz
譬	wlt
饺	eztc
垄	dqdo
畴	sto
杠	lud
鬓	irs
讼	zzjk
晏	jsry
弈	jlgq
鞍	qox
瘸	aiif
钮	yze
珏	eig
钰	jhe
傀	uzf
噔	hhu
驭	jhp
靶	ivx
萦	jkxc
韬	oug
恙	jub
懿	jlt
竺	kmk
吝	drg
羁	egzp
荀	chxr
癫	hxi
嘭	whu
菇	ljx
恃	tlc
瘪	iwi
儡	dgf
踌	stn
呦	jxu
榕	fad
昵	ylri
躇	smnr
烬	erm
酌	ksj
丙	iqq
涎	cbh
哒	heu
冽	dphh
鸾	digy
砌	alt
烨	jrm
翟	kjc
辗	knsm
噎	jku
驹	eep
噼	wgu
咎	eeg
亵	cpgm
陨	jmb
蠕	fms
冕	pqq
雌	xnk
茸	faxb
瑛	jjg
剃	olb
掰	iaw
蹙	xic
橡	cwd
佯	jzf
笃	hck
崛	eizs
勘	uot
稼	eym
桀	ekc
渝	jbhh
汐	cghc
锈	cee
磅	iut
壕	mrom
娄	dtp
撮	xsvj
玑	egg
祠	xnw
鹫	eegy
娲	gey
黏	ybm
珀	wfg
睽	ubpo
栓	tfd
绫	dkz
阑	dqpe
邑	jlu
瑕	cdg
磋	xst
粟	zic
薯	tcx
沪	mihm
讷	yrj
岑	xyz
炜	ggmg
玮	ggg
娼	syy
迂	jen
伎	elf
鲸	ejb
翡	vgvc
坝	iro
铐	uwe
洼	geh
蹊	cgnh
寐	pdlg
肾	twq
鸯	jyj
敝	ilh
涧	euhr
崆	uvz
甭	ioij
笠	dlkd
扈	mim
哝	yau
芮	fex
卉	met
靳	erx
诬	gjj
札	kadk
婊	izy
裘	aya
扉	vxm
疮	sai
巅	hxz
坞	gio
膳	tsr
剌	drt
鳄	brb
捺	yrvc
悼	hwc
茧	eqxs
毋	gmk
曙	tcrr
馅	cute
簸	ijk
忒	orcl
叟	zd
拴	tfv
嬷	pqy
稣	zjb
痹	iliq
垣	jioh
蛤	masu
谏	euj
羹	lhb
沥	dlh
蛾	bds
瑚	mmg
熔	fam
惆	stc
雏	smb
饷	cnt
拗	qt
燎	dom
熠	jlm
薰	csx
蕃	voxo
捋	dsvx
籁	dbk
髦	prs
飓	ehvi
簿	iikx
迢	oon
汩	lchr
闸	kap
狩	tka
鲨	tehj
蜥	cgs
惴	kec
胯	ufr
侨	aof
劭	twhd
烹	whg
咣	lau
攸	jxfg
锄	sme
硝	cdt
颔	msf
鸥	rxuy
滕	oort
寰	mil
紊	gggc
蕉	edx
稠	stmu
蟆	pas
垢	lko
楷	urd
炊	slmf
忻	cvc
炳	iqmi
腆	oqr
褒	iugm
酋	ayb
赃	nyi
拈	yxv
抒	tjv
孰	tmg
袄	qtw
褂	lfw
孺	fmn
胭	jor
赘	keq
嫡	hny
礁	edt
珉	psg
啜	sxu
钳	abel
晾	dwr
茎	ejxl
隧	zeb
窿	dal
骋	smp
嫦	szy
槛	eud
掳	dcv
莞	lbx
瓢	woc
曜	jwr
锯	ehe
猖	sya
遐	cdnj
蹋	ornc
飕	zxv
麾	mll
渍	nlh
猥	gga
篝	lxk
殉	cxh
枷	eodu
蜒	jqs
皎	ezi
霁	elja
诩	csj
窖	epl
咫	kfs
檬	pod
乒	wja
奚	cgwh
淤	jeh
溯	zih
凋	hdh
纺	vpz
篱	dnk
泌	plh
刨	wri
樵	aodb
忏	ssca
盎	quj
戾	dlma
咀	esu
屹	jlzj
挎	ufv
羔	lub
殃	jyh
庚	lhl
淼	pzt
淀	huh
隘	qbb
绛	ewz
缨	jjz
焘	hwt
璨	xsg
跤	edn
锵	ame
摁	bwv
痊	aiig
嫔	wsy
臻	kqk
泯	pyh
糜	pnlp
睦	pip
喵	pdu
缥	wdz
褥	fiw
魇	jns
汶	gwh
馋	sqt
渎	hmh
蜿	gos
抠	uxvc
诶	bx
墩	hso
棣	hld
沓	ort
喏	fru
诲	mejp
琶	wag
缈	pzz
缔	hlz
酝	jxj
耷	heh
弼	illl
柬	eqqy
浏	dyhh
拷	utv
剁	hxeh
柿	tld
琵	wng
沂	jnhe
蕙	mex
捻	yqvc
帛	iqie
柠	ykd
饵	bpt
撂	dpv
娓	ggy
乓	wya
轲	uks
髯	fqs
娉	wjy
圭	llo
璀	xzg
苔	ojx
肪	vzr
吮	tmu
瞩	kcp
啄	ksu
帷	ghe
箍	ljk
蟑	kys
炖	hxm
梗	lmd
捎	tuv
瞿	abp
嗬	mkuu
蘑	pqx
唏	cgue
鹊	aox
矶	egte
羌	amb
骼	ldl
筛	tak
鲤	dfb
羲	cgb
祺	anwi
馈	uet
伫	kif
羿	jlcq
苞	iux
犁	dnmy
铎	hse
啬	zrt
舷	cbk
矗	sit
癖	wfit
掣	srkt
匾	iqu
硷	eqt
矽	cgtc
谧	plj
瀛	jkh
珞	dxg
衲	yrw
毓	jhpk
恺	urce
纬	ggz
惰	hxc
嘤	jju
诣	jljr
谛	hlj
藻	ntx
啷	dyu
佘	tdf
黠	cdm
饲	zlt
虬	ays
涤	hnh
骡	dsp
钵	ite
邯	mqlb
笋	zmk
芥	epxe
醺	csjb
佼	ezfc
舜	txw
龌	gfk
簪	no
痰	oqi
蹂	ftn
恻	xrc
簧	mgk
甥	thtd
腼	pqrp
驮	osph
缤	ivz
潺	sqh
獠	doa
筏	vak
锭	hae
阙	aopf
粤	jow
瞌	ukp
髻	els
琏	dqg
龊	sxk
椎	kld
唆	zsug
煦	chrb
嵋	phz
幡	voeo
翌	jlcd
毡	kopu
碳	ost
鸨	iti
闽	pyps
躏	drn
蜓	oks
咻	cou
捍	msvl
睨	ylp
鼾	mon
桔	ekdu
娆	fry
抉	eivy
玟	psgc
蜻	ajs
徨	mgf
嗲	hauc
碾	yqtm
哐	uaug
粼	dspk
啐	xeut
谑	coj
嚏	olu
甬	jqkj
鳖	ihij
榨	krdk
倜	olf
稷	elmg
妤	jbyj
篡	xck
晤	gir
肇	kwm
咂	neu
帚	kdk
瘤	dyi
瞠	shp
嚅	fmu
怆	sbc
镔	ive
撵	yqvs
裆	hyw
腺	cur
骁	cdp
坷	uro
箐	ejk
螃	wzs
冢	kql
锢	lie
晁	srr
濒	ivhf
蝗	mgs
烽	vhm
辘	dis
莘	tqx
撬	apv
澹	hshu
瓮	gwi
亘	lwq
钊	kueh
篓	ddk
缇	onz
宸	syl
泓	mahk
鞑	hax
胄	kkj
羚	dkbk
绥	zbz
笺	exk
荤	msx
迄	aln
踞	ehnu
桨	enhd
慵	jvc
噤	eru
幌	mee
荻	hnx
跚	ton
袒	onw
浣	mch
榄	dnd
痪	mci
荼	omx
晗	mqr
阉	joph
腋	jrr
骰	otl
曝	wirt
涮	tch
踵	kqn
炬	ehm
涣	mchh
俟	zlfh
皑	qji
瞑	pkp
渲	cch
擞	zdv
赂	dii
湮	joho
麓	did
铿	uhe
埔	wco
峦	digz
噘	eyu
涓	efhr
掬	eevp
莓	phx
怏	juc
萃	xex
呲	ngu
蹒	wqn
鳌	qrqj
睐	dbpd
昱	jhr
旌	ejv
摞	dxv
吠	vdu
濮	wmh
卞	iugi
琬	gng
谙	qoj
啕	oruv
轶	jls
搪	ozv
陇	dqbi
纨	gqz
膺	jjlr
皋	lui
霭	qrj
呓	jluj
橄	lnd
纶	dhzi
垛	hxod
嗫	ypu
盅	kvkp
拄	kcvk
踝	mvn
臧	nys
淅	cghe
岌	enze
岱	hbfz
璞	wmg
缄	exzl
秧	jym
翱	qri
卤	dcqc
逅	mkn
靥	jrs
磐	wqku
壑	mrq
斓	dqge
翊	jldc
挛	digt
琰	jng
叁	zok
佗	osf
阖	mdp
戬	eqj
怂	zqfc
汲	enhe
垠	jso
迥	evn
咛	yku
邂	cpn
杞	afd
痘	hki
臊	zw
藕	rdx
湄	phh
媲	wly
癞	dbi
辄	kdsk
獒	qrqa
恪	urcu
砾	dlt
痉	eai
吒	keua
蜕	oes
椰	jkd
仨	zef
纣	kkz
馁	ygt
镐	lte
蜈	gms
窈	jtl
秤	swm
桢	kqd
粱	dqhp
辐	vmso
悖	idc
涔	xyhe
偕	ckfi
渭	gdh
汴	iuh
蜴	jlsg
桅	ghd
隅	jbbh
卯	ptw
骜	qwq
孚	vmwn
禺	jbqh
琥	mcg
阚	usp
杵	scd
掖	jrvj
畸	egou
晔	jrrt
婀	bk
菡	msxm
噶	laul
昙	oqrk
坍	ooo
俑	jqf
滤	dhhc
侏	kjf
潦	dohc
挲	zsh
覃	oqc
硫	dyt
俸	vwf
蟠	wqs
弋	jlq
梆	iyd
驸	vip
笈	enke
忱	syc
恿	jqkc
胥	cek
垦	ugko
滢	jkhj
窕	ozlk
滇	hxhi
邬	gjg
圃	wcg
咿	jguj
徙	cff
瘴	kuit
舫	vpk
嗝	ldu
泞	yahh
藐	pzxb
赣	lsd
鹦	jjiy
逵	ubn
戍	tihl
榭	cpdx
揩	uav
熹	cgtb
蟾	sqsu
霾	pjj
蔫	yxx
跛	ijn
岐	anzj
脐	anr
糗	azp
螳	ozs
哺	icu
鹭	din
蚣	lvs
炀	jzm
嵬	ghzk
褶	krwi
恸	ozc
隽	ecf
籽	nfp
釜	vciq
剐	lfu
鸠	eoe
磷	dstq
娑	zshy
谄	snj
巳	zlk
恣	nlhc
猬	gda
酪	dwju
溟	pkh
丕	wgi
隼	zmft
峒	hzz
芋	jhxj
觊	elze
旖	jfv
筵	jqkk
娣	hly
盹	hmp
涸	mdhu
劾	mdg
颌	ldf
趔	dpo
殇	tyh
噌	xhu
轧	kas
沽	ljh
愫	zicc
鸢	jfly
龇	ngk
玷	hug
掸	hnv
趄	apo
溥	wchx
疵	xg
皖	gni
邺	jrjb
杳	jtd
聿	jhkq
镀	hie
鹉	gcky
匍	wmw
崴	grz
岖	aez
幔	pse
蝈	lss
雒	dxgq
镑	iue
臆	jlrc
偃	jnfy
蜗	gts
瞰	uspg
侬	yaf
郸	hobb
搡	zpv
缆	dnz
袂	pdw
楮	scdr
诠	aij
洵	chh
犊	hmy
摹	pqxt
蟀	tos
邋	den
瓒	nsg
苻	vmxx
荦	dxx
竣	exd
骥	elp
泗	zlh
痣	kli
贲	iltf
胴	hzr
潼	oahd
弑	tlcl
匐	vmwo
姣	edyc
谤	iuj
蘸	ksx
蟋	cgsc
渥	gfho
浒	mcht
蛐	aes
阂	mdpf
糯	yxp
愠	jxcp
嵇	egmz
谒	jrjk
绾	gnz
舀	jtw
呤	dauk
噙	asu
槟	ivdi
嘣	ihu
诃	mkj
宓	plli
脓	yar
樟	kydt
忪	zvc
蛰	kdvs
咤	kru
捱	qjv
阜	viwt
峥	khz
濡	fmh
遢	oenc
瑙	ytg
碉	hdt
荃	aix
孵	vjd
讹	bdj
嗵	ovu
彝	jnk
颀	ane
苓	dkxk
咝	zguz
臾	jbwy
篆	kck
椭	opd
沏	aghh
颦	wskt
蛆	aesa
淆	coh
揄	jbvh
嗑	uru
辎	ngs
踮	hqn
犷	lea
荔	dlxd
鳅	aob
闫	jqpz
徵	khfg
隗	ubb
渤	iqhd
馍	pqth
锏	eqe
楣	phdp
蜃	twss
遛	deno
倌	lff
氤	jva
戌	ceql
嶙	dszq
馗	ube
匮	ueuf
揶	jdv
胚	wxr
啻	slg
敕	sltg
夙	zie
珈	eog
锹	ade
摒	iavu
迩	bpn
啾	eoum
峪	jhz
靼	haxh
菠	itx
蓟	elx
沅	jihb
馥	vim
槌	sbd
燮	cpm
褛	dsw
贻	jniu
礴	iqtx
豚	ohr
氲	jsa
湍	ofh
腌	jorh
蚱	krs
殡	irh
毗	wno
耙	irvi
诽	vgj
褴	dqw
恁	ywf
呷	coue
蚌	ius
瘁	xei
铝	dseu
蔻	ukxj
憩	ala
锚	pre
濑	dbhf
耘	jhv
俾	ifft
鬃	nvs
裟	tehm
祢	pnw
苒	fnx
蘅	mox
鱿	jtb
唷	jtur
傥	opfb
袈	eodm
豺	sjw
町	hjo
掇	hsv
坯	wgo
阏	joph
戛	edq
贮	kii
塾	tmgo
剽	wdc
孬	yui
衩	svw
镣	dpe
戊	giwl
犟	ewl
酉	jdq
夥	mpl
斡	gft
珩	mog
匝	neue
诘	ekj
攫	eivj
潢	mgh
黔	abm
臃	jvr
罂	jjiv
轼	tls
酗	chjc
嘹	dou
阪	inb
璎	jjgy
冗	fql
桧	med
闳	map
皿	pyq
囡	yog
辍	sxs
觎	jbfe
浚	exhg
闰	fxp
臼	eew
蹩	iki
煲	iufm
怵	sic
囤	ohg
罔	gpqg
蚓	jys
碴	sat
姒	zly
灸	eze
蚯	aos
嗥	mrut
堑	aus
箴	kqkl
谗	sqj
嵘	fazd
箩	dsk
艮	lwk
碱	eqtl
葆	itxd
旎	yfv
谆	ksjn
粽	nzp
牒	hkw
泸	dmh
蔺	drxq
刽	lef
锷	bre
诋	hfj
缜	kgzi
爻	jrcc
贰	bo
坳	qwo
睑	eqp
葭	eox
昀	jhrh
噫	jguc
妪	jhy
镂	dkey
癸	lzk
沣	vhh
笆	ieki
壬	fya
绉	kkzq
抨	whvt
箕	egk
叵	wjuu
坨	osoi
颉	ekt
姹	sry
赳	eoo
琮	xag
焊	msm
淬	xeh
纭	jhzk
埠	iio
泱	jyhj
恹	joca
淙	xah
榛	kqdm
酵	epjn
銮	dige
孛	idt
嗳	qbuj
佶	enfu
犒	uwy
茱	kjx
饪	fwt
孪	dign
泠	dkhk
砺	dltg
遽	ehny
嗟	ehul
钙	lbe
鲲	usb
谚	jsjw
闾	dbpu
谟	pqj
馊	zxt
翦	eqbc
雉	kltq
虱	tgks
糠	uyp
锴	urei
赈	kwim
骠	idp
旮	lee
峋	chzr
跆	ojn
瘠	enir
潸	toh
饕	ouu
佚	jlft
淄	ngho
谀	jbj
镳	ideb
廿	yuq
喟	ueur
偻	dsfy
绺	dzz
沱	osh
囱	xvw
铳	sze
袤	pwg
兖	jngb
栾	digd
畿	egol
诌	kxj
赓	lhlf
苯	igx
佻	odf
繇	jtwc
魈	cdlr
谲	eiju
泾	ejh
獗	eia
鞅	jyx
蹶	ein
绔	uiz
雹	irjk
旯	dare
洱	bph
馄	mht
粲	xsq
哂	tgu
蔗	krx
饨	ohto
奘	nuk
芍	trx
淞	zvhk
腴	jbr
剜	gol
汾	vyh
顼	ceg
濂	dbhe
蜚	vxv
殒	jmh
麝	trl
鹞	jww
蚤	nts
浃	eoh
坂	ino
颚	bruf
忤	gcc
洙	kjh
祗	kgw
迤	jnnj
眦	nlp
彗	mevq
暹	cxnq
赧	yno
佝	lxf
蒯	ujx
郦	dld
僮	kbfd
钺	joel
嘞	dxud
硅	llt
玳	hbg
蛹	jqsj
睾	luw
螭	sgs
赁	drf
盂	jbjp
瑁	pwgp
俅	ayf
侗	hzf
骛	gik
宕	hulu
纂	nbk
堰	jsoy
厩	ees
萋	agx
鄢	jokb
帔	wde
蓁	kqx
杈	srd
熨	jxt
挞	orv
觐	erxe
阗	obp
钏	sce
煊	cfm
泫	cchz
迳	ean
夔	ubbg
缮	tsz
燧	zemz
嘁	agu
孱	sqtn
懑	pwh
邕	jvk
柩	eed
耆	ant
漕	xrhr
鹄	mmly
龛	uof
饯	eut
餮	ophm
幄	gfe
鹘	mmly
爰	jiw
噻	zau
倨	ehfu
汜	zlhk
诙	mlj
锃	nwe
颧	aixf
纰	wgz
绡	cdzr
鏖	qrl
氢	aja
颢	mwrf
楔	chd
藜	dnx
郢	jqub
妫	lly
栀	kgdk
岫	cezj
谥	tljp
骧	cmp
犄	egyu
葳	gxxl
辇	yqvs
魑	sgld
璜	mgg
聒	lsb
椿	ssd
谩	psj
伢	jafj
琊	jag
骅	mqp
鹜	giky
闩	tfpq
颍	jqif
翕	cgf
濠	mrhm
仞	fwf
鳗	pqbj
玖	ezg
踊	jqnj
皈	lli
骊	dnp
痿	ggi
芑	afx
孑	ekk
帼	lsej
撸	djv
檄	cndg
啵	itu
昶	spj
柚	jkdj
篑	uek
陲	sbb
潋	duhg
亟	endq
樽	nsd
遨	qrn
锺	kvek
舶	iqk
莆	wmxv
蛀	kis
琨	usg
邈	pzn
棂	dkd
抻	sqv
搽	savc
俪	dlfd
铉	cce
怩	ync
嚯	mxum
茁	ksxs
韭	ezvq
膘	idr
酩	pqju
榔	dzdb
娩	pqyp
忸	yzc
刎	gggh
扪	pyvp
漳	kyh
呶	yruj
仃	hjf
佞	yafy
饬	sltd
裨	ilwt
壹	jgt
黜	sim
巽	cxk
鹂	dndy
滂	wyh
徉	jzfj
戕	amk
埂	lmo
僖	cgfu
纫	fwzf
奂	mcb
溉	lbh
猊	yna
胛	ear
卟	icui
锌	cvet
遑	mgn
跻	egn
妗	ery
蒿	mu
钛	obe
岷	psz
葩	wex
磺	mgt
魃	ial
汕	tsh
蠡	dfk
苋	cux
肛	lyr
潞	dihu
阕	aopo
铤	oqe
桠	jed
涿	kshy
薜	ilxt
氐	hgt
鲛	edb
睥	ilpt
滦	dihd
稔	fgm
锲	ape
徜	szfu
哙	uou
冼	cqh
獐	kya
讧	mzj
喙	meuy
氨	qoa
缯	nhz
褓	itw
赊	tkic
菀	gnx
鄱	wqv
炅	evr
碜	sgt
戗	amf
嫫	pqyh
瓴	dkfg
犍	exye
酊	hjj
臌	lcrj
钠	yre
螓	ass
镌	efe
铀	jte
羯	ekb
挝	gtv
谡	zij
邙	pzgb
襁	anws
渚	kch
胫	earl
箸	kikr
逖	oln
雎	eeaq
砥	hfth
衢	abf
狒	vda
骞	axl
荟	mexk
汛	cxht
盥	lcw
睚	jap
栎	dldd
祚	nxw
砣	osti
烩	memk
夯	myh
拮	ekvu
驷	zlp
掴	lsv
蘩	vqxc
蜞	ans
乜	ypk
灏	mwhf
殓	duhq
哔	ilu
擢	ksvq
殛	enhq
荪	zsx
徇	cxfr
蹴	xin
忾	ubc
谯	aojb
鸵	osy
疹	kgi
韫	jxg
祛	aew
膻	tor
黢	aem
仄	nrs
唳	dlu
烊	jzmj
孀	tay
斫	kst
腚	har
牍	hmw
佃	huf
懋	pwd
赡	tsi
鹗	bruy
秣	pfmp
榷	aodq
镭	dhe
铄	txe
庾	jslj
媾	lky
嫒	qby
饽	ittn
佥	axf
谌	syj
尕	lvy
啮	ypus
蝼	dts
闱	ghp
篙	luk
逡	asn
膑	irr
荥	ckxt
隍	mgb
蕨	eix
罄	aat
郓	jxl
囵	dhgi
橹	dcd
诰	lwj
蹇	eql
睢	zlpq
喱	dnu
肓	mag
榈	dbd
绶	tkz
罹	dnzg
槊	txbd
瑗	jcg
槁	ltd
秸	ehmu
裱	izw
牦	pry
荑	jnx
滓	nfh
腓	vhrv
谶	swj
砝	vvt
舐	tla
秆	lnm
荏	fgx
邝	ublb
芈	pfqq
斛	mmb
暨	eleh
狻	zfa
滟	jshi
恫	hzc
麋	pnlp
纾	tjz
锟	use
粑	iep
诳	ugj
氅	spbp
寮	dolc
鹑	shg
驽	ymy
囫	mmgg
炷	kim
缙	erz
徕	djf
弭	pflb
橇	add
痢	dli
撺	xfv
柑	lodl
圜	migm
儆	eqfg
魉	dnl
妊	fwy
矍	eip
犸	pva
哓	cdub
酶	phjp
庖	wrl
缢	jlzp
俎	ncf
墉	jvo
鲫	elbb
藓	cqx
佰	irf
痔	klix
觥	lvb
哞	px
旃	kovh
伉	uuf
猷	jtba
怄	rk
牯	lcy
锨	cxe
豢	mchy
轱	ljs
泵	iwt
擀	lnv
蝌	ukst
绻	abz
呔	hauo
绌	siz
蓑	zsxm
纥	lkz
釉	jkw
翳	jluc
殁	pfhj
讫	alj
蜇	kkv
砧	kqtu
殄	oqhw
萼	brx
辔	wdzu
诮	apj
胰	jnr
蜍	smsc
浔	chhx
钜	ehee
瘌	dri
趿	oene
瘀	jei
鸪	ljty
霰	cuj
鹧	krly
诨	mxjs
掼	lcvf
僭	eufr
弁	iuk
湎	pqh
蹉	xsn
汨	plhr
栉	kldb
醍	onj
磬	aatu
铂	iqe
蓼	dzx
泷	tyhi
梏	lid
祜	miw
鸩	kwhy
虺	mzq
豌	gohk
嘬	nsu
疡	jzi
杲	ltr
荞	aoxa
煨	gxm
蛔	mbs
涝	dwh
焖	pwm
祉	kfwk
魍	gpl
锉	xxe
跎	osn
桎	kldo
娠	tqy
诿	ggj
瓯	rxug
偈	elfk
殚	hoh
镁	pge
邳	wgib
胱	lar
痂	eoi
刍	smbq
醐	mmj
糅	ftp
岿	ulz
愎	ilc
赝	jssf
笳	eok
唁	jsuu
齑	eggq
崂	drz
狎	cdae
踽	esn
揆	ubv
鳍	anb
钹	iqej
侩	uofk
帧	kqef
裾	eewu
椁	lpd
唿	mjuc
澍	tihx
崧	zvzk
衾	avfm
骈	wbp
仟	axfa
勖	chp
羸	dhgv
谪	kdj
柁	osd
狲	zsa
珲	mlg
蛭	kls
痍	jnij
俦	stf
猢	mmar
镫	hwe
戡	uotl
鼹	jne
悌	olch
濯	kshq
莅	dlxd
懔	dyc
咩	phu
誊	oohu
鳝	tsbu
韪	ggr
噱	ciu
亓	anbq
铩	tee
硌	lrt
俚	dff
椤	dsd
脍	uor
汞	lqlt
淖	ywh
姘	wvy
聩	ueb
泅	ayhf
喑	jvur
绦	ouz
铡	kae
桫	zsdt
恽	jxcs
薏	jlxc
遒	ayn
痨	drid
蚪	hds
屙	bkt
蒺	enxh
觞	tybw
葺	alx
煅	hcm
悱	vgc
茕	avx
靛	hua
诓	uaj
忝	oqoh
箔	iqki
珥	bpg
菅	exx
嶷	jnz
酃	dkjb
岬	eaz
臬	ypnd
舢	tok
肱	lvr
焙	idmu
逦	dfn
啖	hsum
冁	snb
鸷	klvy
蜢	pms
莠	jdx
茔	jkxo
铨	aie
胺	qsr
堇	eyx
艽	edxe
湟	mghg
瑭	ozg
踅	civf
芨	egx
逶	gxn
嶂	kuz
钾	eaee
跹	cxna
徭	jrf
鹌	qoh
狍	wra
笞	sgku
埙	cso
仵	gcft
缛	fiz
椽	sid
暝	pkri
苕	ooxu
酮	oaj
貉	mdw
婺	giky
糨	ewp
囿	jkgr
铖	soe
畹	gno
帏	gheg
镝	hge
缦	pszj
铣	cfe
轸	kgsw
舂	svq
碘	hqt
黍	tcm
芫	jix
馔	kcti
铢	kje
槿	eydq
赭	kro
涪	vmhu
塬	jioc
氯	dha
倬	ksf
酡	osj
傣	hrf
颏	ukgf
缱	aqz
浜	iyh
篾	ppk
柘	krdu
猕	pna
桉	qod
砒	wgti
邶	idib
洌	dphh
衿	evwe
颛	kfzf
蜮	jhs
骢	xvp
柒	aghd
呖	dlud
郅	klkb
饴	jnt
圩	gho
茯	vmxa
疱	wwi
圄	jsgu
琚	eegu
橐	osq
钿	hue
枸	ldd
貅	cow
蛎	dlsg
嫱	aqy
爿	wqkq
辂	disu
綦	ana
唢	zpuf
笤	ook
鼬	jke
苜	pixp
窠	ukll
嗄	qau
卅	zrq
茏	dax
艄	tuk
苡	jfx
辚	dssq
囹	dkgk
撷	ckvf
伥	syf
疟	yoi
骓	klp
筌	aik
屐	egtj
猁	dla
傩	ysfy
疽	eeia
珙	lqg
貊	pfw
诟	lkj
鬣	dps
鼐	yby
獭	ova
獾	mfa
洮	orhk
邛	avlb
赅	lai
擤	cqv
稗	ibm
咴	mlu
楂	sad
氮	hsa
竽	jbk
勐	pmn
谔	brj
碣	ektk
铧	mqe
逑	ayna
郾	jnub
铆	pte
褡	hew
滁	smh
陂	ixb
喁	jau
湫	aoh
蚺	fqsf
钨	gje
钲	khek
綮	aam
蕲	anx
遴	dsnq
舛	sbcq
荠	elxa
稞	ukm
阄	eop
荚	edxe
媪	qty
鎏	dyhe
笏	mik
悒	jlci
晷	lzr
郗	cgcb
宥	jkl
豸	klww
摈	irvi
儋	hof
葶	okx
凫	vmwe
阡	axb
蚨	vmsv
粕	wfp
猗	jga
纛	hwhc
畲	tkfo
睇	hlp
洇	jvh
醮	epjb
虢	lsw
癣	cbi
珐	vr
酆	vhqb
诒	jnj
踯	knn
馏	dyto
莛	okxf
髭	ngsi
龈	jskm
锒	dze
钯	ivei
楹	jkdp
贽	klvf
菖	syx
灞	irhr
虻	pos
苌	szx
躅	kmns
牝	wry
钎	axea
畦	ano
欤	jbjf
桁	modh
腩	ynr
吖	jeu
蠹	hiq
瓤	fzg
淝	vhhi
鸶	zgzy
亳	iqga
楫	endb
薨	mvx
訇	mvw
镊	ype
陟	klb
镗	oze
樗	sjd
苫	toxu
阆	dup
莒	esxu
罅	cyv
稹	kgm
豕	tfqy
涫	lchl
螟	pks
骝	dyp
蓿	cex
祧	odw
苎	kixq
擘	ift
犴	qsa
玎	hjg
侉	uff
仝	oafl
厝	xxs
馐	cot
邰	ojkb
潍	ghh
兕	zlq
赍	egtf
龅	iukk
黩	hmm
胪	dmr
抟	oiv
诤	kwjk
鬈	aisk
芪	anxt
莳	tnx
毽	eup
筇	avk
猞	tkau
砭	ixtv
腱	eur
澧	dfh
挈	apvt
怼	hej
镞	nme
貔	wnw
嬗	tsy
醴	dfj
搠	txv
杷	wad
薹	ojxo
杌	gid
铬	lreu
讴	rxj
闼	orp
拊	vcvx
歃	tra
蝮	vis
沆	muh
烷	gqm
箜	uvk
彀	lkt
雠	stft
荩	erxe
揿	arv
恂	chcr
茴	mbx
癯	abi
衽	fww
鲈	dmb
缟	ltz
昴	ptr
廪	dyl
圻	anoe
垓	lao
奁	dbhc
瘙	zwi
痫	cbid
黟	jgm
讦	ekjl
矾	vqt
铰	ezec
氖	yra
烯	cgme
陉	ckb
耄	pwt
妯	kty
踟	snnu
菟	oix
鲧	lmbc
镛	jve
峄	jlzq
镱	jle
竦	zqd
搦	yxvh
吡	ifui
鳏	lfb
飨	cnc
猡	dsa
痼	lii
讣	vij
荭	maxl
馕	yzt
枰	wkd
黼	vcj
檫	sadc
鄯	tsbb
鲇	ybbu
酽	jsjs
垅	dqo
佤	gvf
歙	cgff
骘	klbp
妁	txy
垩	brjo
蠃	dpg
锆	lwe
枇	wnd
鄞	jsxb
乩	egkk
幂	plle
蟊	prks
沭	tiht
垭	jeo
鹳	lcx
萁	anxi
伧	xyfk
苁	xvxf
恚	meo
盱	cep
鼋	jibh
钤	abee
矬	xsto
帑	opy
侪	sjf
穑	zrm
脶	dsr
煸	ixm
娌	dfy
砀	hutw
孳	ngbn
蚋	fes
脔	digf
缁	ngz
箬	fxk
樯	aqd
麂	efl
猱	yrad
跸	ilnt
甑	nwb
掮	abv
岈	jazj
芾	vmxq
龃	esk
趸	hmg
沔	pqhk
蹰	smnx
苣	ehx
裢	dbws
萸	jbx
郧	jhub
捭	irvt
謇	eqlu
笫	nfkw
妣	ify
枞	xvd
疥	epi
啁	kxu
氰	aka
蒹	exxe
檑	dhd
莴	gtx
禳	fzw
缌	zgzc
夤	jsci
鹬	jhky
玢	ivgh
镏	dye
狯	uoa
焐	gim
縻	pnlc
莜	jtx
腭	brr
鲑	llbo
淦	lsh
洹	mihh
荇	cax
鲠	lmbl
蚝	mrs
榉	esd
楝	dud
艨	pok
楸	aodm
睃	zsp
鹈	onb
棹	kwd
瀣	cphe
龉	jsku
鬻	jhlq
庥	col
骐	anpi
筢	wak
柝	oxd
堀	ujo
膂	dsvr
磔	kdt
柞	nxd
泔	loh
锰	pme
聃	hobf
徂	xmf
堞	hko
蟥	mgsi
墀	sno
薅	mux
艟	svk
嵯	xsz
怿	jlcq
窳	jsll
蛳	zgse
彘	klki
迨	hbn
犰	ayae
荜	ilxt
篦	ilk
橛	eid
焯	sum
趺	vjn
倥	uqf
鸹	lzay
椋	dqdc
崃	djz
旒	dyv
芡	auxf
芩	asxe
耧	dtv
庠	cql
狴	ila
钴	lce
樾	jod
欸	qrk
穰	fzm
螯	qrqs
耒	dgv
眙	jnp
罴	wnz
肄	jliq
怛	hac
缃	cmz
哏	lyu
逄	wzn
岙	qwj
沤	rxh
荨	abx
娈	digy
圉	jsgt
叻	drud
耋	hkto
邴	iqib
毂	lctj
俳	wjfv
铱	jge
艏	tdk
喈	ehui
蓠	dnxd
薮	zdx
峤	epz
貘	pfwh
崤	coz
笄	egku
缗	pszr
蹁	wbn
蕤	fbx
璁	xvg
渑	pqhh
秫	tmm
掾	jcv
祆	cxw
豉	sfh
醪	drj
庑	gcl
茛	lwx
莼	shx
筮	tlk
挹	jlvi
媸	sgy
阒	ahp
怫	vmc
鲔	ggb
疣	jti
镍	yped
褫	sfwe
锛	iqem
轳	dms
鲵	ynb
熵	tym
馑	eyt
眇	pzp
轺	jrsu
塄	doo
涞	djh
杼	kidj
崮	liz
岘	cuze
诂	lcj
镢	eie
鲶	ybbc
氟	vma
鲮	dkbg
蔌	zix
椹	kqdt
洄	mbh
栊	dadi
孢	iunk
郏	edeb
郴	sqd
侑	jkfr
詈	dlz
獬	cpa
澶	sqhh
箧	apk
鳃	zab
矸	lot
讵	ehj
枋	vydv
璺	gww
鞣	ftx
澌	zgh
啭	kcuk
蜉	vmsn
黻	vmjj
耦	rdv
樘	ozd
跖	knnu
蛉	dks
箪	hok
逋	ijnv
扦	axv
愆	axfc
鳟	nsb
藿	mxxm
浠	cghe
痱	vdi
憷	sicf
殳	tje
葚	twx
纡	jez
翮	mdq
戋	exqh
黧	dnmb
鲽	hkb
诔	dgj
曷	mdr
毖	ilii
髋	ufl
狳	jba
槎	sadl
坻	hfo
哚	hpud
蜊	dnsh
铙	yreb
嫘	dhy
漯	dxhc
骟	tsp
捌	ievh
椴	hcd
溘	urhp
墒	tyo
阋	clp
牖	jdw
愍	pypc
龋	ask
篁	mgkg
刈	jlch
蠲	efb
谝	wqj
悭	axc
鬲	ldq
瓠	mihl
撄	jjv
棰	sbds
麸	vjp
圪	lkoj
錾	nsse
笮	nsk
轾	klso
杓	trdt
砷	tqt
剀	urzh
疴	uki
餍	jssm
锱	nge
寤	gil
糍	xnp
瞽	lctp
芎	csxl
尻	uut
缡	dnzd
捩	dpva
蹼	wcn
鳕	cbb
裰	hsw
窨	jrlr
偬	nqf
茑	yzx
榫	zmd
幛	kuet
峁	ptz
蓊	gmxc
鏊	qwqe
秭	nfm
鲅	irb
瘢	ioij
茼	oax
汊	srhs
郜	lwl
芰	elxj
旄	prv
殍	wzh
樨	cgdy
碇	hat
涑	ziht
摭	knvb
钡	idef
凼	hutq
垆	dmo
萘	ybx
炔	aym
蟮	tss
蓍	tgx
岢	urzu
飧	zsc
俣	jsf
碓	het
刿	lez
孓	eik
谰	dqj
蕖	abxd
痧	tei
霈	wdjw
钚	iie
槲	mmd
铗	edee
绐	hbz
痈	jvi
埚	lso
狷	eca
酢	xijk
阍	msp
螫	tlo
欹	aghf
傈	dlfd
怙	mic
渌	diht
壅	jvgo
赀	ngkf
癔	jlic
莪	bdx
潆	jkhc
檩	dydc
逯	dint
浞	kshf
痤	xsi
蔸	hxx
翥	kit
菽	tjxj
鸱	sgty
盍	mdo
茭	edxc
黥	akm
酰	cxjb
赉	dbdf
霪	jsjf
菏	mdx
诹	nxj
苴	eexa
粳	ejpl
糌	nop
趵	iwnt
舸	lrk
蛩	avls
枥	dldd
蘼	pnx
蕈	cxx
襦	fmw
膈	ldr
芏	hix
畈	vso
笊	kwkk
艉	ggk
燠	jhmh
阊	syp
厣	jnse
傧	ivf
鸬	dmdy
艿	yrx
攮	ypv
酚	vqj
塍	sor
椟	hmd
菰	ljxl
氦	mba
笸	wjk
疸	hni
镪	ames
圮	wfo
醛	aijg
篌	mtk
髡	uss
谖	cfj
徼	epfg
醯	cgj
裣	dqwq
枳	kfd
蓖	ilxi
髫	oos
酯	kfj
暾	osrg
訾	nfku
缳	miz
碛	altf
镒	jlep
孥	ymyn
硖	cdte
溧	dlhd
柢	hfdh
镬	mxe
糁	tqp
皴	xsk
虼	lrs
卺	eydk
鋈	gih
帙	klet
鍪	ptke
锞	urel
蘧	abxy
簟	hukt
鞫	eexu
泮	wshi
溱	ash
眭	zlpo
坩	loo
嬖	ilty
鄄	ecc
砻	dadu
郯	oqm
隰	cnb
筚	ilkt
朐	abr
墼	egs
跬	uzn
愀	azc
醚	pnjp
鳜	leb
萑	mix
蚧	epse
遄	sin
戆	ludc
麇	esl
柰	ybd
趱	nno
鲂	vzbv
螅	cgsc
垸	jco
裎	sow
埸	jlo
槠	kjdr
儇	cffm
肽	obr
卮	kgwk
绀	lsz
顸	molf
筲	tukr
倮	dpf
媵	jary
岜	iez
谵	koj
褊	iqwx
鲟	chb
瘐	jsi
帻	nde
簋	lzkp
梃	oqdf
缵	nbz
礅	hst
屣	cft
缶	vdg
亍	sibk
鹚	xnby
缒	kezk
刖	jorh
炻	tnm
荽	zlx
磴	hwth
砬	dat
锶	zge
鼍	osu
瘿	jqiy
跣	cqn
疖	ehib
迓	jrnj
炝	awm
啉	dsud
硒	cgtc
汔	alhj
驺	nxp
蛄	ljsu
伛	jsfc
绂	vmz
鞯	exxn
燹	cqq
髀	illt
缫	zuz
跗	vjnx
銎	avle
凇	zvhk
殂	xmh
嗉	ziu
铘	jde
饫	jht
檗	iftd
辏	xks
鼙	wnt
璩	abg
悛	afc
褙	idw
煳	mmm
笕	eqke
鲥	tnbx
尥	dpq
锍	dzek
劢	pbg
嵊	twzs
轫	fws
饧	cktw
佾	jlfr
鲩	mcbb
谳	jsja
棼	vydh
苷	lox
觚	ljb
萏	hsx
熘	domo
羝	hgb
鹕	mmty
觜	nzk
喾	uib
蘖	ypxd
剡	jnmh
椐	eedu
曩	ypr
瑷	qbg
砗	skt
髁	ukll
蚍	wns
阃	ump
溲	zxh
匏	wrh
桡	frd
狺	jsau
鲢	dbbs
耨	ykv
豳	ivzy
缑	lxz
愦	uec
蝾	fas
榧	vgd
搴	axlt
洫	chhc
蚜	jas
荸	inx
磙	lmt
坜	dlo
粜	ops
螈	jisc
轭	brsk
绨	onzh
庋	lzlj
皲	eslj
胝	kgrh
滹	mjh
铍	wne
麈	kcl
邗	mqlb
跏	eonu
锔	ebe
蝣	jts
鲋	vibx
柙	cdd
鸫	hvh
罘	vmzi
獍	eaab
硼	wotr
疝	tsiz
勰	ckd
鹾	xsd
扃	esm
皤	wqi
潲	twhr
笥	zlku
葸	cfxc
鲱	vxb
旰	lsr
溏	ozh
偾	vwff
溽	fih
伲	ylf
剞	eghh
锗	kre
悝	ulc
漭	pph
痦	gii
嘏	lctj
袢	wsw
鳎	ovb
昝	nng
滏	vch
廨	cpl
觳	mmtj
戢	enu
桷	eidj
舻	dmk
郛	vmwb
彖	ock
裉	uww
蓐	fix
脘	gnr
疠	dlig
艋	pmk
嬲	yzo
郇	micb
粝	dlpg
鹩	doq
耜	zlv
坼	sro
埕	soog
鹪	edfy
栌	dmdt
尜	laq
宄	lzle
瘊	mti
嫠	dngy
蠓	pmsp
洳	fihu
埒	dpox
墁	pso
铊	oee
锂	dfe
蔟	xix
蹀	hknd
颟	poxf
劬	abed
濞	ilhi
鲎	mkb
蠖	mxs
悃	umc
唣	nwua
谮	nwj
畀	ilo
裒	wtg
镲	sve
锝	hde
郫	wnib
蚬	cqs
邡	vyv
嗍	zsur
螨	pns
阈	jhpl
赜	nduf
怍	nxc
鳐	jrb
鄣	kydb
陔	lab
狁	jma
拶	nev
汆	xff
觯	klbh
鹣	exby
呒	vcu
钼	pie
磲	abtd
颡	zpj
搛	exv
蝰	ubs
眄	pup
慊	auc
劁	adf
畋	obog
肫	ksr
崦	joz
酹	ddj
簏	diki
胼	wbr
瘳	sxi
锑	oge
蝓	jbs
暌	ubro
舁	jbe
诜	tqj
芗	cmx
尢	jtqk
菔	vmxj
焓	mqm
蒌	dtx
旆	wdv
胙	nxr
浈	kqh
觇	soke
缣	exze
颞	ypbf
碡	kxt
谠	hpj
埽	zwo
栲	utd
踔	ssn
鲷	hdbu
袼	lkw
芟	toxj
僳	zif
槭	ald
鲞	cnh
蚴	jksd
桴	vmd
佧	uvf
蒉	uex
檠	akxd
囟	crw
飑	idvk
燔	vqmo
狨	faa
觫	zibt
疃	obod
幞	vmey
溴	ceh
唑	nxu
苊	brxk
溷	mxhy
鲆	wkbt
掊	wdvu
畚	igk
骖	xop
榇	swd
癜	hui
堠	mko
泖	pth
浼	pgh
硗	adt
隹	klf
哿	lrd
僦	eef
隈	gxbm
碚	idtu
馓	znt
隳	mlbh
罱	dnzt
怃	gccg
嵫	ngzz
篼	hxkb
觌	hnt
辊	lms
篥	dlkd
垴	yto
醢	mrj
虮	efs
诎	aej
绱	tuz
埘	tno
陬	nxbj
祓	vmwj
锩	ebek
蠼	abs
菘	zvx
圯	jno
锕	qee
戥	hmr
蚶	mos
侔	ptf
砼	oat
藁	ltx
呙	lsu
絷	knvc
镡	cse
牾	gcyu
籴	hnf
佴	ybf
瞢	poxp
杪	pzd
昃	nrr
鬏	eos
缧	dhzc
耪	wpv
揠	jrvy
橼	jid
爨	xcw
狃	yza
诼	ksjy
嗌	qbup
嘌	wpu
蛴	ansa
畎	abo
雩	jbju
鹆	jhiy
蕞	nex
脬	wurn
羼	sst
缬	ckz
漶	mchc
哕	jbu
荛	frxb
谇	zej
廛	sqlo
氚	sfa
蒽	bqx
袷	aowu
甍	poxg
黾	pyu
烃	ojml
铵	qne
鬯	suw
襻	wswt
嗾	zdu
躞	cpnj
柽	shd
镉	lde
遘	lkn
诖	lfjo
绲	lmz
岵	mizu
钣	ine
逭	mcn
觖	eib
莰	unx
茌	snx
疔	hji
圬	gjo
禊	clw
虿	sbg
刳	ujh
蝤	aysj
秕	ifm
葑	vhx
呋	vju
匦	lzue
豇	emhl
铯	zre
垧	tpo
洧	ggh
吣	aru
桕	eede
钪	uue
浯	gmh
窬	jbl
埴	kno
惝	spc
崞	lszn
眚	tmtp
颃	mzg
蛞	uxs
镆	pfe
薷	fmxb
茺	svx
蕻	mzx
闶	uype
嫜	kyy
囝	eqg
蒗	dux
蚰	jtsj
鳔	ipb
骶	hfl
圹	ubo
敉	pfp
畛	kgo
轵	kfsi
黹	kfjh
晡	ijr
湔	exhh
瞀	pwk
龀	swk
砉	mzv
篪	snk
鞔	pqxp
仳	wff
芄	gqx
猃	cqa
溆	chhj
甾	nak
钭	hdet
髑	hml
锘	yxe
髂	aylu
硪	gftl
潴	kjhr
裥	eqw
郐	uofb
瘘	dki
屺	afze
胗	kqrw
笪	hakh
鲼	vwb
枵	cddm
髌	irl
甯	yal
羟	anbl
鲭	ajb
腧	tir
龆	ooku
沩	ghhg
绁	cpz
崾	jwz
蛏	shso
悫	aotc
溻	oeh
罾	nhzr
舳	kmkj
忉	huch
蜱	wnst
氆	wcp
锸	see
钒	vqev
蛱	edse
敫	ezig
爝	eim
舯	kvkk
笾	ixk
罟	lcz
铫	jre
踬	klnf
箅	ilkq
绋	vmzv
埝	yuo
芘	wnx
濉	zlhq
籼	cxpz
楦	ccd
曛	csrb
聱	qrqb
鹁	iqty
硭	pztg
茆	ptx
谂	tgjc
炱	ojkm
钍	oce
馇	set
唪	vmu
纩	ubz
栝	lzd
褰	axlm
饩	clt
趑	ngo
菹	njx
鳊	ixbx
鲳	sybr
掎	efvu
屦	ehty
莨	dqxm
莩	vmxn
埤	wnot
螽	kvgs
醅	wxj
蜩	oosu
瘗	jlio
莸	jtxj
癍	ioig
埭	hbo
啶	hauf
鞲	lxx
枘	fed
庹	opl
郄	clcb
硎	ckth
髹	cosd
毪	pmp
氘	huaq
赙	viix
洎	elhn
湓	wyhp
卣	jdqq
茈	xnxi
浍	uoh
栳	dtdi
笱	ldk
骒	urp
阌	gypj
搌	knvm
跽	elnc
揸	kev
渫	cphd
邾	kjk
擐	mcv
噍	epu
氇	djp
觋	cnge
堙	jvoo
撙	nmv
颥	fmj
鲦	oob
疳	loi
桄	lad
踣	iqn
窭	ehl
鞒	aoxa
慝	oruc
襞	iltm
矧	tgt
獯	csa
瀹	johx
蒇	snxl
榱	xld
艴	vmvi
刭	eqkh
唛	prug
苤	wwx
钋	wte
嗪	asum
蛘	jzs
黪	xnm
攉	msvm
钕	yse
毹	tjfp
氩	jra
垡	vafo
缂	urzl
骀	ojp
锇	bde
鳇	mgbg
肟	gfr
瘰	dpi
哌	wbu
蜣	ams
仡	lkfj
籀	kkk
薤	cpx
砟	kvt
瓿	iidg
僬	edfb
嵛	jbz
忭	iuc
瘛	sli
垌	hzo
槔	ludt
蛲	yrs
锓	aye
滠	trhj
煺	oem
劓	jlnh
嘧	plu
蟛	wos
陴	wnb
俜	wjfk
辋	gps
龠	jof
腠	xkr
轹	dlsd
稆	dsmu
蝥	prks
堋	woo
鞴	idxj
黉	mab
柃	dkdk
镘	psej
殪	jlhh
蒡	iuxv
胍	lzrl
骱	eple
杩	prd
恧	yhb
跫	avlf
唼	tru
酾	tajd
硐	hzt
胲	mrr
烀	mjm
氍	abpp
忮	klc
芤	uxx
箢	jfkk
哳	keue
鲡	dnb
檎	asd
饔	jvgm
戽	mimt
砑	jrt
甏	iwtg
氡	hva
钬	mpe
墚	dqod
苘	aqxu
穸	cgl
觏	lkqe
骺	mtl
枧	eqde
鹨	dec
瘼	pfi
桤	agde
毵	zokp
糈	csp
酲	sojg
岣	ldz
肷	aqr
铒	bpe
鲣	exbo
蛑	pts
裼	cgwg
酎	kkjx
毳	xepp
坫	huo
酐	loj
铪	meeu
贶	ubi
胂	twrt
躜	nfn
嵴	enzr
趼	eqn
锊	doe
泺	dxhd
舴	ndk
疬	dlid
肭	yrr
涠	ghhg
鹇	cbpy
碹	cct
粢	nghp
眵	sgp
蟪	mes
劂	eish
苈	dlxd
锼	zxe
珧	jrgk
吲	jyu
脞	xp
嶝	hwz
锾	mie
钌	dzed
坭	ynoi
碲	hlt
瓞	hklt
茳	emx
躐	dpn
嵝	ddz
陧	ypbo
厍	trs
鄹	nxbb
砹	qbtc
砘	hxto
鸸	bjb
螗	ozsu
铽	ore
阼	nxbk
埯	qno
廑	eyl
摅	tjvc
芴	gix
苄	iuxi
醵	ehjy
硇	yrt
酴	omj
堍	oio
舾	cgk
舄	cle
艚	xrkr
夼	uehs
鼗	ork
筅	cqk
胨	hzrh
砜	vht
鲚	elba
淠	wlh
圊	ajg
迕	gcn
菪	huxu
朊	fbr
鐾	idte
滗	ilhp
躔	sqn
腈	ejrr
筘	ukk
蠊	dbs
箦	ndkf
橥	kjad
馘	lsbl
蕺	enxl
镧	dqe
犏	wxy
仉	kpf
瘥	sbi
绠	lmzl
糇	mtp
垲	uroe
莶	cxxq
坌	iwio
蹯	vqn
钫	vye
礓	emt
揞	qnv
铋	ile
岽	hvz
肀	jhkq
鸲	abey
羰	oyb
傺	slf
澉	lnh
肼	eqre
胬	ycyf
衄	yhc
锫	whe
酞	obj
鼯	gme
枨	sods
赆	eri
鹛	php
鹋	poxy
榍	cpdr
窀	ksl
桊	echd
捃	exvu
蕹	gwx
葙	cmxp
罨	jnzh
锿	qae
酤	ljj
蜾	lps
恝	edv
跞	dln
蒴	txx
锬	oqem
鲻	ngbo
绗	mzz
锪	mse
钷	wjeu
巯	ayk
眢	jfcp
冱	mihm
蛸	cdsr
掭	ouvh
驵	npp
庳	illt
萆	ilxt
瘅	hoi
铞	hpee
眍	uxpc
羧	zsb
钽	one
瘭	idic
帱	ste
搋	shve
阽	hubu
鹱	miy
鲒	ekbu
甓	wltg
锖	amer
蓥	jkxe
垤	hkoo
泐	drh
荬	prxh
蝻	yns
箨	oxk
瘵	kbi
谫	eqjh
胩	uvr
钔	pye
蓰	cfxf
迮	ndn
耖	swv
踺	eune
椠	ausd
廒	qrlg
氪	ura
聍	ykb
赇	ayi
氙	cxa
猹	saa
篚	vgk
牿	liy
埏	too
镓	eoee
锎	uae
舣	jfkj
仫	pif
鼷	cgeh
痄	kri
螬	xrsr
鳢	dfbh
鳙	jvbj
镦	hee
撖	msvg
耩	env
洚	ewhq
铑	dte
瞵	dspq
螵	wds
葜	aoxh
钇	jfe
楗	eude
镎	yae
钐	toe
贳	tltf
鸺	cofy
醭	im
骣	snpn
鹎	ixi
嚆	muu
耠	msvu
劐	msxh
犋	ehy
鳓	drb
蔹	dqxg
腽	grr
瞍	zdp
萜	ohx
舭	ifki
钆	lae
瘕	eaij
稂	dzm
脎	zrr
耵	hjb
膦	drrq
镅	phe
粞	cgp
癃	dai
醑	csjr
铟	jveh
疰	kiik
漤	dnhy
耢	dwv
铌	yne
碥	iqtx
镩	xfe
蓣	jhxf
菝	iax
怊	sucu
蝽	sss
镄	vde
铼	dje
仂	drfd
耥	oyv
癀	mgii
脲	yprt
缲	adz
鲐	ojb
酏	jfj
鼢	vyeh
戤	lby
鳘	pypj
礞	pot
磉	zptd
牮	eufy
镨	wce
菥	cgxe
耔	nfv
脒	pfr
稃	vjm
筻	lukl
喹	ubu
醌	usj
镥	dce
鼽	ayne
痃	cii
鲰	nxbj
簖	hcke
耱	pfv
岍	axz
瘃	kmi
禚	ksw
铷	fme
塥	ldo
镤	wme
辁	aisg
铈	tle
螋	zxs
赕	hnim
瀵	vwhi
苠	psxp
蒎	wbx
氕	wha
铴	oye
铕	jder
鲕	bjbb
茚	jrxb
鲴	lib
彐	elkq
鲺	tgb
铥	hoe
轷	mjs
铹	dre
荮	kkx
腙	nvr
喆	kdtu
蒈	urx
丌	egqq
乇	osw
氽	omft
谘	ngj
阢	gib
坶	pco
茇	iaxj
菸	jox
拚	wvv
挢	ezva
揲	hkv
揎	cfv
摺	kdvi
擗	wfv
甙	hbl
咭	eguu
哜	elu
囗	ghqq
後	mkfg
猓	lpa
猸	pha
馀	jbt
庀	wfl
沲	hxhj
渖	tght
弪	eal
缍	hpz
缋	mezf
缏	iuz
楱	xxd
榀	wyd
榘	estd
軎	gds
搿	ldw
肜	far
膣	klr
膪	soru
臁	dbr
欷	cgcf
飚	idvm
熳	psm
憝	heg
泶	cib
砩	vmt
砦	kbk
礤	xvt
钶	uke
钸	iiee
镙	dsec
镟	ccef
痖	jvij
窆	iql
疋	jvkf
虍	mjq
蚵	urs
蟓	cws
蠛	ppsl
箝	abk
簦	hhkh
舡	sikl
舨	ink
糸	plz
麴	aetp
醣	ozj
謦	aatu
鳆	vibg
鳋	zub
髟	ids
齄	ken
敹	doqg
㨄	kxv
挼	fqv
仌	ijf
骭	lsl
鍉	hgf
罥	eczr
丼	hne
嬅	mqy
畊	lho
砳	drtu
垇	qwoq
苶	ykx
朒	yhr
膖	wyr
豗	mlqy
砯	wjt
嚱	clu
湦	thh
烓	gxmo
珃	fng
珄	thgt
焺	thm
麤	xjl
玽	ldg
暒	akrt
婋	cdy
琞	twrj
蕥	jvxj
莀	syxm
莯	pixd
翧	cflc
琂	jqgu
妉	hoy
晹	jlrg
昍	cfrr
妳	yfy
跩	kjn
犼	mdau
玏	drgd
瑊	exg
猋	idaa
羴	tob
怹	oofc
惢	zpc
埜	jrdo
尛	pqc
玊	zig
鿔	lkeu
氼	ylt
恏	mwy
兲	oxg
巭	ljl
烎	jsum
屌	hzte
躾	pgt
実	tnly
雫	yvj
込	jenf
円	jiq
喰	xou
凪	kfe
広	lel
炤	kwmu
桜	jjdy
沢	ndhs
䌷	sxzj
筊	ezk
祂	oewj
畑	obmo
咲	cpuh
芶	ldxk
囧	evg
咗	nsul
吔	jkuj
嘢	jruj
係	clf
喺	cfuc
卌	clq
揾	gwv
嗻	kkub
昰	tlr
薙	olx
劏	oybh
嗮	zbu
嘥	zauf
叒	fxj
佢	abfe
㞗	ayt
郬	ajab
靘	aaa
炁	alq
珮	wdg
呯	wku
惗	yuc
撚	yqvb
孃	yqym
嫐	yty
嗱	yaut
唸	yuu
槑	phud
搣	ppv
擝	phv
冇	ptq
慜	pypc
攞	dsvg
喥	hsuj
〇	dkjj
躝	dqn
嚟	dlut
粦	dspq
冧	dsld
冚	unl
唓	sku
嚡	mjuo
㗎	eyud
菓	lpx
啩	lfui
攰	let
咁	lou
嘅	ldue
瞓	vwps
奀	bqi
唞	hdut
掟	hav
俤	hlf
哋	hlu
啲	hgu
肏	xwf
噃	ituo
屄	igt
揼	iwvt
㞎	ivt
抦	iqvi
粄	inp
閪	cgpc
喎	gau
啱	jouu
猇	cdae
苧	ykxh
昤	dkr
纮	maz
昄	inr
夬	loky
乂	jlw
彳	slwf
彧	jhq
烜	cbm
祇	anwt
燚	jlmm
晞	cgre
湜	tnh
浐	snhs
梣	syd
僔	nmf
槜	ned
寁	nnl
矰	nht
慥	nwc
麀	jxli
鋆	jhoe
煴	jsmp
籥	jokx
廙	jll
倻	jkfb
垚	jro
猺	jrav
滧	jrhg
䲟	jrbb
䗛	cosr
翛	cdfc
廆	ggl
滃	gmhc
蕰	gqxp
芠	gyx
窊	gel
㑇	kkf
柊	kvd
瑑	kcg
帨	teeb
陎	tjb
骦	tap
墡	tso
屾	tqzz
鲹	tqb
玿	trg
焞	osm
㻬	ojg
猯	ofa
煓	ofm
圫	osoa
萚	oxx
黇	oxxu
菼	onx
趯	olo
慆	ouc
廋	zxl
璲	zeg
襚	zew
旞	zev
鹔	ziz
骕	zip
㧐	zqv
瓀	fbg
䎃	fnf
驲	flp
麹	aepp
婘	aiy
杄	axd
愭	anc
衃	wxc
酦	wtj
玶	wkg
蚲	wks
狉	wga
苉	wfx
鲏	wnbj
弸	wol
潖	wah
笯	ymk
傉	yif
麑	ynl
媆	ywyh
迺	yrn
偭	pqf
杧	pzdg
亹	pyg
癗	dgi
垏	dho
葎	dhx
漋	dah
疁	dyo
嫽	doy
磏	dbte
筤	dzk
埌	duo
箖	dskd
裈	usw
婫	usy
剋	uxt
櫆	ubdt
骙	ubpo
矻	ujt
埪	uvo
斝	eau
娵	eey
泂	evhu
麖	ejl
墐	ero
欻	szm
漴	sah
㳘	svh
堾	sso
儳	sqf
韂	ssx
瓻	sgc
偁	shf
庱	sml
茝	srx
垞	sao
惛	mscr
袆	mlw
玒	magl
硔	mat
琀	mqg
垾	mso
侴	sdf
耇	ldt
堌	lio
垙	laob
堽	lyo
堨	bro
涐	bdh
楯	hxd
嘚	hxu
楪	hkd
剟	hsjh
亸	hpg
萣	haxf
亶	hng
瑳	xsgl
玼	xfg
袯	iqwj
摽	ipv
瀌	idh
坋	iwo
倴	iwf
蚆	ies
嶟	nsz
噂	nmux
鲗	nhb
璪	ntg
臜	ner
崒	nmz
珇	ncg
鬷	nvq
疭	nzi
捽	nsv
酂	nscb
鼒	ngx
镃	ngez
鄑	ngjb
牂	nyk
鄫	nhbb
簉	nwk
倧	nvf
岞	nxz
嗞	nguz
玥	jog
祎	jgw
咉	jyuj
玚	jzg
旸	jzr
靿	jwxd
訚	jspu
栐	jqdj
耰	jxv
槱	jdd
祐	jkwu
妘	jhyk
缊	jxzp
赟	jsgf
燏	jhmu
遹	jhnu
薁	jhxh
㺄	jsah
滪	jhhf
堉	jhor
澭	jvhj
鲬	jqb
鄘	jvlb
埇	jqoj
㶲	jzmj
嫄	jiyc
蜎	jfsr
妧	jiyb
湲	jihj
溁	jkhd
䓨	jjxv
甗	jnqg
戭	jnll
蝘	jnsy
漹	johb
墕	jsob
渰	jnhq
棪	jnd
弇	jnfq
䶮	jndo
沇	jnhb
觃	jsen
㑊	jlfj
簃	jnkc
嫕	jly
宧	jnlq
昳	jlrt
杙	jldl
螠	jlsp
浥	jlhi
羕	jubj
垟	jzo
飏	jzvw
馌	jrtp
媱	jryv
窅	jtlp
峣	jrz
珢	jsgm
嚚	jsuu
慭	jrdc
禋	jvwo
溵	jvhj
歅	jvcf
崟	jsze
硍	jstm
愔	jvcr
猰	jrah
堐	jao
玡	jagj
鲉	jtbj
钖	jze
褕	jbwh
淯	jhhr
玙	jbgj
爚	jomx
彟	jyc
颙	jaq
媖	jjy
珣	chgr
禤	cfwc
愃	cfc
琇	cegy
噀	cxu
栒	chdr
谞	cej
垿	cho
珝	csg
昫	chru
魆	cel
媭	cewy
敩	cibg
峃	cibz
茓	cix
讻	csjc
夐	ct
翾	cfz
暶	cir
衒	ccf
瑄	cfg
珛	cegr
脩	cofr
滫	czh
薢	cpxy
㙦	ckfo
絜	ckvc
偰	cpf
蟏	cdsz
皛	czi
涍	cphn
虓	cdee
恔	cpcc
洨	cohc
鸮	cduy
孅	cxy
㬎	cqr
禒	cqwy
玹	cbg
狝	cqac
忺	cxc
伭	cbfz
挦	cbv
珦	cwg
煋	cjm
铏	cke
觿	cgbu
爔	cgml
巇	cgz
鳛	cnbi
釐	cgg
暿	cgru
嶲	cgzk
嶍	cnz
傒	cgfh
绤	clzu
枲	cfk
窸	cglc
郤	cli
潟	clh
伈	cyf
炘	cvm
昡	ccr
咺	cbuh
咥	cluo
䜣	cvj
叚	cdkj
屼	giz
踒	gtn
鳁	gqbp
坬	geo
鳚	gdbx
薳	ggxm
碨	gdtm
㧑	ggv
霨	gdjx
鹀	gmgy
珷	gcg
峿	gmz
旿	gcr
涴	gfhk
偓	gff
椀	gnd
婠	goy
塆	goo
尪	gyq
鹟	ghiy
辒	gqs
榅	gqd
炆	gym
畖	geol
洈	ghhk
髽	kzs
纻	kiz
䏝	kfr
晫	ksrt
鳣	kobh
偡	ksft
齇	kena
劄	kak
鲊	kvb
啫	krur
烝	khd
婤	kxy
鸼	kxk
辀	kxs
㤘	kkc
衠	ksfh
砫	kitk
柷	kidb
穜	kqmd
茽	kzx
僎	kcf
䓬	ksxt
叕	ksjj
椓	ksdy
棁	ksdb
䦃	kser
鹯	kog
栴	kod
飐	knvu
擿	klvu
疐	kltf
榰	kgdr
稙	kgmk
锧	klef
畤	klo
梽	kldc
晊	klro
庤	kllx
暲	kyr
鬒	kgsi
葴	kqxl
揕	kwvt
袗	kgww
纼	kwzj
瑱	kwg
䗪	krls
詟	kdd
晢	kdvr
曌	kwrl
旐	kwvk
鲝	kvbj
䃎	krt
溠	krhl
奓	krhc
挓	keva
沚	kfh
汋	ksht
拃	kvv
禛	kqwi
腨	tcrb
阇	tdp
睄	twp
婌	tmy
鹴	tajy
礵	tat
嶦	tszu
晱	tnr
掞	tsvm
栻	tldl
䏡	tlrc
鸤	tgty
邿	tgo
奭	tlqy
陞	thb
瞫	tgp
侁	tqfb
珅	tqg
燊	tqm
瘆	twi
柖	trdu
昇	thr
隃	tib
棽	tqd
腯	omr
鲖	oab
嬥	ozy
媞	ony
鳀	onbf
蹚	oyn
嘡	oyu
熥	ohm
弢	oul
鞳	orxu
褟	oewc
魋	obl
璮	ong
坉	oho
鲀	ohb
稌	omm
葖	ojxa
梌	omd
橦	oadd
烔	oam
峂	oaz
侂	osfa
淟	oqhi
盷	obph
沺	obho
湉	obhu
颋	oqn
桯	ojd
珽	oqg
侹	oqf
榃	oqdo
惔	oqcm
啴	oou
倓	oqfm
䴘	ogw
瑅	ongf
俶	olfj
䣘	ozbb
镋	ope
䲢	oorj
縢	oorc
螣	oors
绹	orz
梼	ordx
曈	oard
朓	ozrk
晪	oqri
渟	okh
圢	oqoh
阘	orpc
㛚	oqy
磹	oqt
蒐	zxx
蹜	zinr
傃	zifc
甦	zjl
窣	zjlt
娀	zvy
溹	zph
楒	zgd
㟃	zgzu
偲	zgf
虒	zgw
溞	zuh
潵	zvhg
靸	zvxe
涘	zlhh
璱	zrgi
漦	sngt
汭	feh
瑢	fag
堧	fio
鄀	fxx
婼	fxy
蘘	fzx
瀼	fzh
嬬	fmy
镕	fae
爇	fxxb
蒻	fxxh
儴	fzf
纴	fwzf
萩	aoxm
鞧	aoxj
玱	amg
囷	asgm
婍	afy
拤	adv
灈	abhq
鼩	abeu
竘	asdu
胠	aer
㭕	aed
坥	aeoa
棤	xxdr
埆	aoo
䓖	avxd
鳈	aib
瑔	aig
棬	afdk
佺	aif
璆	aygw
鹙	aomy
訄	ayeu
癿	aki
硚	aota
蒨	auxr
伣	auf
圲	axo
蔃	aqxs
碃	aatr
勍	akg
鲯	anbi
磜	altc
棨	afmd
跂	ann
䓫	anxu
郪	agab
呇	aft
踦	agn
锜	aneu
慬	asc
嵚	avz
骎	avp
袪	aewk
碶	alth
䓛	aex
玘	afge
抔	wtv
穙	wmm
薸	woxc
鳑	wzb
雱	wyj
玭	wsg
酺	wmj
潽	wjh
䥽	wtej
楩	wbd
㛹	wby
涄	wjhk
荓	wkxu
泙	wkh
洴	wkhu
磻	wqt
䴙	wlty
澼	wlht
伾	wgf
搒	wov
淜	wohr
椪	wwd
墣	wmo
槃	wqkd
芃	woxv
呣	pmu
嚄	rj
秾	yam
杻	yzd
婻	ysy
萳	yqx
薿	yfx
砮	ycyu
嵲	ypz
齉	yun
耏	ybbw
臑	ywr
峱	yraz
乸	yvjp
嫚	psy
牤	pyy
㠓	poz
旻	psrc
祃	prwp
瑂	phgp
媄	pgy
愐	pqcp
勔	pqpd
丏	pqqk
蓂	pkxi
洺	pkhu
祕	plwi
牻	pzy
尨	pzq
厖	pzs
幪	poe
獴	pma
楙	pwdd
芼	pwxp
眊	pwp
碈	pst
湣	pyhr
忞	psgc
孖	pen
鬘	pqs
洣	pfhp
剅	dth
䁖	dxpy
圙	dog
脟	dpr
橑	dodc
姈	dky
祾	dkw
峛	dfz
㫰	dur
崀	duz
崚	dozg
饹	dkt
梾	djd
鞡	dex
镴	drek
瞭	dpp
罍	dhov
礌	dht
蕗	dix
澛	dch
僇	dif
稑	dim
琭	digt
菉	dixt
甪	diwj
䂮	dyvu
哢	dzu
瑬	dyhj
鹠	dydy
罶	dzzo
珋	dzgb
镠	dyew
䴕	dphy
蓏	dpx
簝	dok
憭	dzc
漻	dohw
蹽	ddn
瑓	duge
梿	dbds
辌	dqs
悢	dwcm
㥄	dkc
坽	dko
鸰	dkfy
襕	dqwe
㰀	dndt
醨	dnj
㮾	dpd
塱	dpdo
蓢	dpxr
烺	dpm
堎	dwo
簕	drk
俫	djfd
荖	dtxi
嫪	dwy
潾	dshq
璘	dsgq
蝲	drsh
藟	dgx
眬	dap
飗	dyvo
俍	dqfm
舲	dkkk
勠	dicd
箓	dikt
啰	dsuc
髎	dolw
壸	umt
焜	usm
姱	uzy
煃	uzm
硿	uvtl
鲙	uob
㧟	ujv
崁	usz
牁	ukku
洘	uth
鹍	usr
堃	usv
戣	ubk
圐	ujg
洭	uah
墈	usod
嵁	uoz
衎	usf
磡	ust
硁	uht
炣	urm
炌	ubm
㸆	uwm
晙	exr
䌹	evz
坰	esou
㠇	eez
膙	enr
秬	ehme
㛃	ekvy
珺	exgu
畯	exo
焌	exmg
葰	exxg
莙	esxu
鲪	esbu
槚	eadf
䴗	ebp
腒	eer
筥	esku
崌	eezu
砠	eet
泃	eeh
岨	eeza
弆	esoq
岠	ehz
焗	ebm
玃	eiaj
傕	eif
砄	eit
玦	eigy
冏	evqu
焆	efm
氿	ezh
檞	ewd
湝	ehh
悈	epc
玠	epg
劼	ektd
皭	epix
斠	epqt
䴔	edgy
峧	edz
藠	epxi
暕	eqre
靬	exxl
鞬	exxe
鳉	embx
弶	ewlc
鼱	eje
䴖	eja
猄	ejac
倞	eafc
汫	eqhe
蹐	enn
惎	ela
鱾	efbe
徛	elfu
堲	ene
罽	elzh
殣	erhq
溍	erhr
祲	erw
珒	evgq
䐃	evrm
鳒	exbe
璟	eqgc
漈	elhc
䲠	ssb
倕	sbf
惙	sxc
旵	snrz
巉	sqz
㬚	srrg
弨	sul
蹅	svn
侘	srfa
嵖	sazh
犨	sxf
瑃	ssgr
圌	sbgb
濋	sch
摴	sjv
䝙	sjwc
䢺	sjs
噇	sgud
瀍	sqho
辿	sonz
镵	sqe
摛	sgv
胣	sfr
佁	slfu
鲿	szbk
憕	soc
澂	sohg
赪	sho
牚	swb
珹	sog
宬	sol
琤	shgk
珵	sogg
疢	swi
瞋	sqp
珫	svgb
逴	ssnt
椆	std
琡	sig
翀	svck
痓	slio
鲘	mkbu
婳	mfy
昒	mjr
貆	miwh
㬊	mbrj
峘	mizh
媓	mgy
嬛	miym
姮	moy
垕	mkm
郈	mkmb
觟	mfb
橞	medc
鳠	mib
嫭	miym
鄠	mij
淴	mjhc
昈	mir
谼	mai
翃	maq
竑	mad
吽	mvu
澴	mihm
荁	mixh
鹮	mizy
㸌	mxmm
濩	mxhj
佸	msfu
喤	mgu
㘎	mnu
暵	msry
蔊	msxl
崡	mqz
鸻	mofy
龢	mdfm
熇	mrm
鹖	mdry
隺	mrhq
垎	mrou
郃	mdfb
龁	mdk
饸	mdt
鞨	mdxk
盉	mdm
嗐	mbu
鄗	mwg
淏	mwho
滉	mbhb
嵅	mqzu
虷	mqs
硊	metk
翯	mrc
翙	mezc
齁	mxn
爟	lcm
腘	lsrj
矼	lyt
浭	lhh
荄	lax
晐	larf
暅	lwr
姤	lkyu
鬶	llv
珪	llgo
邽	llob
瀔	lchj
羖	lcb
唝	lzuf
祼	lcwl
蒄	lfx
毌	lckq
瓘	lcg
琯	lbg
洸	lah
鳡	lnb
玕	log
㭎	lyd
冮	lyh
滆	ldh
筀	lek
鹒	lhly
筶	lwku
鳤	lbbl
粿	lpp
馃	lpt
璠	vqg
棐	vgvd
剕	vdvh
朏	vgr
簠	vck
鄜	vjl
琈	vmg
洑	vmha
砆	vjt
韨	vmgj
玞	vjg
㳇	vih
芣	vmxi
墦	vqo
赗	vwip
崶	vhzx
堼	mwo
沨	vhhc
豮	vyq
翂	vqc
棻	vqxd
榑	vmdx
牥	vyy
昉	vpr
茀	vmxv
咡	bou
陑	bjbb
祋	hewj
耑	hfz
绖	hkz
窎	hpl
扂	hum
髢	hns
珰	hyg
璒	hhg
扽	hwv
叇	hbb
炟	ham
荙	haxh
塅	hcoj
垱	huoh
惇	hscn
厾	hjk
瑖	hcg
䏲	hkr
㙍	hsoj
埵	hpo
琔	hugf
憺	hscu
疍	hskh
蹢	hnnu
鞮	hgx
踶	hlnf
䃅	hgth
媂	hlye
菂	hlxt
垈	hbfo
轪	hbs
鱽	hubh
舠	hukh
捯	hrv
跶	hen
杕	hxdh
䗖	hls
垯	heo
邨	xso
缞	xlzm
悰	xac
跐	xfni
嶒	xoz
漼	xzh
熜	xvm
莝	xxx
莿	xlx
泚	xfh
佽	xlff
鸧	xyfy
馞	iqmn
蔈	idxc
俵	ipf
昪	iurq
抃	iuv
蛃	iqs
昺	iqri
鲾	igb
塝	iuo
琫	img
胈	iar
妭	iay
祊	ihw
镚	iwe
欂	iqdx
糒	idpj
椑	ixdt
蔀	iix
镈	iqex
嶓	itz
鲌	iqb
桲	iqdn
哱	itun
砵	itti
僰	iqqf
藨	idxb
儦	idfb
熛	idmc
脿	izr
萹	ixxx
靽	isx
湴	ish
柈	isdi
觱	iluj
珌	ilgi
诐	ilj
邲	ilib
佖	ilf
坒	ilio
赑	ilif
棓	iudu
玤	iugv
栟	iqdu
枹	iudk
邠	ivi
鲃	ieb
羓	iebi
犇	iqy
朳	ied
隩	qwb
奡	qwqq
璈	qrg
唵	qnu
卬	qzw
盦	qof
垵	qoo
毐	qrt
叆	qbbj
匜	jnuj
嶅	qrqz
矞	jhku
遆	onne
憙	cftc
舥	wek
悆	jhfc
龂	jske
郿	phpb
肸	cgrt
鄅	jsjb
霅	krju
鳂	gxbm
邘	jbjb
醾	pnjp
襫	tlwy
褯	epw
襜	sowu
鹝	jlqy
䴓	tgq
诇	ctj
讱	fwjf
翚	mlcs
敔	jsgg
郚	gmgb
裛	jlgm
瑧	kqgm
瑀	jsgj
琄	ccg
瑆	cjg
瓖	cmgm
珸	gmgu
琟	ghg
珕	dlgd
璥	eqgg
瑨	erg
琎	erge
璬	ezgg
飔	zgvc
菍	ypxc
玓	hlgt
琲	idgv
㙘	juo
埫	opo
墘	aboj
埼	anou
垍	elo
垺	vmo
埗	iioi
赒	kxi
冔	csq
扺	kfvt
揳	chv
扞	msvl
摏	svv
幖	idec
忳	ohc
勚	jltd
禔	kgwf
祏	tnw
禘	hlw
穄	elmc
嚭	wft
縠	mmtj
榖	lctj
豨	cgq
硙	ght
碏	aotr
饻	cgtm
馉	lctr
饳	hxts
屃	cltf
螱	gdts
甡	tqtt
嵎	jbzh
崄	cqz
酅	cgzb
峗	ghzk
崿	brz
滍	klhs
泜	kghh
涢	jhhf
沄	jhhk
潏	jhhu
浟	jthg
潩	jlhi
洢	jghj
湑	chhr
㳚	chhl
澥	cphy
洿	gjhu
溦	gxh
浉	tghe
洓	alhy
汧	axhu
渼	pghh
溇	dthy
澪	dkhk
浰	dlhh
浬	dfhd
㵐	eihf
澽	ehhy
浕	erhe
漖	eph
滘	ephu
泇	eohu
瀱	elhh
漷	mph
浛	mqhu
㽏	lshl
浲	vohv
氾	vqh
汈	hdhh
溚	ovh
浡	iqhn
沘	ifh
昣	kgrw
晅	cbr
旴	cer
昽	dari
繄	jguc
鄃	tjfb
畬	tkfo
谿	cgwu
嬿	jsy
婞	cayt
姞	enyu
姽	lzy
姶	bry
睎	cgpe
棫	jhd
枍	jldc
椸	jndj
梠	dsdu
朸	dldd
桹	dzdm
枅	egd
梴	sodk
羱	jibc
闿	urpe
骃	jvp
骍	cjp
骉	idpp
凘	zghe
凓	dlhd
鹡	enhy
竫	eadk
耤	envr
哃	oau
咍	mauu
㕮	vcuc
咇	ilui
鼫	tne
铚	kleo
锳	jje
钘	ckeu
铻	gmeu
艅	jbkc
镮	miem
斶	sie
帡	wke
翷	dspc
缐	cuzt
刬	ssl
翈	cdec
熻	cgmc
烻	jsmk
䎖	nhbc
煟	gdmr
烶	oqmf
燋	edm
烠	mbm
煁	sym
扆	jfm
恓	cgcc
扊	jnmm
虤	jqme
馧	jsmp
穟	zemz
扅	jnmc
䅟	xnmw
馝	ilm
鄌	ozlb
庼	aql
髃	jblh
珖	lag
靺	pfxp
鞁	idxj
靰	gixb
匼	ukuu
俙	cgfe
伋	enfe
虸	nfs
蠋	kms
蟫	jsst
䗴	oksf
蜐	eks
蚄	vys
黡	jnsb
茋	kfxh
蒱	wmxv
糵	ypxp
㿠	mbi
藦	pqxt
鹲	poxy
鄚	pwxb
蒟	esxu
蓇	ljxr
䢼	lvxb
苾	ilxi
颎	evi
雊	lkeq
皕	ilir
皦	ezig
艎	mgkg
皞	mwit
岊	eki
瑝	mggg
鹢	jlby
攽	ioig
跱	klnx
蹾	hsng
羑	jdb
锽	mgeg
筼	jhkf
簰	wjkt
篯	exkl
筦	lbk
筜	hyk
鹐	axby
觭	egb
