的	d
我	w
是	u
了	l
你	n
在	z
和	h
都	dx
不	b
有	y
就	j
也	yl
好	hx
个	g
人	r
说	us
用	yy
他	t
这	v
来	ld
要	yv
去	q
会	hf
看	k
中	vk
想	x
没	m
啊	a
那	ni
吧	bl
给	gj
能	nf
对	df
上	ud
到	dv
多	ds
吗	ml
里	lg
被	bk
做	zp
又	yr
过	gp
让	rd
还	hd
她	tl
打	dm
把	bm
而	e
着	vr
大	di
从	c
它	tlb
写	xc
再	zo
字	zt
得	dr
搞	gx
狗	gz
猫	mq
一	yj
真	ve
下	xx
但	da
叫	jl
很	ho
比	bg
呢	nr
最	zf
更	gf
地	dt
等	dy
吃	i
像	xe
后	hr
时	ub
只	vg
点	dp
先	xr
话	hg
与	ys
快	kf
玩	wp
当	du
已	yg
问	wo
完	wpb
以	ygl
将	jy
您	nc
找	vx
爱	ao
太	to
谁	ur
才	cd
年	nv
新	xh
跟	ge
别	bs
学	xi
哇	wl
按	aa
哎	ab
前	qv
睡	uf
加	jd
所	s
为	wr
为	wkl
可	kl
出	ia
嗯	ef
该	gb
向	xep
却	qd
哦	o
小	xl
天	tr
高	gq
买	mu
呀	ylk
刚	gu
事	ut
好	hvn
坏	hft
发	f
全	qo
开	kb
万	wa
之	vj
心	xhd
帮	bu
回	hw
牛	nm
家	jdb
长	iw
月	yd
卖	mo
岁	sf
成	if
唉	aok
跑	p
走	zz
早	zx
连	lv
滴	dj
越	ydt
无	wla
阿	al
送	sy
分	fe
黑	hi
额	ee
妈	mln
换	hc
们	me
难	np
同	tj
祝	vh
恩	eey
干	ga
算	sc
路	lh
并	bw
呗	bi
少	ux
猜	cb
放	fd
擦	cl
转	vs
错	cp
脸	lp
贴	tk
陪	pr
带	do
笑	xlv
敢	go
谱	pm
拿	nu
二	eh
煮	vm
鸡	jj
或	hp
书	ua
每	mj
画	hga
坐	zpt
咯	km
掉	dl
讲	ju
梦	mf
冷	ly
花	hs
于	ym
手	uz
咋	zm
哟	yp
爆	bv
站	va
变	ba
看	knu
哥	gr
版	bo
水	uv
起	qg
图	tlk
弄	ny
住	vhr
啦	ll
够	grj
咩	mk
累	lk
倒	dvr
肉	rr
毛	mi
神	usp
请	qw
拉	llf
肿	vn
听	te
内	nk
噢	op
唱	id
骂	mik
装	vw
三	sn
蛮	mp
腿	tv
正	vf
瘦	urb
卤	lm
俺	aor
老	lx
俩	ln
抱	bvf
忙	mw
超	iq
疼	tf
胖	pd
喔	wpk
车	ir
某	mz
第	dtv
教	jm
生	uc
中	vyk
进	jv
假	jn
差	ii
忘	wd
热	ri
选	xs
啥	uu
微	wi
求	qm
若	rp
些	xk
久	jz
苦	kmc
米	mg
约	yu
飞	fi
吓	xxk
亲	qh
照	vv
赢	yn
饿	ei
读	dly
秒	mlh
信	xv
另	lw
儿	ek
靠	kv
聊	lu
远	ysz
懂	dn
羯	js
低	djr
呆	db
晒	uo
追	vt
见	ja
跳	tlz
挂	gg
哪	nmk
鸟	nl
呃	eik
挺	tw
贵	gfv
元	yo
摩	meg
疯	fc
张	vu
萌	mfc
头	ta
活	hl
行	xn
哒	dlk
次	ct
本	bom
骗	pa
店	dag
考	kx
歌	grk
喂	wk
强	qi
死	sg
收	uxj
贱	jab
噗	pak
恨	hox
撸	la
喵	mm
亮	le
弱	rpg
破	pg
哼	hck
拍	pb
躺	tp
抢	qu
吐	tm
日	rt
谈	tpy
饭	fa
帅	ufl
离	lb
号	hv
闹	nvm
办	bal
还	hoz
养	ypy
红	hj
猪	vaq
刷	usu
呐	nik
姐	jc
洗	xg
种	vy
喝	hrk
菜	co
如	rl
赞	za
丢	dz
捏	nkf
非	fil
粉	fo
怕	pi
坑	kc
总	zn
曾	cf
爹	dk
蛋	daz
型	xnk
咱	zpk
屎	ug
纸	vgs
杀	ul
自	ztp
白	bd
急	jb
催	ctr
吖	alk
改	guj
特	ti
包	bq
愿	yc
妹	mkn
唔	wlk
受	urv
抓	vsf
钱	qvj
者	vl
喷	pe
鱼	ymd
瞎	xd
此	cg
乱	lc
滚	god
呦	yx
晚	woo
留	lmp
晕	ygo
风	fcj
抽	ix
块	kft
怪	gfx
度	dh
戳	is
往	wpr
便	bar
楼	lam
党	dpx
咬	yxk
吹	it
练	las
删	un
条	tu
耶	ye
丫	ylb
系	xt
君	jg
丑	iz
件	jar
近	jvz
两	lua
雨	ysa
力	lt
面	ma
球	qmw
重	ij
火	hlb
爬	pu
脚	jlo
管	gs
偶	oz
行	hwr
痛	ty
黄	hb
嘴	zv
戴	dog
情	qn
各	gi
门	ms
卡	kmu
倒	dxr
跪	gfz
道	dvz
病	bwb
边	br
搜	sx
短	dsu
混	hrd
指	vgf
翻	fn
词	cby
招	vq
尿	nlu
摸	mpf
嘤	yek
撒	sm
毁	hvj
顶	dw
马	mmv
喊	hok
由	ya
悲	bif
组	zms
帖	tc
则	ze
爪	vgi
配	pk
乃	nuv
斤	jh
秀	xo
伤	uur
喽	lxk
蓝	lpc
及	jbp
谢	xq
因	yh
泡	pv
未	wka
款	ks
定	dwb
深	ue
渣	vld
粗	ca
咔	klk
输	uai
床	ib
碗	wou
外	wox
宅	vd
纯	ifs
熊	xks
汗	ha
搭	dlf
药	yvc
使	ugr
感	gow
宫	gk
双	uw
演	yod
木	mh
粑	blm
班	bn
赚	vc
货	hpr
亿	yt
拼	ph
嗨	hbk
其	qb
名	mn
类	lkm
棒	bdm
王	ww
骑	qbm
片	pap
金	jhr
茶	iu
处	ih
砸	zu
查	ium
光	gw
气	qt
枪	qy
句	jf
扔	rc
试	uty
嫁	jx
且	qc
切	qq
醒	xw
惹	rlc
停	tn
树	uh
爽	uud
台	td
口	kz
半	bab
鞋	xsg
雪	xoy
任	ro
摔	ugf
接	jk
操	cq
娶	qs
入	rh
提	tb
狠	hoq
背	bib
挖	wlf
烂	lah
级	jbs
间	jr
乖	ggq
达	duz
云	yf
冲	ik
团	tok
瓶	pn
主	vmw
踢	tjz
硬	yw
嘞	li
女	ns
动	dyy
剪	jp
线	xa
叔	uau
念	na
表	blf
挑	tmf
致	vtg
槽	ci
满	mod
甩	up
油	yad
皆	jkb
捡	jpf
省	uy
八	blp
皮	pbp
子	zg
酒	jzd
救	jo
穷	qk
亦	ytw
忍	ror
妞	nz
反	foi
呜	wak
部	bh
借	jq
插	il
街	jkr
烦	fp
关	gd
草	cx
诗	uj
直	vb
踩	cu
嘿	hik
课	ki
臭	irz
城	ift
票	pl
剩	ufq
趣	qf
握	wg
李	lgm
嘛	mlk
撞	vef
汤	tud
刀	dq
挤	jgf
替	tt
夜	yi
扯	ilf
懒	lo
腰	yq
房	fw
香	xy
安	an
奔	be
穿	idb
凭	pnr
咦	yb
杯	bim
泪	lkd
慢	max
虐	nd
逛	gez
碎	sfu
既	jt
痘	drb
题	tbo
舔	tpu
即	jbg
凉	lid
准	vo
占	vab
屁	pt
记	jty
胸	xp
摆	buf
国	gl
蛇	uei
派	po
称	ic
拖	ts
盘	pp
控	ky
血	xcp
咧	lck
忒	tty
味	wkk
交	jmw
四	st
投	taf
偷	tx
涨	vp
躲	dlu
推	ttf
抹	mif
副	fh
搬	bnf
咪	mjk
尽	jvi
堵	dmt
藏	cw
山	unk
虎	hm
乐	lip
左	zl
吵	ixk
岂	qgu
欠	qa
传	io
笨	bov
寄	jtb
修	xz
烧	uq
眼	yoo
机	jjm
相	xym
套	tvd
撑	icf
蝎	xki
绿	lf
甜	tvu
糖	twm
奥	av
鬼	gv
份	for
烤	kxh
命	mwr
补	bmp
象	xed
节	jkc
惨	cox
熟	uaw
瞧	quo
群	qfy
海	hu
墙	qit
作	zpr
鸭	ylj
样	ydm
圆	yok
嫌	xvn
身	uez
逗	drz
旧	jol
断	dc
歪	wb
戏	xty
段	dcp
罗	lls
盖	goy
羊	ywb
闲	xvm
美	mjy
夹	jca
觉	ji
炒	ixh
仍	rf
莫	mgc
排	pdf
五	wm
傻	um
篇	prv
性	xwx
租	zah
几	jgp
周	vxk
桥	qum
区	qhk
队	dfe
碰	pf
蹭	cfz
哈	hlk
拆	ibf
哭	ka
卷	jsj
场	ip
吻	wok
男	npt
应	yeg
哄	hn
签	qr
法	fm
色	si
需	xhy
流	lmd
杨	ywm
逼	bj
娃	wu
劝	qcy
圈	qdk
集	jbr
语	ysy
涂	tld
平	pna
期	qj
暖	nso
座	zpg
缺	quf
矮	au
空	kk
软	rs
憋	bkx
肥	fr
退	tfz
扑	paf
耍	uge
牌	pdp
烟	ynh
狼	lwq
减	jpd
抄	iqf
理	lgw
劈	pj
印	yvp
望	wdw
陈	ise
郑	vfb
整	vyu
郭	gsw
蹲	dg
恋	law
兔	th
知	vju
娘	nin
驴	lmm
辣	lix
偏	prr
噶	guk
据	jff
数	uhm
清	qe
粮	lim
归	gt
灰	ht
姓	xwn
绝	jis
么	mr
欲	yfg
豆	dra
剧	jfu
待	dor
待	dbr
那	nlv
师	ujl
犯	faq
位	wkr
扣	kr
较	jli
齐	qbw
灯	dch
明	mno
酸	sd
帝	dtw
值	vbr
论	lr
季	jth
土	tmu
右	yru
啃	ko
熬	ai
揍	zr
赶	got
银	ycj
合	he
细	xts
厚	hri
西	xj
南	npu
朝	iiu
狂	kbq
随	sw
瞅	izo
界	jqt
盯	de
趁	iot
淡	dad
轻	qei
岛	dxn
嗷	aik
猛	my
宝	bx
脱	tso
方	fu
刮	gsu
费	fk
遍	baz
抠	kxf
霜	uwy
零	lny
星	xeo
夸	ksd
邮	yay
睇	dto
汪	wud
取	qse
菇	gac
易	yto
蒸	vcc
愁	iah
化	hgr
足	zlk
揉	ra
佛	fer
六	low
码	mmu
龙	lj
糗	qz
馋	ipu
刘	lmw
服	fl
蟹	xqd
牙	yug
富	fhb
吾	wlw
冰	bed
七	qja
常	iwx
底	dgg
仅	jxr
习	xb
粘	vnm
奖	jul
妆	vwl
爷	yef
吼	hz
弯	wn
炖	drh
嫩	no
文	ws
基	jjc
经	je
坨	tlt
射	ui
单	dnb
薄	bic
隔	gee
史	ugk
伞	so
搓	cs
跌	dkz
雾	wh
必	bt
呸	pik
捧	py
似	str
困	krk
掰	bb
令	lwr
怎	zov
刺	ctu
答	duv
冒	mv
凶	xpk
船	iov
酱	jel
趴	plz
闪	uom
昂	aw
紧	jxl
贼	zrb
电	dao
声	uct
具	jfq
压	yli
雷	lry
钻	zd
湿	ujd
登	dcb
啪	plk
百	bua
终	vks
哆	dsk
酷	kh
波	bp
林	lcm
治	vtd
醉	zfy
唯	wrk
弹	tpg
砍	kou
原	yoi
咳	ke
猿	yoq
秤	ifh
害	hob
甚	uoc
锅	gsj
官	gdb
遭	zq
赌	dmb
怒	nh
炸	vi
飘	pmx
胡	hlg
村	cgm
仔	zgr
解	jcd
订	dwy
卧	wgi
捂	wmf
播	bpf
伐	fur
量	lio
割	grb
淘	tid
埋	md
塞	sb
略	ldt
淫	ycd
宽	kd
透	trz
凑	cr
劲	jvj
重	vyq
届	jqu
倍	bkr
胃	wkt
嬛	xdn
举	jsx
灭	mqa
残	cpd
封	fct
属	umu
粥	vxg
脑	nx
福	flp
扫	sxf
韩	hpu
废	fkg
升	ucp
煎	jrb
征	vcr
捞	lq
罚	fus
慌	hwx
叠	dsy
饼	bwu
母	mmm
勒	lig
存	cfu
杜	dhm
胜	ufo
虽	stk
妖	yqn
叼	dmk
根	gem
负	fhd
春	ig
虾	xdi
迷	mb
啰	ls
寸	cru
体	tg
供	gkr
抛	pq
烫	tdd
拽	vff
炮	pvh
防	fwe
冻	dyd
编	brs
侠	xcr
勿	whb
共	gy
纹	wss
闻	wsm
北	bjl
守	uzb
挡	dpf
拌	baf
甄	vex
牵	qrd
发	fif
克	kiu
摄	uif
布	bhu
降	jee
怂	snr
笔	bgv
奶	nun
曰	yuk
霾	mdy
颗	krg
九	jzp
泥	nb
於	ymf
教	jll
瑟	siw
遮	vrz
澡	zxd
痒	ypb
锁	sl
吸	xjk
敷	faf
德	der
踹	ifz
介	jqr
舞	wmp
浓	nj
料	llm
蹦	bf
嘎	glk
潮	iid
现	xaw
长	vpp
壳	ket
调	tuy
罪	zfs
证	vfy
亏	kt
剃	ttb
摇	yif
素	sh
肾	uol
填	tvt
精	jem
沾	vnd
盒	her
闷	mom
犬	qsd
通	tkz
铁	tcj
腻	nt
公	gkb
著	vhc
晃	heo
铺	paj
潘	pnd
砖	vdu
孔	kn
乳	rm
食	ubr
建	jaz
垫	daf
键	jaj
捅	tnf
饱	bxu
欧	ox
伪	wj
盼	pao
滑	htd
运	yrz
绕	rv
戒	jqg
缠	ips
散	soc
散	sac
拜	bou
嘘	xhk
枰	pnm
赵	vvt
脏	zuo
屏	pnu
页	yia
范	fac
逃	tiz
结	jss
巨	jfk
处	imw
言	ypw
梗	gym
攒	zof
翘	ql
挠	nif
溜	lz
市	utw
剑	jaq
分	fob
初	iap
啧	zek
利	lth
针	vej
掐	qdf
啵	bpk
博	beu
否	fz
虚	xhh
造	zvz
巧	qlg
寻	xf
蠢	ioi
托	tsf
朵	dlj
逆	ntz
骚	sq
测	cid
局	jmu
剁	dpj
缘	yos
般	bnv
诺	npy
叶	yik
均	jgt
肌	jjo
东	dka
端	dd
宠	in
税	ufh
容	rj
斯	sj
物	whn
录	lhe
丽	lta
盐	ypt
败	bob
稍	uqh
咸	xvw
摘	vbf
矣	ygs
众	vyr
惊	jex
竟	jw
嗲	dnk
干	gna
漏	lrd
湖	hld
沉	isd
截	jsg
朱	vap
付	fhr
醋	ch
撕	sjf
获	hpc
朕	voo
冥	mnb
丝	sjs
轮	lfi
河	hed
炫	xch
塔	tmt
袁	yot
喜	xgt
魂	hfy
赔	prb
耳	eu
撤	iif
碧	btw
贪	tnr
扛	kw
镇	voj
肺	fko
祸	hpp
果	glt
怀	hsx
嚯	hpk
拱	gn
顺	uri
器	qtk
秋	qzh
孙	sgz
巴	bls
捐	jdf
屋	wau
沪	hh
猴	haq
夏	xxb
龟	gtd
转	vci
耐	noe
仨	slr
争	vcd
肯	kov
歇	xko
极	jbm
案	aab
扭	nzf
观	gdy
卸	xqv
设	uiy
趟	tdt
攻	gkg
抖	dzf
静	jwf
除	ile
旁	pw
稳	woh
董	dnc
逢	ff
浅	qp
环	how
申	ueo
遇	yfz
绑	bps
乘	ifq
缩	ss
泰	toi
紫	zgv
认	roy
串	ick
痣	vtb
沙	uld
友	yz
战	vav
尼	nbu
臀	tfu
丁	dea
股	gm
步	bhv
档	ddm
鼻	bbz
识	uby
叻	lik
颇	ppp
限	xae
幅	flj
响	xu
旅	lsf
跨	kg
意	ytl
侬	njr
哩	ljk
威	wiw
糕	gqm
赛	sob
麻	mug
瓜	gsi
拧	nw
室	utb
愣	lfx
显	xpo
尊	zgb
寒	hpb
广	gud
率	lfw
品	px
休	xzr
凹	aq
维	wrs
裤	khp
搂	lxf
斜	xsr
苏	sa
免	mpd
居	jhu
餐	cn
膏	gqw
染	rod
轰	hk
唐	twg
幂	mt
婚	hgn
瑕	xcw
皂	zvb
桶	tnm
立	ltw
客	kib
状	vel
枕	vom
坟	fs
扶	flf
故	gh
尾	wju
千	qrp
震	voy
粽	zy
叹	tak
古	gmu
灵	lne
堆	dtt
恶	eiy
损	sof
呼	hak
琴	qcw
虫	ijv
展	vou
善	uay
芙	flc
狮	ujq
抗	kdf
科	krh
松	sk
徐	xm
乡	xyv
充	ikw
弄	lyw
拎	lhf
须	xhp
衫	unp
尖	jrx
森	se
扎	vlf
膜	meo
晴	qno
婊	bln
衣	yjw
迟	ibz
酥	say
章	vul
僧	scr
产	iow
竖	uhl
横	hfm
聚	jfe
娇	jmn
十	uba
宋	syb
尚	udx
依	yjr
瞄	muo
旺	wdo
甘	gnc
啾	jzk
膘	bmo
田	tvk
噜	lak
悬	xoq
距	jfz
己	jgk
青	qef
郎	lwl
糟	zqm
雅	ymy
惯	gc
唷	ypk
噻	sbk
麦	mof
侃	kor
罢	bis
京	jew
添	trd
曲	qsk
扇	uah
嚼	juk
芯	xhc
许	xsy
赖	lou
音	yhl
葱	ck
丸	wpl
搁	grf
揪	jzf
榜	bpm
遛	loz
宰	zub
俩	lur
赏	upx
谷	gmb
曝	bvo
赐	ctb
黏	nvh
腹	fho
桌	vsb
蜜	mtb
消	xmd
勺	uib
辞	cbu
江	jyd
兵	beq
裙	qfp
饮	yxu
蝶	dsi
蔡	coc
侧	cir
告	gvn
寺	stt
仙	xrr
甲	jno
赴	fht
角	jld
钗	ibj
薛	xuc
止	vgl
磕	kru
港	gpd
曹	cic
崽	zuu
评	pny
坎	kot
巾	jhk
勾	gxb
窗	iwb
罐	gcf
艾	aoc
斗	dru
凡	fpj
继	jts
刻	kiw
保	bxr
厄	eii
蕾	ljc
抬	tdf
驻	vhm
弟	dtb
喘	isk
皱	vrd
喇	lmk
唰	usk
附	fhe
失	ujp
暗	aao
野	yll
橙	ifm
裸	llp
蘸	vac
桑	su
嘉	jdt
沟	gxd
民	mc
厂	ipa
疤	blb
靴	xug
涅	nq
弃	qtw
汁	vjd
列	lqd
梨	lbh
灌	gcd
净	jwd
温	we
批	pjf
互	hha
罩	vvs
尔	eud
帐	vdj
圣	ufy
馅	xau
柜	gfm
粪	fom
挫	cpf
曼	mao
肝	gno
然	rpx
仇	iar
扁	bph
翔	xiy
肩	jrh
液	yid
掏	tq
末	mga
院	yce
杠	gdm
姜	jyy
谨	jxy
瓦	wma
焦	jmr
湾	wnd
堂	twx
智	vtu
湘	xyd
钟	vkj
辆	lei
莎	ulc
联	lve
瞪	dfo
祭	jtx
项	xeg
壶	hlt
奇	qbd
枚	mrm
兮	xjb
薇	wic
镜	jwj
拐	gpf
兜	dxp
俄	eer
优	yxr
贺	hil
景	jwo
余	ymr
崩	bc
工	gka
剥	bqe
吞	tgt
盗	dvd
窄	vub
军	jgb
携	xsf
痴	ijb
影	ywo
煲	bqr
当	ddx
舌	ueq
衰	ugy
骨	gmg
铅	qrj
划	htg
礼	lgp
裹	gly
饶	riu
顿	drt
鼠	umj
砂	ulu
盆	ps
恕	uhn
搅	jlf
专	vdt
拦	lpf
浪	ldd
卯	mx
菊	jmc
沈	uod
判	pab
引	yxg
制	vtn
复	fhp
漂	pmd
彩	cuc
族	zlf
稿	gxh
漫	mad
摁	eo
绛	jes
核	hem
郝	hxi
挨	abf
挨	adf
脉	moo
妮	njn
标	bmm
创	ie
鹅	eew
哔	btk
颤	iaw
乔	quy
睁	vco
梳	uam
思	sjt
舒	uar
凸	tal
移	ybh
框	kem
泼	ppd
邓	dfy
恰	qx
阴	yhe
鲜	xry
患	hci
帽	mvj
柳	lzm
磅	bdu
斩	voi
忌	jtj
鲍	bvy
侯	har
熏	xgq
彭	pft
册	cik
邀	yqz
晾	leo
掌	vpx
玉	yfw
弦	xvg
楞	lfm
业	yil
汇	hfd
社	uip
骆	lpm
吨	dgk
坡	ppt
懵	myx
蒜	scc
财	cdb
赠	zfb
怨	ycx
涮	ucd
墨	mgl
注	vhd
庙	mlg
斑	bnw
靓	lef
呲	cj
吉	jbt
券	qcj
迎	ynz
玻	bpw
筋	jhv
霍	hpy
嗑	kik
视	utp
洒	smd
乜	mkv
译	yty
夫	fae
铲	ioj
柴	idv
蒋	juc
悟	whx
兰	lpb
茬	iuc
漆	qjd
恤	xfx
华	htr
垮	kgt
孤	gaz
箭	jav
屯	tfa
削	xmx
叉	ily
普	pmb
英	yec
州	vxd
志	vtt
商	uuw
禁	jvm
厅	tei
载	zog
私	sjh
浇	jmd
腚	dwo
户	hhd
独	dlq
脆	cfo
瞒	mpo
蒂	dtc
壹	yjt
徒	tlr
欸	er
世	utc
简	jpv
佬	lxr
锤	iwj
蛆	qhi
嘚	drk
唇	ifi
捶	iwf
宁	nn
增	zc
禅	ipp
县	xaq
忧	yxx
仿	fpr
铊	tlj
葬	zdc
权	qom
龚	gkl
羞	xzy
劫	jsq
童	tjl
希	xjx
蹬	dcz
癖	pgb
职	vbe
瘫	tnb
粒	ltm
渡	dhd
绣	xos
欺	qjc
敌	dbu
毕	btb
实	ubb
腐	fmg
杂	zuj
仗	vdr
藕	ozc
糊	hlm
逮	doz
墓	mhc
萱	xdc
浮	fld
哉	zb
度	dlg
织	vjs
籽	zgm
岗	gpu
腔	qyo
蒙	mcc
喃	npk
扬	ywf
备	bkw
雄	xku
眠	mvo
牢	lib
萨	sic
撮	csf
耶	yre
迈	moz
焖	moh
严	ypa
奏	zri
续	xfs
系	jtp
沃	wgd
呈	ifk
押	ylf
种	vnh
冯	ffd
倩	qar
愈	yfr
憨	hne
脖	beo
嫖	pun
川	idp
鹿	lhg
嗦	ssk
窜	cc
撅	juf
樱	yem
皇	hbb
镐	gxj
忆	ytx
挽	wof
讨	txy
栽	zbg
庆	qwg
卡	qnu
胶	jmo
敬	jwc
润	rrd
永	ynd
咒	vrk
棍	grm
袭	xbl
俊	jrr
噎	yrk
嘭	pc
陶	tie
厝	cpi
嗅	xok
痰	tpb
乌	wap
险	xpe
甭	bfb
俾	bgr
邱	qzq
碳	tau
采	cuv
伸	uer
孟	mfz
鼓	gmt
贝	bkk
缓	hss
蚝	hii
咽	yak
纵	zys
卒	zlw
吱	vjk
钙	goj
翅	itv
耗	hvl
雀	qdx
棵	krm
挪	nlf
始	ugn
皿	mxk
钉	dej
冬	dkw
洋	ywd
苗	muc
盛	ufi
袜	wip
纳	nis
茧	jpc
啤	pbk
暂	zai
妥	tlv
盲	mww
误	why
菌	jgc
浴	yfd
勇	yns
孽	nqc
枉	wpm
峰	fcu
汉	had
晏	yao
嚷	rpk
研	ypu
库	khg
榛	vem
叽	jjk
噔	dck
陌	mge
吒	vlk
护	hhf
闭	btm
贾	jnx
捎	uqf
垵	ant
抵	dgf
莲	lvc
肚	dho
冤	ydb
椒	jmm
獒	aif
葛	gec
仓	cur
朗	lpl
义	ytd
尸	ujk
辛	xhl
唠	lvk
轴	vai
煞	uid
胆	doo
枣	zxu
稀	xjh
晨	iso
仁	rsr
庄	vwg
撩	luf
秃	tah
乙	ygv
临	lcl
嗔	iek
婶	uon
灸	jzj
鲁	lmy
宴	yab
币	btp
速	shz
索	slu
佳	jdr
姬	jjn
咕	gak
返	foz
禾	hep
链	laj
誓	utf
眯	mjo
瓷	cbd
绘	hfs
恃	utx
吕	lsk
番	fnc
哀	aby
铝	lsj
乎	hap
蛙	wli
置	vts
氪	kiq
掀	xrf
埃	abt
芊	qrc
裆	dup
镁	mjj
卢	llb
兑	dfb
阔	kp
谜	mby
差	iby
昏	hgu
谓	wky
承	ifl
忠	vkv
潜	qvd
瞟	plo
驼	tlm
欢	hdy
巫	wag
悔	hvx
诚	ify
崴	wuu
呛	qyk
呛	qek
涩	sid
曾	zcb
轶	yti
递	dtz
烙	lvh
棉	mvm
霸	biy
缝	ffs
切	qkq
嘀	dbk
祛	qhp
舟	vxp
鞭	brg
瘾	yxb
亭	tnw
阉	ynm
荼	tlc
呕	ozk
顾	ghi
雇	ghh
舍	ulr
质	vti
镶	xyj
背	bkb
剂	jtq
渴	kld
昨	zlo
间	jam
帖	tqj
叮	dek
姚	yin
蛤	hui
乍	vip
谎	huy
阳	ywe
亲	qwl
荤	hgc
忽	haw
账	vdb
枝	vjm
剥	bpe
舍	uir
桃	tim
捷	jsf
揭	jkf
勤	qcc
畔	pat
荡	ddc
嗝	gek
嘟	dak
奉	ffi
孝	xll
桩	vwm
挑	tlf
售	urr
拳	qoj
犊	dln
徕	ldr
溅	jad
助	vhq
铜	tjj
泡	pqd
泯	mxd
盾	dri
焉	ynv
悦	ydx
夺	dld
伦	lfr
诸	vay
瑞	rfw
萧	xmc
宜	ybb
跶	dlz
拾	ubf
珠	vaw
凤	ffj
揽	lof
圭	gtt
弓	gkv
池	ibd
境	jwt
谦	qry
莪	eec
匿	ntk
审	uob
隆	lje
妾	qql
硅	gtu
咻	xzk
叭	blk
触	ihd
缸	guf
坊	fut
嚓	clk
旗	qbf
莱	ldc
孩	hdz
嗡	wc
哑	ymk
裁	cdg
亡	www
淌	tpd
吆	yqk
危	wid
硕	upu
倔	jir
荣	rjc
泉	qob
嗳	auk
卵	lsp
钵	bpj
谣	yiy
债	vor
恒	hfx
肠	iwo
拟	ng
拴	udf
垂	iwq
伏	flr
撬	qlf
妃	fin
恐	kng
媛	yon
菲	fic
靡	mgg
矗	ihu
晓	xlo
搏	bef
抡	lgf
睿	rfb
腌	yno
撇	pcf
筒	tnv
鸣	mnk
淋	lcd
娟	jdn
搽	iuf
眨	vmo
目	mhk
揣	ipf
彪	bmh
兹	zj
恁	nor
绳	ufs
脾	pbo
囤	tfk
姆	mmn
洁	jsd
妻	qju
迁	qrz
姨	ybn
秦	qci
序	xfg
称	ioh
异	yts
束	uhg
康	ku
嗓	sp
觅	mtv
篮	lpv
营	ync
镑	bdj
汀	ted
俏	qlr
掺	inf
珊	unw
螨	moi
傍	bdr
司	sjv
崖	yuu
芭	blc
嘣	bck
叁	sns
豹	bvv
哗	hsk
辨	bax
兆	vve
瘪	bcb
枯	kam
芮	rfc
犹	yaq
誉	yfx
蜡	lii
涛	tqd
僵	jyr
阵	voe
坛	tpt
煨	wih
吡	bgk
幸	xwt
栋	dym
刨	bvb
刨	pib
瑛	yew
努	nmn
椅	ygm
袄	ax
玛	mmw
晋	jvy
氧	ypq
吽	hkk
武	wmy
作	zsr
瘟	web
矬	clu
卫	wke
俱	jfr
坠	vfe
蜀	ums
捣	dxf
柚	yrm
辱	rmi
吟	yck
廖	llg
竹	vlg
柔	ram
奴	nln
祖	zmp
棕	zk
咚	dkk
洪	hjd
泛	fad
斋	vbw
眉	mru
穴	xib
卿	qep
燥	zvh
佑	yrr
奔	bod
尘	isx
校	xlm
扎	vuf
迪	dbz
雌	cbv
姿	zjd
馊	sxu
沿	ypd
席	xbg
确	qdu
胯	kgo
擤	xwf
嗖	sxk
燕	yac
遂	sfz
逾	ymz
咿	yjk
焗	jmh
应	ywg
炕	kdh
奸	jrn
避	btz
贰	ehy
缁	zjs
冠	gcb
汝	rmd
厌	yai
颓	twh
殿	dau
隐	yxe
哨	uvk
掂	drf
宣	xdb
呱	gsk
馍	meu
绮	qgs
荒	hwc
驱	qhm
累	lrt
魏	wkh
豪	hiw
糙	cqm
妍	ypn
砰	pcu
砌	qtu
瑜	ymw
翁	wcg
瘸	qib
飙	bmq
畅	idu
预	yfy
腮	sbo
宇	ysb
蛹	yni
空	kyb
刹	ulx
施	ujf
唬	hmk
糯	npm
参	cns
嫂	sxn
艘	sxv
阮	rse
拥	yk
癣	xsb
嬴	ynw
倾	qer
扩	kpf
叨	tqk
挥	htf
豁	hsb
啷	luk
楚	im
莉	ltc
厮	sji
滩	tnd
辽	luz
例	ltr
貂	dmv
玄	xow
歼	jrd
宥	yrb
噌	cck
耙	bil
脂	vjo
积	jjh
幺	yqv
卦	ggt
纱	uls
蚊	wsi
隋	swe
颂	syg
数	umm
齁	hxz
玮	wjw
霉	mry
杆	gnm
栓	udm
炝	qeh
珂	krw
苯	boc
厨	ili
筐	kwv
寨	vob
铰	jlj
岭	lwu
享	xuw
璐	lhw
囊	nwg
籍	jbv
符	flv
伯	ber
煤	mrh
幼	yry
蔫	nrc
呷	xdk
怡	ybx
辈	bkf
斌	bhw
蛊	gmi
激	jjd
韵	yrl
胀	vdo
佟	tjr
酿	ne
歉	qaj
衬	iop
突	tab
覆	fhx
访	fpy
埸	ytt
仪	ybr
士	utu
弗	flg
浩	hvd
谋	may
掩	yof
遵	zgz
孕	yrn
谤	bdy
簋	gvv
辟	btu
妇	fhn
杏	xwm
碑	biu
杵	imm
农	njb
坪	pnt
贬	bpb
嗜	utk
皎	jlb
珞	lpw
蝉	ipi
姑	gan
钦	qhj
帘	lvb
堪	knt
耽	dne
捆	kof
恼	nxx
倚	ygr
筛	ubv
碘	dpu
棚	pfm
缇	tbs
蚺	rpi
町	det
态	tot
绞	jls
扰	rx
笛	dbv
苑	ycc
笼	ljv
傲	avr
尺	igu
劳	lic
磡	kau
茨	cbc
穆	mhh
巢	iiv
寝	qxb
涠	wrd
粤	ydp
闰	rrm
沐	mhd
帕	pij
佐	zlr
葵	kwc
跋	buz
坚	jrl
岸	aau
绷	bcs
荷	hec
症	vcb
堕	dpe
凯	kuu
笋	sov
亨	hcw
绒	rjs
棣	dtm
矫	jlu
愚	ymt
鹏	pfo
咏	ynk
虏	lmh
熙	xji
碍	aou
虹	hji
洛	lpd
妓	jtn
彦	yaw
焕	hch
琳	lcw
癌	ad
霆	tny
祇	qbp
悌	ttx
拘	jhf
脓	njo
闫	ypm
膈	geo
杖	vdm
腾	tfo
匪	fj
叉	imy
葡	plc
津	jhd
碇	dwu
膝	xjo
拈	nrf
蹄	tbz
灾	zbb
绊	bas
溏	twd
惧	jfx
嘬	zs
硌	giu
浣	hcd
晶	jeo
掷	vtf
谗	ipy
郡	jry
幻	hcy
卜	bml
羹	gcy
孬	nqb
铬	gij
宿	shb
奈	nod
窃	qqb
杰	jsm
拄	vmf
擀	gof
饬	itu
馕	nwu
攥	zcf
肘	vz
辰	isi
茎	jec
箍	gav
吠	fkk
尻	kq
导	dxs
谴	qpy
钻	zcj
惟	wrx
梵	fam
验	yam
芳	fuc
粿	glm
婆	ped
犟	jeg
玫	mrw
钛	toj
息	xjz
区	oxk
溶	rjd
捯	dif
锥	vtj
叙	xfr
慎	uox
渊	ydd
撵	npf
逝	utz
浸	jvd
滇	drd
卟	bmk
陀	tle
泽	zed
屈	qhu
察	iub
炸	vuh
艳	yaf
仔	zur
溺	ntd
嘶	sjk
啐	cfk
翠	cfx
种	ijh
谂	uoy
栖	qjm
柄	bwm
闵	mxm
肛	guo
洇	yhd
皖	wob
抻	ief
咣	gwk
坞	wht
掘	jif
估	gar
逑	qmz
逐	vlz
诉	shy
炎	yph
烩	hfh
萎	wjc
袖	xop
聂	nqe
羽	ysx
芽	yuc
俯	fmr
瘤	lmb
娥	een
赤	itt
禹	ysp
毯	tom
钞	iqj
仰	ypr
瀑	phd
宏	hjb
廋	sxg
丰	fcs
剖	pxl
暨	jtg
黍	umh
盈	ynn
胗	veo
禄	lhp
夕	xjp
仕	utr
鑫	xhj
蔻	krc
吭	kck
苔	tdc
铛	icj
藤	tfc
宗	zkb
螺	lli
褪	tfp
锯	jfj
榨	vim
薜	btc
锦	jxj
竞	jwl
浙	vid
韦	wrf
藓	xpc
澳	avd
炜	wjh
鲸	jey
匀	yfb
媒	mrn
曝	pho
囡	nnk
溪	xjd
朴	pmm
杭	hwm
鳓	liy
遗	ybz
衩	imp
屙	eru
魅	mkg
伙	hlr
倪	nbr
屑	xqu
益	ytb
殴	oxq
纠	jzs
磐	ppv
瘀	yhb
艋	myv
燃	rph
聋	ljl
规	gtf
狐	hlq
瓢	pux
论	lfy
脐	qbo
茜	xjc
於	yhf
镕	rjj
候	hrr
庵	ang
狷	jcq
炆	wsh
宾	bhb
抹	mlf
宵	xmb
姝	uan
蟒	mpi
鼬	yrj
历	lti
皓	hvb
逸	ytz
煸	brh
肱	gko
蚶	hni
孰	ulw
俚	lgr
延	ypz
薰	xgc
壳	qlt
戚	qjw
翟	dbx
倦	jcr
氢	qeq
诵	syy
模	mem
烘	hkh
渍	ztd
喆	vet
决	jid
跃	ydz
浆	jyl
塑	shn
嵌	qau
锉	cpj
艺	ytc
匹	pgk
敝	btx
霏	fiy
韬	tqw
政	vfv
貌	mvv
担	dnf
釉	yrc
铺	phj
酌	vly
匙	ibo
暇	xco
淑	uad
硪	wgu
蓬	pfc
痧	ulb
丧	sdt
逄	pwz
柏	bum
寿	urf
舅	joj
汞	gng
滥	lad
蘼	mbc
昕	xho
儒	rlr
庭	tng
航	hwv
廊	lwg
鲤	lgy
怜	lvx
攒	cof
汰	tod
秆	goh
炉	llh
齿	igv
玖	jzw
肋	lko
伢	yur
嗄	uik
窥	ktb
啼	tbk
樊	fpm
屡	lsu
固	ghk
缀	vfs
径	jwr
陡	dze
墩	dgt
泵	bfu
箸	vhv
斧	fmf
喻	yfk
绾	wos
吮	uok
耻	ige
掴	ggf
屠	tlu
嘁	qjk
瓮	wf
赣	gal
违	wrz
慧	hff
荐	jac
偈	jtr
蟑	vui
击	jjf
竿	gnv
纲	gus
寐	mkb
陋	lre
挈	qqf
蚤	zxi
帖	tkj
埵	dlt
怔	vfx
疏	uav
珍	vew
钝	drj
耄	mvl
贤	xvl
胚	pio
垢	grt
灿	cah
耒	ljf
昙	tpo
婵	ipn
聘	pve
坍	tnt
咀	jsk
肽	too
敛	lpq
饵	euu
伍	wmr
促	chr
琛	iew
暑	umo
圃	pmk
嗤	ijk
枭	xmn
舀	yxv
窑	yib
缰	jys
频	pcv
沫	mgd
恢	htx
迩	euz
秾	njh
锡	xjj
莓	mrc
惠	hfi
寮	lub
塘	twt
览	lol
遥	yiz
熵	uuh
狸	lbq
铢	vaj
阻	zme
诈	viy
统	tns
孑	jsl
睬	cuo
堇	jxc
牧	mhn
乾	qvu
蹿	cdz
悍	hax
蛀	vhi
髂	qxg
卅	sia
剐	ggk
盟	mfo
焐	whh
涯	yud
祢	mbp
锕	alj
猎	lqq
丘	qzj
琼	qkw
烹	pcw
壕	hit
煽	unh
幌	huj
糍	cbm
醍	tby
凝	nnd
技	jtf
铃	lnj
轨	gvi
脊	jgr
崇	iju
鉴	jal
捕	bmf
驳	bem
敏	mxp
蕊	rvc
挞	tif
垚	yit
蠃	llw
融	rjg
哐	kwk
瑾	jxw
泾	jed
婷	tnn
舵	dpv
昌	iuo
锰	myj
鼯	wlj
癸	gvb
缅	mps
卓	vlb
佩	pkr
冢	vnb
槛	kom
灞	bid
菲	fjc
讷	niy
姘	phn
泫	xcd
抿	mxf
查	vlm
玥	ydw
旋	xof
枫	fcm
黯	aal
狄	dbq
务	whw
棘	jbu
乜	nqv
碌	lhu
嗫	nqk
匠	jek
孵	fal
萝	llc
箩	llv
泷	ljd
晗	hpo
昇	uco
濂	lvd
鼎	dwp
启	qgh
胤	yve
锐	rfj
销	xmj
检	jpm
泠	lnd
龄	lnv
驿	ytm
骁	xmm
寞	mgb
搋	igf
甯	nwb
描	muf
窘	jeb
率	ufw
濮	pld
酮	tjy
糁	som
筷	kfv
朔	upn
搂	lzf
绗	hws
择	zef
狙	jhq
闸	vum
娼	iun
唛	mok
诡	gvy
挎	kgf
陕	uoe
笠	ltv
谛	dty
浜	bud
铭	mnj
祥	xip
硼	pfu
馨	xht
茅	mic
褶	vlp
综	zks
爰	yov
埂	gyt
瞥	pkx
丙	bwa
枷	jdm
剌	liu
壬	rsp
企	qgr
霖	lcy
逊	xrz
岗	guu
阶	jke
矛	miy
擒	qcf
巡	xfz
疲	pbb
臻	veg
厕	cii
昵	nto
龌	wgv
侵	qhr
垒	ljs
蛾	eei
旱	hao
淼	mlu
膳	uao
澄	ifd
纽	nzs
婕	jsn
碉	dmu
邵	uvd
袍	pip
矿	keu
效	xlw
炙	vtx
倡	idr
鲞	xuj
跺	dpz
典	dpq
怵	ihx
碱	jpu
蹉	csz
鹤	hib
摧	ctf
锈	xoj
嚼	jik
褒	bqy
疾	jbb
寇	krb
缕	lss
策	civ
糜	mbg
繁	fpp
悯	mxx
矜	jhm
戈	gry
怯	qqx
趾	vgz
钾	jnj
炳	bwh
黔	qvl
腺	xao
蚕	cpt
廷	tnz
饥	jju
钠	nij
钚	bhj
株	vam
蜂	fci
夷	yba
贩	fab
剔	tjo
蓄	xfc
庸	ykg
芋	yfc
睹	dmo
芬	fec
酉	yzx
嗟	jkk
呤	lwk
雯	wsy
腩	noo
拢	lnf
仆	plr
梯	tjm
绫	lns
伟	wjr
坯	pjt
汾	fsd
霞	xcy
堤	djt
邻	lcr
寡	ggb
莰	koc
霰	xay
浒	hmd
苟	gzc
鸽	grr
斗	dzu
蜷	qoi
惑	hpg
掳	lmf
旭	xfj
跤	jmz
裘	qmq
寅	ycb
韧	row
猾	htq
炊	ith
馁	nju
肤	fao
慰	wku
绢	jcs
斥	itj
愉	ymx
诓	kwy
姊	zgn
缈	mls
恪	kix
炷	vhh
镌	jdj
湜	ubd
裴	prf
狱	yfq
箫	xmv
蚀	ubu
衿	jhp
焊	hah
猹	iuq
芝	vjc
瞻	vno
哝	njk
蔷	qic
璞	plw
洺	mnd
趸	dow
凿	zi
瑶	yiw
梭	ssm
搔	sqf
阙	qdm
瓤	rw
谶	ioy
裕	yfp
庹	tlg
妲	dun
召	vvd
廉	lvg
昧	mko
暧	aoo
钼	mhj
仄	zii
瑷	aow
璟	jww
蚁	ygi
檀	tpm
簪	znv
岚	lpu
鬓	bve
沸	fkd
葭	jdc
漪	yjd
鹃	jdk
萁	qbc
稻	dvh
冉	rok
揩	kbf
焯	iqh
糠	kum
兀	wha
彬	bhm
瞭	llo
槿	jxm
耕	gcl
穗	sfh
硝	xmu
磷	lcu
玲	lnw
筠	yfv
钣	boj
擅	uaf
缚	fhs
腕	wao
渺	mld
贯	gcm
爻	yix
陆	loe
蜇	vrf
昭	vqo
卑	bip
铐	kvj
锄	ilj
钴	gmj
慑	uix
渚	vmd
辑	jbi
祗	vjp
芥	jqc
狨	rjq
耨	nrl
淞	skd
悭	qrx
岳	ydq
珑	ljw
契	qtf
夯	hud
杉	unm
涡	wpd
拗	avf
拗	nof
酯	vgy
熹	xjt
呋	fak
肇	vvh
枞	ckm
域	yft
禽	qcr
衔	xvr
乏	fup
贡	gyg
培	prt
牟	mas
况	ked
坝	bit
奢	urd
艮	goo
苕	uic
秘	mth
帆	fnj
镖	bmj
储	imr
迫	pgz
泣	qtd
姥	lxn
郁	yfu
戊	whg
滤	lfd
萍	pnc
隼	sor
髻	jte
窟	kab
述	uhz
渠	qmd
霓	nby
蒿	hq
痿	wjb
诌	vxy
茗	mnc
斐	fjf
胧	ljo
齉	ndz
劁	qmr
茑	nlc
禀	bww
磊	lju
丛	cjr
耀	yvg
锣	llj
艇	twv
蜱	pbi
氨	anq
恳	kog
沣	fcd
遣	qpz
瞬	uro
耿	gye
噪	zvk
概	gom
闺	gtm
钮	nzj
蹼	pmz
虱	ujv
瑰	gtw
伶	lnr
昱	yfo
蕙	hfc
庥	xzg
锵	qyj
薅	hqc
予	yss
嗞	zjk
拓	tpf
藉	jbc
蔓	mac
蔚	wkc
恬	tvx
酣	hny
嘱	vmk
踝	hsz
欸	aus
欸	ejs
硒	xju
琅	lww
耪	ppl
戟	jgu
鞠	jhg
焚	fsm
庞	pwg
矢	ugp
婴	yeb
靶	bmg
囚	qmk
虑	lfh
役	ytr
济	jtd
篓	lzv
乞	qgp
稚	vth
茄	qsc
磋	csu
敦	dgw
尕	gmn
涐	eed
琶	puw
逞	iy
臊	sqo
抑	ytf
愤	fox
轧	yii
眺	tlo
戌	xhw
峡	xcu
载	zug
翕	xjr
肓	hww
芒	mwc
硫	lmu
橱	ilm
辅	fmi
祠	cbp
辙	vei
禅	uap
杳	yxm
贞	veb
坂	bot
恺	kux
龊	ipv
洹	hod
枳	vgm
材	cdm
示	ute
镀	dhj
侣	lsr
獾	hdq
氮	daq
憎	zcx
翀	ikx
楸	qzm
亟	jbl
昴	mxo
簇	chv
振	vof
赦	uii
栗	ltx
鼋	yoy
嘲	iik
珰	duw
怖	bhx
涵	hpd
氟	flq
卞	baw
诀	jiy
污	wad
灼	vlh
镰	lvj
唳	ltk
夭	yqp
驰	ibm
雍	ykw
绺	lzs
铡	vuj
鲜	xpy
赟	ygw
纬	wjs
髋	kdg
侨	qur
钡	bkj
祕	mtp
茕	qkc
铪	hlj
剜	wnb
慈	cbb
笙	ucv
甫	fmu
筝	vcv
掣	iin
厥	jii
麓	lhm
彤	tjd
畀	btt
虞	ymh
婢	btn
掸	dof
擂	lkf
暄	xdo
扼	eif
叟	sz
蹚	tuz
旷	keo
绯	fis
协	xsu
铂	bej
鲎	hrx
岫	xou
芷	vgc
圙	ldk
鹀	wlg
蹙	chw
柿	utm
啸	xlk
筹	iav
谅	ley
茂	mvc
梢	uqm
漱	uhd
箕	jjv
兴	xex
跛	biz
庚	gcg
卉	hfu
佰	bur
沽	gad
啡	fik
摹	mec
滨	bhd
疱	pvb
祐	yrp
圐	kak
旮	glj
玚	yww
觜	zjv
掠	ldf
扉	fih
嗽	sr
绵	mvs
铀	yaj
嫉	jbn
镊	nqj
婧	jwn
羔	gqy
獴	myq
佺	qor
忻	xhx
诃	hry
迹	jtz
巽	xrs
蚌	bdi
障	vde
椎	vtm
扫	svf
绅	ues
焙	bkh
糊	hhm
址	vgt
媳	xbn
纨	wps
仟	qrr
啰	llk
孖	zjz
蚬	xpi
昊	hvo
躬	gku
絮	xfn
芡	qac
汲	jbd
榕	rjm
贾	gmx
猩	xeq
桓	hom
葛	glc
逍	xmz
蓑	ssc
颐	ybi
嚷	ruk
乸	nmy
瑄	xdw
凰	hbj
锂	lgj
趋	qht
锚	mij
殉	xrd
苞	bqc
愠	yrx
晖	hto
堡	bmr
腋	yio
妤	ymn
湄	mrd
埔	pmt
岬	jnu
祼	gcp
蕖	qmc
殷	yhp
鸦	yly
粟	shx
喙	hfk
丈	vda
熘	lzh
眯	mbo
曜	yvo
襦	rlp
庇	btg
宸	isb
碴	iuu
胞	bqo
庾	ysg
汆	cdr
醺	xgy
鹭	lhz
麂	jgl
愀	qlx
腓	fro
蒹	jrc
瑗	ycw
槐	hsm
植	vbm
蜕	tfi
璃	lbw
雏	ild
驶	ugm
尬	giy
啜	ipk
貘	mgv
蕃	bpc
毋	wlm
羲	xjy
肆	ste
怛	dux
勘	knc
聪	cke
薯	umc
旬	xfb
毗	pbt
娑	ssd
爨	ccj
玦	jiw
撼	haf
勋	xgk
婉	won
霄	xmy
飒	sil
椿	igm
谏	jay
奋	fod
诳	kby
麝	uil
蕨	jic
煌	hbh
绦	tqs
拇	mmf
镲	imj
烙	lph
悼	dvx
迦	jdz
皙	xjm
铱	yjj
俶	ihr
濠	hid
邨	cgt
龅	bqv
䁖	lxo
镚	bfj
饸	heu
饹	lru
噙	qck
淮	hsd
笺	jrv
昼	vri
厢	xyi
俑	ynr
虔	qvh
晦	hfo
飨	xux
酪	lvy
呓	ytk
谙	any
垃	llt
踅	xif
荚	jcc
腭	eio
屿	ysu
椴	dcm
铸	vhj
臧	zuv
镯	vlj
颊	jcj
狈	bkq
佯	ywr
邝	keg
铉	xcj
诫	jqy
嵩	sku
翰	hau
檄	xbm
祯	vep
镬	hpj
珈	jdw
菀	woc
喳	ilk
娆	rin
腙	zko
谝	ppy
馃	glu
驭	yfm
彻	iir
擎	qnc
髅	lag
溯	shd
乓	puq
坊	fwt
娲	wln
禧	xgp
纶	lfs
谬	moy
殆	dod
摒	bwf
叶	xsk
疵	cjb
睾	gqp
粲	cad
缶	fzw
廿	nac
乂	ytp
绀	gas
鹳	gcc
螃	pwi
跐	cjz
惘	wpx
檬	mfm
泮	pad
硐	dyu
箧	qqv
铠	kuj
诏	vvy
魁	kwg
铮	vcj
褐	hip
究	jzb
菱	lnc
镂	lrj
椽	iom
歹	dua
碜	iou
迂	yhz
坳	avt
癞	lob
姻	yhn
彷	pwr
铅	ypj
羸	lrw
毳	cfm
镉	gej
嫚	man
仂	lir
蛟	jmi
铳	iyj
溃	kfd
舂	iki
鸢	ydy
秧	yuh
凋	dmd
撇	pkf
沓	tiu
晤	who
撰	vcf
蜗	wpi
沤	or
钰	yfj
惶	hbx
懈	xqx
艏	uzv
醅	piy
栊	ljm
戕	qyp
缤	bhs
喱	lbk
醛	qoy
馒	mpu
笳	jdv
葆	bxc
偲	cbr
烨	yih
鲛	jmy
陨	yoe
偃	yor
熔	rjh
叱	itk
奚	xjv
骏	jrm
劣	lqu
嬉	xjn
迭	dsz
氯	lfq
厘	lbi
燔	fph
猥	wjq
玟	wsw
驷	stm
麒	qbl
诘	jsy
茵	yhc
轼	uti
磅	pwu
侉	kgr
苡	ygc
琢	vlw
蹩	bsx
缨	yes
络	lps
鳗	mpy
氐	dgu
妒	dhn
恍	hux
校	jlm
榭	xqm
镗	twj
佣	ykr
娣	dtn
倘	tpr
涕	ttd
褂	ggp
砺	ltu
侩	kfr
沥	ltd
笏	hhv
砷	ueu
胍	gso
旻	mco
炯	jeh
奘	zdp
僦	jor
醨	lby
隈	wie
埗	bht
珺	jrw
鹾	clb
窍	qlb
嫡	dbn
锹	qmj
愧	kfx
砚	yau
嗵	tkk
鹫	jow
奎	kwd
石	daa
纺	fps
宪	xab
辜	gag
铍	pbj
钕	nsj
偌	rpr
绚	xcs
铵	aoj
锎	kbj
骞	qrb
鬣	lqe
圩	wrt
蚂	mmi
嫫	men
棹	vvm
蚴	yri
咥	xtk
埤	ptt
琨	kgw
凛	lxd
羌	qyy
莽	mpc
爵	jiv
鳍	qby
鞑	dug
迸	bfz
骸	hdg
阀	fum
哽	gyk
狭	xcq
篡	ccv
唾	tpk
槌	iwm
秉	bwq
咴	htk
僻	ptr
噼	pjk
煜	yfh
鳃	sby
蹇	jpb
诞	day
怠	dos
戗	qyr
疝	uab
徵	vgr
耙	pul
刹	iix
氘	dqq
濑	lod
萼	eic
哙	kfk
阪	boe
馥	fhh
缳	hos
溴	xod
犇	ben
皴	cgy
瞰	kao
俵	blr
冼	xpd
戋	jrg
晡	bao
祎	yjp
谠	dpy
髎	lug
髓	sv
烬	jvh
询	xfy
缉	jjs
芜	wlc
偿	iwr
夔	kwb
鸮	xmk
讽	fy
濡	rld
悄	qmx
渭	wkd
祟	sfi
箬	rpv
悚	snx
蜃	uoi
采	cov
冶	yld
懦	npx
鲔	wjy
跖	vbz
亢	kdw
桦	hgm
胴	dyo
戢	jbk
煦	xfo
尴	gny
獭	tmq
琐	slw
铯	sij
鸯	yuy
姒	stn
惦	dax
怄	orx
橡	xem
殳	uaj
澎	pfd
眭	sto
玑	jjw
玘	qgw
藜	lbc
邋	llz
垞	iut
昉	fpo
燊	ueh
癿	bsb
瞋	ieo
纮	hjs
胩	kmo
脞	clo
骺	hag
驯	xrm
剿	jlv
膛	two
疆	jyg
蝠	fli
绽	vas
匕	bgp
舆	ymj
燎	luh
藻	zxc
楔	xkm
膀	bpo
呻	uek
弘	hjg
歧	qbv
璨	caw
顽	wpy
昝	zow
辟	ptu
奠	dab
魍	wpg
耧	lal
辔	pks
霹	pjy
嚏	ttk
颈	gyj
晟	ifo
荷	hic
噱	xik
靳	jvg
俭	jpr
隅	yme
鸵	tln
扦	qrf
氰	qnq
酚	fey
荠	jtc
叨	dqk
鳎	tmy
潴	vad
褙	bkp
龈	ycv
彳	itp
芗	xyc
焰	yah
吏	ltg
匣	xck
衷	vky
敞	ipx
饲	stu
筏	fuv
酬	iay
琰	yow
贸	mvp
豉	igd
舫	fpv
蹂	raz
骰	tag
卜	bpl
鹜	whm
丐	goa
圾	jjt
氩	yiq
纂	zsv
蠹	dhg
祭	vox
泗	std
绉	vrs
榆	ymm
噤	jvk
邈	mlz
髦	mie
忑	tix
惆	iax
浐	iod
窿	ljb
龋	qsv
矫	juu
囱	ckp
泚	cgd
珲	hfw
痈	ykb
钊	vqj
阆	ldm
黉	hjx
浔	xfd
湃	pod
湫	qzd
缐	xas
脲	nlo
釐	xjw
锻	dcj
旨	vgb
绸	ias
斟	vec
隙	xte
钨	waj
岐	qbu
帷	wrj
烁	uph
葫	hlc
垄	lnl
堰	yat
绷	bys
翩	prh
箴	vev
讫	qty
匈	xpb
崛	jiu
钿	daj
扪	msf
沂	ybd
迥	jez
魑	ijg
堠	hrt
玠	jqw
涓	jdd
蛏	ici
莘	uec
睦	mho
遑	hbz
箜	kkv
鞣	rag
戛	jcb
丕	pjb
烝	vcl
舶	bev
诎	qhy
邂	xqz
镦	dgj
刿	gfu
悃	kox
氾	fpd
澌	sjd
瑀	ysw
蒟	jsc
蒻	rpc
蠊	lvi
邬	waw
愕	eix
盔	ktu
饷	xuu
轲	kri
蝗	hbi
犸	mmq
朽	xzm
幔	maj
铛	duj
狡	jlq
睫	jso
斫	vlu
泌	mtd
讥	jjy
骊	lbm
猗	yjq
搡	spf
虺	hvw
誊	tfj
牲	ucn
胰	ybo
锃	zfj
锟	kgj
眦	zto
巍	wiu
骷	kag
霭	auy
鲈	lly
冗	rn
峻	jru
稼	jxh
褪	trp
吭	hwk
嫒	aon
珀	pgw
龛	knr
胳	gro
螂	lwi
疚	job
绥	sws
蜘	vji
亳	bew
狲	sgq
酢	zpy
苔	tbc
埒	lqt
屃	xtu
岜	blu
柰	nom
殂	cld
祉	vgp
苒	roc
颧	qoc
鹧	vig
坭	nbt
尜	gux
秣	mgh
糇	ham
肫	vgo
蕞	zfc
蚧	jqi
蠓	myi
谖	xdy
馇	ilu
淬	cfd
戮	lhx
鬃	zke
骤	vrm
帛	beb
徼	jlr
沧	cud
篷	pfv
沛	pkd
瞿	qmo
乒	peq
惭	cpx
瘘	lrb
洼	wld
矩	jsu
矾	fpu
弛	ibg
赁	lvr
蹶	jiz
黜	ihl
媞	utn
皋	gqb
蔬	uac
丧	sut
恸	tyx
翟	vdx
苣	jfc
揣	iff
菘	skc
氖	nuq
簸	biv
旌	jef
蝙	bri
堡	phr
铟	yhj
隧	sfe
怅	idx
杞	qgm
淖	nvd
漉	lhd
簟	dav
耘	yfl
赅	gbb
骋	iym
貉	hev
囟	xvp
纫	ros
绌	ihs
骀	tdm
阇	dam
俳	pdr
喾	khx
徊	hsr
撺	cdf
攉	hsf
璁	ckw
砼	tju
蔸	dxc
鲷	dmy
哌	pok
埭	dot
庠	xig
忞	mcw
栳	lxm
潦	lud
焓	hph
瑙	nxw
篼	dxv
簏	lhv
綮	qwh
荻	dbc
诒	yby
谮	zoy
锇	eej
鹣	jrj
揖	yjf
踪	zkz
鲲	kgy
裳	uux
虻	mfi
涎	xvd
碓	dfu
锭	dwj
缎	dcs
辖	xci
蝰	kwi
螭	iji
铣	xgj
涤	dbd
宦	hcb
磬	qwt
钺	ydj
徙	xgr
衡	hfr
遂	swz
嫔	pcn
囔	nuk
诬	way
珽	tww
蛄	gai
鹄	hln
缟	gxs
驮	dpm
氚	idq
柩	jom
蠡	lgh
拯	vyf
篦	btv
鹊	qdc
匍	plb
烷	wph
诹	zxy
匐	flb
刖	ydo
纪	jgs
瘩	dlb
岷	mcu
庖	pig
酹	lky
钍	tmj
朴	pum
刳	kad
疥	jqb
纾	uas
貔	pbv
跆	tdz
钭	dzj
俣	ysr
姮	hfn
慬	qcx
榄	lom
槭	qtm
焘	tqf
琚	jhw
痉	jwb
蒌	lac
蔟	chc
蝤	qmi
裎	ifp
镛	ykj
鹑	ifw
坼	iit
夼	kud
嬿	yan
峄	ytu
忐	tou
慝	tik
潟	xtd
玎	dew
瘙	svb
蒐	sxc
蓓	bkc
褓	bxp
逅	hrz
酊	dey
镆	mgj
镱	ytj
阡	qre
霪	ycy
玺	xgd
亓	qba
琊	yuw
谪	vey
祀	stp
蚯	qzi
铿	kcj
髯	rpe
臼	jop
俸	ffr
儇	xdr
绍	uvs
舷	xvv
峥	vcu
泸	lld
睑	jpo
穹	qkb
旋	xcf
郢	ywk
麋	mbl
攘	rpf
忿	fof
赭	vli
亍	iha
妨	fwn
倌	gdr
夙	shj
菡	hac
醮	jly
罴	pbs
蹴	chz
壤	rpt
曌	vvo
腑	fmo
缄	jrs
缭	lus
蚩	ijc
择	vdf
旃	vnf
揆	kwf
桡	rim
觥	gkd
曛	xgo
柠	nnm
疃	tst
痢	ltb
祆	xrp
咤	vik
垓	gbt
埘	ubt
氛	feq
璠	fpw
缜	vos
桴	flm
稗	boh
旎	ngf
洽	qxd
篁	hbv
橛	jim
砵	bpu
绻	qss
萘	noc
讵	jfy
邰	tds
髭	zje
鬏	jze
芫	yoc
慊	qax
圮	pgt
婀	ern
岢	klu
溱	qcd
狍	piq
甾	zbv
竦	snl
缞	cts
蟆	mui
鄱	pec
镥	lmj
陂	pbe
鲳	iuy
泷	uwd
糁	uem
凼	ddk
劢	mow
媄	mjn
嫱	qin
孛	bku
崚	lfu
捃	jrf
捩	lqf
楦	xcm
淝	frd
炣	klh
焜	kgh
牤	mun
珅	uew
琬	wow
睐	loo
筘	krv
艿	nuc
苄	bac
蚪	dzi
铒	euj
靬	qvg
龠	ydr
纛	dvf
钧	jgj
镝	djj
酋	qmb
觑	qfh
晁	iio
蕈	xrc
脍	kfo
偎	wir
胁	xso
炬	jfh
箐	qwv
镫	dfj
獠	luq
蠕	rli
屉	ttu
绡	xms
庑	wmg
袂	mkp
铆	mxj
黥	qnl
啬	sit
厩	joi
蹈	dxz
亵	xqy
胥	xhz
薨	hkc
锢	ghj
锲	qqj
贿	hfb
忤	wmx
燚	yth
蔑	mqc
顷	qwb
鬟	hoe
洄	hwd
凫	fln
佞	nwr
嘡	tuk
宙	vrb
狒	fkq
蝴	hli
躏	lvz
迄	qtz
噩	eiw
圉	ysk
氲	ygq
篾	mqv
鳅	qzy
叆	aoy
椟	dlm
耦	ozl
琮	cjw
祚	zpp
萃	cfc
遐	xcz
帚	vze
氡	dkq
猬	wkq
猱	niq
蟊	mim
襄	xyy
俎	zmr
傣	dur
庋	gvg
彖	tch
氙	xrq
滂	pud
珥	euw
隘	aoe
鲠	gyy
腌	alo
烊	ywh
懔	lxx
滓	zgd
濞	btd
牖	yzp
胱	gwo
荇	xwc
莼	ifc
蜓	tni
衲	nip
鲌	bey
黝	yzl
黻	fly
匙	ujo
卬	awp
埯	aot
埼	qbt
弢	tqg
徨	hbr
懊	avx
樯	qim
汩	gmd
淠	ptd
煳	hlh
珐	fiw
痱	fkb
瘳	ixb
眇	mlo
秫	ulh
腘	glo
茁	vlc
荞	quc
萸	ymc
蛔	hwi
诔	ljy
铑	lxj
阄	jzm
陟	vte
颡	spy
髌	bvg
鲑	gty
莳	ubc
䶮	yol
兢	jeu
刬	iaj
圬	wat
圳	vot
墒	uut
姗	unn
娉	pen
媖	yen
宬	ifb
嵘	rju
嵛	ymu
怙	hhx
慵	ykx
扃	jph
昳	dso
汶	wod
溲	sxd
烜	xsh
煋	xeh
瓿	bhl
皛	xlb
簕	liv
缱	qps
耋	dsl
耔	zgl
肟	wgo
脬	pqo
苤	pcc
莛	tnc
葎	lfc
蛉	lni
蛩	qkg
郤	xtg
郴	iem
铕	yzj
铽	tij
镮	hoj
隹	vtr
鞨	heg
驸	fhm
鲃	bly
鲼	foy
鹈	tbb
桉	anm
勐	myz
陛	bte
隶	lty
诅	zmy
纷	fes
嵬	wru
牍	dlp
掾	ycf
褥	rhp
吝	lvw
胄	vry
锊	ldj
罹	lbs
豕	uga
踵	vnz
豢	hcj
橇	qmm
鼾	hnz
猡	llq
予	yms
狺	ycq
侦	ver
奡	avb
疟	ndb
艉	wjv
薮	szc
藐	mlc
闳	hjm
隳	hte
匏	pid
篱	lbv
蹽	lmz
堑	qai
竽	ymv
擂	lrf
峭	qlu
獬	xqq
竺	vlv
诽	fjy
抟	tof
肮	auo
腴	ymo
臊	svo
穰	rwh
蓍	ujc
惇	dgx
缯	zcs
辘	lhi
骥	jtm
绷	bfs
怆	iex
怦	pcx
搪	twf
犒	kvn
觐	jvc
谟	mey
郦	ltl
鲀	tfy
麈	vml
济	jgd
戬	jpy
盎	ady
籁	lov
罘	fls
贮	vhb
辊	goi
蔓	wac
啭	vck
嗉	shk
峁	mxu
徂	clr
樗	iam
瞌	kro
笥	stv
绲	gos
缗	mcs
蚜	yui
豸	vtp
镞	zlj
鼐	non
模	mlm
宿	xzb
宿	xob
兕	sta
埴	vbt
岙	avy
崾	yvu
沆	hdd
煊	xdh
琤	icw
琵	pbw
璀	cv
皑	adb
矍	jio
缃	xys
缥	pms
舸	glv
膻	uno
涡	gsd
杻	izm
杻	nzm
叨	dik
唝	hnk
塄	lft
姤	grn
孓	jil
尨	mwl
怍	zpx
杲	gxo
枹	bqm
榔	lwm
槁	gxm
璋	vuw
瘁	cfb
绨	tts
芑	qgc
茛	goc
萄	tic
蔌	shc
蝽	igi
谇	sfy
谧	mty
踔	isz
辏	cri
锘	npj
驺	zxm
伽	glr
㸆	kvh
丏	mpg
伈	xxr
伾	pjr
侏	var
侹	twr
吣	qvk
哃	tjk
唢	slk
啴	iok
啶	dwk
嗾	szk
囷	qgk
垸	yct
墈	kat
墼	jji
妊	ron
妯	van
娌	lgn
屣	xgu
峣	yiu
崀	ldu
嵝	lzu
忸	nzx
愔	yhx
慥	zvx
戽	hhh
揿	qvf
敉	mgm
晫	vlo
枇	pbm
枞	zkm
氕	pkq
氤	yhq
渼	mjd
湓	psd
烃	teh
煺	tfh
爝	jih
猃	xpq
猕	mbq
瑢	rjw
甏	bft
甦	sag
疔	deb
硗	qmu
禤	xdp
稙	vjh
穑	sih
窊	wlb
笆	blv
笊	vvv
翾	xds
耑	ddu
脎	sio
腧	uho
苁	ckc
茺	ikc
荮	vrc
萜	tkc
葑	fcc
蒉	kfc
蛸	xmi
蜾	gli
衄	nfp
袼	grp
褯	jqp
诂	gmy
贶	keb
跞	ltz
迮	zez
遄	ioz
酞	toy
锶	sjj
霈	pky
靸	smg
馓	sou
驲	rtm
鬯	idk
鲂	fwy
黪	col
鼫	ubj
狩	urq
戍	uhw
惩	ifr
蒯	kpc
牒	dsp
蟠	ppi
佃	dar
遏	eiz
擘	bgu
湟	hbd
睃	sso
璜	hbw
徭	yir
猊	nbq
腱	jao
倜	ttr
缆	los
殡	bvd
伥	iur
桅	wrm
癍	bnb
篙	gqv
邕	ykv
蔼	auc
螳	twi
铌	nbj
镴	lij
蚣	gki
搠	upf
馈	kfu
馗	kwj
袒	top
鳜	gfy
儡	ljr
宕	ddb
旖	ygf
牦	min
獐	vuq
襕	lpp
甥	ucu
窨	yvb
绶	urs
侗	dyr
晌	upo
疽	jhb
逵	kwz
嚅	rlk
梏	ghm
漳	vud
猝	chq
诧	iiy
颉	xst
桠	ylm
簌	shv
觊	jtu
迳	jwz
钇	ygj
饧	xnu
纤	qas
瓒	zaw
蔗	vic
趺	faz
铧	htj
堞	dst
舢	unv
苴	jhc
蜮	yfi
铩	ulj
蚌	bfi
匆	ckb
埽	svt
妩	wmn
忪	skx
搐	ihf
楪	dsm
殚	dnd
皈	gtb
裈	kgp
貅	xzv
钋	ppj
镧	lpj
饴	ybu
骖	cnm
堙	yht
孺	rlz
睥	pto
窣	sab
筵	ypv
蜩	tui
铈	utj
镨	pmj
铫	yij
咐	fhk
峨	eeu
挝	wpf
棂	lnm
炔	quh
烽	fch
瑁	mvw
筮	utv
箪	dnv
绔	khs
薤	xqc
蚋	rfi
蚓	yxi
鄄	jcx
酡	tly
馐	xzu
喑	yhk
妫	gtn
憔	qux
檑	lrm
淆	xud
潺	ipd
燮	xqh
畚	bos
眈	dno
糌	znm
繇	yav
羧	ssy
翛	xmr
聒	gse
臃	yko
蕤	rwc
褫	igp
詈	lts
讴	oxy
诜	uey
谌	isy
锆	gvj
锜	qbj
阱	jwe
隍	hbe
飧	sgx
鹂	lbl
黼	fmy
沓	duu
纶	gds
镗	tuj
柞	zpm
玢	few
佣	yyr
澄	dfd
糜	mrg
繁	pep
枸	gzm
仳	pgr
倬	vsr
咡	ehk
圯	ybt
娩	mpn
崮	ghu
怩	nbx
旯	luo
曩	npo
柢	dgm
沚	vgd
牂	zup
畴	iat
畹	wot
砒	pju
砭	bru
础	imu
笾	brv
筢	puv
篝	gxv
纰	pjs
绱	uds
缊	yrs
缵	zss
艄	uqv
苋	xac
菟	thc
诋	dgy
诮	qly
跂	qbz
轫	roi
钪	kdj
锪	hsj
锼	sxj
鞧	qzg
鞴	bkg
韫	yrw
馘	glb
鸨	bxb
朴	pgm
嫚	mnn
伽	qsr
仉	vpr
仫	mhr
侔	mar
俜	per
偬	znr
卣	yzb
噍	jlk
囵	lfk
圌	iwk
坌	bof
坬	wlt
垌	dyt
垟	ywt
垱	ddt
垲	kut
垾	hat
埆	qdt
埝	nat
堍	tht
堐	yut
堽	gut
塝	bdt
墚	lit
妗	jvn
妘	yfn
妣	bgn
姱	ksn
娓	wjn
娵	jhn
嬬	rln
孀	uwn
孳	zjb
尪	wuy
屼	whu
岍	qru
岣	gzu
峘	hou
忉	dqx
怊	iqx
悱	fjx
憬	jwx
戤	gon
扂	dah
擞	szf
敩	xlx
杄	qrm
柊	vkm
栲	kxm
檎	qcm
檞	jcm
洸	gwd
浒	xsd
涔	csd
涿	vsd
湝	jkd
溚	dud
溽	rhd
漦	ibw
漴	ijd
漼	cvd
澧	lgd
烔	tjh
熇	hih
牁	krp
牿	ghn
猇	xmq
玕	gnw
琔	daw
瑱	taw
璈	aiw
璪	zxw
畈	fat
痫	xvb
睽	kwo
矧	uou
砟	vmu
磉	spu
祲	jvp
稂	lwh
窭	jfb
竑	hjl
筅	xpv
筌	qov
筦	gsv
箢	ydv
篌	hav
绁	xqs
绖	dss
绠	gys
绹	tis
缂	kis
缔	dts
缙	jvs
缛	rhs
羑	yzy
羼	iau
翃	hju
耏	eke
耵	dee
舴	zev
艟	ikv
芠	wsc
茌	ibc
荪	sgc
荸	bbc
莞	gsc
萩	qzc
蒎	poc
蒴	upc
蕗	lhc
藠	jlc
蘩	fpc
蝻	noi
螋	sxi
蟫	yci
袷	qdp
裉	kop
褟	tlp
襜	inp
诙	hty
谰	lpy
趯	ttt
跣	xpz
跬	kvz
踦	ygz
蹾	dgz
躐	lqz
躔	ipz
躜	zdz
轪	doi
遨	aiz
遴	lcz
鄹	zxe
酤	gay
酩	mwy
酾	ujy
醐	hly
钔	msj
锍	lzj
锒	lwj
锿	abj
镤	plj
阒	qfm
陞	uce
鞲	gxg
饹	gru
馑	jxu
鬘	mpe
鲙	kfy
鲭	qey
鹌	and
麑	nbl
黇	trc
龃	jsv
𧿹	mmz
婠	wnn
傀	kvr
晷	gvo
锏	jpj
魈	xmg
倮	llr
狞	nnq
橼	yom
魃	bug
恫	dyx
殖	vbd
傩	nlr
纥	hes
劾	hew
陉	xne
佝	gxr
苌	iwc
鹞	yvv
亸	dlw
隗	wje
悢	lex
狰	vcq
伉	kdr
螟	mni
鞘	uqg
廪	lxg
蝮	fhi
鹱	hhn
廓	kpg
鼹	yoj
廙	ytg
蝼	lai
蹑	nqz
辚	lci
琥	hmw
骈	pvm
瑚	hlw
禳	rwp
鲇	nvy
鳟	zgy
恹	ynx
胙	zpo
辎	zji
锷	eij
毐	aut
髹	xze
覃	tpx
廨	xqg
恻	cix
傧	bhr
孢	bqz
翱	aib
崆	kku
粜	tli
跄	qez
铖	ifj
囹	lnk
墉	ykt
掇	dsf
汴	bad
砧	veu
跻	jjz
鋈	whd
鬲	gea
叇	doy
吩	fek
啻	itw
媪	axn
峋	xfu
纻	vhs
鏖	ail
齑	jjq
殷	ynp
垛	dpt
嘧	mtk
埚	gst
帔	pkj
泞	nwd
狻	sdq
盥	gcj
藁	gxc
赂	lhb
隰	xbe
骠	plm
钥	yvj
侈	igr
勍	qnw
坩	gnt
墁	mat
甗	yoh
砫	vhu
籀	vrv
纡	yhs
胼	pvo
舄	xtj
衽	rop
袈	jdl
逡	qgz
铄	upj
铋	btj
锞	kij
镋	tpj
陲	iwe
岵	hhu
帻	zej
牝	pvn
盍	heq
缫	sqs
荭	hjc
蜒	ypi
蝓	ymi
踉	lez
踌	iaz
逶	wiz
酺	ply
阋	xtm
骼	geg
鳊	bry
鳙	yky
龉	ysv
芦	lmc
趄	qqt
佻	tmr
匜	ybk
匦	gvk
媸	ijn
嫪	lvn
幄	wgj
廒	aig
慆	tqx
擐	hcf
斝	jnk
栝	gsm
歃	uiq
焞	tgh
犴	aaq
玃	jiq
珣	xfw
畿	jjg
疳	gnb
砬	luu
祧	tmp
秭	zgh
稔	roh
罅	xxf
翂	fex
翥	vhl
耜	stl
胲	huo
臌	gmo
芘	bgc
莠	yzc
蓊	wy
蓐	rhc
蕹	wfc
袆	htp
袤	mvy
襁	qup
讣	fhy
踣	bez
蹯	fpz
躇	ilz
郯	tph
鍪	mam
锨	xrj
髡	kge
鲊	vmy
黠	xcl
迫	puz
楷	jkm
绰	iqs
荥	xnc
络	lvs
坷	klt
锔	jmj
膀	puo
膀	pwo
啁	vqk
儋	dnr
劼	jst
勰	xsl
哢	lyk
哿	gll
唪	fyk
噀	xrk
垧	upt
墀	ibt
墡	uat
奭	utd
婼	rpn
媲	ptn
崿	eiu
帑	tpn
帨	ufj
廛	ipg
彟	yue
旐	vvf
枲	xgs
椀	wom
椸	ybm
榱	ctm
汭	rfd
泔	gnd
漓	lbd
烠	hwh
熜	ckh
犷	guq
狯	kfq
玿	uiw
琀	hpw
琎	jvw
璮	tow
瓞	dsg
瘛	itb
瞫	uoo
硭	mwu
硿	kyu
祜	hhp
秕	bgh
窬	ymb
笤	tuv
缲	qms
罟	gms
羝	djy
耇	gzl
耠	hsl
聍	nne
聩	kfe
肪	fwo
芟	unc
芴	whc
苘	qwc
荄	gbc
萑	hoc
蓂	mtc
虮	jgi
蛴	qbi
蠖	hpi
裒	pay
裢	lvp
裥	jpp
褊	bpp
诐	bty
谵	vny
跚	unz
踬	vtz
蹁	pvz
遘	grz
钫	fuj
镢	jij
闶	kdm
阗	tvm
骒	kim
髃	ymg
鬈	qoe
鳇	hby
黟	yjl
鼗	tiv
什	usr
哄	hyk
脏	zdo
撒	slf
蛤	gei
场	iwt
稍	uvh
薄	bec
唉	abk
露	lhy
塞	sib
晕	yro
供	gyr
咔	kmk
阿	ere
扒	puf
蒙	myc
炮	pih
炮	bqh
涌	ikd
省	xwu
埋	mpt
臭	xoz
拧	nnf
脉	mgo
折	uef
尽	jxi
答	dlv
结	jks
参	ces
识	vty
读	dry
圈	jck
片	prp
降	xie
累	ljt
几	jjp
约	yqs
胖	ppo
绿	lhs
爪	vxi
们	msr
朝	vqu
强	qug
少	uvx
冲	iyd
难	nay
无	mea
跑	piz
解	jqd
别	bqk
车	jha
正	vca
提	djf
更	gca
便	pvr
大	doa
哦	ogk
见	xak
打	duf
要	yqx
了	lla
都	dal
着	vqy
的	djb
的	dbb
觉	jlx
偻	lar
犍	qvn
瘩	dub
芾	fkc
杈	iim
烊	ydh
趄	jht
钐	unj
镡	ipj
坷	krt
芫	ypc
锔	jhj
镏	loj
骀	dom
颏	kew
貉	hiv
蹊	qjz
厦	xxi
荑	ybc
㑇	vrr
㕮	fmk
㙘	yqt
㟃	sju
㠇	jou
㠓	mfu
㤘	vrx
㥄	lnx
㧐	snf
㫰	ldo
㬊	hso
㭎	gum
㶲	yyh
㺄	ysq
㿠	heb
䃅	dju
䃎	viu
䅟	coh
䏡	uto
䐃	jro
䓛	qhc
䗖	dti
䗛	xzi
䢺	iai
䦃	vsj
䲟	yvy
䲠	igy
䴓	ujb
䴘	tji
上	upb
丽	lba
亟	qtl
仆	par
估	ghr
佖	btr
侂	tsr
侴	izr
俟	qbr
倧	zkr
倴	bor
偁	icr
偓	wgr
偭	mpr
偰	xqr
傃	shr
傉	nhr
傺	itr
僇	lhr
僔	zor
儳	ipr
儴	rwr
冁	iob
凉	led
划	hgg
刷	ugu
刺	cju
刽	gfr
剕	fkf
劄	vuv
劈	pgu
劐	hsc
勔	mpm
单	ipb
厖	mwi
可	kid
同	tyk
吐	thk
吗	muk
吗	mmk
吵	iqk
呃	erk
呇	mou
呢	nbk
和	hsh
咧	lkk
咪	mgk
咯	lpk
哦	eek
哪	nlk
哪	nek
啊	amk
喋	vuk
嗯	efk
嗯	eyk
嘎	gmk
噂	zok
噇	ibk
嚆	hqk
囊	nug
圲	qrt
坉	tft
坋	fot
坜	ltt
坫	dat
坰	jpt
坽	lnt
垌	tjt
垍	jtt
垙	gwt
垭	ylt
垴	nxt
垺	flt
垿	xft
埇	ynt
埏	unt
埪	kkt
堌	ght
堧	rot
堨	eit
堾	igt
塅	dct
塆	wnt
塥	get
墐	jvt
墘	qvt
墣	plt
墦	fpt
夹	gla
夹	jda
奘	vup
妭	bun
姈	lnn
姶	ein
娀	skn
娠	uen
婌	uln
婍	qgn
婘	qon
婤	vxn
婫	kgn
婻	nan
媆	rsn
媓	hbn
媛	ycn
嫕	ytn
嫘	lrn
嫜	vun
嫦	iwn
嫽	lun
孅	xrn
寁	zob
尾	ygu
岊	jsb
岞	zpu
岽	dku
峃	xix
峤	quu
峿	wlu
崄	xpu
崒	zlu
崟	ycu
崦	ynu
嵊	ufu
嵫	zju
嵲	nqu
嶍	xbu
嶟	zgu
差	cjy
帡	pnj
帱	dvj
幪	mfj
庱	iyg
廆	wjg
廑	jxg
弨	iqg
弸	pfg
忳	tfx
忺	xrx
怫	flx
恝	jcf
恧	nfe
恶	ely
悈	jqx
悝	ktx
悰	cjx
惛	hgx
愃	xdx
愐	mpx
愭	qbx
慭	yvl
憕	ifx
憭	llx
戆	gdl
戌	qhw
戭	yob
扆	ygh
抢	qyf
抹	mgf
拧	nwf
挡	ddf
挦	xvf
挲	sld
捎	uvf
掊	pzf
掖	yrf
揳	xkf
搁	gef
搒	bdf
搒	pff
摏	ikf
摛	ijf
摴	iaf
擞	srf
擿	tjf
数	upm
斶	ihj
旞	sff
旰	gao
旵	ioo
旿	wmo
昃	zio
昄	boo
昈	hho
昤	lno
昺	bwo
晊	vto
晐	gbo
暅	gfo
暲	vuo
暶	xoo
暾	tgo
朏	fjo
杉	ulm
杧	mwm
枘	rfm
柈	bam
柖	uim
柽	icm
栒	xfm
栩	xsm
桄	gwm
桯	tem
桲	ppm
梠	lsm
梣	ism
梴	inm
梿	lvm
棁	vsm
棓	bkm
棤	cpm
椅	yjm
楒	sjm
榅	wem
榧	fjm
槚	jnm
槜	zfm
槱	yzm
橑	lum
櫆	kwm
欸	eis
欸	eks
沘	bgd
洘	kxd
洧	wjd
浈	ved
涍	xld
涨	vdd
淙	cjd
溞	sqd
滃	wcd
滆	ged
滏	fmd
滫	xzd
潸	und
澭	ykd
澽	jfd
濋	imd
瀌	bmd
瀼	rwd
瀼	rdd
炌	koh
炟	duh
炻	ubh
焆	jdh
焌	qhh
煁	ish
煓	tdh
熬	aqf
爟	gch
牟	mhs
牥	fun
牻	mwn
犋	jfn
犏	prn
犨	ixr
犴	hnq
狃	nzq
狉	pjq
狳	ymq
狴	btq
猁	ltq
猄	jeq
猯	tdq
獍	jwq
玒	hjw
玞	faw
玤	bdw
玱	qyw
玶	pnw
玼	cgw
珇	zmw
珋	lzw
珖	gww
珝	xsw
珦	xew
珷	wmw
琈	flw
琟	wrw
琡	ihw
琫	by
瑃	igw
瑅	tbw
瑑	vcw
瑔	qow
瑖	dcw
瑳	csw
璬	jlw
璲	sfw
璺	woj
瓀	rsw
瓖	xyw
瓘	gcw
瓦	wia
瓻	ijx
畎	qst
畯	jrt
疁	lmt
疭	zyb
疸	dob
痄	vib
痼	ghb
瘊	hab
瘕	jnb
瘭	bmb
皤	peb
盉	heh
盦	anr
盷	tvo
眍	kxo
眚	uyu
眵	ijo
睄	uvo
睚	yuo
瞍	szo
瞠	ico
瞵	lco
矰	zcu
矸	gnu
砆	fau
砗	iru
硁	kcu
硇	niu
碃	qwu
碡	vau
碲	dtu
磙	gou
磻	ppu
礓	jyu
礵	uwu
祃	mip
祊	bcp
祋	dfp
祏	ubp
祾	lnp
禊	xtp
禒	xpp
禘	dtp
秘	bth
秸	jkh
稃	fah
稆	lsh
稌	tlh
稑	lhh
稹	voh
穙	plh
竘	qsl
笮	zlv
笱	gzv
笸	piv
筇	qkv
筠	jgv
筤	lwv
筻	gdv
箖	lcv
箨	tpv
篚	fjv
篪	ibv
簃	ybv
簉	zvv
簖	dcv
簝	luv
簠	fmv
簰	pdv
纩	kes
纭	yfs
经	jws
缉	qjs
缧	lrs
缩	shs
缪	mos
缬	xss
翯	hix
耖	iv
耢	lvl
耥	tul
耰	yxl
肭	nio
肷	qpo
胈	buo
胠	qho
胣	igo
脟	lqo
脿	blo
腒	jho
腠	cro
腽	wio
膏	gvw
膙	juo
膦	lvo
臑	nvo
舠	dqv
舥	plv
艨	mfv
芄	wpc
芏	dhc
芤	kxc
芯	xvc
苉	pgc
苧	nnc
茈	zgc
茋	dgc
茓	xic
茳	jyc
茼	tjc
茽	vyc
荖	lxc
荙	duc
荛	ric
荨	qvc
荽	stc
莝	cpc
莿	ctc
菝	buc
菹	zac
菼	toc
萏	dac
萚	tpc
萣	dwc
萳	npc
萹	brc
葖	tac
葰	slc
葺	qtc
蒄	gdc
蒇	ioc
蒈	kuc
蒡	bdc
蔀	bhc
蕰	wec
薁	avc
薸	puc
薿	ngc
藨	bmc
虷	gni
虸	zgi
虹	jei
虼	gii
蚂	mii
蚄	fui
蚆	bli
蚱	vii
蚲	pni
蛃	bwi
蛑	mai
蛘	ywi
蛞	kpi
蛱	jci
蛲	nii
蛸	uqi
蜎	ydi
蜐	jsi
蜣	qyi
蜿	wni
蝾	rji
螵	pmi
螽	vkd
蟛	pfi
衎	kar
衩	iip
袗	vop
袯	bep
裎	iyp
裼	ttp
褕	ymp
襚	sfp
觇	inv
觟	hgd
訇	hkb
訚	ycm
讧	hy
诖	ggy
豮	fsu
貆	hov
赆	jvb
赒	vxb
赗	ffb
赜	zei
赳	jzt
趑	zjt
趱	zot
趵	bvz
趼	jpz
踒	wpz
踽	jsz
蹅	imz
蹐	jbz
蹒	ppz
蹶	joz
轷	hai
辒	wei
辿	inz
过	gsz
迕	wmz
迺	nuz
逖	ttz
通	tyz
逦	lgz
逭	hcz
邠	bhf
邡	fuf
邿	ujt
郎	ldl
鄑	zjy
鄠	hhy
酂	zan
酏	ygy
钖	ywj
钘	xnj
钢	gdj
铘	yej
铷	rlj
锓	qxj
锫	prj
锱	zjj
镄	fkj
镅	mrj
镎	nuj
镩	cdj
阼	zpe
阽	dae
陎	uae
陔	gbe
隃	uhe
隩	ave
雱	puy
靽	bag
鞅	ydg
鞮	djg
鞳	tig
韂	iag
韪	wjo
顸	hng
颋	twz
颥	rly
饪	rou
饯	jau
馞	beh
骃	yhm
骅	htm
骕	shm
骦	uwm
髢	dbe
髫	tue
髽	vse
鬷	zkg
魆	xhg
鱽	dqy
鱾	jgy
鲏	pby
鲐	tdy
鲕	eky
鲗	zry
鲬	yny
鲴	ghy
鲾	bjy
鲿	iwy
鳁	wey
鳂	wiy
鳑	pwy
鳛	xby
鳤	gsy
鸤	uju
鸧	cul
鸫	dkd
鸼	vxv
鹨	lox
鹯	vnw
麇	qfl
麹	qhf
黢	qhl
黩	dll
鼒	zjc
鼢	fsj
鼱	jej
鿍	gdt
鿏	moj
𠅤	xbw
𠳐	buk
𣲘	wmd
𤫉	xqw
𥕢	ciu
𥖨	zvu
𦈡	xhs
𦝼	lao
𦝼	lmo
𦰡	nic
𨐈	gwi
𨟠	qdo
𨱔	zgj
𨺙	nte
𩾌	kuy
𪣻	lat
𪨶	uru
𪩘	you
𫄧	yps
𫄨	ijs
𫍯	xvy
𫍲	xly
𫐐	nbi
𫐓	rai
𫑡	mfk
𫓧	faj
𫓯	jjj
𫓶	xdj
𫔶	nqm
𫗧	shu
𫗴	vnu
𫘨	tbm
𫚖	cgv
𫚭	lqy
𫞩	msw
𫟅	lis
𫟹	hjj
𫠆	kvv
𫠊	xom
𫠜	nbv
𫭟	oxt
𫭢	lot
𫰛	xnn
𫸩	kxg
𬇙	bkd
𬇹	gld
𬉼	ozh
𬊈	xfh
𬌗	hey
𬍡	ddd
𬒔	gyu
𬘩	tes
𬘭	ies
𬙊	mgs
𬜯	luc
𬟽	dki
𬣳	hoy
𬤇	yhy
𬩽	xfe
𬪩	njy
𬬭	lfj
𬬸	uhj
𬬹	usj
𬭁	mmj
𬭤	haj
𬭩	wcj
𬭬	hfj
𬭯	pcj
𬭶	hij
𬭸	lcj
𬭼	sfj
𬮿	goe
𬯀	jje
𬯎	twe
𬱖	dby
𬳵	pjm
𬴂	fim
𬶋	jhy
𬶏	wry
𬶠	lay
𬸣	xrb
𬺓	imv
〇	xev
㐁	taa
㐄	kgu
㐌	ybp
㐜	iaq
㐤	dnj
㐫	xpw
㐬	lms
㐭	lxw
㐳	whr
㐷	mmr
㐺	ycr
㐻	nkr
㑃	axr
㑋	qkr
㑌	kwr
㑌	wur
㑍	lkr
㑎	nxr
㑙	dsr
㑝	lyr
㑟	byr
㑣	lpr
㑤	mur
㑱	rxr
㑶	xtr
㑷	tor
㑻	mir
㑿	vvr
㒀	vmr
㒂	vlr
㒃	ehr
㒊	sir
㒍	lrr
㒓	tir
㒔	dlr
㒔	thr
㒖	ozr
㒗	tdr
㒙	mvr
㒚	yvr
㒚	wor
㒝	mqr
㒡	yar
㒥	fcr
㒴	gmr
㒵	mvb
㒸	sfb
㒿	lbo
㓃	dhb
㓈	bwd
㓋	gyd
㓎	qhd
㓑	xwd
㓓	npd
㓞	qxf
㓡	gsf
㓣	qxr
㓤	qxt
㓦	bbb
㓧	gnr
㓱	tar
㓸	vsy
㓸	dxy
㓹	cfi
㓹	jti
㓼	itm
㓾	ibu
㔃	xus
㔊	vow
㔋	jri
㔋	lpi
㔌	zre
㔌	cze
㔍	isv
㔏	llu
㔑	itc
㔓	jpq
㔕	jbq
㔘	ihi
㔜	buv
㔝	lul
㔝	lil
㔩	eib
㔭	iib
㔶	gok
㔷	lrk
㔾	xrv
㔿	zra
㕆	hhi
㕉	kii
㕊	fai
㕌	aoi
㕐	xqi
㕒	wii
㕕	hcs
㕜	ugv
㕟	kfb
㕢	gob
㕦	hgk
㕩	pdk
㕪	dok
㕫	fpk
㕫	fck
㕬	gkk
㕬	syk
㕭	aqk
㕭	avk
㕶	ey
㕹	fuk
㕻	pz
㖃	hzk
㖅	xfk
㖇	ekk
㖐	wjk
㖑	xqk
㖓	hjk
㖖	nqx
㖘	vek
㖞	wbk
㖟	urk
㖢	qbk
㖣	trk
㖥	jrk
㖨	lhk
㖷	ubk
㖸	ndk
㖹	pek
㖹	fok
㖻	rrk
㗂	uyk
㗈	mak
㗌	vtk
㗑	bbk
㗕	gxk
㗗	bik
㗘	bek
㗙	iak
㗢	dyk
㗥	kpk
㗨	xkk
㗫	qqk
㗬	vlx
㗰	cjk
㗳	tmk
㗷	suk
㗾	xuk
㗿	hek
㘂	cbk
㘅	xvk
㘇	rjk
㘈	ngk
㘐	pvk
㘢	wyk
㘦	qct
㘨	nqt
㘪	hvt
㘲	jmt
㘸	zdd
㘸	zpd
㙀	jot
㙁	mrt
㙁	mht
㙂	dft
㙂	wft
㙅	bxt
㙇	iht
㙈	xxt
㙓	kwt
㙔	wjt
㙔	hpt
㙗	wit
㙚	xet
㙛	bmt
㙟	lpt
㙩	lut
㙬	ycl
㙱	hvk
㙳	hot
㙸	bvt
㙹	mft
㙺	gft
㙻	ipt
㙾	xtt
㚂	ndt
㚃	ygt
㚆	fhw
㚇	zkx
㚊	kbx
㚍	kvx
㚔	nqd
㚖	zeb
㚘	hif
㚚	kkd
㚣	xun
㚫	sin
㚬	jgn
㚯	xcn
㚰	pin
㚱	qzn
㚲	inn
㚲	dpn
㚲	dan
㚴	bhn
㚵	dkn
㚷	eun
㚹	mxn
㚹	lzn
㛄	yjn
㛅	ehn
㛍	qqn
㛍	xpn
㛏	qmn
㛐	szn
㛒	drn
㛔	fcn
㛔	pfn
㛖	ssn
㛗	qkn
㛗	zsn
㛘	pgn
㛙	xhn
㛝	bkn
㛞	lyn
㛥	tin
㛦	lon
㛧	mon
㛨	qun
㛬	lhn
㛯	fan
㛯	vcn
㛱	win
㛴	nxn
㛵	icn
㛶	tan
㛼	iln
㛼	uin
㜃	lan
㜆	mtn
㜈	mhm
㜊	von
㜌	nzt
㜍	twn
㜎	xtn
㜖	cin
㜗	cnn
㜗	sen
㜘	qfn
㜜	avn
㜤	npn
㜥	mdn
㜧	ydn
㜨	ndn
㜪	uel
㜮	lpn
㜲	wyn
㜳	hsn
㜴	mfn
㜷	xpg
㜼	vbn
㝀	hvm
㝂	viz
㝃	mpz
㝍	xcb
㝐	rjb
㝑	mwb
㝕	nnb
㝗	lwb
㝘	yjb
㝝	lcb
㝟	mib
㝩	kub
㝭	xwb
㝯	qub
㝱	mfb
㝵	ded
㝵	aod
㝶	aos
㝹	nau
㝾	zly
㞂	tvy
㞊	xfi
㞎	bmu
㞎	plu
㞪	nie
㞲	yyu
㞷	hbc
㞻	hvu
㞽	xdu
㟄	xiu
㟅	ywu
㟆	htu
㟇	cpu
㟊	flu
㟖	lyu
㟘	tuu
㟙	zeu
㟛	zau
㟜	mbu
㟝	pru
㟟	xeu
㟩	mcm
㟫	qou
㟬	szu
㟺	lau
㟼	aiu
㠅	fhu
㠈	rru
㠑	zfu
㠗	avu
㠙	hiu
㠜	ntu
㠝	cou
㠟	lbu
㠢	hsu
㠧	mgu
㠪	jfg
㠭	vog
㠯	ygk
㠲	bgj
㠴	roj
㠸	khj
㠹	jqj
㠺	muj
㡅	nlj
㡇	jkj
㡈	mpj
㡉	xvj
㡋	anj
㡏	taj
㡑	qmh
㡑	jlh
㡒	vgj
㡗	tbj
㡙	bjj
㡛	mwj
㡜	xqj
㡠	vfj
㡭	jtv
㡯	vdg
㡱	jzg
㡲	hog
㡳	vgg
㡵	lng
㡷	bog
㡸	vmg
㡸	iug
㡽	vvg
㡾	xag
㡿	itg
㢀	ctg
㢁	igg
㢁	ugg
㢂	yog
㢂	dtg
㢄	drg
㢅	lyg
㢊	aug
㢊	ygg
㢔	zng
㢙	qcg
㢚	lmg
㢛	yag
㢛	qrg
㢡	jup
㢧	jcg
㢯	dmg
㢯	mcg
㢲	xrg
㢵	uig
㢻	rfg
㢼	bqg
㢽	eug
㣂	eig
㣄	qmg
㣅	zag
㣈	sth
㣎	mhb
㣜	xnr
㣝	skr
㣠	tqr
㣢	tbr
㣫	vnr
㣬	qtr
㣱	zer
㣲	wrr
