的	d
我	w
是	u
了	l
你	n
在	z
和	h
都	dx
不	b
有	y
就	j
也	yl
好	hx
个	g
人	r
说	us
用	yy
他	t
这	v
来	ld
要	yv
去	q
会	hf
看	k
中	vk
想	x
没	m
啊	a
那	ni
吧	bl
给	gj
能	nf
对	df
上	ud
到	dv
多	ds
吗	ml
里	lg
被	bk
做	zp
又	yr
过	gp
让	rd
还	hd
她	tl
打	dm
把	bm
而	e
着	vr
大	di
从	c
它	tlb
写	xc
再	zo
字	zt
得	dr
搞	gx
狗	gz
猫	mq
一	yj
真	ve
下	xx
但	da
叫	jl
很	ho
比	bg
呢	nr
最	zf
更	gf
地	dt
地	drt
等	dy
吃	i
像	xe
后	hr
时	ub
只	vg
点	dp
先	xr
话	hg
与	ys
快	kf
玩	wp
当	du
已	yg
问	wo
完	wpb
以	ygr
将	jy
您	nc
找	vx
爱	ao
太	to
谁	ur
才	cd
年	nv
新	xh
跟	ge
别	bs
学	xi
哇	wl
按	aa
哎	ab
前	qv
睡	uf
加	jd
所	s
为	wr
为	wkd
可	kl
出	ia
该	gb
向	xep
却	qd
哦	o
小	xl
天	tr
高	gq
买	mu
呀	ylk
刚	gu
事	ut
好	hvn
坏	hft
发	f
全	qo
开	kb
万	wa
之	vj
心	xhd
帮	bu
回	hw
牛	nm
家	jdb
长	iw
月	yd
卖	mo
岁	sf
成	if
唉	aok
跑	p
走	zz
早	zx
连	lv
滴	dj
越	ydz
无	wla
阿	al
送	sy
分	fe
黑	hi
额	ee
妈	mln
换	hc
们	me
难	np
同	tj
祝	vh
恩	eex
干	ga
算	sc
路	lh
并	bw
呗	bi
少	ux
猜	cb
放	fd
擦	cl
转	vs
错	cp
脸	lp
贴	tk
陪	pr
带	do
笑	xlv
敢	go
谱	pm
拿	nu
二	eh
煮	vm
鸡	jj
或	hp
书	ua
每	mj
画	hga
坐	zpt
咯	km
掉	dl
讲	ju
梦	mf
冷	ly
花	hs
于	ym
手	uz
咋	zm
哟	yp
爆	bv
站	va
变	ba
看	kno
哥	gr
版	bo
水	uv
起	qg
图	tlk
弄	ny
住	vhr
啦	ll
够	grj
咩	mk
累	lk
倒	dvr
肉	rr
毛	mi
神	usu
请	qw
拉	llf
肿	vn
听	te
内	nk
噢	op
唱	id
骂	mik
装	vw
三	sn
蛮	mp
腿	tv
正	vf
瘦	urb
卤	lm
俺	aor
老	lx
俩	ln
抱	bvf
忙	mw
超	iq
疼	tf
胖	pd
喔	wpk
车	ir
某	mz
第	dtv
教	jm
生	uc
中	vya
进	jv
假	jn
差	ii
忘	wd
热	ri
选	xs
啥	uu
微	wi
求	qm
若	rp
些	xk
久	jz
苦	kmc
米	mg
约	yu
飞	fi
吓	xxk
亲	qh
照	vv
赢	yn
饿	ei
读	dly
秒	mlh
信	xv
另	lw
儿	ek
靠	kv
聊	lu
远	ysz
懂	dn
羯	js
低	djr
呆	db
晒	uo
追	vt
见	ja
跳	tlz
挂	gg
哪	nmk
鸟	nl
呃	eik
挺	tw
贵	gfb
元	yo
摩	mem
疯	fc
张	vu
萌	mfc
头	ta
活	hl
行	xn
哒	dlk
次	ct
本	boa
骗	pa
店	dag
考	kx
歌	grq
喂	wk
强	qi
死	sg
收	uxw
贱	jab
噗	pak
恨	hox
撸	la
喵	mm
亮	le
弱	rpg
破	pg
哼	hck
拍	pb
躺	tp
抢	qu
吐	tm
日	rt
谈	tpy
饭	fa
帅	ufa
离	lb
号	hv
闹	nvm
办	bal
还	hoz
养	ypy
红	hj
猪	vaq
刷	usd
呐	nik
姐	jc
洗	xg
种	vy
喝	hrk
菜	co
如	rl
赞	za
丢	dz
捏	nkf
非	fia
粉	fo
怕	pi
坑	kc
总	zn
曾	cf
爹	dk
蛋	dai
型	xnt
咱	zpk
屎	ug
纸	vgs
杀	ul
自	ztp
白	bd
急	jb
催	ctr
吖	alk
改	guw
特	ti
包	bq
愿	yc
妹	mkn
唔	wlk
受	urv
抓	vsf
钱	qvj
者	vl
喷	pe
鱼	ymd
瞎	xd
此	cg
乱	lc
滚	god
呦	yx
晚	woo
留	lmt
晕	ygo
风	fcj
抽	ix
块	kft
怪	gfx
度	dh
戳	is
往	wpx
便	bar
楼	lam
党	dpx
咬	yxk
吹	it
练	las
删	un
条	tu
耶	ye
丫	ylb
系	xt
君	jg
丑	iz
件	jar
近	jvz
两	lua
雨	ysa
力	lt
面	ma
球	qmw
重	ij
火	hld
爬	pu
脚	jlo
管	gs
偶	oz
痛	ty
黄	hb
嘴	zv
戴	dog
情	qn
各	gi
门	ms
卡	kmb
倒	dxr
跪	gfz
道	dvz
病	bwb
边	br
搜	sx
短	dsu
混	hrd
指	vgf
翻	fn
词	cby
招	vq
尿	nlu
摸	mpf
嘤	yek
撒	sm
毁	hvj
顶	dw
马	mma
喊	hok
由	ya
悲	bix
组	zms
帖	tc
则	ze
爪	vgp
配	pk
乃	nup
斤	jh
秀	xo
伤	uur
喽	lxk
蓝	lpc
及	jbn
谢	xq
因	yh
泡	pv
未	wke
款	ks
定	dwb
深	ue
渣	vld
粗	ca
咔	klk
爸	bif
输	uai
床	ib
碗	wou
外	wox
宅	vd
纯	ifs
熊	xkd
汗	ha
搭	dlf
药	yvc
使	ugr
感	gox
宫	gk
双	uw
演	yod
木	mh
粑	blm
班	bn
赚	vc
货	hpb
亿	yt
拼	ph
嗨	hbk
其	qb
名	mn
类	lkm
棒	bdm
王	ww
骑	qbm
片	pap
金	jhr
茶	iu
处	ih
砸	zu
查	ium
光	gw
气	qt
枪	qy
句	jf
扔	rc
试	uty
嫁	jx
且	qc
切	qq
醒	xw
惹	rlc
停	tn
树	uh
爽	uud
台	td
口	kz
半	bab
鞋	xsg
雪	xoy
任	ro
摔	ugf
接	jk
操	cq
娶	qs
入	rh
提	tb
狠	hoq
背	bio
挖	wlf
烂	lah
级	jbs
间	jr
乖	ggp
达	duz
云	yf
冲	ik
团	tok
瓶	pn
踢	tjz
主	vmd
硬	yw
魔	meg
嘞	li
女	ns
动	dyl
剪	jp
线	xa
叔	uay
念	na
表	blf
挑	tmf
致	vtw
槽	ci
满	mod
甩	up
油	yad
皆	jkb
捡	jpf
省	uy
八	blp
皮	pba
子	zg
酒	jzd
救	jo
穷	qk
亦	ytw
忍	rox
妞	nz
反	fop
呜	wak
部	bh
借	jq
插	il
街	jkr
烦	fp
关	gd
草	cx
诗	uj
直	vb
踩	cu
嘿	hik
课	ki
臭	irz
城	ift
票	pl
剩	ufd
趣	qf
握	wg
李	lgm
嘛	mlk
撞	vef
汤	tud
刀	dq
挤	jgf
替	tt
夜	yi
至	vtt
扯	ilf
懒	lo
房	fw
腰	yq
香	xy
安	an
奔	be
穿	idx
凭	pnj
咦	yb
杯	bim
泪	lkd
慢	max
虐	nd
逛	gez
碎	sfu
既	jt
痘	drb
题	tbu
舔	tpu
即	jbe
凉	lid
准	vo
占	vab
屁	pt
记	jty
胸	xp
摆	buf
国	gl
蛇	uei
派	po
称	ic
拖	ts
盘	pp
控	ky
血	xcp
咧	lck
忒	ttx
味	wkk
交	jml
四	st
投	taf
偷	tx
涨	vp
躲	dlu
推	ttf
抹	mif
副	fh
式	utg
搬	bnf
咪	mjk
尽	jvi
堵	dmt
藏	cw
山	una
虎	hm
乐	lip
左	zl
吵	ixk
岂	qgu
欠	qa
传	io
笨	bov
寄	jtb
修	xz
烧	uq
眼	yoo
机	jjm
相	xym
套	tvd
撑	icf
蝎	xki
绿	lf
甜	tvu
糖	twm
奥	av
鬼	gv
份	for
烤	kxh
命	mwr
补	bmy
象	xed
节	jkc
惨	cox
熟	uah
瞧	quo
群	qfy
海	hu
墙	qit
作	zpr
鸭	yln
样	ydm
圆	yok
嫌	xvn
逗	drz
身	uep
旧	joa
断	dc
歪	wb
戏	xty
段	dcu
罗	lls
盖	gom
羊	ywd
闲	xvm
美	mjd
夹	jcf
觉	ji
炒	ixh
仍	rf
莫	mgc
排	pdf
五	wm
傻	um
篇	prv
性	xwx
租	zah
几	jgp
周	vxk
桥	qum
区	qhk
队	dfe
碰	pf
蹭	cfz
哈	hlk
拆	ibf
卷	jse
哭	ka
场	ip
吻	wok
男	npt
应	yeg
哄	hn
签	qr
法	fm
色	si
需	xhy
流	lmd
杨	ywm
逼	bj
娃	wu
劝	qcl
圈	qdk
集	jbm
语	ysy
涂	tld
平	pna
期	qj
暖	nso
座	zpg
缺	quf
矮	au
空	kk
软	rs
憋	bkx
肥	fr
退	tfz
扑	paf
耍	ugn
牌	pdp
烟	ynh
狼	lwq
减	jpd
抄	iqf
理	lgw
劈	pj
印	yve
望	wdw
陈	ise
郑	vfe
整	vyv
郭	gse
蹲	dg
恋	lax
兔	th
娘	nin
知	vju
驴	lmm
辣	lix
偏	prr
噶	guk
据	jff
数	uhw
清	qe
粮	lim
归	gt
灰	ht
姓	xwn
绝	jis
么	mr
欲	yfg
豆	dra
剧	jfd
待	dox
待	dbx
那	nle
犯	faq
师	uja
位	wkr
扣	kr
较	jli
齐	qbw
灯	dch
明	mno
酸	sd
帝	dtj
值	vbr
论	lr
季	jth
土	tma
右	yrk
啃	ko
熬	ai
揍	zr
赶	goz
银	ycj
合	he
细	xts
厚	hri
西	xj
南	npu
朝	iio
狂	kbq
随	sw
瞅	izo
界	jqt
盯	de
趁	ioz
淡	dad
轻	qei
岛	dxn
嗷	aik
猛	my
宝	bx
脱	tso
方	fu
刮	gsd
费	fk
遍	baz
抠	kxf
霜	uwy
零	lny
星	xeo
夸	ksd
邮	yae
睇	dto
汪	wud
取	qse
菇	gac
易	yto
蒸	vch
愁	iax
症	vfb
化	hgr
足	zlk
佛	fer
揉	ra
六	low
码	mmu
龙	lj
糗	qz
馋	ipu
服	fl
蟹	xqi
牙	yua
富	fhb
吾	wlw
冰	bed
七	qja
常	iwj
底	dgg
仅	jxr
习	xb
粘	vnm
奖	jud
妆	vwj
爷	yef
吼	hz
弯	wn
炖	drh
嫩	no
文	ws
基	jjt
经	je
坨	tlt
射	ui
单	dnb
薄	bic
隔	gee
史	uga
伞	so
搓	cs
跌	dkz
雾	wh
必	bt
呸	pik
捧	py
似	str
困	krk
掰	bb
令	lwr
怎	zox
刺	ctd
答	duv
冒	mv
凶	xpi
船	iov
酱	jey
趴	plz
闪	uom
昂	aw
紧	jxs
贼	zrb
电	daa
声	ucu
具	jfb
压	yli
雷	lry
湿	ujd
钻	zd
登	dcd
啪	plk
百	bua
终	vks
哆	dsk
酷	kh
波	bp
林	lcm
治	vtd
醉	zfy
唯	wrk
弹	tpg
砍	kou
原	yoi
咳	ke
猿	yoq
秤	ifh
害	hob
甚	uoq
锅	gsj
官	gdb
遭	zq
赌	dmb
怒	nh
飘	pmf
炸	vi
胡	hlo
村	cgm
仔	zgr
解	jcj
订	dwy
卧	wgb
播	bpf
捂	wmf
伐	fur
量	lio
割	grd
淘	tid
埋	md
塞	sb
略	ldt
淫	ycd
宽	kd
透	trz
凑	cr
劲	jvl
重	vyp
届	jqu
倍	bkr
胃	wko
嬛	xdn
举	jsd
灭	mqa
残	cpd
封	fcc
属	umu
脑	nx
粥	vxg
福	flu
扫	sxf
韩	hpu
废	fkg
升	ucp
煎	jrh
征	vcx
捞	lq
罚	fus
慌	hwx
叠	dsq
饼	bwu
勒	lil
存	cfu
杜	dhm
胜	ufo
虽	stk
妖	yqn
叼	dmk
负	fhd
根	gem
春	ig
虾	xdi
迷	mb
啰	ls
寸	cra
体	tg
供	gkr
抛	pq
烫	tdh
拽	vff
防	fwe
炮	pvh
冻	dyd
编	brs
侠	xcr
勿	whg
共	gy
纹	wss
闻	wse
北	bja
挡	dpf
守	uzb
拌	baf
甄	vew
牵	qrn
克	kie
摄	uif
布	bhj
降	jee
怂	snx
笔	bgv
奶	nun
霾	mdy
颗	kry
九	jzp
泥	nb
於	ymf
教	jlw
瑟	siw
遮	vrz
澡	zxd
痒	ypb
锁	sl
吸	xjk
敷	faw
德	dex
踹	ifz
介	jqr
舞	wmr
含	hpk
浓	nj
料	llm
蹦	bf
嘎	glk
潮	iid
长	vpp
现	xaw
壳	keu
调	tuy
罪	zfs
证	vfy
亏	kt
剃	ttd
摇	yif
肾	uoo
素	sh
填	tvt
精	jem
沾	vnd
盒	hem
闷	mom
犬	qsd
通	tkz
铁	tcj
架	jxm
腻	nt
公	gks
著	vhc
晃	heo
潘	pnd
铺	paj
砖	vdu
孔	kn
乳	rm
食	ubr
垫	dat
建	jaz
键	jaj
捅	tnf
饱	bxu
欧	ox
伪	wj
兽	urk
盼	pao
滑	htd
运	yrz
绕	rv
缠	ips
戒	jqg
散	sa
散	sow
拜	bop
嘘	xhk
枰	pnm
赵	vvz
屏	pnu
脏	zuo
页	yia
范	fac
逃	tiz
馆	gsu
结	jss
领	lwy
巨	jfk
处	imw
言	ypd
梗	gym
攒	zof
翘	ql
挠	nif
溜	lz
市	utw
分	fob
剑	jad
初	iay
利	lth
啧	zek
针	vej
掐	qdf
啵	bpk
博	beu
否	fz
巧	qlg
虚	xhh
造	zvz
寻	xf
蠢	ioi
托	tsf
朵	dlm
逆	ntz
骚	sq
测	cid
何	her
局	jmu
剁	dpd
缘	yos
般	bnv
代	dor
诺	npy
均	jgt
叶	yik
肌	jjo
东	dka
宠	in
端	dd
税	ufh
首	uzq
容	rj
斯	sj
物	whn
录	lha
丽	lta
盐	ypm
败	bob
稍	uqh
咸	xvg
摘	vbf
矣	ygs
众	vyr
惊	jex
竟	jw
敲	qmg
嗲	dnk
漏	lrd
沉	isd
截	jsg
朱	vap
付	fhr
醋	ch
撕	sjf
获	hpc
朕	voo
冥	mnb
轮	lfi
丝	sja
河	hed
炫	xch
塔	tmt
袁	yot
喜	xgu
魂	hfg
赔	prb
耳	eu
碧	btu
撤	iif
贪	tnb
扛	kw
镇	voj
肺	fko
果	gla
怀	hsx
刑	xnd
拱	gn
顺	ury
器	qtk
秋	qzh
孙	sgz
巴	bla
捐	jdf
屋	wau
沪	hh
猴	haq
龟	gtd
夏	xxw
耐	noc
转	vci
仨	slr
争	vcd
肯	koo
歇	xkq
板	bom
案	aab
扭	nzf
观	gdj
卸	xqe
兼	jrb
设	uiy
趟	tdz
攻	gkg
抖	dzf
除	ile
静	jwq
旁	pw
稳	woh
董	dnc
逢	ff
浅	qp
环	how
申	uea
遇	yfz
绑	bps
乘	ifp
缩	ss
泰	tof
紫	zgs
认	roy
串	ica
痣	vtb
沙	uld
友	yz
尼	nbu
战	vag
臀	tfo
丁	dea
股	gm
步	bhv
档	ddm
鼻	bbz
叻	lik
识	uby
颇	ppy
限	xae
幅	flj
响	xu
旅	lsf
跨	kg
崔	ctu
意	ytx
侬	njr
哩	ljk
糕	gqm
威	wig
麻	mug
赛	sob
瓜	gsp
拧	nw
室	utb
愣	lfx
显	xpo
尊	zgc
广	gud
率	lfw
品	px
休	xzr
凹	aq
维	wrs
裤	khy
搂	lxf
苏	sac
斜	xsd
免	mpd
居	jhu
餐	cn
膏	gqo
染	rom
轰	hk
唐	twg
幂	mt
婚	hgn
瑕	xcw
皂	zvb
桶	tnm
立	ltd
客	kib
枕	vom
坟	fs
扶	flf
故	gh
千	qrp
尾	wju
震	voy
粽	zy
叹	tak
古	gmu
灵	lnh
堆	dtt
恶	eix
损	sof
呼	hak
琴	qcw
虫	ija
展	vou
芙	flc
抗	kdf
狮	ujq
科	krh
松	sk
徐	xm
充	ikd
乡	xya
弄	lyc
拎	lhf
须	xhp
衫	uny
尖	jrx
森	se
扎	vlf
膜	meo
晴	qno
婊	bln
衣	yjd
迟	ibz
酥	say
章	vul
产	iod
僧	scr
竖	uhl
横	hfm
兄	xpk
聚	jfe
娇	jmn
十	uba
石	ubk
宋	syb
尚	udx
依	yjr
瞄	muo
旺	wdo
膘	bmo
甘	gna
啾	jzk
田	tva
噜	lak
距	jfz
悬	xox
己	jga
青	qeo
郎	lwe
糟	zqm
雅	ymv
惯	gc
唷	ypk
噻	sbk
麦	mof
侃	kor
钓	dlj
罢	bis
京	jew
丹	dnp
添	trd
曲	qsa
嚼	juk
芯	xhc
赖	lou
许	xsy
音	yhl
葱	ck
丸	wpj
搁	grf
揪	jzf
榜	bpm
遛	loz
宰	zub
俩	lur
赏	upb
谷	gmb
曝	bvo
赐	ctb
黏	nvh
腹	fho
桌	vsm
蜜	mti
消	xmd
勺	uig
辞	cbu
江	jyd
兵	beq
蝶	dsi
饮	yxu
蔡	coc
侧	cir
告	gvk
寺	stc
仙	xrr
赴	fhz
甲	jna
角	jld
钗	ibj
薛	xuc
止	vga
港	gpd
磕	kru
曹	cio
崽	zuu
巾	jha
坎	kot
评	pny
窗	iwx
勾	gxg
罐	gcf
艾	aoc
斗	drd
凡	fpd
继	jts
刻	kid
保	bxr
厄	eii
蕾	ljc
抬	tdf
驻	vhm
弟	dtb
喘	isk
喇	lmk
皱	vri
唰	usk
附	fhe
失	ujp
暗	aao
野	yll
橙	ifm
裸	lly
桑	su
蘸	vac
嘉	jdu
沟	gxd
民	mc
厂	ipa
袋	doy
疤	blb
靴	xug
涅	nq
弃	qtc
汁	vjd
梨	lbm
列	lqd
灌	gcd
净	jwd
温	we
批	pjf
互	hha
罩	vvs
尔	eud
帐	vdj
柜	gfm
圣	uft
馅	xau
挫	cpf
粪	fom
曼	mao
肝	gno
然	rph
仇	iar
邪	xse
扁	bph
翔	xiy
液	yid
掏	tq
末	mga
杠	gdm
院	yce
姜	jyn
谨	jxy
瓦	wma
焦	jmh
湾	wnd
堂	twt
湘	xyd
智	vto
钟	vkj
辆	lei
莎	ulc
联	lve
瞪	dfo
祭	jtu
项	xeg
壶	hlu
奇	qbd
枚	mrm
兮	xjb
薇	wic
术	uhm
镜	jwj
拐	gpf
兜	dxe
俄	eer
优	yxr
贺	hib
景	jwo
余	ymr
剥	bqd
崩	bc
工	gka
盗	dvm
吞	tgk
窄	vux
军	jgb
陆	lhe
携	xsf
痴	ijb
影	ywp
煲	bqh
当	ddx
舌	ueq
衰	ugy
骨	gmg
铅	qrj
裹	glw
礼	lgu
饶	riu
顿	dry
鼠	umj
砂	ulu
盆	ps
恕	uhx
搅	jlf
专	vda
拦	lpf
浪	ldd
卯	mx
菊	jmc
沈	uod
判	pad
引	yxg
复	fhp
漂	pmd
彩	cup
族	zlf
稿	gxh
漫	mad
摁	eo
绛	jes
郝	hxe
挨	abf
挨	adf
脉	moo
扇	unh
妮	njn
标	bmm
创	ie
鹅	een
哔	btk
乔	qup
睁	vco
梳	uam
思	sjt
凸	taa
框	kem
移	ybh
泼	ppd
恰	qx
患	hcx
鲜	xry
阴	yhe
帽	mvj
磅	bdu
柳	lzm
斩	voi
忌	jtj
鲍	bvy
侯	har
熏	xgh
彭	pfp
册	cik
邀	yqz
晾	leo
掌	vpu
玉	yfa
楞	lfm
汇	hfd
社	uiu
骆	lpm
吨	dgk
坡	ppt
雕	dmv
懵	myx
蒜	scc
财	cdb
赠	zfb
涮	ucd
怨	ycx
墨	mgt
注	vhd
庙	mlg
斑	bnw
靓	lej
吉	jbk
呲	cj
券	qcd
玻	bpw
迎	ynz
霍	hpy
筋	jhv
嗑	kik
视	utj
洒	smd
乜	mkg
译	yty
夫	faa
柴	idm
铲	ioj
蒋	juc
悟	whx
兰	lpb
茬	iuc
漆	qjd
恤	xfx
华	htu
垮	kgt
孤	gaz
箭	jav
屯	tfa
叉	ild
普	pmo
英	yec
志	vtu
州	vxi
禁	jvu
商	uuw
厅	tei
载	zog
私	sjh
腚	dwo
浇	jmd
户	hhd
独	dlq
脆	cfo
瞒	mpo
蒂	dtc
壹	yju
徒	tlx
欸	er
胎	tbo
简	jpv
世	utc
佬	lxr
蛆	qhi
嘚	drk
捶	iwf
唇	ifi
宁	nn
增	zc
仿	fpr
铊	tlj
县	xas
忧	yxx
权	qom
葬	zdc
龚	gkl
羞	xzy
劫	jsl
童	tjl
希	xjj
蹬	dcz
癖	pgb
尤	yaa
职	vbe
粒	ltm
渡	dhd
绣	xos
尝	iwd
欺	qjq
毕	btb
敌	dbw
差	ily
实	ubb
腐	fmg
形	xnp
杂	zuj
藕	ozc
仗	vdr
逮	doz
糊	hlm
墓	mht
萱	xdc
浮	fld
哉	zb
度	dlg
织	vjs
籽	zgm
岗	gpu
腔	qyo
蒙	mcc
喃	npk
备	bkw
扬	ywf
雄	xkv
牢	lib
眠	mvo
萨	sic
撮	csf
耶	yre
迈	moz
焖	moh
漂	pld
续	xfs
严	ypa
奏	zrf
沃	wgd
系	jtp
呈	ifk
箱	xyv
押	ylf
种	vnh
堡	bxt
冯	ffd
购	grb
倩	qar
憨	hnx
愈	yfx
脖	beo
嫖	pun
川	idp
鹿	lhg
嗦	ssk
窜	cc
撅	juf
樱	yem
邦	bue
皇	hbb
镐	gxj
挽	wof
讨	txy
栽	zbg
庆	qwg
胶	jmo
卡	qnb
敬	jww
润	rrd
永	ynd
咒	vrk
棍	grm
袭	xbl
井	jwa
俊	jrr
嘭	pc
陶	tie
厝	cpi
痰	tpb
嗅	xok
乌	wap
甭	bfb
险	xpe
俾	bgr
邱	qze
钢	guj
碳	tau
采	cum
贝	bka
鼓	gmv
孟	mfm
伸	uer
蚝	hii
缓	hss
咽	yak
纵	zys
卒	zlw
吱	vjk
裂	lqy
钙	goj
翅	itv
耗	hvl
棵	krm
雀	qdv
彼	bgx
挪	nlf
皿	mxa
钉	dej
冬	dkw
苗	muc
盛	ufm
袜	wiy
茧	jpc
纳	nis
啤	pbk
妥	tlv
暂	zao
盲	mwo
误	why
菌	jgc
浴	yfd
孽	nqc
枉	wpm
勇	ynl
峰	fcu
汉	had
嚷	rpk
晏	yao
研	ypu
库	khg
榛	vem
噔	dck
叽	jjk
陌	mge
吒	vlk
闭	btm
护	hhf
贾	jnb
捎	uqf
垵	ant
抵	dgf
莲	lvc
肚	dho
冤	ydb
臣	isa
椒	jmm
獒	aiq
葛	gec
仓	cur
朗	lpo
义	ytd
唠	lvk
辛	xhl
轴	vai
胆	doo
煞	uih
枣	zxc
稀	xjh
晨	iso
仁	rsr
庄	vwg
撩	luf
秃	tah
乙	yga
嗔	iek
临	lca
灸	jzh
婶	uon
鲁	lmy
宴	yab
币	btp
速	shz
佳	jdr
索	sls
咕	gak
姬	jjn
返	foz
禾	hep
链	laj
眯	mjo
瓷	cbw
绘	hfs
密	mtu
恃	utx
吕	lsk
番	fnt
哀	abw
铝	lsj
乎	hap
蛙	wli
氪	kiq
置	vts
埃	abt
芊	qrc
掀	xrf
裆	duy
镁	mjj
兑	dfb
卢	llb
阔	kp
谜	mby
暮	mho
洲	vxd
差	iby
昏	hgo
谓	wky
承	ifa
忠	vkx
潜	qvd
瞟	plo
驼	tlm
欢	hdy
悔	hvx
巫	wag
诚	ify
崴	wuu
呛	qyk
呛	qek
涩	sid
曾	zco
轶	yti
递	dtz
烙	lvh
棉	mvm
霸	biy
缝	ffs
嘀	dbk
切	qkd
祛	qhu
舟	vxp
鞭	brg
瘾	yxb
黎	lbh
亭	tnw
荼	tlc
阉	ynm
呕	ozk
雇	ghh
顾	ghy
舍	ulr
镶	xyj
背	bko
剂	jtd
渴	kld
昨	zlo
间	jam
帖	tqj
叮	dek
姚	yin
蛤	hui
谎	huy
乍	vip
阳	ywe
荤	hgc
亲	qwl
忽	hax
账	vdb
剥	bpd
舍	uir
枝	vjm
捷	jsf
桃	tim
揭	jkf
荡	ddc
嗝	gek
畔	pat
嘟	dak
奉	fff
孝	xlz
挑	tlf
桩	vwm
犊	dln
徕	ldx
拳	qou
泯	mxd
泡	pqd
铜	tjj
助	vhl
盾	drp
焉	ynv
悦	ydx
夺	dld
伦	lfr
瑞	rfw
诸	vay
萧	xmc
宜	ybb
跶	dlz
拾	ubf
珠	vaw
凤	ffj
圭	gtt
揽	lof
池	ibd
境	jwt
谦	qry
莪	eec
匿	ntk
隆	lje
审	uob
妾	qqn
硅	gtu
咻	xzk
叭	blk
触	ihi
缸	guf
坊	fut
嚓	clk
窦	drx
莱	ldc
旗	qbf
孩	hdz
嗡	wc
裁	cdg
哑	ymk
亡	wwd
淌	tpd
吆	yqk
硕	upu
危	wid
颈	jwy
倔	jir
荣	rjc
嗳	auk
泉	qob
钵	bpj
卵	lsp
谣	yiy
恒	hfx
债	vor
肠	iwo
拟	ng
拴	udf
垂	iwp
妃	fin
伏	flr
撬	qlf
恐	knx
媛	yon
菲	fic
矗	ihv
靡	mgf
搏	bef
晓	xlo
抡	lgf
睿	rfb
腌	yno
颁	bny
撇	pcf
筒	tnv
淋	lcd
鸣	mnk
搽	iuf
娟	jdn
彪	bmh
揣	ipf
目	mha
恁	nox
眨	vmo
兹	zj
囤	tfk
脾	pbo
绳	ufs
姆	mmn
妻	qjn
迁	qrz
秦	qch
姨	ybn
称	ioh
序	xfg
束	uha
异	ytc
康	ku
嗓	sp
篮	lpv
觅	mtj
镑	bdj
汀	ted
营	ync
掺	inf
螨	moi
俏	qlr
珊	unw
傍	bdr
贫	pcb
芭	blc
司	sjg
崖	yuu
嘣	bck
传	vcr
叁	sns
豹	bvv
哗	htk
献	xaq
辨	bad
兆	vve
瘪	bcb
枯	kam
芮	rfc
蜡	lii
涛	tqd
犹	yaq
誉	yfy
僵	jyr
阵	voe
辫	bas
吡	bgk
坛	tpt
煨	wih
幸	xwt
栋	dym
刨	pid
刨	bvd
瑛	yew
努	nml
袄	ax
氏	utp
椅	ygm
玛	mmw
吽	hkk
晋	jvo
氧	ypq
矬	clu
瘟	web
武	wmv
作	zsr
俱	jfr
捣	dxf
蜀	ums
柚	yrm
坠	vft
辱	rmc
吟	yck
廖	llg
肖	xmo
竹	vlg
柔	ram
奴	nln
棕	zk
祖	zmu
咚	dkk
洪	hjd
泛	fad
斋	vbw
眉	mro
奔	bod
卿	qem
穴	xib
佑	yrr
燥	zvh
尘	ist
校	xlm
迪	dbz
扎	vuf
雌	cbv
馊	sxu
姿	zjn
胯	kgo
确	qdu
席	xbj
擤	xwf
嗖	sxk
遂	sfz
燕	yac
逾	ymz
兴	xwb
咿	yjk
卷	jce
默	mgh
奸	jrn
炕	kdh
应	ywg
避	btz
贰	ehb
缁	zjs
冠	gcb
汝	rmd
厌	yai
颓	twy
殿	dau
掂	drf
呱	gsk
馍	meu
绮	qgs
哨	uvk
宣	xdb
隐	yxe
荒	hwc
累	lrs
驱	qhm
豪	hiu
魏	wkg
糙	cqm
妍	ypn
砰	pcu
砌	qtu
瑜	ymw
飙	bmf
畅	idu
瘸	qib
翁	wcy
空	kyx
腮	sbo
蛹	yni
宇	ysb
唬	hmk
袅	nly
施	ujf
糯	npm
辩	bax
参	cns
嫂	sxn
阮	rse
艘	sxv
癣	xsb
拥	yk
扩	kpf
倾	qer
叨	tqk
嬴	ynn
挥	htf
豁	hsg
啷	luk
楚	im
莉	ltc
厮	sji
滩	tnd
辽	luz
例	ltr
歼	jrd
泄	xqd
玄	xow
宥	yrb
耙	bil
噌	cck
脂	vjo
刁	dmg
积	jjh
幺	yqa
卦	ggb
纱	uls
隋	swe
蚊	wsi
鳖	bky
痕	hsb
齁	hxb
数	umw
颂	syy
玮	wjw
霉	mry
杆	gnm
珂	krw
炝	qeh
栓	udm
苯	boc
裱	bly
厨	ili
筐	kwv
铰	jlj
岭	lwu
享	xud
璐	lhw
瓣	bag
籍	jbv
囊	nwa
映	ywo
伯	ber
符	flv
煤	mrh
蔫	nrc
幼	yrl
势	utl
呷	xdk
怡	ybx
辈	bki
斌	bhw
蛊	gmi
激	jjd
佟	tjr
韵	yry
胀	vdo
衬	ioy
酿	ne
歉	qaq
访	fpy
覆	fhx
突	tax
埸	ytt
弗	fla
士	uta
仪	ybr
浩	hvd
谋	may
谤	bdy
簋	gvv
尿	stu
惜	xjx
掩	yof
遵	zgz
辟	btx
妇	fhn
杏	xwk
耸	sne
碑	biu
杵	imm
农	njb
坪	pnt
贬	bpb
皎	jlb
珞	lpw
嗜	utk
蝉	ipi
姑	gan
钦	qhj
耽	dne
堪	knt
帘	lvb
碘	dpu
捆	kof
恼	nxx
筛	ubv
棚	pfm
蚺	rpi
缇	tbs
町	det
笛	dbv
绞	jls
扰	rx
态	tox
苑	ycc
傲	avr
尺	iga
茨	cbc
磡	kau
劳	lic
笼	ljv
穆	mhh
巢	iii
寝	qxb
涠	wrd
闰	rrm
粤	ydp
跋	buz
刊	knd
葵	kwc
沐	mhd
帕	pij
佐	zlr
讹	eey
坚	jrt
岸	aau
绷	bcs
荷	hec
症	vcb
堕	dpt
凯	kuj
笋	sov
黛	doh
亨	hcw
棣	dtm
矫	jlu
绒	rjs
虏	lmh
鹏	pfn
咏	ynk
愚	ymx
碍	aou
虹	hji
妓	jtn
洛	lpd
焕	hch
琳	lcw
癌	ad
霆	tny
祇	qbu
拘	jhf
脓	njo
膈	geo
叉	imd
碇	dwu
匪	fj
津	jhd
葡	plc
杖	vdm
拈	nrf
溏	twd
蹄	tbz
膝	xjo
灾	zbb
浣	hcd
惧	jfx
硌	giu
嘬	zs
谗	ipy
弧	hlg
晶	jeo
掷	vtf
卜	bma
铬	gij
羹	gcg
幻	hcy
郡	jre
孬	nqb
奈	nod
窃	qqx
宿	shb
饬	itu
稠	iah
擀	gof
杰	jsh
拄	vmf
舱	cuv
馕	nwu
辰	isi
茎	jec
肘	vz
攥	zcf
吠	fkk
箍	gav
尻	kq
导	dxc
谴	qpy
惟	wrx
钻	zcj
梵	faf
验	yam
芳	fuc
粿	glm
犟	jen
玫	mrw
婆	pen
钛	toj
壁	btt
捯	dif
鳄	eiy
弩	nmg
区	oxk
溶	rjd
慎	uox
叙	xfy
锥	vtj
卟	bmk
贷	dob
浸	jvd
撵	npf
逝	utz
陀	tle
渊	ydd
察	iub
泽	zed
炸	vuh
溺	ntd
艳	yaf
仔	zur
翠	cfy
啐	cfk
谂	uoy
嘶	sjk
种	ijh
栖	qjm
柄	bwm
肛	guo
闵	mxm
皖	wob
洇	yhd
抻	ief
咣	gwk
徽	htx
慕	mhc
坞	wht
估	gar
掘	jif
逑	qmz
诉	shy
逐	vlz
臂	bto
哲	vek
烩	hfh
鲨	uly
萎	wjc
炎	yph
俯	fmr
瘤	lmb
聂	nqe
芽	yuc
羽	ysx
钞	iqj
赤	itt
毯	tom
禹	ysp
宏	hjb
瀑	phd
廋	sxg
仰	ypr
丰	fca
剖	pxd
黍	umh
胗	veo
苍	cuc
蔻	krc
禄	lhu
仕	utr
夕	xjp
鑫	xhj
尹	yxa
熨	yrh
吭	kck
苔	tdc
薜	btc
铛	icj
锯	jfj
螺	lli
藤	tfc
褪	tfy
榨	vim
滋	zjd
宗	zkb
锦	jxj
竞	jwl
浙	vid
澳	avd
勃	bel
韦	wra
炜	wjh
藓	xpc
邹	zxe
媒	mrn
囡	nnk
曝	pho
溪	xjd
杭	hwm
鳓	liy
朴	pmm
屙	eru
遗	ybz
衩	imy
伙	hlr
倪	nbr
嚄	hsk
纠	jzs
艋	myv
幕	mhj
殴	oxu
磐	ppu
屑	xqu
益	ytm
瘀	yhb
规	gtf
狐	hlq
论	lfy
瓢	pug
脐	qbo
茜	xjc
镕	rjj
於	yhf
庵	ang
候	hrr
鸠	jzn
狷	jcq
炆	wsh
宾	bhb
抹	mlf
姝	uan
宵	xmb
邢	xne
煸	brh
岔	iiu
肱	gko
蚶	hni
皓	hvb
历	lti
蟒	mpi
逸	ytz
鼬	yru
俚	lgr
孰	ulw
壳	qlu
薰	xgc
延	ypz
翟	dby
倦	jcr
戚	qjg
氢	qeq
烘	hkh
渍	ztd
锉	cpj
浆	jyu
决	jid
嵌	qau
塑	sht
敝	btw
霏	fiy
匹	pgk
韬	tqw
貌	mvv
政	vfw
匙	ibb
担	dnf
铺	phj
淑	uad
硪	wgu
暇	xco
釉	yrp
酌	vly
蓬	pfc
痧	ulb
巳	sta
逄	pwz
丧	sdt
柏	bum
汞	gng
舅	joj
滥	lad
蘼	mbc
寿	urc
昕	xho
航	hwv
儒	rlr
庭	tng
鄣	vue
鄂	eie
秆	goh
廊	lwg
鲤	lgy
怜	lvx
汰	tod
坦	tot
攒	cof
齿	igv
玖	jzw
肋	lko
炉	llh
翘	qug
嗄	uik
伢	yur
笫	zgv
谍	dsy
窥	ktx
溜	lod
屡	lsu
啼	tbk
泵	bfu
陡	dze
墩	dgt
固	ghk
径	jwx
箸	vhv
缀	vfs
耻	ige
斧	fmf
吮	uok
绾	wos
喻	yfk
掴	ggf
赣	gad
嘁	qjk
屠	tlu
瓮	wf
辉	htg
偈	jtr
荐	jac
鸥	oxn
萋	qjc
违	wrz
蟑	vui
埵	dlt
竿	gnv
纲	gus
击	jja
陋	lre
寐	mkb
挈	qqu
帖	tkj
午	wmp
蚤	zxi
钝	drj
耄	mvl
疏	uap
怔	vfx
灿	cah
婵	ipn
垢	grt
耒	lja
胚	pio
昙	tpo
贤	xvb
资	zjb
咀	jsk
聘	pve
肽	too
坍	tnt
琛	iew
促	chr
饵	euu
圃	pmk
暑	umo
盅	vkm
嗤	ijk
迩	euz
缰	jys
沫	mgd
秾	njh
频	pcy
枭	xmm
窑	yix
舀	yxv
寮	lub
莓	mrc
朋	pfo
览	loj
狸	lbq
熵	uuh
遥	yiz
铢	vaj
睬	cuo
孑	jsa
涉	uid
统	tns
诈	viy
阻	zme
堇	jxc
蹿	cdz
牧	mhn
髂	qxg
乾	qvu
卅	sia
蛀	vhi
锕	alj
剐	ggd
祢	mbu
妄	wdn
焐	whh
涯	yud
糍	cbm
壕	hit
幌	huj
猎	lqq
烹	pch
琼	qkw
丘	qzp
醍	tby
崇	iju
戆	vex
轨	gvi
技	jtf
脊	jgo
铃	lnj
凝	nnd
驳	bem
凳	dfj
蠃	lld
敏	mxw
蕊	rvc
挞	tif
垚	yit
瑾	jxw
泾	jed
哐	kwk
融	rji
婷	tnn
鱿	yay
昌	iuo
舵	dpv
癸	gvd
桔	jsm
锰	myj
缅	mps
鼯	wlu
灞	bid
菲	fjc
槛	kom
讷	niy
佩	pkr
姘	phn
泫	xcd
冢	vnb
卓	vlb
查	vlm
抿	mxf
玥	ydw
黯	aah
狄	dbq
枫	fcm
棘	jbc
乜	nqg
嗫	nqk
务	whw
旋	xof
孵	fal
晗	hpo
匠	jej
濂	lvd
泷	ljd
箩	llv
萝	llc
昇	uco
搋	igf
检	jpm
泠	lnd
龄	lni
寞	mgb
甯	nwb
启	qgh
锐	rfj
销	xmj
胤	yvp
描	muf
糁	som
率	ufw
酮	tjy
尧	yig
绗	hws
筷	kfv
搂	lzf
朔	upo
娼	iun
狙	jhq
择	zef
闸	vum
唛	mok
浜	bud
谛	dty
诡	gvy
挎	kgf
笠	ltv
陕	uoe
铭	mnj
硼	pfu
祥	xiu
馨	xhu
埂	gyt
茅	mic
毅	ytl
爰	yov
综	zks
丙	bwa
枷	jdm
冏	jek
霖	lcy
瞥	pko
企	qgr
壬	rsp
饰	utu
逊	xrz
岗	guu
厕	cii
阶	jke
矛	mis
昵	nto
疲	pbb
擒	qcf
龌	wgi
巡	xfz
臻	vev
澄	ifd
碉	dmu
蛾	eei
旱	hao
婕	jsn
垒	ljs
淼	mlu
纽	nzs
侵	qhr
膳	uao
倡	idr
袍	piy
邵	uve
鲞	xuj
效	xlw
畜	xft
炙	vth
怵	ihx
蹉	csz
典	dpb
巅	dru
跺	dpz
碱	jpu
佗	tlr
鳌	aiy
褒	bqw
摧	ctf
鹤	hin
嚼	jik
宓	mtb
哞	mxk
锈	xoj
策	civ
繁	fps
疾	jbb
矜	jhm
寇	krb
缕	lss
糜	mbm
悯	mxx
闽	mxi
炳	bwh
苷	gnc
戈	gra
钾	jnj
黔	qvh
腺	xao
趾	vgz
饥	jju
钠	nij
廷	tnz
蛰	vei
睹	dmo
贩	fab
芬	fec
蜂	fci
亥	hod
嗟	jkk
腩	noo
剔	tjd
雯	wsy
蓄	xfc
夷	yba
庸	ykg
酉	yza
芋	yfc
株	vam
呤	lwk
汾	fsd
绫	lns
拢	lnf
坯	pjt
仆	plr
梯	tjm
伟	wjr
堤	djt
浒	hmd
莰	koc
邻	lce
霞	xcy
霰	xay
偕	xsr
欣	xhq
疮	iwb
旦	dao
斗	dzd
鸽	grn
苟	gzc
惑	hpx
跤	jmz
犁	lbn
掳	lmf
蜷	qoi
旭	xfo
炊	ith
猾	htq
馁	nju
裘	qmy
韧	row
寅	ycb
斥	itj
肤	fao
绢	jcs
镌	jdj
恪	kix
诓	kwy
缈	mls
湜	ubd
慰	wkx
炷	vhh
姊	zgn
猹	iuq
焊	hah
衿	jhy
洺	mnd
哝	njk
裴	pry
璞	plw
蔷	qic
蚀	ubu
箫	xmv
狱	yfq
责	zeb
瞻	vno
芝	vjc
妲	dun
阙	qdm
瓤	rw
搔	sqf
梭	ssm
瞳	tjo
庹	tlg
瑶	yiw
凿	zi
暧	aoo
瑷	aow
廉	lvg
昧	mko
畏	wkt
颖	ywh
仄	zii
召	vvd
粢	zjm
鬓	bvi
沸	fkd
葭	jdc
岚	lpu
萁	qbc
檀	tpm
蚁	ygi
簪	znv
彬	bhm
稻	dvh
揩	kbf
糠	kum
瞭	llo
冉	roa
莎	ssc
兀	wha
焯	iqh
钣	boj
耕	gcl
磷	lcu
玲	lnw
穗	sfh
硝	xmu
筠	yfv
昶	ipo
缚	fhs
渺	mld
刃	rod
擅	uaf
腕	wao
监	jrm
陆	loe
爻	yii
卑	bip
锄	ilj
钴	gmj
辑	jbi
芥	jqc
铐	kvj
耨	nrl
悭	qrx
狨	rjq
慑	uix
淞	skd
昭	vqo
敖	aiw
拗	avf
拗	nof
枞	ckm
呋	fak
革	gea
夯	hud
佶	jbr
珑	ljw
契	qtd
杉	unm
涡	wpd
倭	wpr
岳	ydu
肇	vvh
酯	vgy
坝	bit
乏	fup
艮	goa
贡	gyb
况	ked
牟	mas
培	prt
禽	qcr
奢	urd
苕	uic
衔	xvr
域	yft
镖	bmj
储	imr
帆	fnj
甪	lhp
滤	lfd
秘	mth
姥	lxn
萍	pnc
迫	pgz
郁	yfe
斐	fjw
蒿	hq
髻	jti
窟	kax
胧	ljo
茗	mnc
齉	ndb
霓	nby
茑	nlc
劁	qmd
渠	qmm
述	uhz
隼	sou
痿	wjb
诌	vxy
氨	anq
禀	bwd
丛	cja
沣	fcd
恳	kog
磊	lju
锣	llj
蜱	pbi
艇	twv
耀	yvg
耿	gye
瑰	gtw
闺	gtm
蕙	hfc
伶	lnr
钮	nzj
蹼	pmz
遣	qpz
虱	uji
瞬	uro
庥	xzg
昱	yfo
噪	zvk
欸	ejq
欸	auq
酣	hny
薅	hqc
踝	hsz
琅	lww
蔓	mac
耪	ppl
锵	qyj
恬	tvx
拓	tpf
蔚	wkc
硒	xju
予	yss
嘱	vmk
嗞	zjk
靶	bmg
磋	csu
敦	dgw
涐	eed
焚	fsh
尕	gmx
戟	jgg
鞠	jhg
篓	lzv
虑	lfh
琶	pub
庞	pwg
乞	qgp
茄	qsc
囚	qmk
矢	ugp
婴	yeb
逞	iy
愤	fox
肓	hwo
栾	lom
臊	sqo
眺	tlo
翕	xjy
峡	xcu
戌	xhg
抑	ytf
毓	yfm
载	zug
坂	bot
禅	uau
橱	ilm
辅	fmi
恺	kux
硫	lmu
芒	mwc
杳	yxm
贞	veb
鄙	bge
豳	bhu
材	cdm
翀	iky
氮	daq
镀	dhj
獾	hdq
亟	jba
侣	lsr
昴	mxo
楸	qzm
示	ute
憎	zcx
枳	vgm
尢	wua
怖	bhx
嘲	iik
簇	chv
珰	duw
氟	flq
涵	hpd
栗	ltx
赦	uii
犀	xjn
鼋	yom
甑	zfw
振	vof
钡	bkj
驰	ibm
铪	hlj
诀	jiy
髋	kdg
唳	ltk
镰	lvj
绺	lzs
侨	qur
茕	qkc
纬	wjs
污	wad
鲜	xpy
夭	yqp
雍	ykw
赟	ygb
铡	vuj
灼	vlh
豺	idv
慈	cbx
甫	fma
衮	gol
厥	jii
陵	lne
麓	lhl
弥	mbg
衾	qhy
笙	ucv
授	urf
彤	tjp
匝	zlj
筝	vcv
婢	btn
铂	bej
掸	dof
扼	eif
绯	fis
旷	keo
擂	lkf
圙	ldk
叟	sz
蹚	tuz
鹀	wln
协	xsu
岫	xou
暄	xdo
虞	ymh
彘	vta
芷	vgc
佰	bur
滨	bhd
跛	biz
玚	yww
筹	iav
蹙	chz
啡	fik
旮	glj
箕	jjv
圐	kak
谅	ley
茂	mvc
摹	mec
疱	pvb
梢	uqm
柿	utm
漱	uhd
啸	xlk
兴	xeb
觜	zjj
舛	isx
扉	fih
羔	gqd
琯	gsw
诃	hry
婧	jwn
掠	ldf
绵	mvs
镊	nqj
佺	qor
嗽	sr
忻	xhx
铀	yaj
獴	myq
蚌	bdi
焙	bkh
钉	dwj
糊	hhm
迹	jtz
柬	jpa
啰	llk
勉	mpl
仟	qrr
雀	qlv
扫	svf
绅	ues
纨	wps
媳	xbn
巽	xrg
障	vde
址	vgt
椎	vtm
孖	zjz
岱	dou
葛	glc
躬	gku
昊	hvo
桓	hom
汲	jbd
菌	jrc
乸	nmy
芡	qac
嚷	ruk
榕	rjm
逍	xmz
猩	xeq
瑄	xdw
颐	yby
寓	yfb
郅	vte
苞	bqc
堡	bmt
怼	dfx
祼	gcu
毫	him
凰	hbj
晖	hto
岬	jnu
锂	lgj
锚	mij
湄	mrd
埔	pmt
蕖	qmc
趋	qhz
殉	xrd
腋	yio
嗌	ytk
妤	ymn
愠	yrx
胞	bqo
庇	btg
碴	iuu
宸	isb
汆	cdr
腓	fro
喙	hfk
麂	jgl
赍	jjb
窖	jlx
熘	lzh
鹭	lhn
眯	mbo
愀	qlx
襦	rly
粟	shm
饕	tqu
醺	xgy
曜	yvo
殷	yhp
庾	ysg
瑗	ycw
啜	ipk
聪	cke
爨	cch
怛	dux
藩	fnc
蕃	bpc
尬	giy
槐	hsm
际	jte
玦	jiw
勘	knl
璃	lbw
貘	mgv
驽	nlm
毗	pbt
驶	ugm
薯	umc
肆	sty
娑	ssn
蜕	tfi
植	vbm
龅	bqi
镚	bfj
镲	imj
俶	ihr
椿	igm
邨	cge
悼	dvx
奋	fod
饹	lru
撼	haf
濠	hid
饸	heu
煌	hbh
迦	jdz
谏	jay
蕨	jic
诳	kby
烙	lph
䁖	lxo
拇	mmf
飒	sif
麝	uil
绦	tqs
婉	won
鹟	wcn
霄	xmy
勋	xgl
铱	yjj
谙	any
椴	dcm
腭	eio
淮	hsd
晦	hfo
荚	jcc
笺	jrv
垃	llt
酪	lvy
氓	mww
噙	qck
析	xjm
飨	xuu
厢	xyi
踅	xiz
俑	ynr
屿	ysu
狈	bkq
弁	bac
馃	glu
翰	hay
镬	hpj
颊	jcy
珈	jdw
诫	jqy
邝	kee
励	ltl
娆	rin
嵩	sku
菀	woc
檄	xbm
铉	xcj
佯	ywr
盂	ymm
喳	ilk
祯	veu
铸	vhj
镯	vlj
腙	zko
摒	bwf
粲	cam
彻	iix
疵	cjb
跐	cjz
殆	dod
硐	dyu
坊	fwt
缶	fzp
绀	gas
郜	gve
睾	gqp
鹳	gcn
髅	lag
纶	lfs
谬	moy
廿	naa
螃	pwi
乓	puq
箧	qqv
擎	qnu
拭	utf
溯	shd
叶	xsk
乂	ytp
鸳	ydn
坳	avt
碜	iou
椽	iom
毳	cfm
歹	dua
镉	gej
褐	hiy
究	jzx
魁	kwg
癞	lob
仂	lir
羸	lrw
菱	lnc
镂	lrj
嫚	man
靡	mbf
彷	pwx
铅	ypj
姻	yhn
迂	yhz
诏	vvy
铮	vcj
葆	bxc
缤	bhs
偲	cbr
铳	iyj
舂	ikf
凋	dmd
惶	hbx
讳	hfy
笳	jdv
蛟	jmi
溃	kfd
喱	lbk
麟	lcl
栊	ljm
馒	mpu
沤	or
撇	pkf
祁	qbe
戕	qyg
俅	qmr
醛	qoy
艏	uzv
沓	tio
蜗	wpi
晤	who
懈	xqx
魇	yog
秧	yuh
烨	yih
钰	yfj
撰	vcf
磅	pwu
叱	itk
迭	dsz
燔	fph
艰	jry
桨	jum
鲛	jmy
诘	jsy
侉	kgr
厘	lbi
劣	lql
琉	lmw
氯	lfq
玟	wsw
颞	nqy
麒	qbl
熔	rjh
轼	uti
驷	stm
猥	wjq
奚	xjv
偃	yor
鄢	yne
苡	ygc
茵	yhc
陨	yoe
疹	vob
蹩	bsz
埗	bht
鹾	cll
娣	dtn
氐	dgp
妒	dhn
褂	ggy
胍	gso
笏	hhv
恍	hux
炯	jeh
僦	jor
珺	jrw
侩	kfr
醨	lby
砺	ltu
络	lps
鳗	mpy
朦	mfo
旻	mco
募	mhl
砷	ueu
蟀	ufi
倘	tpr
隈	wie
校	jlm
榭	xqm
缨	yes
佣	ykr
蕴	yrc
奘	zdd
琢	vlw
龇	zji
镗	twj
铵	aoj
嫡	dbn
辜	gau
鹫	jon
锎	kbj
奎	kwd
愧	kfx
琨	kgw
崂	liu
鬣	lqi
蚂	mmi
嫫	men
钕	nsj
埤	ptt
铍	pbj
骞	qrb
锹	qmj
偌	rpr
庶	uhg
嗵	tkk
圩	wrt
宪	xab
绚	xcs
砚	yau
蚴	yri
棹	vvm
咥	xtk
耙	pul
阪	boe
犇	ben
迸	bfz
俵	blr
晡	bao
憧	ikx
槌	iwm
篡	ccv
皴	cgp
鞑	dug
怠	dos
诞	day
谠	dpy
氘	dqq
萼	eic
阀	fum
馥	fhh
哽	gyk
骸	hdg
缳	hos
蹇	jpb
戋	jra
爵	jiv
隽	jcn
瞰	kao
哙	kfk
髎	lug
凛	lxd
鸰	lnn
娈	lon
莽	mpc
爿	ppa
僻	ptr
噼	pjk
鳍	qby
羟	quy
羌	qyy
鳃	sby
疝	uab
唾	tpk
狭	xcq
冼	xpd
溴	xod
峪	yfu
煜	yfh
徵	vgx
采	com
垞	iut
偿	iwr
瞋	ieo
脞	clo
惦	dax
胴	dyo
昉	fpo
讽	fy
尴	gny
眭	sto
纮	hjs
骺	hag
桦	hgm
玑	jjw
缉	jjs
烬	jvh
胩	kmo
亢	kdw
夔	kww
邋	llz
藜	lbc
懦	npx
怄	orx
澎	pfd
玘	qgw
悄	qmx
濡	rld
箬	rpv
铯	sij
蜃	uoi
燊	ueh
殳	uaj
姒	stn
祟	sfi
髓	sv
琐	slw
獭	tmq
鲔	wjy
芜	wlc
纤	xrs
橡	xem
鸮	xmn
煦	xfd
埙	xgt
鸯	yun
冶	yld
彰	vup
跖	vbz
癿	bsb
膀	bpo
匕	bgp
辟	ptx
扁	prh
璨	caw
彳	itp
酚	fey
蝠	fli
颌	hey
弘	hjg
乩	jjg
荠	jtc
俭	jpr
疆	jyg
靳	jvg
颈	gyy
噱	xik
燎	luh
耧	lal
辔	pki
霹	pjy
歧	qbv
扦	qrf
氰	qnq
呻	uek
晟	ifo
鳎	tmy
膛	two
叨	dqk
嚏	ttk
鸵	tln
顽	wpy
魍	wpg
蜥	xji
芗	xyc
楔	xkm
驯	xrm
龈	yci
舆	ymb
隅	yme
昝	zoo
绽	vas
潴	vad
荷	hic
卜	bpa
敞	ipw
豉	igd
泚	cgd
囱	ckp
蠹	dha
筏	fuv
舫	fpv
觚	gaj
珲	hfw
矫	juu
噤	jvk
阆	ldm
釐	xjl
窿	ljx
髦	mii
贸	mvb
邈	mlz
脲	nlo
湃	pod
湫	qzd
龋	qsi
蹂	raz
墅	uht
泗	std
忑	tix
骰	tag
匣	xck
氩	yiq
焰	yah
琰	yow
痈	ykb
钊	vqj
衷	vkw
绉	vrs
纂	zsv
绷	bys
舶	bev
蛏	ici
魑	ijg
绸	ias
玳	dow
钿	daj
锻	dcj
诟	gry
刿	gfd
堠	hrt
葫	hlc
瓠	hhg
遑	hbz
戛	jca
鳉	jyy
玠	jqw
迥	jez
蒟	jsc
涓	jdd
崛	jiu
箜	kkv
悃	kox
蠊	lvi
垄	lnl
扪	msf
丕	pja
讫	qty
鸲	qmn
鞣	rag
蒻	rpc
莘	uec
烁	uph
澌	sjd
帷	wrj
钨	waj
隙	xte
邂	xqz
匈	xpg
堰	yat
沂	ybd
瑀	ysw
斟	ved
旨	vgb
镦	dgj
嫒	aon
霭	auy
岜	blu
馇	ilu
殂	cld
疍	dap
铛	duj
尜	gux
胳	gro
吭	hwk
糇	ham
蝗	hbi
虺	hvi
讥	jjy
稼	jxh
胛	jno
狡	jlq
郊	jme
睫	jso
蚧	jqi
疚	job
眷	jco
峻	jru
轲	kri
骷	kag
盔	ktm
锟	kgj
螂	lwi
埒	lqt
犸	mmq
幔	maj
蠓	myi
泌	mtd
柰	nom
坭	nbt
瓯	oxw
珀	pgw
芩	qcc
苒	roc
戎	rjg
冗	rn
搡	spf
牲	ucn
绥	sws
狲	sgq
苔	tbc
誊	tfj
湍	tdd
褪	try
巍	wiu
邬	wae
屃	xtu
朽	xzm
勖	xfl
墟	xht
谖	xdy
胰	ybo
猗	yjq
锃	zfj
鹧	vin
祉	vgu
蜘	vji
肫	vgo
斫	vlu
眦	zto
蕞	zfc
酢	zpy
螯	aii
堡	pht
襞	bty
蝙	bri
帛	beb
簸	biv
惭	cpx
沧	cud
骋	iym
弛	ibg
绌	ihs
黜	ihh
揣	iff
璁	ckw
撺	cdf
淬	cfd
埭	dot
担	daf
荻	dbc
翟	vdy
簟	dav
鲷	dmy
篼	dxv
阇	dam
锇	eej
矾	fpu
赅	gbb
皋	gqb
鲧	goy
焓	hph
郃	hee
貉	hev
攉	hsf
旌	jef
咎	jok
矩	jsu
苣	jfc
蹶	jiz
喾	khd
栳	lxm
潦	lud
瘘	lrb
漉	lhd
簏	lhv
忞	mcw
氖	nuq
瑙	nxw
淖	nvd
俳	pdr
哌	pok
沛	pkd
篷	pfv
乒	pej
杞	qgm
綮	qws
瞿	qmv
荃	qoc
纫	ros
丧	sut
觞	uuj
蔬	uac
菘	skc
隧	sfe
骀	tdm
砼	tju
恸	tyx
洼	wld
庠	xig
囟	xvp
铟	yhj
耘	yfl
谮	zoy
骤	vrm
鬃	zki
咉	yuk
媞	utn
褓	bxy
蓓	bkc
篦	btv
裳	uuy
坼	iit
螭	iji
氚	idq
鹑	ifn
蔟	chc
痤	clb
耷	dle
瘩	dlb
焘	tqh
涤	dbd
邸	dge
玎	dew
酊	dey
铥	dzj
缎	dcs
碓	dfu
匐	flg
缟	gxs
蛄	gai
姮	hfn
逅	hrz
鹄	hln
宦	hcb
纪	jgs
疥	jqb
痉	jwb
柩	jom
琚	jhw
窠	krx
刳	kad
夼	kud
蝰	kwi
鲲	kgy
酹	lky
蠡	lgi
蒌	lac
虻	mfi
岷	mcu
镆	mgj
囔	nuk
辇	npi
徘	pdx
庖	pig
貔	pbv
嫔	pcn
匍	plg
朴	pum
槭	qtm
蹊	xjz
阡	qre
慬	qcx
磬	qwu
罄	qwf
蝤	qmi
鹊	qdn
瘙	svb
潲	uvd
纾	uas
蒐	sxc
珽	tww
钍	tmj
驮	dpm
烷	wph
杌	whm
诬	way
潟	xtd
徙	xgx
辖	xci
涎	xvd
铣	xgj
惺	xex
嬿	yan
峄	ytu
镱	ytj
揖	yjf
霪	ycy
颍	ywy
甬	yns
镛	ykj
俣	ysr
钺	ydj
錾	zaj
拯	vyf
卮	vjp
踪	zkz
诹	zxy
遂	swz
稗	boh
邶	bke
孛	bkz
陂	pbe
砵	bpu
鲳	iuy
亍	iha
缞	cts
凼	ddk
砥	dgu
蚪	dzi
婀	ern
铒	euj
璠	fpw
钒	fpj
妨	fwn
淝	frd
氛	feq
俸	ffr
酆	fce
桴	flm
腑	fmo
麸	fam
垓	gbt
觥	gkj
倌	gdr
毌	gca
菡	hac
篁	hbv
睑	jpo
缄	jrs
醮	jly
儆	jwr
臼	jop
鬏	jzi
讵	jfy
橛	jim
捃	jrf
岢	klu
炣	klh
髁	krg
铿	kcj
筘	krv
揆	kwf
焜	kgh
睐	loo
痢	ltb
缭	lus
捩	lqf
崚	lfu
泷	uwd
镥	lmj
蟆	mui
劢	mol
牤	mun
媄	mjn
麋	mbl
艿	nuc
旎	ngf
柠	nnm
狍	piq
罴	pbd
圮	pgt
鄱	pee
亓	qba
憩	qtx
洽	qxd
慊	qax
嫱	qin
穹	qkx
蚯	qzi
铨	qoj
绻	qss
壤	rpt
攘	rpf
桡	rim
糁	uem
绍	uvs
珅	uew
埘	ubt
竦	snl
夙	shj
邰	tde
疃	tst
饨	tfu
琬	wow
玺	xgw
歙	uiq
舷	xvv
祆	xru
嚣	xmk
楦	xcm
儇	xdr
旋	xcf
曛	xgo
琊	yuw
邺	yie
缢	yts
壅	ykd
欤	ymq
鹬	yfn
芫	yoc
龠	ydr
甾	zbi
择	vdf
咤	vik
旃	vnf
曌	vvk
谪	vey
赭	vli
鸩	von
缜	vos
峥	vcu
窒	vtx
蛭	vti
骜	avm
靬	qvg
腌	alo
叆	aoy
隘	aoe
埯	aot
懊	avx
濞	btd
髌	bvg
鲌	bey
刬	iad
郴	iee
宬	ifb
匙	ujb
瘳	ixb
莼	ifc
琮	cjw
萃	cfc
傣	dur
纛	dvd
蹈	dxz
戥	dyg
籴	dbr
耋	dsl
昳	dso
氡	dkq
噩	eiw
鹗	ein
珥	euw
珐	fiw
狒	fkq
翡	fjy
痱	fkb
鲼	foy
黻	flb
驸	fhm
彀	gru
锢	ghj
汩	gmd
胱	gwo
庋	gvg
鲑	gty
腘	glo
鞨	heg
薨	hkc
煳	hlh
蝴	hli
怙	hhx
镮	hoj
鬟	hoi
洄	hwd
蛔	hwi
贿	hfb
扃	jph
厩	joi
阄	jzm
炬	jfh
钧	jgj
脍	kfo
圹	ket
铑	lxj
簕	liv
诔	ljy
獠	luq
躏	lvz
懔	lxx
葎	lfc
孪	loy
铆	mxj
袂	mky
眇	mlo
篾	mqv
蔑	mqc
靺	mgg
猱	niq
佞	nwr
耦	ozl
滂	pud
脬	pqo
譬	pty
淠	ptd
苤	pcc
埼	qbt
迄	qtz
缱	qps
樯	qim
荞	quc
锲	qqj
郄	qqe
黥	qnh
顷	qwb
箐	qwv
蛩	qki
酋	qmb
鳅	qzy
觑	qfj
嵘	rju
蠕	rli
颡	spy
啬	sit
姗	unn
墒	uut
莳	ubc
秫	ulh
槊	upm
溲	sxd
肃	sha
嘡	tuk
弢	tqg
铽	tij
鹈	tbn
屉	ttu
莛	tnc
蜓	tni
彖	tca
猬	wkq
偎	wir
汶	wod
肟	wgo
庑	wmg
忤	wmx
圬	wat
遐	xcz
氙	xrq
皛	xlb
绡	xms
胁	xso
荇	xwc
煋	xeh
畜	iht
烜	xsh
蕈	xrc
䶮	yol
卬	awe
熠	yth
媖	yen
慵	ykx
牖	yzp
铕	yzj
黝	yzh
嵛	ymu
萸	ymc
谀	ymy
圉	ysk
禺	yma
氲	ygq
圳	vot
宙	vrb
帚	vzj
隹	vtp
茁	vlc
恣	ztx
滓	zgd
耔	zgl
兹	cbb
俎	zmq
祚	zpu
訾	zgy
嵴	jbu
镝	djj
皑	adb
桉	anm
盎	adm
肮	auo
奡	ava
岙	avu
笆	blv
枹	bqm
甏	bfw
绷	bfs
陛	bte
黪	coh
姹	iin
鬯	idb
琤	icw
茺	ikc
樗	iam
怆	iex
蝽	igi
踔	isz
苁	ckc
枞	zkm
辏	cri
徂	clx
瘁	cfb
璀	cv
啶	dwk
疔	deb
牍	dlp
耑	ddu
惇	dgx
垩	eit
鲂	fwy
纷	fes
罘	fls
杲	gxo
槁	gxm
舸	glv
茛	goc
唝	hnk
牯	gmn
诂	gmy
绲	gos
辊	goi
蜾	gli
鼾	hnb
沆	hdd
闳	hjm
戽	hhh
豢	hcj
彗	hff
翚	hty
麾	htm
隳	hte
馄	hfu
徛	jtx
骥	jtm
济	jgd
戬	jpg
耩	jul
侥	jlr
觐	jvj
孓	jia
爝	jih
矍	jio
竣	jrl
墈	kat
㸆	kvh
犒	kvn
瞌	kro
贶	keb
蒉	kfc
籁	lov
榔	lwm
罍	lrf
塄	lft
篱	lbv
缡	lbs
娌	lgn
跞	ltz
郦	lte
蹽	lmz
尨	mwa
嵝	lzu
辘	lhi
锊	ldj
猡	llq
蔓	wac
邙	mwe
懋	mvx
峁	mxu
懑	mox
勐	myl
猕	mbq
谧	mty
敉	mgm
丏	mpa
藐	mlc
缗	mcs
谟	mey
模	mlm
鼐	non
忸	nzx
杻	nzm
杻	izm
衄	nfx
锘	npj
匏	pib
霈	pky
湓	psd
怦	pcx
枇	pbm
琵	pbw
伾	pjr
邳	pje
缥	pms
氕	pkq
芑	qgc
堑	qat
硗	qmu
伽	glr
吣	qvk
揿	qvf
檠	qnm
巯	qma
囷	qgk
穰	rwh
妊	ron
驲	rtm
瑢	rjw
褥	rhy
脎	sio
靸	smg
臊	svo
穑	sih
膻	uno
畲	urr
蓍	ujc
塾	ult
腧	uho
兕	ste
笥	stv
锶	sjj
嗾	szk
薮	szc
嗉	shk
蔌	shc
甦	sag
宿	xzb
宿	xob
谇	sfy
唢	slk
酞	toy
啴	iok
搪	twf
萄	tic
绨	tts
萜	tkc
侹	twr
烃	teh
哃	tjk
煺	tfh
窊	wlx
嵬	wru
艉	wjv
梧	wlm
寤	whb
鹉	wmn
谿	xjg
猃	xpq
缃	xys
蛸	xmi
獬	xqq
伈	xxr
煊	xdh
禤	xdu
蚜	yui
峣	yiu
弋	yta
狺	ycq
愔	yhx
氤	yhq
瘿	ywb
腴	ymo
予	yms
掾	ycf
垸	yct
慥	zvx
迮	zez
缯	zcs
璋	vuw
笊	vvv
侦	ver
埴	vbt
稙	vjh
踵	vnz
舯	vkv
妯	van
胄	vro
荮	vrc
贮	vhb
麈	vml
侏	var
竺	vlv
啭	vck
晫	vlo
孜	zjw
驺	zxm
诅	zmy
怍	zpx
叨	dik
蜚	fji
崀	ldu
崾	yvu
蔼	auc
锿	abj
鹌	ann
聱	aie
遨	aiz
鏊	avj
癍	bnb
塝	bdt
蚌	bfi
鸨	bxn
碚	bku
鞴	bkg
畚	bos
荸	bbc
妣	bgn
睥	pto
砭	bru
笾	brv
玢	few
擘	bgu
骖	cnm
涔	csd
侘	iir
诧	iiy
潺	ipd
躔	ipz
羼	iau
襜	iny
伥	iur
怊	iqx
谌	isy
棽	iel
棽	uel
惩	ifx
澄	dfd
漦	ibu
茌	ibc
褫	igy
笞	ijv
艟	ikv
漴	ijd
畴	iat
帱	iaj
搐	ihf
础	imu
圌	iwk
惙	ipx
匆	ckg
猝	chq
漼	cvd
溚	dud
轪	doi
殚	dnd
眈	dno
箪	dnv
垱	ddt
宕	ddb
忉	dqx
玓	dtw
缔	dts
诋	dgy
柢	dgm
扂	dah
琔	daw
癜	dab
佃	dar
窎	dlx
铫	yij
堞	dst
牒	dsp
绖	dss
楪	dsm
仃	der
耵	dee
垌	dyt
侗	dyr
蹾	dgz
峨	eeu
遏	eiz
咡	ehk
耏	ekp
砝	fmu
蘩	fpc
畈	fat
繁	pes
悱	fjx
烽	fch
咐	fhk
趺	faz
鄜	fae
戤	gog
玕	gnw
堽	gut
锆	gvj
篙	gqv
绠	gys
蚣	gki
岣	gzu
篝	gxv
崮	ghu
梏	ghm
牿	ghn
榖	gmh
酤	gay
坬	ggt
夬	gfa
筦	gsv
莞	gsc
洸	gwd
妫	gtn
皈	gtb
鳜	gfy
蝈	gsi
垾	hat
龢	heh
熇	hih
竑	hjl
翃	hjy
篌	hav
醐	hly
铧	htj
峘	hou
湟	hbd
璜	hbw
隍	hbe
芨	jjc
觭	jjj
袷	qdy
腱	jao
翦	jpy
噍	jlk
藠	jlc
檞	jcm
湝	jkd
妗	jvn
缙	jvs
荩	jvc
馑	jxu
迳	jwz
阱	jwe
岠	jfu
龃	jsi
娵	jhn
疽	jhb
苴	jhc
枸	gzm
蠲	jdy
垲	kut
钪	kdj
栲	kxm
缂	kis
牁	krp
裉	koy
绔	khs
姱	ksn
郐	kfe
鲙	kfy
蒯	kpd
睽	kwo
逵	kwz
馗	kwj
馈	kfu
跬	kvz
鹍	kgn
旯	luo
镴	lij
褴	lpy
镧	lpj
缆	los
稂	lwh
锒	lwj
塱	lpt
檑	lrm
儡	ljr
詈	lts
雳	lty
澧	lgd
墚	lit
趔	lqz
遴	lcz
棂	lnm
舲	lnv
锍	lzj
蕗	lhc
囵	lfk
纶	gds
杩	mim
牦	min
瑁	mvw
嵋	mru
钔	msj
娩	mpn
酩	mwy
侔	mar
仫	mhr
𧿹	mmz
蝻	noi
曩	npo
怩	nbx
猊	nbq
铌	nbj
麑	nbl
埝	nat
讴	oxy
筢	puv
蒎	poc
槃	ppm
蟠	ppi
襻	pay
砒	pju
仳	pgr
纰	pjs
俜	per
钋	ppj
镤	plj
镨	pmj
朴	pgm
锜	qbj
跂	qbz
踦	ygz
岍	qru
杄	qrm
汧	qrd
戗	qeg
憔	qux
诮	qly
伽	qsr
檎	qcm
鲭	qey
邛	qke
犰	qmq
萩	qzc
鞧	qzg
阒	qfm
筌	qov
炔	quh
埆	qdt
轫	roi
嚅	rlk
嬬	rln
孺	rlz
溽	rhd
缛	rhs
蕤	rwc
蚋	rfi
磉	spu
埽	svt
铩	ulj
舢	unv
绱	uds
劭	uvl
艄	uqv
矧	uou
诜	uey
陞	uce
筮	utv
酾	ujy
狩	urq
绶	urs
孀	uwn
妁	upn
搠	upf
蒴	upc
缌	sjs
虒	sjp
忪	skx
螋	sxi
锼	sxj
擞	szf
愫	shx
簌	shv
窣	sax
荪	sgc
飧	sgu
睃	sso
羧	ssy
挲	ssu
褟	tly
沓	duo
螳	twi
鄌	twe
镗	tuj
绹	tis
倜	ttr
趯	ttz
黇	trh
瑱	taw
蜩	tui
烔	tjh
堍	tht
菟	thc
橐	tla
畖	wlt
畹	wot
箢	ydv
尪	wuy
桅	wrm
煟	wkh
娓	wjn
硙	wku
芠	wsc
郚	wle
屼	whu
俙	xjr
郗	xje
苋	xac
筅	xpv
跣	xpz
纤	qas
猇	xmq
翛	xmr
燮	xqh
绁	xqs
薤	xqc
饧	xnu
貅	xzv
馐	xzu
衒	xcx
徇	xrx
郇	xfe
堐	yut
桠	ylm
筵	ypv
垟	ywt
徉	ywx
羕	ydy
繇	yav
圯	ybt
饴	ybu
瘗	ytb
旖	ygf
舣	ygv
钇	ygj
佚	ytr
蚓	yxi
喑	yhk
堙	yht
窨	yvx
颙	yjy
臃	yko
邕	yki
佣	yyr
卣	yzb
羑	yzy
觎	ymj
蜮	yfi
韫	yrw
缊	yrs
瓒	zaw
糌	znm
牂	zup
璪	zxw
舴	zev
砟	vmu
仉	vpr
漳	vud
獐	vuq
蔗	vic
蓁	vec
絷	vbs
沚	vgd
挝	wpf
倬	vsr
涿	vsd
偬	znr
缵	zss
躜	zdz
柞	zpm
嫚	mnn
叚	xca
锪	hsj
