去	q
我	w
而	e
人	r
他	t
有	y
是	u
出	i
哦	o
配	p
啊	a
算	s
的	d
非	f
个	g
和	h
就	j
可	k
了	l
在	z
小	x
从	c
这	v
吧	b
你	n
吗	m
不	bu
把	ba
使	ui
又	yz
深	uf
删	uj
谁	uw
越	yt
赞	zj
兄	xs
闹	nc
乎	hu
阿	aa
恰	qx
撒	sa
洒	sa
它	ta
何	he
躺	th
敲	qn
间	jm
各	ge
几	ji
混	hy
图	tu
陪	pw
酸	sr
四	si
含	hj
跌	dp
超	ic
于	yu
加	jx
站	vj
举	ju
末	mo
再	zd
儿	er
已	yi
设	ue
时	uio
处	iu
挖	wa
横	hg
区	qu
着	ve
任	rf
其	qi
类	lw
套	tc
克	ke
秒	mn
名	mk
副	fu
批	pi
拖	to
流	lq
六	lqw
喔	oo
啊	aaK
吖	aak
锕	aaj
腌	aao
爱	ai
艾	aic
哎	aik
唉	aiku
哀	aiy
挨	aif
埃	ait
矮	aiu
碍	aiuc
暧	aio
癌	aib
蔼	aicr
隘	aie
皑	aibj
霭	aiyr
嗳	aiky
嫒	ain
毐	aitm
欸	ais
叆	aiyy
瑷	aiw
砹	aiux
锿	aij
嗌	aikm
按	an
安	anb
暗	ano
案	anbm
岸	anu
俺	anr
黯	anl
庵	ang
鞍	angn
谙	any
氨	anq
胺	anon
鹌	and
桉	anm
犴	anqg
唵	ank
铵	anj
埯	ant
盦	anrm
垵	antn
𩽾	anyn
昂	ah
肮	aho
盎	ahy
卬	ahp
傲	ao
奥	aop
熬	aof
敖	aofw
澳	aod
凹	aol
懊	aox
嗷	aok
拗	aofl
袄	aopy
鳌	aofy
翱	aob
獒	aofq
骜	aofm
坳	aot
鏖	aolj
遨	aoz
媪	aon
螯	aofi
岙	aoy
璈	aow
鏊	aofj
聱	aofe
廒	aog
奡	aobl
隩	aoe
薁	aoc
嶅	aofu
吧	baK
八	bap
爸	baf
巴	bas
罢	basq
拔	bafy
霸	bay
疤	bab
跋	baz
扒	bafb
叭	bak
芭	bac
靶	bag
坝	bat
耙	bal
笆	bav
魃	bagy
粑	bam
钯	baj
灞	bad
捌	bafd
鲅	bayy
岜	bau
鲃	bayb
菝	bacy
蚆	bai
胈	bao
羓	bayb
朳	bamb
妭	ban
白	bd
百	bda
败	bdb
摆	bdf
拜	bdu
柏	bdm
掰	bduu
伯	bdr
佰	bdrb
稗	bdh
捭	bdfu
半	bj
办	bjl
般	bjv
板	bjm
班	bjw
伴	bjr
版	bjp
搬	bjf
扮	bjff
斑	bjww
扳	bjfy
瓣	bjx
绊	bjs
颁	bjfy
拌	bjfb
阪	bje
坂	bjt
瘢	bjb
钣	bjj
癍	bjbw
攽	bjfw
柈	bjmb
昄	bjo
湴	bjd
靽	bjg
𨭉	bjwj
帮	bh
膀	bho
邦	bhf
棒	bhm
绑	bhs
榜	bhmf
傍	bhr
磅	bhu
梆	bhme
镑	bhj
谤	bhy
蚌	bhi
浜	bhd
蒡	bhc
玤	bhw
搒	bhff
塝	bht
𠳐	bhk
保	bc
报	bcf
包	bcb
宝	bcby
抱	bcfb
暴	bco
爆	bch
薄	bcc
堡	bcr
饱	bcu
豹	bcv
胞	bcob
剥	bce
鲍	bcy
褒	bcym
刨	bcbd
苞	bccb
鸨	bcbn
曝	bcou
煲	bcrh
葆	bccm
雹	bcyb
褓	bcp
炮	bchb
龅	bcvb
孢	bcz
趵	bczu
枹	bcm
瀑	bcd
被	bw
备	bww
北	bwl
背	bwb
呗	bwk
杯	bwm
辈	bwf
悲	bwfx
贝	bwkr
倍	bwr
卑	bwp
惫	bwwx
碑	bwu
狈	bwq
蓓	bwc
悖	bwx
孛	bwuz
焙	bwh
邶	bwbe
陂	bwe
钡	bwj
褙	bwpo
碚	bwuk
鞴	bwg
鐾	bwuj
鹎	bwpn
棓	bwmk
糒	bwmy
琲	bwwf
椑	bwmu
臂	bwuo
鞁	bwgp
𬇙	bwd
本	bf
奔	bfd
笨	bfv
贲	bfu
苯	bfc
锛	bfj
畚	bfs
犇	bfn
坌	bff
倴	bfr
栟	bfm
夯	bfdl
崩	bg
蹦	bgz
绷	bgs
迸	bgzk
甭	bgb
嘣	bgk
泵	bgu
镚	bgj
甏	bgt
琫	bgw
祊	bgp
蚌	bgi
比	bi
必	bix
毕	bib
笔	biv
避	biz
闭	bim
鼻	bizw
逼	bizt
屄	biu
臂	biuo
壁	biut
彼	bir
碧	biw
币	bip
陛	bie
鄙	bik
蔽	bic
匕	bipv
毙	bibb
辟	biux
婢	bin
弊	bixc
璧	biuy
庇	big
敝	bixw
痹	bibw
弼	bigb
贲	biub
俾	biru
裨	bipu
薜	bicx
哔	biku
愎	bixw
吡	bikb
跸	bizu
妣	binb
篦	bivb
荜	bicu
狴	biq
毖	bibb
蓖	bicb
嬖	biun
筚	bivu
髀	bigu
荸	bicz
濞	bid
畀	bit
赑	bibb
秕	bih
箅	bivw
芘	bicb
佛	birf
襞	biuy
苾	bicb
滗	bidm
铋	bij
庳	bigu
萆	bicu
皕	bibb
咇	bikb
舭	bivb
沘	bidb
珌	biwb
觱	biwy
诐	biy
邲	bibe
佖	birb
馝	bihb
坒	bibt
泌	bidb
秘	bihb
鲾	biyt
边	bm
便	bmr
变	bmw
遍	bmz
编	bms
辩	bmx
鞭	bmg
辨	bmxl
扁	bmh
辫	bmxs
贬	bmb
蝙	bmi
匾	bmk
卞	bmwb
汴	bmd
弁	bmsc
砭	bmu
煸	bmhc
褊	bmp
笾	bmv
鳊	bmy
昪	bmo
忭	bmxb
苄	bmc
抃	bmf
碥	bmuc
萹	bmcc
𨚕	bmse
表	bn
标	bnm
镖	bnj
彪	bnh
飙	bnq
婊	bnn
骠	bnmu
镳	bnjh
膘	bno
裱	bnp
杓	bnmu
飑	bnf
俵	bnr
鳔	bny
摽	bnfu
瘭	bnb
熛	bnhu
藨	bnc
儦	bnrh
骉	bnmm
瀌	bnd
幖	bnju
脿	bnoy
别	bp
憋	bpx
瘪	bpb
鳖	bpxy
蹩	bpxz
癿	bpbv
宾	bb
彬	bbm
斌	bbw
滨	bbd
鬓	bbe
缤	bbs
镔	bbj
濒	bbdy
槟	bbmb
殡	bbdb
膑	bbo
摈	bbf
玢	bbwf
傧	bbr
豳	bbu
邠	bbfe
髌	bbg
并	bk
兵	bkq
冰	bkd
病	bkb
柄	bkm
饼	bku
禀	bkw
秉	bkqr
丙	bka
炳	bkh
槟	bkmb
摒	bkf
屏	bkuk
邴	bkbe
昺	bko
栟	bkmk
蛃	bki
波	bo
伯	bor
博	bou
薄	boc
脖	boo
拨	bof
播	boft
勃	boul
玻	bow
膊	booc
柏	bom
搏	bofc
驳	bomx
剥	boe
泊	bod
簸	bov
帛	bob
钵	boj
跛	boz
渤	bodl
菠	bocp
礴	bouc
孛	bouz
啵	bok
舶	bovb
卜	bol
饽	bouz
铂	bojb
钹	bojy
箔	bovb
亳	bowq
擘	bouu
趵	bozu
檗	boum
鹁	boun
僰	bour
踣	bozk
镈	bojc
砵	boub
鲌	boy
哱	bokz
嶓	bout
浡	bodz
馞	boh
艴	bofb
蕃	boct
欂	bomc
袯	bop
𬭛	bojp
部	bul
步	buv
布	buu
补	bup
怖	bux
捕	buf
卜	buld
簿	buvc
埔	but
哺	buk
埠	butf
卟	bukb
堡	bur
逋	buz
钚	buj
晡	buo
瓿	bulw
醭	buy
蔀	buc
埗	butu
𬷕	bufn
擦	ca
嚓	cak
才	cd
菜	cdc
彩	cdcp
采	cdv
财	cdb
材	cdm
猜	cdq
蔡	cdcu
裁	cdg
踩	cdz
睬	cdo
偲	cdr
参	cj
残	cjd
惨	cjx
餐	cjdg
灿	cjh
惭	cjxj
蚕	cjt
璨	cjw
粲	cjdm
骖	cjm
黪	cjl
䅟	cjhp
藏	ch
苍	chc
仓	chr
舱	chv
沧	chd
伧	chrv
鸧	chl
草	cc
操	ccf
肏	ccr
艹	cca
曹	ccc
嘈	cck
糙	ccm
槽	ccmo
漕	ccd
屮	cckl
芔	cccc
艚	ccv
螬	cci
𥕢	ccu
测	ce
侧	cer
册	cek
策	cev
厕	cei
恻	cex
岑	cf
涔	cfd
参	cfs
曾	cg
层	cgu
蹭	cgz
噌	cgk
嶒	cguo
差	ia
查	iam
察	iab
茶	iac
插	iaf
诧	iay
叉	iayd
岔	iafu
嚓	iak
茬	iact
衩	iap
碴	iau
姹	ian
杈	iami
搽	iafm
刹	iax
檫	iamu
槎	iamg
汊	iad
镲	iaj
锸	iajj
馇	iaud
垞	iat
侘	iar
猹	iaq
蹅	iaz
嵖	iaud
喳	iakd
𥻗	iamd
拆	id
柴	idv
钗	idj
差	idy
豺	idvc
侪	idr
茝	idc
虿	idw
瘥	idb
产	ij
颤	ijw
缠	ijs
禅	ijp
蝉	iji
搀	ijf
铲	ijj
婵	ijn
掺	ijfp
阐	ijm
忏	ijx
馋	iju
潺	ijd
蟾	ijik
谄	ijy
谗	ijyd
孱	ijuz
冁	ijb
澶	ijdd
觇	ijv
镡	ijju
羼	ijuy
廛	ijg
巉	ijut
蒇	ijc
韂	ijgk
躔	ijz
刬	ijjd
浐	ijdi
襜	ijpk
瀍	ijdt
骣	ijmz
镵	ijjt
旵	ijo
啴	ijk
梴	ijmv
儳	ijr
单	ijbu
辿	ijzu
𬊤	ijh
长	ih
常	ihx
场	iht
唱	ihk
厂	iha
尝	ihxy
昌	iho
畅	ihu
肠	ihop
偿	ihr
敞	ihxw
怅	ihxi
倡	ihro
娼	ihn
嫦	ihnj
猖	ihq
昶	ihy
徜	ihrk
氅	ihxm
伥	ihri
裳	ihxy
菖	ihc
苌	ihci
阊	ihm
鬯	ihkb
惝	ihxk
鲳	ihyo
鲿	ihyy
𬬮	ihj
朝	icu
潮	icd
吵	ick
嘲	icko
抄	icf
炒	ich
巢	icv
钞	icj
晁	ico
焯	ichu
耖	icl
怊	icx
弨	icg
绰	ics
车	ie
彻	ier
扯	ief
撤	iefw
澈	ied
掣	ien
砗	ieu
坼	iet
尺	ieun
㬚	ieo
沉	if
陈	ife
臣	ifk
晨	ifo
尘	ifx
趁	ift
辰	ifi
衬	ifp
嗔	ifkb
琛	ifw
称	ifh
宸	ifb
忱	ifxe
抻	iff
碜	ifu
谌	ify
谶	ifyj
郴	ifm
棽	ifmv
瞋	ifob
榇	ifmm
龀	ifv
疢	ifbh
梣	ifmv
煁	ifhb
𬘭	ifs
成	ig
城	igt
程	igh
称	ighx
承	igl
诚	igy
盛	igi
乘	igq
撑	igf
呈	igk
惩	igr
丞	igla
澄	igd
逞	igz
橙	igm
骋	igmk
瞠	igo
秤	ighp
铖	igj
塍	igot
琤	igw
裎	igp
澂	igdw
埕	igtw
柽	igmt
蛏	igit
酲	igyw
枨	igmi
珵	igww
赪	igib
偁	igrr
宬	igb
牚	igx
珹	igwi
憕	igxb
庱	igg
噌	igko
晟	igoi
铛	igje
吃	ii
持	iif
迟	iiz
赤	iit
痴	iib
池	iid
尺	iiu
齿	iiv
斥	iij
驰	iim
耻	iie
翅	iivx
哧	iik
炽	iih
嗤	iiki
蚩	iic
叱	iikb
弛	iig
侈	iir
啻	iiw
敕	iiuw
螭	iii
魑	iign
饬	iiul
笞	iivk
匙	iio
踟	iizk
墀	iitn
豉	iidv
媸	iin
褫	iip
鸱	iiun
彳	iipr
茌	iict
篪	iivj
瘛	iibx
摛	iifn
眵	iiox
傺	iiru
漦	iiwu
胣	iioy
瓻	iix
痓	iibt
𫄨	iis
冲	is
充	isw
重	isq
虫	isv
崇	isu
宠	isb
忡	isx
憧	isxl
铳	isj
舂	isi
艟	isvl
翀	isxv
茺	isc
珫	iswy
漴	isd
涌	isdy
种	ish
㳘	isdy
摏	isf
抽	iz
仇	izr
臭	izz
丑	izv
愁	izh
筹	izvc
瞅	izo
酬	izy
绸	izs
畴	izt
踌	izzc
惆	izx
稠	izhk
俦	izrc
雠	izry
瘳	izb
犨	izrn
帱	izj
杻	izm
侴	izrd
椆	izmk
出	iuU
楚	ium
除	iue
初	iup
触	iud
厨	iui
础	iuu
储	iur
畜	iux
褚	iupo
搐	iuf
橱	iumc
躇	iuz
雏	iudv
锄	iuj
矗	iuuq
杵	iumu
楮	iumo
怵	iuxu
黜	iul
绌	ius
蜍	iuim
刍	iude
滁	iudm
樗	iumk
蹰	iuzc
憷	iuxz
亍	iua
俶	iury
斶	iuji
摴	iufk
䝙	iuv
䢺	iuie
濋	iudz
琡	iuw
𬺓	iuvz
欻	ix
揣	ik
踹	ikz
搋	ikf
啜	ikk
传	ir
穿	irb
船	irv
川	irp
喘	irk
串	irkl
钏	irj
椽	irm
舛	irx
遄	irz
氚	irq
床	il
窗	ilb
创	ilr
疮	ilbv
闯	ilm
怆	ilx
幢	ilj
噇	ilk
吹	iv
垂	ivq
锤	ivj
捶	ivf
炊	ivh
槌	ivm
陲	ive
棰	ivmt
倕	ivr
圌	ivk
春	iy
纯	iys
唇	iyi
蠢	iyii
淳	iyd
醇	iyy
椿	iym
鹑	iyw
莼	iyc
蝽	iyio
瑃	iywo
䲠	iyyo
堾	iyt
𬭚	iyj
戳	io
啜	iok
龊	iov
辍	ioi
绰	ios
踔	ioz
惙	iox
逴	iozu
此	ci
次	cid
刺	ciu
词	ciy
辞	ciux
慈	cib
赐	cibw
磁	ciuy
伺	cir
瓷	cidw
茨	cic
雌	civ
祠	cip
呲	cik
疵	cibb
泚	cidb
糍	cim
鹚	cibn
茈	cicb
跐	ciz
玼	ciw
佽	cirq
兹	ciby
差	ciyg
莿	cicd
𫚖	civy
从	cs
匆	csb
聪	cse
丛	csr
葱	csc
琮	csw
淙	csd
囱	csp
骢	csm
苁	cscr
枞	csmr
璁	cswx
熜	csh
悰	csx
凑	cz
辏	czi
腠	czo
粗	cu
促	cur
醋	cuy
簇	cuv
猝	cuq
蹙	cuw
蹴	cuz
卒	cuwu
徂	curq
殂	cud
蔟	cuc
窜	cr
蹿	crz
篡	crv
撺	crf
攒	crfb
汆	crr
爨	crj
镩	crji
脆	cv
催	cvr
翠	cvx
崔	cvu
摧	cvf
粹	cvm
悴	cvxu
璀	cvw
啐	cvk
萃	cvc
瘁	cvb
淬	cvd
榱	cvmv
毳	cvmm
漼	cvdv
缞	cvs
存	cy
村	cym
寸	cyu
忖	cyx
皴	cyy
邨	cyt
错	co
措	cof
挫	cofr
搓	cofg
撮	cofy
磋	cou
蹉	coz
锉	coj
厝	coi
矬	cour
嵯	coug
痤	cob
鹾	cobg
脞	coo
瑳	cow
棤	com
莝	coc
大	da
打	daf
答	dav
达	daz
搭	dafk
哒	dak
瘩	dab
嗒	dakk
沓	dau
耷	dad
鞑	dag
靼	dagd
妲	dan
褡	dap
跶	dazd
怛	dax
笪	davd
垯	dat
溚	dadk
炟	dah
荙	dac
鿎	daud
𨱏	daj
𫟼	dajd
带	dd
代	ddr
待	ddrc
呆	ddk
袋	ddry
戴	ddg
黛	ddrh
歹	dda
贷	ddrb
逮	ddz
怠	dds
殆	ddd
岱	ddru
玳	ddw
呔	ddkt
傣	ddru
大	ddar
迨	ddzk
绐	ddsk
叇	ddy
埭	ddt
骀	ddm
轪	ddi
垈	ddrt
但	dj
单	djb
淡	djd
担	djf
弹	djg
丹	djk
蛋	djz
胆	djo
旦	djoa
诞	djy
耽	dje
惮	djx
石	dja
眈	djoe
澹	djdk
掸	djfu
郸	djbe
殚	djdu
啖	djkh
氮	djq
儋	djr
聃	djer
箪	djv
亶	djw
疸	djbd
萏	djc
瘅	djbu
疍	djzd
赕	djbh
憺	djxk
膻	djod
𫢸	djru
𬘘	djs
当	dh
党	dhx
荡	dhc
挡	dhf
档	dhm
铛	dhj
裆	dhp
宕	dhb
砀	dhu
珰	dhw
凼	dhk
谠	dhy
垱	dht
菪	dhcu
筜	dhv
𣗋	dhmx
𬍡	dhd
到	dc
倒	dcr
道	dcz
刀	dcv
导	dcs
岛	dcn
盗	dcd
叨	dck
蹈	dczj
祷	dcp
捣	dcf
稻	dch
悼	dcx
纛	dcfx
忉	dcxd
氘	dcq
捯	dcfd
鱽	dcy
舠	dcvd
帱	dcj
的	de
地	det
得	der
德	derx
嘚	dek
锝	dej
得	dw
嘚	dwk
扽	df
等	dg
灯	dgh
登	dgb
瞪	dgo
邓	dgy
凳	dgbj
蹬	dgz
噔	dgk
镫	dgj
磴	dgu
澄	dgd
戥	dgog
嶝	dgub
璒	dgw
地	di
第	div
弟	dib
底	dig
低	dir
帝	diw
敌	diu
抵	dif
递	diz
迪	dizy
滴	did
的	diB
蒂	dic
狄	diq
笛	divy
嘀	dik
堤	dit
邸	diue
嫡	din
棣	dim
缔	dis
谛	diy
涤	didm
荻	dich
娣	dind
诋	diyu
氐	diud
砥	diuu
镝	dij
睇	dio
坻	ditu
柢	dimu
鞮	digz
羝	diyu
觌	diuj
籴	dirm
骶	digu
碲	diuj
禘	dip
翟	dix
踶	dizz
菂	dicu
髢	die
玓	diwu
杕	dimd
蹢	dizg
媂	dinj
提	difz
䃅	diuu
䗖	dii
茋	dicu
𤧛	diwj
𬱖	diyy
嗲	dx
点	dm
电	dmy
店	dmg
殿	dmu
典	dmq
颠	dmuy
垫	dmf
甸	dmb
惦	dmx
奠	dmbd
掂	dmfv
癫	dmby
巅	dmuy
淀	dmd
滇	dmdb
玷	dmw
踮	dmz
佃	dmr
靛	dmfz
碘	dmub
钿	dmj
簟	dmv
癜	dmbu
坫	dmt
阽	dme
扂	dmh
琔	dmwz
掉	dn
调	dny
屌	dnu
雕	dnk
吊	dnkj
钓	dnj
刁	dnv
叼	dnkd
貂	dnvk
凋	dnd
碉	dnuk
鲷	dnyk
铫	dnjv
铞	dnjj
窎	dnb
汈	dndd
爹	dpf
蝶	dpi
叠	dpy
碟	dpu
迭	dpz
谍	dpym
喋	dpk
牒	dpp
堞	dpt
耋	dpl
鲽	dpym
昳	dpo
蹀	dpzm
瓞	dpg
垤	dptt
绖	dps
楪	dpm
𫶇	dpuj
定	dk
顶	dkd
丁	dka
盯	dko
订	dky
叮	dkk
鼎	dkp
钉	dkj
锭	dkjz
町	dkt
仃	dkr
酊	dkyd
腚	dkoz
玎	dkw
碇	dku
疔	dkb
啶	dkkz
耵	dke
萣	dkc
丢	dq
铥	dqj
动	ds
东	dsa
洞	dsd
懂	dsx
冬	dsw
董	dsc
冻	dsdd
栋	dsm
咚	dsk
峒	dsu
胴	dso
侗	dsr
恫	dsxk
鸫	dsdn
垌	dst
硐	dsuk
氡	dsq
胨	dsod
岽	dsud
𬟽	dsi
都	dz
斗	dzu
抖	dzf
豆	dza
逗	dzz
兜	dzp
陡	dze
窦	dzb
痘	dzbb
蚪	dzi
蔸	dzc
篼	dzv
钭	dzj
读	dzy
度	du
独	duq
毒	duf
读	duy
杜	dum
肚	duo
赌	dub
督	duu
渡	dud
嘟	duk
堵	dut
妒	dun
都	dul
睹	duoo
笃	duv
渎	dudd
镀	duj
犊	dund
牍	dup
蠹	dug
黩	duld
阇	dumo
芏	duc
椟	dumd
髑	dugi
厾	duvq
𬭊	dujt
断	dr
段	drp
短	dru
端	drl
锻	drj
缎	drs
煅	drh
椴	drm
耑	drue
簖	drv
塅	drt
瑖	drw
对	dv
队	dve
堆	dvt
兑	dvb
怼	dvy
碓	dvu
祋	dvp
顿	dy
盾	dyi
蹲	dyz
敦	dyw
沌	dyd
遁	dyzo
吨	dyk
钝	dyj
墩	dyt
炖	dyh
盹	dyo
惇	dyx
趸	dywz
礅	dyu
蹾	dyzw
砘	dyut
镦	dyjw
囤	dykt
多	do
躲	dou
朵	doj
夺	dod
堕	doe
哆	dok
跺	doz
踱	dozy
舵	dov
咄	doki
度	dog
剁	dojd
铎	dojf
惰	dox
垛	dot
掇	dof
哚	dokm
裰	dop
埵	dott
饳	doui
亸	dow
剟	doy
驮	dom
㙍	doty
饿	ee
呃	eek
恶	eey
额	eeb
俄	eer
愕	eex
鹅	eew
噩	eewk
娥	een
厄	eei
峨	eeu
鄂	eeke
遏	eez
扼	eef
鳄	eeyk
蛾	eeiw
婀	eenk
讹	eeyb
阿	eee
锷	eej
颚	eeky
鹗	eekn
萼	eec
屙	eeuk
谔	eeyk
垩	eeyt
腭	eeo
欸	ees
莪	eecw
轭	eeiv
苊	eecv
锇	eejw
崿	eeuk
姶	eenk
涐	eed
哦	eeK
堨	eet
𥔲	eeuk
𫫇	eekx
嗯	en
恩	eny
摁	enf
蒽	enc
而	erA
二	era
尔	erd
耳	ero
饵	eru
迩	erz
贰	ery
洱	erde
珥	erw
铒	erj
鸸	ere
陑	eree
鲕	erye
咡	erk
耏	erep
发	fa
法	fad
罚	fas
乏	fap
伐	far
阀	fam
筏	fav
砝	fau
珐	faw
垡	fart
反	fj
饭	fju
翻	fjc
烦	fjh
凡	fjj
犯	fjq
范	fjcv
番	fjct
繁	fjp
返	fjz
泛	fjd
帆	fjjf
贩	fjb
樊	fjm
藩	fjct
梵	fjmf
蕃	fjct
幡	fjjt
蘩	fjcx
璠	fjw
矾	fjuf
畈	fjt
燔	fjht
钒	fjjf
氾	fjdv
蹯	fjzt
墦	fjtt
𫔍	fjjt
𬸪	fjcn
放	fh
房	fhh
防	fhe
方	fhw
仿	fhr
芳	fhc
访	fhy
妨	fhn
坊	fht
纺	fhs
肪	fho
舫	fhv
枋	fhm
昉	fhof
鲂	fhyf
邡	fhf
钫	fhj
牥	fhnf
蚄	fhi
飞	fw
非	fwL
费	fwf
菲	fwc
废	fwg
妃	fwn
肥	fwo
啡	fwk
匪	fwkf
沸	fwd
肺	fwou
绯	fws
斐	fwfw
霏	fwy
翡	fwfx
扉	fwh
吠	fwkq
诽	fwyf
蜚	fwfi
狒	fwq
腓	fwof
悱	fwx
淝	fwdb
芾	fwcu
痱	fwb
榧	fwm
鲱	fwyf
篚	fwv
朏	fwoi
棐	fwfm
镄	fwj
剕	fwfd
𬴂	fwmf
分	ff
份	ffr
纷	ffs
奋	ffd
愤	ffx
粉	ffm
氛	ffq
吩	ffk
芬	ffc
焚	ffmh
坟	fft
忿	fff
粪	ffmg
汾	ffdf
玢	ffw
酚	ffy
棼	ffmf
偾	ffrb
鲼	ffyb
棻	ffcm
鼢	ffj
翂	ffxf
瀵	ffdg
坋	fftf
豮	ffu
𣸣	ffdb
风	fg
封	fgt
凤	fgj
峰	fgu
疯	fgb
锋	fgjf
枫	fgm
丰	fgs
奉	fgi
冯	fgd
缝	fgsf
逢	fgz
讽	fgy
蜂	fgif
烽	fgh
俸	fgr
沣	fgdf
沨	fgdf
酆	fgue
葑	fgc
唪	fgk
砜	fguf
赗	fgbo
浲	fgdf
崶	fguc
佛	fo
否	fz
缶	fzp
服	fuo
夫	fue
父	fub
复	fup
福	fupt
府	fug
负	fud
付	fur
富	fubt
妇	fun
附	fuec
伏	furq
傅	furc
浮	fudz
扶	fuf
抚	fufw
符	fuv
肤	fuof
腹	fuow
幅	fuj
咐	fuk
覆	fux
腐	fugr
弗	fugl
赴	fut
斧	fufj
俯	furc
赋	fubv
辅	fui
芙	fuc
拂	fuff
甫	fuu
俘	furz
缚	fus
蝠	fuit
敷	fufw
脯	fuof
佛	furf
袱	fupq
腑	fuoc
辐	fuit
孚	fuvz
驸	fum
釜	fufb
苻	fucc
匐	fubt
宓	fubb
阜	ful
孵	fulz
馥	fuh
茀	fucf
涪	fudk
茯	fucq
凫	funj
蚨	fuif
拊	fufc
蝮	fuiw
讣	fuy
黼	fuyf
芾	fucu
趺	fuz
怫	fuxf
氟	fuq
蜉	fuiz
黻	fuyy
麸	fuff
绂	fusy
跗	fuzc
鲋	fuyc
罘	fusb
滏	fudb
郛	fuve
菔	fucy
桴	fumz
幞	fujf
祓	fupy
呋	fukf
绋	fusf
莩	fucz
赙	fubc
鄜	fule
芣	fucb
洑	fudq
簠	fuvm
榑	fumc
稃	fuhz
韨	fuw
玞	fuwf
砆	fuuf
垺	futz
艴	fufb
㕮	fukf
㳇	fudf
琈	fuwz
𫓧	fujf
𫖯	fuvy
尬	ga
嘎	gak
伽	gar
噶	gakr
旮	gaj
咖	gakk
尕	gan
尜	gax
轧	gai
钆	gajv
戛	gab
该	gd
改	gdj
盖	gdy
概	gdm
丐	gda
钙	gdjg
溉	gdd
赅	gdb
垓	gdt
陔	gde
戤	gdn
荄	gdc
晐	gdo
𬮿	gdej
感	gj
干	gja
敢	gje
赶	gjt
甘	gjc
尴	gjy
杆	gjm
肝	gjo
竿	gjv
橄	gjmw
赣	gjl
秆	gjh
柑	gjmg
擀	gjf
玕	gjw
淦	gjd
泔	gjdg
矸	gju
坩	gjtg
绀	gjs
苷	gjcg
旰	gjog
疳	gjb
酐	gjyg
澉	gjdw
虷	gji
鳡	gjyx
㽏	gjdg
刚	gh
港	ghd
钢	ghj
岗	ghu
冈	ghk
缸	ghf
纲	ghs
罡	ghsv
杠	ghm
肛	gho
筻	ghv
冮	ghdg
矼	ghug
堽	ght
戆	ghl
扛	ghfg
㭎	ghmx
鿍	ghtf
高	gc
告	gcn
搞	gcf
糕	gcm
稿	gch
膏	gcw
羔	gcy
皋	gcb
镐	gcj
睾	gcp
篙	gcv
诰	gcyk
槁	gcmk
杲	gco
缟	gcs
锆	gcjk
郜	gcne
藁	gcc
槔	gcmu
筶	gcvk
个	geR
哥	gek
格	gem
歌	gekq
革	gec
隔	gee
阁	gemk
葛	gecr
割	geb
胳	geo
戈	gey
搁	gef
鸽	ger
疙	gebv
骼	geg
嗝	gekg
硌	geu
咯	gekk
铬	gej
盖	geym
鬲	gea
圪	get
蛤	gei
舸	gev
膈	geog
虼	geiv
袼	gep
哿	gel
镉	gejg
仡	gerv
饹	geuk
塥	getg
滆	ged
合	gerk
给	gw
跟	gf
根	gfm
亘	gfa
艮	gfo
哏	gfk
茛	gfc
更	gg
耿	gge
哽	ggk
耕	ggl
羹	ggy
庚	ggg
梗	ggm
赓	gggb
埂	ggt
鲠	ggyg
绠	ggs
浭	ggd
暅	ggo
颈	ggj
鹒	gggn
𬒔	ggu
公	gs
工	gsa
功	gsg
攻	gsgw
宫	gsb
共	gsc
供	gsr
恭	gsgx
弓	gsv
贡	gsgb
躬	gsu
拱	gsf
龚	gsl
巩	gsgf
蚣	gsi
觥	gsd
汞	gsgu
肱	gso
珙	gsw
䢼	gsge
硔	gsug
够	gz
狗	gzq
构	gzm
勾	gzb
购	gzbg
沟	gzd
钩	gzj
苟	gzc
垢	gzt
篝	gzv
佝	gzr
媾	gzn
枸	gzmj
诟	gzy
彀	gztu
缑	gzs
遘	gzz
鞲	gzg
笱	gzvj
觏	gzf
岣	gzu
姤	gznk
雊	gzjv
耇	gzl
句	gzbk
古	gu
故	gug
顾	gui
股	guo
姑	gun
骨	gugo
孤	guz
谷	gub
鼓	gut
固	guk
估	gur
咕	gukg
辜	gugx
雇	guh
蛊	guim
菇	guc
汩	gud
箍	guv
锢	guj
沽	gudg
贾	gux
鹘	gugn
臌	guov
牯	gung
轱	guig
鸪	gugn
梏	gum
痼	gubg
钴	gujg
毂	gutu
崮	guu
诂	guy
瞽	guto
菰	gucg
蛄	guig
羖	guyu
觚	gudg
嘏	gugy
罟	gus
榖	gutu
酤	guyg
馉	guuo
牿	gunk
堌	gutg
蓇	guco
鲴	guyg
呱	gukg
鹄	gunn
瀔	gudu
𦙶	guog
挂	gx
瓜	gxi
刮	gxu
寡	gxb
卦	gxt
呱	gxk
褂	gxp
剐	gxkd
鸹	gxun
诖	gxy
栝	gxm
胍	gxo
怪	gk
乖	gkq
拐	gkf
掴	gkfy
夬	gkv
关	gr
管	grv
官	grb
观	gry
馆	gru
惯	grx
冠	grbc
贯	grm
灌	grd
罐	grf
棺	grml
倌	grr
盥	grj
掼	grfb
涫	grdl
鳏	gryx
鹳	grc
瓘	grw
祼	grp
琯	grwl
毌	grml
筦	grvy
蒄	grcc
爟	grh
纶	grs
莞	grcy
鳤	gryl
光	gl
广	gld
逛	glz
咣	glk
犷	glq
胱	glo
桄	glm
洸	glde
珖	glw
垙	glt
𨐈	gli
鬼	gv
贵	gvv
规	gvf
归	gvl
跪	gvz
柜	gvm
诡	gvy
瑰	gvw
桂	gvmt
龟	gvd
轨	gvi
闺	gvmt
圭	gvt
桧	gvmy
刽	gvr
癸	gvb
硅	gvu
妫	gvn
珪	gvwt
皈	gvby
晷	gvo
鲑	gvyt
刿	gvud
鳜	gvyq
姽	gvnv
簋	gvvm
庋	gvg
宄	gvbj
匦	gvk
邽	gvte
鬶	gvfg
炅	gvoh
筀	gvvt
滚	gy
棍	gym
衮	gyy
鲧	gyyx
磙	gyu
辊	gyi
绲	gys
过	go
国	gok
果	got
郭	gow
锅	goj
裹	goy
蝈	goi
聒	goe
帼	gojy
掴	gof
椁	gom
虢	gov
埚	gotn
呙	gokn
崞	gou
腘	goo
馘	gob
粿	gomg
蜾	goig
馃	goug
涡	god
𬇹	gody
哈	ha
蛤	hai
铪	haj
还	hd
海	hdd
孩	hdz
害	hdb
骇	hdm
嗨	hdk
骸	hdg
亥	hdw
咳	hdkr
嗐	hdkk
氦	hdq
醢	hdy
胲	hdo
咍	hdkk
汉	hjd
寒	hjb
喊	hjk
韩	hju
汗	hjdg
涵	hjdu
翰	hjux
憾	hjx
罕	hjbg
撼	hjf
悍	hjxg
瀚	hjdx
函	hjku
憨	hje
旱	hjo
酣	hjy
颔	hjr
邯	hjg
捍	hjfg
鼾	hjz
晗	hjok
菡	hjc
焊	hjh
犴	hjq
顸	hjgy
邗	hjge
焓	hjhk
蚶	hji
扞	hjfg
撖	hjfw
虷	hjig
暵	hjot
浛	hjdk
琀	hjw
㘎	hjkw
垾	hjt
崡	hjuu
嵅	hjuk
蔊	hjcg
行	hh
航	hhv
杭	hhm
夯	hhd
沆	hhdj
颃	hhw
绗	hhs
吭	hhk
巷	hhg
好	hc
号	hck
毫	hcw
豪	hcwu
浩	hcd
耗	hcl
昊	hco
郝	hci
嚎	hcku
皓	hcb
壕	hct
嗥	hcku
颢	hcoy
濠	hcdu
蒿	hcc
灏	hcdy
貉	hcv
蚝	hcim
薅	hccc
皞	hcbu
淏	hcdt
嚆	hckk
鄗	hcwe
镐	hcj
和	heH
合	her
喝	hek
呵	hekk
河	hed
赫	hei
核	hem
贺	hel
盒	herm
荷	hec
鹤	heb
禾	hep
褐	hepr
嗬	hekk
壑	hebt
阖	hemm
吓	hekx
涸	hedg
劾	hew
颌	hery
阂	hemr
诃	hey
郃	here
纥	hes
貉	hev
龢	herh
鞨	heg
翮	hegx
曷	heo
龁	hevv
盍	heq
菏	heck
盉	heh
饸	heu
熇	hehk
鹖	heon
翯	hex
垎	het
隺	hebv
𬌗	heyk
黑	hw
嘿	hwk
𬭶	hwj
很	hf
狠	hfq
恨	hfx
痕	hfb
𬣳	hfy
哼	hgk
衡	hgr
恒	hgx
亨	hgw
蘅	hgc
珩	hgwd
姮	hgn
桁	hgm
行	hgrd
鸻	hgrn
堼	hgt
红	hs
轰	hsi
洪	hsd
虹	hsig
宏	hsb
鸿	hsdn
哄	hsk
弘	hsg
烘	hsh
泓	hsds
闳	hsm
讧	hsy
薨	hsc
訇	hsbk
荭	hscg
纮	hss
吽	hskn
竑	hsl
蕻	hscg
翃	hsu
黉	hsx
唝	hskb
玒	hsw
谼	hsgg
𫟹	hsj
𬭎	hsjs
后	hz
候	hzr
厚	hzi
吼	hzk
侯	hzru
猴	hzq
喉	hzku
逅	hzz
篌	hzv
瘊	hzb
鲎	hzx
堠	hzt
垕	hzit
齁	hzzj
骺	hzg
糇	hzm
郈	hzie
鲘	hzy
𬭤	hzj
呼	huk
忽	huw
护	huf
胡	hug
虎	huh
湖	hud
糊	hum
户	hudu
互	hua
狐	huq
壶	hut
和	huH
蝴	hui
惚	hux
弧	hugg
唬	hukj
葫	huc
沪	hudh
扈	huhb
瑚	huwo
琥	huwj
浒	hudu
核	humr
鹄	hun
鹘	hugn
斛	hudd
囫	hukw
祜	hup
醐	huy
唿	hukx
猢	huqo
笏	huv
瓠	hudg
槲	humd
怙	huxg
煳	huho
鹕	hugn
滹	hudh
觳	hutu
岵	huu
烀	huhh
鄠	huye
戽	huhd
縠	hutu
冱	hudh
鹱	huny
淴	hudx
昒	huo
鳠	huyy
嫭	hunh
轷	huih
昈	huoh
话	hx
花	hxc
化	hxr
华	hxru
划	hxg
画	hxa
滑	hxd
哗	hxk
猾	hxq
桦	hxm
骅	hxmu
婳	hxn
铧	hxj
砉	hxf
觟	hxdt
坏	hk
怀	hkx
淮	hkd
槐	hkm
徊	hkr
踝	hkz
换	hr
缓	hrs
还	hrz
环	hrw
幻	hry
唤	hrk
欢	hryq
患	hri
焕	hrh
桓	hrm
鬟	hre
宦	hrb
寰	hrby
浣	hrd
痪	hrbd
涣	hrdd
奂	hrdd
圜	hrky
豢	hrj
獾	hrq
洹	hrdd
嬛	hrn
缳	hrsy
萑	hrc
鲩	hryy
郇	hrbe
漶	hrdx
逭	hrzl
擐	hrf
锾	hrjy
镮	hrjy
澴	hrdy
鹮	hrsn
貆	hrv
峘	hru
㬊	hro
荁	hrcd
𤩽	hrwq
𬘫	hrsy
黄	hl
皇	hlb
晃	hlo
慌	hlx
荒	hlc
恍	hlxe
谎	hly
惶	hlxw
凰	hlj
煌	hlh
簧	hlv
徨	hlr
蝗	hli
幌	hlje
潢	hld
璜	hlw
遑	hlz
磺	hlu
隍	hle
肓	hlwo
湟	hldw
蟥	hlih
篁	hlvw
鳇	hlyw
滉	hlde
喤	hlk
癀	hlbh
锽	hljw
艎	hlvw
瑝	hlww
媓	hln
㿠	hlbe
𨱑	hljh
会	hv
回	hvk
挥	hvf
灰	hvu
慧	hvfx
辉	hvx
恢	hvxh
毁	hvj
悔	hvxm
惠	hvi
汇	hvd
绘	hvs
徽	hvr
讳	hvy
晖	hvo
晦	hvom
贿	hvb
秽	hvh
卉	hvuc
麾	hvg
诲	hvym
蕙	hvc
彗	hvfe
诙	hvyh
喙	hvku
荟	hvcy
烩	hvhy
虺	hvw
蛔	hvik
珲	hvwi
咴	hvkh
茴	hvck
恚	hvt
洄	hvdk
袆	hvp
隳	hve
翚	hvxi
翙	hvux
浍	hvdy
蟪	hvix
硊	hvuv
橞	hvm
哕	hvkx
桧	hvmy
溃	hvdb
㧑	hvfw
烠	hvho
𬤝	hvyx
𬭬	hvje
婚	hyn
魂	hyy
昏	hyu
浑	hyd
荤	hyc
馄	hyub
诨	hyyi
珲	hyw
阍	hym
溷	hydu
惛	hyx
碈	hyuo
或	ho
活	hod
火	hob
伙	hor
获	hoc
惑	hog
货	horb
祸	hop
霍	hoy
豁	hobg
和	hoH
夥	hogx
嚯	hok
藿	hocv
镬	hoj
蠖	hoi
攉	hof
钬	hojh
嚄	hoky
锪	hojx
劐	hocd
濩	hody
耠	hol
漷	hode
㸌	hoh
佸	horu
𬴃	hom
级	jis
集	jir
及	jip
机	jim
记	jiy
季	jih
击	jif
急	jid
鸡	jiyn
挤	jifq
系	jipx
即	jig
既	jigw
极	jimj
计	jiyu
激	jidw
继	jism
基	jic
寄	jib
忌	jij
己	jik
际	jie
纪	jisj
技	jifv
济	jidq
迹	jiz
吉	jit
积	jihv
寂	jiby
疾	jibu
姬	jin
绩	jisb
祭	jix
肌	jio
辑	jii
籍	jiv
圾	jitj
妓	jinv
嫉	jinu
饥	jiu
剂	jiq
奇	jidk
给	jisk
脊	jiro
稽	jiho
叽	jikj
唧	jike
讥	jiyj
藉	jico
冀	jibg
戟	jiug
棘	jiuu
缉	jise
悸	jixz
羁	jism
玑	jiw
伎	jirv
霁	jiyq
矶	jiuj
髻	jiek
稷	jihw
岌	jiuj
汲	jidj
畸	jitk
笈	jivj
觊	jiuj
骥	jimg
嵇	jihu
蓟	jicd
箕	jivb
佶	jirk
瘠	jibo
畿	jigt
犄	jink
亟	jil
跻	jizq
殛	jida
暨	jigd
鲫	jiye
偈	jirr
齑	jiqj
蒺	jicu
芨	jicj
屐	jiuv
荠	jicq
楫	jime
赍	jiub
乩	jivv
麂	jilj
笄	jivk
芰	jicv
墼	jiit
鹡	jirn
剞	jidd
戢	jikg
虮	jiij
伋	jirj
垍	jitz
掎	jifk
洎	jidz
跽	jizx
嵴	jiuo
鲚	jiyq
蕺	jicg
罽	jisd
蹐	jizo
姞	jink
漈	jidu
穄	jihu
耤	jilo
觭	jidk
惎	jicx
期	jico
鱾	jiyj
㴔	jidx
堲	jigt
徛	jirk
枅	jimk
瀱	jidd
𪟝	jifl
𫌀	jipb
𫓯	jijt
𫓹	jijb
𬯀	jieq
𬶨	jigy
𬶭	jiyu
家	jxb
价	jxr
假	jxry
架	jxl
甲	jxt
佳	jxrt
夹	jxa
贾	jxx
嘉	jxtk
嫁	jxn
驾	jxlm
颊	jxj
迦	jxz
伽	jxrk
茄	jxc
稼	jxh
枷	jxm
珈	jxw
袈	jxly
戛	jxbg
葭	jxcy
浃	jxd
胛	jxo
痂	jxbk
笳	jxv
岬	jxu
槚	jxmb
钾	jxjj
荚	jxcj
郏	jxje
铗	jxjj
跏	jxzk
蛱	jxi
恝	jxf
斝	jxk
镓	jxju
瘕	jxby
泇	jxdk
𬂩	jxmj
见	jmk
剑	jmq
件	jmr
建	jmz
键	jmj
渐	jmd
简	jmv
坚	jml
肩	jmh
箭	jmvd
舰	jmvj
尖	jmx
监	jmlm
健	jmry
检	jmm
减	jmdk
奸	jmn
艰	jmy
兼	jmb
鉴	jmlj
贱	jmbj
捡	jmf
剪	jmbd
溅	jmdj
践	jmzj
荐	jmc
歼	jmdq
拣	jmfd
煎	jmbh
俭	jmrq
涧	jmdo
茧	jmci
谏	jmyj
柬	jmu
笺	jmvj
缄	jms
戬	jmyg
锏	jmjo
碱	jmuk
睑	jmo
翦	jmbx
饯	jmuj
蹇	jmbz
僭	jmro
菅	jmcl
毽	jmmy
腱	jmoy
謇	jmbk
蒹	jmcj
戋	jmg
槛	jmmm
鞯	jmgz
笕	jmvj
鹣	jmjn
搛	jmfj
缣	jmsj
鞬	jmgy
湔	jmdd
裥	jmp
枧	jmmj
鲣	jmyt
趼	jmzk
谫	jmyd
踺	jmzy
楗	jmmy
暕	jmoj
牮	jmrn
篯	jmvj
犍	jmny
鳒	jmyj
𬣡	jmyj
将	jl
江	jld
讲	jly
降	jle
蒋	jlc
奖	jll
僵	jlr
姜	jlyn
疆	jlg
匠	jlk
浆	jllu
酱	jlly
缰	jls
绛	jlsf
桨	jllm
犟	jlgn
糨	jlm
豇	jldg
茳	jlcg
礓	jlu
洚	jldf
耩	jllr
膙	jlo
鳉	jlyc
弶	jlgx
强	jlgi
虹	jli
叫	jn
教	jnl
交	jnw
脚	jno
角	jnd
较	jni
娇	jnn
焦	jnr
骄	jnm
轿	jnil
搅	jnf
狡	jnq
郊	jnwe
胶	jnof
觉	jnx
嚼	jnk
绞	jns
剿	jnv
浇	jndw
缴	jnsw
蛟	jnif
椒	jnmy
侥	jnrw
矫	jnu
饺	jnuf
蕉	jnc
校	jnmf
礁	jnuh
皎	jnb
窖	jnbk
跤	jnz
佼	jnrf
姣	jnnf
酵	jny
鲛	jnyf
艽	jncj
湫	jndh
醮	jnyh
铰	jnj
峤	jnul
茭	jncf
徼	jnrf
鹪	jnrn
敫	jnbw
噍	jnkh
僬	jnrh
峧	jnuf
滘	jndk
燋	jnh
藠	jncb
皦	jnbw
斠	jnfd
璬	jnww
皭	jnbc
恔	jnxf
䴔	jnwn
漖	jndw
接	jp
解	jpd
姐	jpn
结	jps
界	jpt
节	jpc
杰	jpm
街	jpr
借	jpro
介	jprl
阶	jpe
洁	jpdk
戒	jpg
皆	jpb
劫	jpq
截	jpgv
捷	jpf
揭	jpfr
竭	jpl
届	jpu
藉	jpco
婕	jpnz
睫	jpo
诫	jpy
桀	jpx
芥	jpcj
桔	jpmk
诘	jpyk
价	jprj
颉	jpty
嗟	jpk
孑	jpla
羯	jpyr
拮	jpfk
秸	jph
玠	jpw
碣	jpur
讦	jpyg
疥	jpbj
喈	jpkb
蚧	jpi
疖	jpbe
絜	jpfx
檞	jpmn
劼	jptl
骱	jpgj
鲒	jpyk
褯	jpp
湝	jpdb
岊	jpbu
楷	jpmb
㛃	jpfn
悈	jpxc
蜐	jpil
进	jb
今	jbr
金	jbrb
紧	jbl
近	jbz
尽	jbi
仅	jbry
禁	jbm
劲	jbj
锦	jbjj
巾	jbk
筋	jbv
津	jbd
晋	jby
斤	jbil
谨	jbyw
浸	jbdy
襟	jbp
矜	jbmv
瑾	jbw
烬	jbh
靳	jbg
噤	jbku
觐	jbc
妗	jbn
缙	jbs
堇	jbcw
槿	jbmw
衿	jbpv
荩	jbcd
馑	jbu
卺	jblv
瑨	jbwo
廑	jbgw
琎	jbwj
赆	jbb
溍	jbdo
祲	jbpy
浕	jbdd
墐	jbt
殣	jbdw
珒	jbwy
𬬱	jbjj
经	jk
惊	jkx
竟	jkl
静	jkf
精	jkm
睛	jko
警	jkc
京	jkw
境	jkt
景	jkox
敬	jkcw
镜	jkj
晶	jkoo
净	jkd
径	jkr
竞	jklx
井	jkca
颈	jkjy
靖	jklo
荆	jkcd
菁	jkco
阱	jke
兢	jku
憬	jkxx
婧	jkn
鲸	jky
劲	jkjl
茎	jkcj
丼	jkjd
旌	jkfu
痉	jkb
泾	jkdj
迳	jkz
璟	jkwx
胫	jkoj
儆	jkrw
靓	jkfj
粳	jkmg
獍	jkq
刭	jkjd
腈	jkoo
肼	jkoj
倞	jkrx
璥	jkww
麖	jklx
鼱	jkjo
猄	jkqx
䴖	jkfn
汫	jkdj
竫	jkly
囧	js
炯	jsh
窘	jsb
迥	jsz
炅	jso
颎	jsby
扃	jshk
冏	jsk
坰	jst
泂	jsd
䌹	jss
𬳶	jsm
就	jq
九	jqp
酒	jqd
久	jqdn
旧	jql
救	jqq
究	jqb
舅	jqj
纠	jqs
疚	jqbj
揪	jqf
咎	jqw
鹫	jqwn
鸠	jqjn
啾	jqk
臼	jqpa
灸	jqjh
赳	jqt
厩	jqi
柩	jqm
玖	jqwj
韭	jqfa
阄	jqmd
僦	jqr
鬏	jqe
桕	jqmj
氿	jqdj
㠇	jqu
巨	juk
居	juu
局	juuk
具	juq
据	juf
句	jub
聚	jue
剧	juud
距	juz
惧	jux
拒	jufj
俱	jur
车	jua
矩	juuj
菊	juc
拘	jufj
沮	jud
鞠	jug
狙	juqq
橘	jum
驹	jumj
飓	jufb
锯	juj
咀	jukq
桔	jumk
踞	juzg
炬	juh
掬	jufm
遽	juzu
倨	jurg
雎	juqv
钜	jujj
踽	juzy
裾	jup
琚	juw
疽	jubq
莒	juck
車	juuu
龃	juv
苣	jucj
榉	jumf
讵	juy
苴	jucq
鞫	jugk
焗	juhk
椐	jumg
锔	jujk
筥	juvk
屦	juun
窭	jubn
醵	juyu
蒟	jucj
犋	jun
澽	judu
娵	juny
秬	juhj
崌	juug
岠	juuj
砠	juuq
腒	juo
弆	juqc
泃	judj
岨	juuq
枸	jumj
柜	jumj
趄	jut
䴗	juon
𬶋	juyj
卷	jr
娟	jrn
倦	jrr
捐	jrf
眷	jrj
绢	jrs
鹃	jrk
涓	jrd
圈	jrkv
隽	jrrn
镌	jrjn
蠲	jrb
狷	jrq
鄄	jrx
锩	jrjv
桊	jrjm
焆	jrh
觉	jt
绝	jts
决	jtd
爵	jtv
诀	jty
嚼	jtk
掘	jtf
角	jtdy
厥	jti
倔	jtr
撅	jtfq
珏	jtw
崛	jtu
抉	jtfg
噘	jtkq
攫	jtfy
谲	jtyk
獗	jtq
蹶	jtz
傕	jtrv
蕨	jtc
矍	jto
橛	jtm
镢	jtj
玦	jtwg
孓	jtl
桷	jtmy
觖	jtdg
爝	jth
劂	jtid
玃	jtqy
砄	jtug
㵐	jtdq
𫔎	jtjk
𫘝	jtmg
均	jy
君	jyy
军	jyb
俊	jyr
郡	jyye
峻	jyu
钧	jyj
骏	jym
菌	jyc
竣	jyl
浚	jyd
珺	jyw
麇	jylh
皲	jybp
焌	jyh
葰	jycw
捃	jyf
畯	jyt
莙	jyck
晙	jyo
筠	jyv
隽	jyrn
鲪	jyyk
龟	jydd
䐃	jyoh
卡	ka
咖	kak
喀	kakk
咔	kakb
咯	kakk
胩	kao
开	kd
凯	kdu
慨	kdx
铠	kdj
楷	kdm
恺	kdxj
揩	kdf
锴	kdjb
忾	kdxq
闿	kdmj
剀	kdud
垲	kdt
锎	kdjk
炌	kdh
蒈	kdc
看	kj
堪	kjt
砍	kju
刊	kjg
侃	kjr
坎	kjtq
勘	kjc
槛	kjm
阚	kjmw
瞰	kjo
龛	kjrl
戡	kjcg
崁	kjuq
莰	kjcq
衎	kjrg
磡	kjul
嵁	kjub
墈	kjtl
抗	kh
康	khg
扛	khf
亢	khw
炕	khh
慷	khx
糠	khm
伉	khr
钪	khj
闶	khmj
𡐓	kht
𩾌	khy
靠	kc
考	kcl
烤	kch
铐	kcj
拷	kcf
犒	kcn
尻	kcu
栲	kcm
㸆	kchf
洘	kcd
可	keD
刻	kew
客	keb
科	keh
课	key
颗	keg
咳	kek
渴	ked
柯	kem
棵	kemg
壳	ket
氪	keq
磕	keu
嗑	kekm
珂	kewk
苛	kec
轲	kei
瞌	keo
坷	ketk
恪	kex
蝌	keid
颏	kewy
窠	kebg
稞	kehg
溘	kedm
疴	kebk
岢	keuk
锞	kej
髁	kegg
骒	kemg
缂	kes
牁	kep
匼	kekk
炣	kehk
剋	kw
肯	kf
恳	kfg
啃	kfk
垦	kfgt
裉	kfp
坑	kg
吭	kgk
铿	kgj
硁	kgu
空	ks
恐	ksg
控	ksf
孔	ksz
崆	ksu
箜	ksv
倥	ksr
硿	ksug
埪	kst
口	kz
扣	kzf
寇	kzb
叩	kzk
抠	kzfq
蔻	kzc
芤	kzcv
筘	kzv
眍	kzo
𫸩	kzg
苦	ku
哭	kuk
酷	kuy
库	kug
裤	kup
枯	kum
骷	kugg
窟	kub
绔	kus
喾	kux
刳	kud
矻	kuu
圐	kukf
夸	kx
跨	kxz
垮	kxt
胯	kxo
挎	kxf
侉	kxr
姱	kxn
快	kk
块	kkt
筷	kkv
会	kkr
蒯	kkc
哙	kkk
侩	kkry
脍	kko
狯	kkq
郐	kkre
鲙	kky
浍	kkd
㧟	kkf
宽	kr
款	krt
髋	krg
况	kl
狂	klq
矿	klu
旷	klo
眶	klow
框	klm
匡	klk
筐	klv
哐	klkw
邝	klg
诳	kly
诓	klyw
圹	klt
纩	kls
贶	klb
夼	kld
洭	kldw
𫛭	klqn
亏	kv
愧	kvx
溃	kvd
盔	kvu
魁	kvg
窥	kvb
奎	kvdt
葵	kvc
傀	kvr
睽	kvo
馈	kvub
逵	kvz
馗	kvj
匮	kvk
喟	kvko
夔	kvbw
篑	kvv
岿	kvue
揆	kvf
聩	kve
跬	kvzt
愦	kvxb
悝	kvxl
蝰	kvi
暌	kvot
蒉	kvcb
櫆	kvm
骙	kvmt
喹	kvkt
煃	kvh
戣	kvbg
𫠆	kvvy
困	ky
昆	kyo
坤	kyt
捆	kyf
鲲	kyy
琨	kyw
锟	kyj
髡	kye
阃	kym
悃	kyx
堃	kyft
焜	kyh
壸	kyty
鹍	kyon
裈	kyp
醌	kyyb
婫	kyn
括	ko
扩	kof
阔	kom
廓	kog
蛞	koi
啦	la
拉	laf
辣	lax
垃	lat
腊	lao
喇	lak
蜡	lai
落	lac
剌	lau
邋	laz
旯	laoj
瘌	lab
砬	laul
镴	laj
蝲	laid
鞡	lag
𬶟	lay
来	ld
莱	ldc
赖	ldu
籁	ldv
睐	ldo
癞	ldb
濑	ldd
徕	ldr
崃	ldul
涞	lddl
赉	ldl
俫	ldrl
铼	ldj
梾	ldm
蓝	lj
烂	ljh
懒	ljx
拦	ljf
篮	ljv
岚	lju
兰	ljb
栏	ljm
览	ljl
澜	ljd
揽	ljfj
滥	ljdm
婪	ljmn
阑	ljmj
榄	ljmj
斓	ljw
缆	ljs
褴	ljp
谰	ljy
罱	ljsg
襕	ljpj
镧	ljj
漤	ljdn
𬒗	ljuj
狼	lh
浪	lhd
郎	lhl
朗	lhlo
廊	lhg
螂	lhi
琅	lhw
啷	lhk
榔	lhm
锒	lhj
阆	lhml
烺	lhh
蒗	lhc
莨	lhcl
稂	lhhl
崀	lhu
㫰	lho
㮾	lhlm
埌	lht
塱	lhlt
桹	lhml
筤	lhv
蓢	lhco
老	lc
劳	lcc
牢	lcb
姥	lcn
捞	lcf
唠	lck
佬	lcr
烙	lch
落	lcck
酪	lcy
涝	lcd
崂	lcu
嫪	lcnp
痨	lcbl
醪	lcyp
栳	lcm
铑	lcj
耢	lcl
荖	lccl
铹	lcjl
络	lcs
𫭼	lct
了	le
乐	lep
勒	leg
叻	lek
饹	leu
泐	led
鳓	ley
仂	ler
簕	lev
嘞	lekl
雷	lwy
泪	lwd
累	lwt
勒	lwg
嘞	lwk
蕾	lwc
磊	lwu
垒	lws
擂	lwf
肋	lwo
儡	lwr
镭	lwj
羸	lww
檑	lwm
耒	lwfr
诔	lwyl
嫘	lwn
酹	lwyc
缧	lwsx
礌	lwut
罍	lwtf
藟	lwct
癗	lwb
冷	lg
愣	lgx
楞	lgm
棱	lgmw
塄	lgt
崚	lgu
堎	lgtw
里	li
力	liv
理	liw
李	lim
立	liwb
离	liwn
利	lih
梨	lihm
丽	lia
历	lii
礼	lip
厉	liiw
例	lir
莉	lic
黎	lihu
璃	liwn
励	liil
哩	lik
狸	liq
粒	liml
隶	liy
吏	lig
栗	lix
漓	lid
雳	liyl
厘	liil
俐	lird
笠	livl
沥	lidl
篱	livn
戾	lihq
鲤	liyl
犁	lihn
砾	liu
荔	licl
砺	liuw
郦	lil
藜	licu
骊	limd
俪	lird
鹂	liln
蠡	lihi
栎	liml
唳	likq
喱	likl
罹	lis
痢	lib
莅	licl
俚	lirl
逦	liz
呖	likl
蛎	liiw
猁	liqd
澧	lidb
醴	liyb
娌	lin
蓠	licn
詈	lisk
黧	lihh
蜊	liid
鬲	lial
缡	lisn
傈	lirm
枥	liml
溧	lidm
坜	lit
疠	libw
粝	limw
嫠	liwn
锂	lij
篥	livm
轹	liil
鲡	liyd
疬	libl
苈	licl
浬	lidl
跞	lizl
浰	lidd
鳢	liyb
醨	liyn
凓	lidm
朸	liml
㰀	limu
珕	liwl
𫵷	liul
𬍛	liwl
俩	lx
连	lm
脸	lmo
联	lme
练	lms
恋	lmw
怜	lmx
炼	lmh
莲	lmc
链	lmj
帘	lmb
廉	lmg
敛	lmq
涟	lmd
镰	lmjj
琏	lmwi
濂	lmdj
潋	lmdw
殓	lmdq
奁	lmdq
裢	lmp
楝	lmm
裣	lmpq
鲢	lmy
梿	lmmi
蠊	lmi
蔹	lmcw
瑓	lmwj
浰	lmdd
𬶠	lmyj
两	ll
量	llo
亮	llw
良	lld
凉	lldx
梁	lldm
辆	lli
粮	llm
谅	lly
踉	llz
靓	llf
晾	llox
粱	lldm
魉	llg
椋	llmx
莨	llc
辌	llix
墚	llt
悢	llx
俍	llr
俩	llrl
𫟅	lls
𬜯	llcl
聊	ln
料	lnm
疗	lnb
辽	lnz
廖	lng
撩	lnf
寥	lnbp
僚	lnr
缭	lns
燎	lnh
撂	lnfk
獠	lnq
潦	lnd
镣	lnj
嘹	lnk
瞭	lno
寮	lnbx
蓼	lnc
尥	lny
鹩	lndn
嫽	lnn
髎	lngp
钌	lnjl
蹽	lnzx
漻	lndp
憭	lnx
簝	lnv
橑	lnmx
了	lnA
𪤗	lnt
列	lp
裂	lpd
猎	lpq
咧	lpk
烈	lpdh
劣	lpu
冽	lpdd
趔	lpt
洌	lpdd
鬣	lpe
捩	lpf
埒	lptc
躐	lpz
峛	lpud
脟	lpo
䴕	lpdn
𫚭	lpy
林	lb
临	lbl
琳	lbw
淋	lbd
邻	lbr
麟	lblf
凛	lbdu
拎	lbf
霖	lby
鳞	lbyf
吝	lbwk
躏	lbz
粼	lbm
磷	lbu
嶙	lbuf
蔺	lbc
赁	lbrb
懔	lbx
辚	lbi
遴	lbzf
廪	lbg
潾	lbdf
檩	lbmu
璘	lbwf
啉	lbk
瞵	lbo
膦	lbof
翷	lbmx
箖	lbv
𬭸	lbj
𬴊	lbmf
令	lk
灵	lke
领	lkr
另	lkk
凌	lkd
玲	lkw
零	lky
龄	lkv
铃	lkj
陵	lkew
岭	lku
菱	lkc
伶	lkrs
聆	lkes
翎	lkrx
绫	lks
〇	lkvv
羚	lkys
呤	lkks
苓	lkcs
泠	lkds
棂	lkm
瓴	lkrw
酃	lkye
囹	lkks
鲮	lkyw
蛉	lki
鸰	lkrn
柃	lkms
舲	lkvs
澪	lkds
昤	lko
祾	lkp
姈	lkn
棱	lkmw
㥄	lkx
坽	lkt
刘	lqwd
留	lqp
六	lqwb
柳	lqm
溜	lqd
琉	lqwi
榴	lqmt
浏	lqdd
瘤	lqb
硫	lqu
遛	lqz
陆	lqe
绺	lqs
鎏	lqdj
馏	lqut
骝	lqmt
镏	lqj
旒	lqf
镠	lqjp
锍	lqji
熘	lqh
鹨	lqx
飗	lqft
瑬	lqdy
珋	lqwe
罶	lqst
鹠	lqpn
疁	lqt
碌	lquu
咯	lo
龙	ls
隆	lse
笼	lsv
拢	lsf
胧	lso
珑	lsw
咙	lsk
聋	lsl
垄	lslt
窿	lsb
陇	lsel
泷	lsd
茏	lsc
眬	lsol
栊	lsm
砻	lslu
哢	lskc
昽	lsol
癃	lsbu
漋	lsdu
弄	lswc
𬕂	lsvb
楼	lz
搂	lzf
漏	lzd
髅	lzg
露	lzy
陋	lze
喽	lzk
娄	lzm
篓	lzv
镂	lzj
偻	lzr
蝼	lzi
耧	lzl
蒌	lzc
瘘	lzb
嵝	lzu
溇	lzdn
䁖	lzo
剅	lzdd
𦝼	lzon
𪣻	lzt
路	lu
露	luy
陆	lue
鲁	luyo
录	lueu
撸	luf
卢	lub
鹿	lug
炉	luh
碌	luu
芦	luc
禄	lup
虏	luhl
璐	luw
噜	luk
戮	lux
颅	luby
庐	lugh
漉	lud
掳	lufl
辘	lui
赂	lubk
麓	lum
卤	lubx
鹭	luz
泸	ludu
潞	ludk
橹	lumo
辂	luik
箓	luv
胪	luo
鲈	luyu
轳	luiu
垆	lut
渌	ludu
逯	luzu
鸬	lubn
甪	lupy
蕗	luck
舻	luvu
栌	lumu
簏	luvl
菉	lucu
氇	lumo
僇	lur
琭	luwu
镥	luj
勠	luxl
稑	luht
绿	lus
澛	ludo
𫘧	lumu
𬬻	luju
乱	lr
卵	lrp
鸾	lrw
峦	lrwu
挛	lrwu
銮	lrwj
孪	lrwz
栾	lrwm
滦	lrd
脔	lrwr
娈	lrwn
论	ly
伦	lyr
轮	lyi
仑	lyrb
沦	lyd
抡	lyf
纶	lys
囵	lyk
𫭢	lyt
𬬭	lyj
落	loc
罗	los
洛	lod
络	losk
裸	lop
逻	loz
骆	lom
萝	locx
螺	loi
锣	loj
啰	lok
珞	low
骡	lomx
摞	lof
雒	lowv
荦	locn
箩	lov
椤	lomx
烙	loh
猡	loq
蠃	lowi
脶	loo
漯	lodx
倮	lor
捋	lofc
瘰	lob
泺	lodl
蓏	locg
绿	lv
律	lvr
率	lvw
旅	lvf
吕	lvk
缕	lvs
侣	lvrk
驴	lvm
屡	lvu
履	lvuw
捋	lvfc
滤	lvd
虑	lvh
褛	lvp
铝	lvj
闾	lvmk
榈	lvmk
氯	lvq
膂	lvfo
稆	lvhk
葎	lvc
垏	lvt
偻	lvrn
梠	lvmk
𦝼	lvo
略	lt
掠	ltf
锊	ltj
䂮	ltfu
圙	ltk
吗	ma
马	mav
妈	man
麻	mag
嘛	mak
骂	makm
码	mau
玛	maw
抹	maf
蚂	mai
蟆	maid
犸	maq
杩	mam
祃	map
摩	magu
买	md
卖	mdu
埋	mdt
脉	mdo
麦	mdf
迈	mdz
霾	mdy
劢	mdw
唛	mdk
荬	mdc
鿏	mdj
满	mj
慢	mjx
漫	mjd
曼	mjo
蛮	mjw
瞒	mjol
蔓	mjc
馒	mju
幔	mjj
谩	mjy
鳗	mjyy
缦	mjs
嫚	mjn
墁	mjt
颟	mjcy
螨	mji
鞔	mjg
镘	mjjy
鬘	mje
埋	mjtl
𬜬	mjck
忙	mh
芒	mhc
茫	mhcw
氓	mhw
莽	mhcc
盲	mhwo
蟒	mhi
邙	mhwe
漭	mhd
牤	mhn
硭	mhu
尨	mhl
牻	mhnp
厖	mhip
杧	mhm
毛	mc
冒	mco
貌	mcv
猫	mcq
矛	mcy
帽	mcj
贸	mcp
茂	mcc
茅	mccm
冇	mcu
髦	mce
卯	mcpe
锚	mcjt
袤	mcym
瑁	mcw
懋	mcm
牦	mcn
铆	mcje
昴	mcoe
耄	mcl
蟊	mcmi
峁	mcue
旄	mcf
楙	mcmm
泖	mcd
瞀	mcmo
茆	mcce
蝥	mcmi
芼	mccm
眊	mcom
鄚	mcce
么	me
没	mw
美	mwy
每	mwp
妹	mwn
眉	mwu
梅	mwm
媚	mwno
魅	mwg
玫	mww
枚	mwmw
媒	mwnm
霉	mwym
昧	mwo
煤	mwh
寐	mwb
嵋	mwuo
莓	mwc
湄	mwd
袂	mwpg
楣	mwmo
酶	mwym
镁	mwj
郿	mwue
浼	mwde
鹛	mwun
镅	mwjo
渼	mwdd
糜	mwgm
媄	mwnd
瑂	mwwo
们	mf
门	mfd
闷	mfm
懑	mfdx
扪	mff
焖	mfh
钔	mfj
呇	mfu
𫞩	mfw
梦	mg
猛	mgq
蒙	mgc
孟	mgz
盟	mgo
朦	mgou
萌	mgco
懵	mgx
檬	mgm
蜢	mgi
勐	mgzl
虻	mgiw
艨	mgv
锰	mgj
幪	mgju
艋	mgvm
蠓	mgiu
瞢	mgco
甍	mgcw
獴	mgqu
礞	mgu
㠓	mguu
鹲	mgcn
𫑡	mgk
密	mi
米	mib
迷	miz
秘	mih
弥	mig
蜜	mibi
眯	mio
咪	mik
谜	miy
觅	miv
靡	migf
泌	mid
糜	migm
谧	miym
宓	mibb
祢	mip
芈	mic
麋	mil
弭	mige
汨	mido
猕	miq
幂	mibj
縻	migx
蘼	micf
醚	miym
祕	mipb
敉	mim
嘧	miku
蓂	micl
脒	miom
洣	midm
醾	miym
面	mm
免	mmd
勉	mmdl
绵	mms
眠	mmo
棉	mmm
缅	mmsm
冕	mmoe
腼	mmom
娩	mmn
湎	mmdm
沔	mmdg
渑	mmdd
眄	mmog
丏	mmg
勔	mmml
愐	mmx
偭	mmr
𩾃	mmy
妙	mnn
描	mnf
苗	mnc
庙	mng
渺	mnd
瞄	mno
淼	mnu
喵	mnk
缈	mns
藐	mnce
邈	mnz
眇	mnou
杪	mnm
鹋	mncn
缪	mnsp
灭	mp
蔑	mpc
乜	mpv
咩	mpk
篾	mpvd
民	mb
敏	mbp
抿	mbf
悯	mbx
闵	mbm
珉	mbw
泯	mbd
闽	mbmi
皿	mbk
岷	mbu
旻	mbo
缗	mbs
愍	mbmx
湣	mbdo
黾	mbkd
忞	mbwx
鳘	mbpy
苠	mbc
明	mko
命	mkr
鸣	mkk
冥	mkb
铭	mkj
茗	mkc
瞑	mkol
溟	mkd
酩	mky
暝	mkol
螟	mki
洺	mkdk
谬	mq
缪	mqs
魔	mog
莫	moc
默	mol
模	mom
摸	mof
摩	mogu
磨	mogu
漠	mod
抹	mofw
墨	molt
没	modu
麽	mogm
陌	moe
寞	mob
蓦	mocm
沫	modw
膜	moo
茉	mocw
嬷	mon
蘑	mocu
摹	mocu
馍	mou
谟	moy
嫫	mond
秣	moh
殁	modu
貊	mov
靺	mogw
貘	movd
镆	moj
瘼	mobd
耱	molu
万	moa
无	moay
脉	mooy
藦	mocu
𬙊	mos
某	mz
谋	mzy
眸	mzo
缪	mzs
牟	mzsn
哞	mzk
鍪	mzm
侔	mzr
蛑	mzi
目	mu
母	mum
木	muu
模	mumd
慕	muc
幕	mucj
姆	mun
穆	muh
牧	munw
墓	muct
沐	mud
暮	muco
拇	muf
牡	munt
亩	muw
募	mucl
睦	muo
苜	muco
呒	muk
钼	muj
毪	mumn
仫	mur
牟	mus
𧿹	muz
𬭁	mujm
那	na
哪	nak
拿	nar
娜	nan
纳	nas
呐	nakn
捺	naf
衲	nap
钠	naj
肭	nao
镎	naju
乸	nay
南	nau
𦰡	nac
奶	nd
奈	ndd
耐	nde
乃	ndv
鼐	ndn
氖	ndq
萘	ndc
艿	ndcn
柰	ndm
佴	ndr
迺	ndz
耏	ndep
难	nj
男	njt
南	nju
喃	njk
楠	njm
囡	njkn
赧	nji
腩	njo
蝻	njig
萳	njc
婻	njn
囊	nh
囔	nhk
馕	nhu
攮	nhf
曩	nho
齉	nhz
脑	nco
恼	ncx
挠	ncf
瑙	ncw
孬	ncb
呶	nck
淖	ncd
猱	ncq
铙	ncj
垴	nct
蛲	nci
硇	ncu
臑	ncoe
峱	ncqu
呢	ne
讷	ney
哪	nek
内	nw
馁	nwu
嫩	nf
恁	nfr
能	ng
你	ni
尼	niu
妮	nin
泥	nid
逆	niz
拟	nif
腻	nio
倪	nir
霓	niy
匿	nik
溺	nidg
昵	niob
睨	nioe
旎	nifb
怩	nix
猊	niq
鲵	niye
伲	nirb
坭	nit
铌	nij
麑	nil
薿	nic
呢	nikb
𨺙	nie
𫐐	nii
𫠜	niv
年	nm
念	nmr
黏	nmh
拈	nmf
捻	nmfx
碾	nmu
撵	nmfi
蔫	nmc
廿	nmca
辇	nmfi
鲇	nmy
鲶	nmyx
埝	nmt
粘	nmm
娘	nl
酿	nly
鸟	nn
尿	nnu
袅	nnn
茑	nnc
脲	nno
捏	np
聂	npe
孽	npc
涅	npd
蹑	npz
嗫	npk
啮	npkr
臬	npzm
镊	npj
镍	npjm
蘖	npcm
颞	npey
糵	npcm
陧	npet
乜	npv
嵲	npu
菍	npcx
𫔶	npm
您	nb
宁	nk
凝	nkd
狞	nkq
拧	nkf
柠	nkm
咛	nkk
泞	nkdd
佞	nkr
甯	nkb
苧	nkc
聍	nke
牛	nq
扭	nqf
纽	nqs
妞	nqn
钮	nqj
拗	nqfl
忸	nqx
狃	nqq
杻	nqm
弄	ns
农	nsb
浓	nsd
哝	nsk
侬	nsr
脓	nso
秾	nsh
𬪩	nsy
耨	nz
怒	nu
努	nun
奴	nuny
弩	nung
驽	nunm
孥	nunz
傉	nur
胬	nunr
砮	nunu
笯	nuv
暖	nr
诺	no
挪	nof
懦	nox
喏	nok
糯	nom
娜	non
傩	nor
搦	nofg
锘	noj
𦰡	noc
女	nv
钕	nvj
恧	nve
衄	nvp
虐	nt
疟	ntb
哦	ooK
噢	ook
欧	ou
偶	our
呕	ouk
殴	ouq
鸥	ouqn
藕	ouc
区	oukx
怄	oux
瓯	ouqw
讴	ouy
沤	oud
耦	oul
𠙶	oukl
𬉼	ouh
怕	pa
爬	pav
帕	paj
啪	pak
趴	paz
扒	paf
琶	paw
耙	pal
葩	pac
杷	pam
筢	pavb
舥	pavb
潖	pad
派	pd
排	pdf
拍	pdfb
牌	pdp
徘	pdr
湃	pdd
俳	pdrf
哌	pdk
簰	pdv
蒎	pdc
迫	pdz
盘	pj
判	pjb
叛	pjby
盼	pjo
潘	pjd
攀	pjm
畔	pjt
蹒	pjz
磐	pjv
蟠	pji
槃	pjvm
爿	pjvl
泮	pjdb
袢	pjp
磻	pju
襻	pjpu
番	pjc
胖	pjob
旁	ph
胖	pho
庞	phg
彷	phr
乓	phq
螃	phi
滂	phd
逄	phz
雱	phy
磅	phu
耪	phl
鳑	phyf
膀	phof
跑	pc
炮	pch
泡	pcd
抛	pcf
袍	pcp
咆	pck
刨	pcb
庖	pcg
狍	pcq
疱	pcbb
匏	pcdb
脬	pco
配	pwY
佩	pwr
培	pwt
赔	pwb
裴	pwf
沛	pwd
呸	pwk
胚	pwo
帔	pwj
辔	pws
霈	pwy
旆	pwfu
醅	pwyk
锫	pwjk
衃	pwp
喷	pf
盆	pff
湓	pfd
碰	pg
朋	pgo
鹏	pgon
捧	pgf
砰	pgu
蓬	pgc
篷	pgv
彭	pgt
棚	pgm
膨	pgop
澎	pgd
怦	pgx
嘭	pgk
烹	pgw
抨	pgfp
芃	pgcf
硼	pguo
蟛	pgi
堋	pgto
椪	pgmy
弸	pgg
淜	pgdo
搒	pgff
皮	pip
屁	piu
疲	pib
匹	pik
劈	piud
披	pif
脾	pio
啤	piku
辟	piux
僻	pir
霹	piy
痞	pibk
譬	piuk
噼	pikx
琵	piw
癖	pibx
媲	pin
丕	piba
毗	pit
坯	pitp
纰	pis
裨	pipu
睥	piou
邳	pibe
砒	piub
陂	pie
貔	piv
枇	pim
罴	pish
圮	pitj
鼙	pitu
蚍	pii
铍	pij
郫	pipe
仳	pirb
伾	pirp
蜱	piiu
埤	pitu
嚭	pitk
陴	pieu
淠	pid
甓	piuw
狉	piq
澼	pidx
椑	pimu
否	pibk
鲏	piyp
䴙	piun
苉	pic
𬳵	pimp
片	pm
偏	pmr
骗	pmm
篇	pmv
翩	pmh
便	pmrg
骈	pmmk
蹁	pmz
谝	pmy
胼	pmo
犏	pmn
楩	pmmg
扁	pmhc
㛹	pmng
𡎚	pmt
飘	pn
漂	pnd
票	pnx
瞟	pno
嫖	pnn
瓢	pnxg
缥	pns
剽	pnxd
骠	pnm
朴	pnmb
殍	pndz
嘌	pnk
螵	pni
蔈	pnc
薸	pncu
撇	pp
瞥	ppx
苤	ppc
氕	ppq
𬭯	ppj
品	pb
拼	pbf
贫	pbfb
频	pbv
聘	pbe
嫔	pbn
颦	pbvu
姘	pbnk
牝	pbnb
玭	pbw
𬞟	pbc
平	pk
凭	pkr
评	pky
瓶	pkb
屏	pku
萍	pkc
苹	pkcp
坪	pkt
乒	pkq
娉	pkn
枰	pkm
鲆	pkyp
俜	pkrk
泙	pkd
洴	pkdk
帡	pkj
荓	pkck
冯	pkdm
蚲	pki
涄	pkdk
玶	pkw
破	po
婆	pod
迫	poz
颇	pop
坡	pot
魄	pob
泼	pody
泊	podb
珀	pow
叵	pok
鄱	poc
粕	pom
笸	pov
皤	pobt
钋	poj
钷	pojk
桲	pomz
朴	pomb
繁	popx
陂	poe
䥽	pojy
酦	poy
剖	pz
抔	pzf
裒	pzy
掊	pzfk
普	pu
扑	puf
铺	puj
朴	pum
仆	pur
谱	puy
葡	puc
菩	puck
噗	puk
浦	pud
瀑	pudu
蒲	pucf
埔	put
濮	pudf
璞	puw
圃	pukf
溥	pudc
匍	pub
莆	pucf
堡	purt
脯	puo
蹼	puz
曝	puou
氆	pumo
潽	pudo
酺	puyf
镨	pujo
镤	pujf
蒱	pucf
墣	putf
穙	puh
起	qit
气	qip
奇	qid
期	qic
七	qia
器	qik
骑	qim
齐	qiw
弃	qiwc
妻	qiu
企	qir
启	qih
旗	qif
欺	qicq
岂	qiuj
汽	qidq
棋	qimb
琪	qiwb
泣	qidl
凄	qidn
漆	qidu
戚	qiwx
契	qifd
乞	qipv
祈	qipj
麒	qil
歧	qiv
琦	qiwk
祁	qipe
绮	qis
栖	qimx
炁	qiwh
淇	qidb
崎	qiuk
砌	qiud
蹊	qiz
祺	qipb
迄	qizv
杞	qimj
岐	qiuv
脐	qio
颀	qij
沏	qidd
跂	qizv
憩	qiux
萋	qicn
嘁	qikx
耆	qilo
芑	qicj
蜞	qii
讫	qiy
祇	qipu
鳍	qiyo
亓	qiaw
葺	qice
柒	qidm
綦	qicx
蕲	qicj
畦	qitt
芪	qicu
圻	qitj
萁	qicb
骐	qimb
欹	qidq
碛	qiub
汔	qidv
锜	qijk
槭	qimx
蛴	qiiq
屺	qiuj
亟	qila
玘	qiwj
桤	qimj
埼	qitk
棨	qihm
郪	qiue
磜	qiuu
鲯	qiyb
愭	qix
碶	qiud
俟	qiru
婍	qin
洓	qidu
稽	qiho
缉	qise
荠	qicq
䓫	qick
𨙸	qive
𬨂	qiiu
卡	qxu
掐	qxf
洽	qxd
拤	qxfb
葜	qxc
袷	qxp
髂	qxg
前	qm
钱	qmj
千	qmp
潜	qmd
牵	qmdn
倩	qmr
浅	qmdj
签	qmv
歉	qmjq
欠	qmdr
乾	qmu
谦	qmy
迁	qmz
遣	qmzl
茜	qmc
芊	qmcq
嵌	qmuq
虔	qmh
铅	qmjk
谴	qmyl
钳	qmjg
黔	qml
堑	qmi
骞	qmb
佥	qmra
仟	qmrq
缱	qms
纤	qmsq
阡	qme
钎	qmjq
钤	qmjv
掮	qmf
芡	qmcq
荨	qmcc
扦	qmfq
愆	qmrx
悭	qmx
搴	qmbu
慊	qmxj
褰	qmby
汧	qmdk
肷	qmo
蒨	qmco
靬	qmg
椠	qmim
杄	qmm
鹐	qmdn
岍	qmuk
圲	qmt
犍	qmn
伣	qmrj
墘	qmtv
磏	qmuj
𬘬	qmso
强	ql
枪	qlm
墙	qlt
抢	qlf
腔	qlo
呛	qlk
跄	qlz
蔷	qlc
锵	qlj
羌	qly
戕	qlp
戗	qlr
襁	qlpi
嫱	qln
樯	qlmk
镪	qlji
炝	qlh
羟	qlyj
蜣	qli
玱	qlw
锖	qljo
蔃	qlci
巧	qng
悄	qnx
瞧	qno
桥	qnm
乔	qny
俏	qnr
翘	qnyx
窍	qnb
鞘	qngo
憔	qnxh
峭	qnu
跷	qnz
侨	qnrl
樵	qnmh
撬	qnf
锹	qnj
壳	qnt
谯	qnyh
橇	qnmm
诮	qnyo
荞	qnc
峤	qnul
愀	qnxh
劁	qnrd
硗	qnuw
鞒	qngl
硚	qnul
缲	qns
雀	qnxv
且	qp
切	qpq
窃	qpb
怯	qpx
妾	qpl
茄	qpc
惬	qpxj
趄	qpt
锲	qpj
伽	qpr
挈	qpf
箧	qpv
慊	qpxj
郄	qpxe
亲	qb
秦	qbi
琴	qbw
侵	qbr
勤	qbc
寝	qbb
擒	qbf
钦	qbj
芹	qbcj
沁	qbd
禽	qbrn
覃	qbx
噙	qbk
衾	qbry
揿	qbfq
芩	qbcv
溱	qbdh
吣	qbkx
嗪	qbkh
锓	qbjy
檎	qbm
骎	qbmy
慬	qbxw
嵚	qbu
梣	qbmv
请	qk
轻	qki
清	qkd
青	qkf
情	qkx
庆	qkg
晴	qko
倾	qkr
卿	qkp
擎	qkc
顷	qkb
蜻	qkio
箐	qkv
氢	qkq
罄	qkt
磬	qktu
亲	qkl
綮	qkh
氰	qkqo
黥	qklx
檠	qkcm
鲭	qky
苘	qkck
圊	qkk
碃	qku
庼	qkgy
勍	qkw
倩	qkro
穷	qs
琼	qsw
穹	qsb
茕	qsc
邛	qsg
筇	qsv
蛩	qsgi
銎	qsgj
䓖	qscl
求	qq
球	qqw
秋	qqh
丘	qqj
邱	qqq
囚	qqk
裘	qqqy
酋	qqb
仇	qqr
虬	qqi
糗	qqm
鳅	qqy
蚯	qqiq
俅	qqrq
泅	qqd
遒	qqz
逑	qqzq
湫	qqdh
楸	qqmh
犰	qqqj
萩	qqc
蝤	qqiy
璆	qqwp
巯	qqji
赇	qqbq
鹙	qqhn
鞧	qqg
鼽	qqzj
訄	qqjk
龟	qqdd
𨱇	qqjq
去	quT
取	que
趣	qut
曲	quk
屈	quu
躯	quuq
驱	qum
娶	quen
趋	qute
渠	qud
觑	quh
瞿	quo
岖	quuq
蛐	qui
蛆	quiq
衢	qur
祛	qup
黢	qul
癯	qub
苣	quc
阒	qumq
龋	quv
蕖	qucm
蘧	qucu
朐	quoj
璩	quw
劬	quj
磲	quum
诎	quy
蠼	quiy
焌	quhw
袪	qupq
氍	quom
鸲	qujn
麹	quf
胠	quoq
灈	qudv
鼩	qujj
竘	qulj
岨	quuq
戌	quwa
㭕	qumq
䓛	quci
坥	qutq
𪨰	quuq
𫭟	qutq
全	qr
权	qrm
拳	qrj
圈	qrk
劝	qry
泉	qrb
犬	qrd
券	qrjd
蜷	qri
痊	qrbw
诠	qryw
荃	qrc
颧	qrcy
绻	qrs
铨	qrjw
筌	qrv
鬈	qre
醛	qryw
悛	qrx
佺	qrr
畎	qrt
棬	qrmv
鳈	qryu
辁	qriw
婘	qrn
瑔	qrw
𨟠	qro
却	qt
确	qtu
缺	qtf
雀	qtx
瘸	qtb
鹊	qtc
阙	qtm
阕	qtmt
榷	qtmv
炔	qth
悫	qtt
碏	qtuo
埆	qtty
𬒈	qtxu
群	qy
裙	qyp
逡	qyz
麇	qyl
囷	qyk
然	rj
染	rjd
燃	rjh
冉	rjk
髯	rje
苒	rjc
蚺	rji
䎃	rjr
让	rh
嚷	rhk
壤	rht
攘	rhf
瓤	rhx
禳	rhp
穰	rhh
瀼	rhd
蘘	rhc
儴	rhr
绕	rc
扰	rcf
饶	rcu
娆	rcn
桡	rcm
荛	rcc
热	re
惹	rec
人	rfP
认	rfy
忍	rfr
仁	rfre
刃	rfd
韧	rfw
壬	rfp
饪	rfu
仞	rfrr
纫	rfs
稔	rfh
荏	rfc
妊	rfn
衽	rfpt
轫	rfi
纴	rfst
讱	rfyr
葚	rfcb
仍	rg
扔	rgf
日	ri
驲	rim
容	rs
荣	rsc
融	rsg
蓉	rscg
绒	rss
溶	rsd
戎	rsgu
榕	rsm
茸	rsce
熔	rsh
冗	rsb
嵘	rsu
镕	rsj
蝾	rsi
狨	rsq
瑢	rsw
肉	rz
柔	rzm
揉	rzf
蹂	rzz
糅	rzmm
鞣	rzg
𫐓	rzi
如	ru
入	rup
辱	rui
乳	ruv
儒	rur
茹	ruc
汝	rud
蠕	ruie
孺	ruz
褥	rupc
嚅	ruk
濡	rude
缛	rus
襦	rupe
溽	rudc
蓐	rucc
洳	rudk
薷	ruce
颥	ruy
嬬	run
铷	ruj
软	rr
阮	rre
堧	rrt
瓀	rrw
媆	rrn
瑞	rv
锐	rvj
蕊	rvc
睿	rvb
芮	rvcn
蚋	rvi
蕤	rvcu
枘	rvm
汭	rvd
润	ry
闰	rym
若	ro
弱	rog
偌	ror
箬	rov
婼	ron
爇	roc
蒻	rocg
鄀	roce
飒	sal
仨	sar
萨	sac
卅	saa
靸	sag
挲	sad
潵	sadw
脎	sao
赛	sd
塞	sdb
腮	sdo
噻	sdk
鳃	sdy
三	sj
散	sjc
伞	sjr
叁	sjs
馓	sju
毵	sjsm
糁	sjm
丧	sh
桑	shy
嗓	shk
搡	shf
颡	shyy
磉	shu
扫	sc
骚	scm
嫂	scn
搔	scf
臊	sco
瘙	scb
缫	scs
埽	sct
溞	scd
色	se
瑟	sew
涩	sed
塞	seb
啬	set
穑	seh
铯	sej
璱	sewb
森	sf
僧	sg
啥	ua
傻	uar
杀	uax
刹	uaxd
莎	uac
煞	uad
纱	uas
沙	uadu
厦	uai
霎	uay
砂	uau
鲨	uady
裟	uady
铩	uaj
嗄	uak
歃	uaq
痧	uab
唼	uakn
挲	uadu
杉	uam
晒	ud
筛	udv
色	udd
山	ujk
闪	ujm
善	ujy
扇	ujh
衫	ujp
珊	ujw
擅	ujf
姗	ujn
讪	ujyu
杉	ujmp
陕	uje
煽	ujhx
膳	ujo
跚	ujz
潸	ujd
缮	ujs
汕	ujdu
禅	ujpu
膻	ujod
赡	ujb
鳝	ujyk
舢	ujv
苫	ujc
嬗	ujnd
鄯	ujye
骟	ujmx
蟮	uji
墡	ujt
剡	ujhd
疝	ujbu
芟	ujcu
埏	ujtv
钐	ujj
嶦	uju
晱	ujoh
单	ujbu
栅	ujmc
烻	ujhv
𫮃	ujtu
上	uh
伤	uhr
商	uhw
尚	uhx
赏	uhxb
晌	uho
裳	uhxy
殇	uhd
觞	uhdp
熵	uhh
墒	uht
绱	uhs
垧	uhtk
少	uc
烧	uch
稍	ucho
绍	ucs
哨	uck
邵	ucd
勺	ucb
梢	ucm
韶	ucl
劭	ucdl
捎	ucf
芍	ucc
苕	ucck
艄	ucv
筲	ucvo
潲	ucdo
蛸	uci
睄	uco
召	ucdk
鞘	ucg
柖	ucmk
玿	ucw
射	ueu
舍	uer
蛇	uei
舌	ueq
涉	ued
摄	uef
社	uep
奢	uedo
慑	uex
赦	ueiw
折	uefj
佘	ueru
麝	uel
赊	ueb
畲	uert
猞	ueqg
歙	uerq
阇	uem
滠	uedy
厍	ueii
拾	uefk
𪨶	ueui
神	ufp
身	ufz
甚	ufc
什	ufr
伸	ufru
沈	ufd
审	ufb
申	uft
慎	ufx
呻	ufk
渗	ufdp
婶	ufn
绅	ufs
肾	ufl
参	ufsp
莘	ufcx
珅	ufw
蜃	ufi
哂	ufkx
谌	ufy
娠	ufni
燊	ufh
瘆	ufbp
椹	ufm
葚	ufcb
砷	ufu
糁	ufmp
棽	ufmv
诜	ufye
甡	ufuu
谂	ufyx
矧	uful
胂	ufo
侁	ufre
瞫	ufou
鲹	ufyp
屾	ufuu
𬬹	ufj
𬳽	ufme
生	ug
声	ugt
圣	ugy
胜	ugo
升	ugp
省	ugu
剩	ugq
盛	ugi
绳	ugs
牲	ugn
笙	ugv
晟	ugoi
甥	ugul
昇	ugoc
乘	ugqr
嵊	ugur
眚	uguo
陞	uge
是	uiO
时	uioc
事	uig
实	uib
十	uia
师	uil
屎	uiu
世	uic
始	uin
失	uip
士	uiua
湿	uid
石	uiak
识	uiy
视	uipj
势	uif
市	uiw
室	uibt
式	uiyg
示	uie
试	uiyg
史	uik
食	uir
施	uify
适	uiz
释	uicf
诗	uiyc
尸	uiv
氏	uipv
侍	uirc
拾	uifk
饰	uiuj
誓	uifk
驶	uim
逝	uizj
狮	uiq
匙	uiob
噬	uikr
仕	uirt
矢	uipd
拭	uifg
嗜	uiko
似	uirr
蚀	uiui
恃	uix
柿	uimj
弑	uixg
轼	uii
虱	uivi
谥	uiym
舐	uiuu
媞	uinz
什	uiru
豕	uiau
莳	uicc
筮	uivr
蓍	uico
螫	uiii
炻	uih
鲥	uiyc
奭	uidb
湜	uidz
埘	uit
酾	uiyd
祏	uipu
栻	uimg
贳	uiub
铈	uij
鲺	uiyi
鼫	uiju
邿	uite
鸤	uiun
嘘	uiky
峙	uiuc
殖	uidq
浉	uidj
襫	uipb
䏡	uiou
䴓	uibn
𫚕	uiyj
𬤊	uiyz
手	uz
受	uzv
收	uzj
首	uzb
守	uzbc
熟	uzw
兽	uzbk
授	uzf
瘦	uzby
售	uzr
寿	uzfc
狩	uzq
绶	uzs
艏	uzvz
书	uu
数	uum
术	uumd
树	uumc
属	uuu
熟	uuw
叔	uuuy
束	uug
舒	uur
输	uui
述	uuz
殊	uud
鼠	uuj
疏	uuv
淑	uudy
竖	uul
署	uus
墅	uult
梳	uumi
蜀	uusi
恕	uun
倏	uurq
暑	uuo
庶	uugh
漱	uudq
赎	uub
姝	uunw
枢	uumq
蔬	uuc
薯	uuco
曙	uuoo
抒	uuf
孰	uuww
戍	uuwd
塾	uuwt
纾	uusy
澍	uudc
黍	uuh
沭	uudu
秫	uuhu
殳	uujy
菽	uucy
腧	uuod
毹	uurm
摅	uufx
婌	uuny
鄃	uure
隃	uue
陎	uuew
𬬸	uuju
刷	ux
耍	uxe
唰	uxk
帅	uk
摔	ukf
甩	uky
衰	ukyv
率	ukw
蟀	uki
栓	ur
拴	urf
涮	urd
闩	urm
腨	uro
双	ul
爽	uld
霜	uly
孀	uln
鹴	ulyn
骦	ulm
礵	ulu
泷	uldl
漴	uldu
水	uv
谁	uvy
睡	uvo
税	uvh
帨	uvj
说	uvyx
顺	uy
瞬	uyo
吮	uyk
舜	uyv
楯	uym
说	uo
烁	uoh
硕	uou
朔	uon
铄	uoj
槊	uonm
搠	uof
妁	uonu
蒴	uoc
数	uom
死	sid
思	sit
似	sir
斯	sic
司	siv
丝	sis
私	sih
寺	sitc
撕	sif
肆	sie
嘶	sik
厮	sii
伺	sirk
祀	sip
嗣	sikk
饲	siu
俟	siru
巳	sikv
泗	sids
咝	siks
姒	sin
汜	sids
驷	sim
鸶	sisn
兕	sia
涘	sidu
缌	sisx
蛳	siij
澌	sidj
锶	sij
笥	sivk
耜	sil
飔	sifx
凘	sidj
虒	siij
㟃	siuk
楒	simx
送	ss
松	ssm
宋	ssb
耸	ssr
诵	ssy
怂	ssrx
𪨊	ssu
颂	ssg
嵩	ssuk
悚	ssx
讼	ssyg
忪	ssxg
淞	ssd
崧	ssug
竦	ssl
凇	ssdg
菘	ssc
娀	ssn
㧐	ssf
搜	sz
艘	szv
嗽	szk
嗖	szky
叟	szj
飕	szf
擞	szfw
馊	szu
薮	szc
廋	szg
溲	szd
嗾	szku
锼	szjy
瞍	szo
蒐	szcg
螋	szi
诉	su
速	suz
苏	suc
素	suf
宿	sub
俗	sur
肃	suy
塑	sun
酥	suyh
簌	suv
粟	sux
稣	suyh
溯	sud
愫	suxx
夙	suj
谡	suyw
窣	subu
蔌	sucq
涑	sudu
嗉	suk
僳	surm
觫	sudu
骕	sum
甦	sug
鹔	suyn
傃	surx
蹜	suzb
缩	sus
𫗧	suu
算	srV
蒜	src
狻	srq
虽	sv
随	sve
岁	svu
碎	svuu
遂	svz
隋	sveo
髓	svg
祟	svi
穗	svh
邃	svzu
隧	sveu
绥	svs
燧	svhu
尿	svuu
睢	svo
眭	svot
荽	svc
谇	svy
濉	svd
穟	svhu
璲	svw
襚	svp
旞	svf
𫟦	sviu
𬭼	svj
孙	sy
损	syf
笋	syv
隼	syr
荪	syc
狲	syq
榫	sym
飧	syx
所	so
索	sou
缩	sos
锁	soj
嗦	sok
梭	som
琐	sow
唆	sokw
娑	sod
蓑	soc
桫	somu
唢	sokb
睃	soo
嗍	soko
挲	sodu
葰	socw
羧	soy
溹	sodx
莎	socu
他	taR
塔	tat
踏	taz
拓	taf
塌	tatx
榻	tam
蹋	tazx
沓	tau
遢	tazx
挞	tafd
趿	tazj
獭	taq
祂	tap
闼	tamd
鳎	tay
铊	taj
溻	tad
阘	tamx
褟	tapx
鞳	tag
鿎	taud
太	td
台	tds
态	tdt
抬	tdf
泰	tdi
胎	tdo
汰	tdd
苔	tdc
跆	tdz
钛	tdj
邰	tdse
薹	tdct
肽	tdot
炱	tdsh
骀	tdm
酞	tdy
鲐	tdyk
谈	tj
叹	tjk
弹	tjg
探	tjf
坦	tjt
贪	tjr
坛	tjty
摊	tjfv
滩	tjd
谭	tjy
潭	tjdu
瘫	tjb
毯	tjm
炭	tju
忐	tjux
檀	tjmd
痰	tjbh
碳	tjuh
袒	tjp
昙	tjo
坍	tjtd
覃	tjx
郯	tjh
镡	tjj
倓	tjrh
锬	tjjh
钽	tjjd
璮	tjw
惔	tjxh
菼	tjc
澹	tjdk
榃	tjmt
磹	tjuu
汤	thd
糖	thm
趟	tht
烫	thdh
堂	thx
唐	thg
膛	tho
倘	thr
淌	thdk
棠	thxm
塘	thtk
搪	thf
螳	thi
傥	thrx
瑭	thw
镗	thj
帑	thn
樘	thmt
蹚	thz
嘡	thk
溏	thdk
螗	thik
羰	thy
镋	thjx
耥	thl
埫	thtk
铴	thjp
䣘	thxe
鄌	thge
逃	tcz
讨	tcy
桃	tcm
涛	tcd
掏	tcf
陶	tce
滔	tcdj
萄	tcc
淘	tcdf
韬	tcw
焘	tcfh
啕	tck
饕	tckg
绦	tcs
叨	tckd
洮	tcdv
梼	tcmc
绹	tcsf
弢	tcg
鼗	tcv
慆	tcx
𫘦	tcmf
特	te
忑	tex
慝	tek
铽	tej
忒	tey
忒	tw
疼	tg
腾	tgo
藤	tgc
滕	tgou
誊	tgj
螣	tgoi
縢	tgox
熥	tgh
䲢	tgoy
提	ti
题	tio
体	tir
替	tif
踢	tiz
梯	tim
蹄	tizj
惕	tix
涕	tid
啼	tik
剔	tiod
屉	tiu
剃	tib
嚏	tikz
倜	tirk
缇	tis
逖	tizh
荑	tic
醍	tiy
悌	tixd
媞	tin
鹈	tibn
绨	tisd
锑	tij
裼	tip
趯	tit
遆	tizj
鳀	tiyz
擿	tifg
䏲	tiod
䴘	tii
瑅	tiw
𫘨	timz
天	tm
田	tmk
甜	tmu
添	tmd
填	tmt
舔	tmux
恬	tmx
腆	tmo
阗	tmm
殄	tmdp
忝	tmtx
湉	tmdu
畋	tmtw
觍	tmq
瑱	tmw
掭	tmf
盷	tmoy
淟	tmdb
晪	tmob
沺	tmdt
黇	tmh
条	tn
调	tny
跳	tnz
挑	tnf
眺	tno
迢	tnzk
窕	tnb
佻	tnr
笤	tnv
祧	tnp
髫	tne
粜	tni
龆	tnvk
蜩	tnik
鲦	tnym
朓	tnov
苕	tnc
嬥	tnn
铁	tp
贴	tpb
帖	tpj
餮	tpd
萜	tpc
听	tk
停	tkr
厅	tki
挺	tkf
庭	tkg
廷	tkz
婷	tkn
亭	tkw
艇	tkv
霆	tky
汀	tkd
蜓	tkit
铤	tkj
葶	tkc
莛	tkct
珽	tkwt
梃	tkm
烃	tkh
渟	tkdd
颋	tkzy
桯	tkmw
侹	tkrt
䗴	tkit
圢	tkt
烶	tkht
𬘩	tks
同	ts
通	tsz
痛	tsb
统	tss
童	tsl
铜	tsj
筒	tsv
桶	tsm
捅	tsf
瞳	tso
桐	tsmk
佟	tsr
彤	tsd
恸	tsx
潼	tsdl
嗵	tsk
僮	tsrl
酮	tsy
仝	tsrg
茼	tsc
曈	tsol
砼	tsu
烔	tsh
垌	tst
橦	tsml
哃	tskk
穜	tshl
鲖	tsyk
峒	tsuk
洞	tsdk
㛚	tsn
峂	tsud
𦒍	tslx
𫍣	tsyk
头	tz
投	tzf
偷	tzr
透	tzz
骰	tzg
突	tub
土	tuu
徒	tur
吐	tuk
途	tuz
涂	tud
屠	tuuo
兔	tudd
秃	tuh
凸	tul
荼	tuc
菟	tuct
钍	tuj
堍	tut
酴	tuy
稌	tuhm
腯	tuo
葖	tucq
梌	tum
㻬	tuw
𬳿	tumm
团	tr
湍	trd
抟	trf
彖	trh
疃	trt
猯	trq
煓	trhe
推	tv
退	tvz
腿	tvo
颓	tvh
褪	tvp
忒	tvy
蜕	tvi
煺	tvhg
魋	tvg
𬯎	tve
吞	ty
屯	tya
臀	tyu
豚	tyo
囤	tyk
饨	tyut
暾	tyow
鲀	tyy
坉	tyt
忳	tyx
焞	tyh
褪	typ
脱	too
托	tof
妥	tov
拓	tofu
陀	toe
驼	tom
唾	tok
驮	tomd
佗	tor
椭	tomo
坨	tot
沱	tod
砣	tou
鸵	ton
跎	toz
柁	tomb
酡	toy
橐	tog
柝	tomi
侂	torq
鼍	tokd
庹	togi
箨	tovf
萚	toc
铊	toj
圫	totq
𬶍	toyb
哇	wak
瓦	waa
娃	wan
袜	wap
蛙	wai
娲	wann
洼	wad
佤	war
窊	wab
腽	wao
坬	wat
凹	wal
畖	watg
外	wd
歪	wdb
崴	wdu
完	wj
万	wja
晚	wjo
玩	wjw
弯	wjwg
碗	wju
湾	wjd
婉	wjn
挽	wjf
腕	wjov
宛	wjb
顽	wjy
丸	wjl
卍	wjv
惋	wjx
莞	wjc
蜿	wji
琬	wjwv
纨	wjs
婠	wjnl
皖	wjby
绾	wjsl
剜	wjbd
菀	wjcv
豌	wjdv
畹	wjt
烷	wjh
脘	wjoy
芄	wjcw
塆	wjtg
椀	wjm
蔓	wjcy
𬇕	wjdw
王	wh
望	whw
往	whr
忘	whwx
网	whk
亡	whwv
汪	whd
妄	whwn
旺	who
枉	whm
惘	whx
罔	whkw
魍	whg
尢	whu
辋	whi
尪	why
为	ww
位	wwr
微	wwrj
未	wwa
围	wwk
卫	wwe
威	www
味	wwkw
维	wws
危	wwd
委	wwh
伟	wwrw
谓	wwy
唯	wwkv
慰	wwu
尾	wwum
喂	wwky
魏	wwhg
薇	wwc
惟	wwx
违	wwz
韦	wwf
畏	wwt
伪	wwrw
尉	wwuc
胃	wwto
巍	wwug
蔚	wwcc
偎	wwry
萎	wwcn
苇	wwcw
炜	wwhw
玮	wwww
猥	wwq
娓	wwn
帷	wwj
纬	wwsw
渭	wwdo
桅	wwm
嵬	wwug
猬	wwqo
隗	wweg
葳	wwcn
痿	wwb
闱	wwmw
煨	wwhy
诿	wwyn
韪	wwo
逶	wwzn
帏	wwjw
圩	wwty
潍	wwdv
溦	wwdj
鲔	wwyo
艉	wwv
隈	wwey
洧	wwdo
沩	wwdw
廆	wwg
霨	wwyc
涠	wwdw
亹	wwwq
碨	wwuy
煟	wwho
琟	wwwv
硙	wwuj
薳	wwcy
峗	wwuv
崴	wwun
洈	wwdv
螱	wwui
鳂	wwyy
鳚	wwyc
𣲗	wwdw
𫇭	wwcw
𬀩	wwow
𬱟	wwdy
𬶏	wwyv
问	wf
文	wfw
温	wfd
闻	wfm
稳	wfh
吻	wfk
纹	wfs
雯	wfy
蚊	wfi
芠	wfc
瘟	wfb
紊	wfwx
汶	wfdw
玟	wfww
刎	wfwd
炆	wfhw
璺	wfj
阌	wfmy
辒	wfim
榅	wfmm
蕰	wfcm
鳁	wfym
𫘜	wfmw
翁	wg
嗡	wgk
瓮	wgg
蓊	wgc
蕹	wgcv
滃	wgd
鹟	wggn
𬭩	wgj
我	wo
握	wof
窝	wob
卧	woi
沃	wod
喔	wok
倭	wor
涡	wodn
龌	wov
蜗	woin
渥	wodt
斡	wou
幄	woj
挝	wofc
莴	woc
硪	wouw
肟	woo
偓	wort
涴	wodv
踒	woz
无	wu
物	wun
五	wua
武	wug
务	wuw
屋	wuu
舞	wup
吴	wuk
午	wupu
误	wuy
雾	wuyl
乌	wupa
悟	wux
伍	wur
呜	wukw
巫	wugr
吾	wuwk
污	wud
捂	wuf
勿	wub
兀	wuae
恶	wuyx
侮	wurm
唔	wukk
梧	wum
妩	wunw
芜	wuc
诬	wuyr
坞	wut
毋	wump
晤	wuo
蜈	wui
邬	wuwe
鹉	wugn
戊	wugp
忤	wuxu
骛	wumm
鹜	wumn
仵	wuru
婺	wumn
钨	wuj
杌	wumw
焐	wuh
庑	wugw
寤	wubk
鋈	wudj
痦	wubk
怃	wuxw
牾	wunk
圬	wutk
浯	wudk
芴	wucw
迕	wuz
鼯	wujk
旿	wuou
靰	wugw
洿	wudk
鹀	wugn
郚	wuwe
屼	wuuw
珷	wuwv
铻	wujk
峿	wuuk
珸	wuwk
𣲘	wudw
西	xi
喜	xit
系	xip
息	xiz
细	xis
希	xix
习	xiv
吸	xik
戏	xiy
洗	xid
惜	xixo
席	xig
袭	xil
悉	xic
嘻	xikk
析	xim
稀	xih
熙	xii
夕	xipd
晰	xio
溪	xidd
兮	xib
牺	xin
膝	xiou
媳	xinx
茜	xicx
隙	xie
昔	xico
锡	xij
嬉	xink
熄	xihx
犀	xiu
曦	xiok
禧	xipk
皙	ximb
玺	xidy
汐	xidx
蹊	xizd
蜥	xiij
奚	xivd
唏	xikj
羲	xiyk
淅	xidj
徙	xir
熹	xith
蟋	xiix
翕	xirx
檄	ximw
僖	xirk
窸	xibx
铣	xije
郗	xixe
晞	xioj
烯	xihj
歙	xirq
屃	xiub
浠	xidj
阋	xime
樨	ximn
傒	xird
醯	xiym
隰	xieh
螅	xiix
爔	xihk
屣	xiuz
硒	xiux
釐	xiw
葸	xicx
咥	xikt
豨	xiuj
禊	xipd
饩	xiuq
郤	xige
觋	xigj
穸	xibx
嶲	xiuk
裼	xipw
舄	xijh
舾	xivx
谿	xivg
恓	xixx
蓰	xicz
鼷	xijd
粞	ximx
巇	xiug
憙	xitx
绤	xisg
菥	xicj
枲	xism
潟	xidh
肸	xiou
酅	xiue
睎	xioj
觿	xidk
嶍	xiub
暿	xiok
俙	xirj
熻	xihx
饻	xiuy
鳛	xiyb
𠅤	xiwx
𫘬	ximd
𬭳	xijk
𬶮	xiyk
下	xx
吓	xxk
夏	xxb
侠	xxr
霞	xxy
瞎	xxo
狭	xxq
暇	xxoy
峡	xxu
虾	xxi
辖	xxik
匣	xxkj
瑕	xxw
遐	xxz
黠	xxl
呷	xxkj
狎	xxqj
厦	xxiw
罅	xxf
硖	xxuj
柙	xxm
叚	xxuy
翈	xxj
先	xm
现	xmw
显	xmo
线	xms
险	xme
仙	xmr
咸	xmwk
鲜	xmy
限	xmeg
闲	xmm
陷	xmej
县	xmq
献	xmu
贤	xml
嫌	xmn
纤	xmsq
羡	xmyq
弦	xmg
掀	xmf
宪	xmb
见	xmk
衔	xmrj
娴	xmnm
涎	xmd
馅	xmuj
舷	xmv
腺	xmou
暹	xmz
苋	xmc
冼	xmde
洗	xmde
藓	xmcy
锨	xmj
霰	xmyw
跹	xmzq
忺	xmx
痫	xmbm
祆	xmp
岘	xmuj
酰	xmye
跣	xmze
燹	xmuh
狝	xmqx
蚬	xmi
猃	xmqq
籼	xmmu
鹇	xmmn
筅	xmve
莶	xmcq
氙	xmqu
挦	xmfc
崄	xmuq
缐	xmsu
孅	xmnj
伭	xmrx
禒	xmpu
㬎	xmoh
𪾢	xmoj
𫍯	xmyk
𬀪	xmoj
𬸣	xmbn
想	xl
向	xlp
相	xlm
像	xlr
象	xld
响	xlk
香	xlh
降	xle
项	xlg
乡	xlv
享	xlw
翔	xly
箱	xlvo
祥	xlpy
详	xlyy
湘	xldo
巷	xlgs
厢	xli
襄	xlyf
镶	xlj
橡	xlmu
饷	xlu
骧	xlmx
飨	xlx
庠	xlgy
缃	xls
芗	xlc
鲞	xljy
瓖	xlwx
葙	xlco
珦	xlwk
𬙋	xlsx
小	xn
笑	xnv
消	xnd
校	xnm
晓	xno
萧	xnc
效	xnw
销	xnj
肖	xnx
啸	xnk
孝	xnl
逍	xnz
潇	xndb
削	xnxd
嚣	xnkk
霄	xny
宵	xnb
哮	xnkz
箫	xnvb
筱	xnvw
枭	xnn
硝	xnu
骁	xnmw
淆	xndo
魈	xng
绡	xns
哓	xnkw
鸮	xnkn
崤	xnuo
枵	xnmk
猇	xnq
洨	xndf
翛	xnr
虓	xnjj
蛸	xni
涍	xndz
蟏	xnib
敩	xnxw
滧	xndw
皛	xnbb
𫍲	xnyy
些	xp
血	xpp
谢	xpy
写	xpb
邪	xpye
协	xpu
鞋	xpg
斜	xpr
泄	xpd
胁	xpo
歇	xpoq
屑	xpuo
械	xpm
携	xpf
谐	xpyb
卸	xpv
挟	xpfj
泻	xpdy
懈	xpx
蝎	xpi
蟹	xpdi
解	xpdn
亵	xpyw
邂	xpz
偕	xprb
榭	xpmc
燮	xph
楔	xpmd
撷	xpfy
瀣	xpdj
獬	xpq
勰	xpl
廨	xpgn
缬	xps
躞	xpzy
绁	xpsu
絜	xpfx
渫	xpdm
薤	xpc
榍	xpmo
揳	xpfd
澥	xpdn
薢	xpcn
叶	xpk
颉	xpt
㙦	xprt
偰	xprd
𤫉	xpw
𬹼	xpvj
新	xb
心	xbd
信	xbr
欣	xbj
辛	xbl
馨	xbt
薪	xbc
歆	xblq
昕	xbo
衅	xbp
芯	xbcx
鑫	xbjj
忻	xbx
锌	xbjx
炘	xbh
囟	xbpx
镡	xbju
伈	xbrx
莘	xbcx
䜣	xby
𫷷	xbg
行	xk
性	xkx
星	xko
形	xkk
兴	xkxb
醒	xky
幸	xkt
型	xkkt
姓	xkn
刑	xkkd
腥	xkou
杏	xkm
猩	xkq
惺	xkxu
邢	xkke
悻	xkxg
省	xku
荥	xkc
擤	xkf
陉	xke
荇	xkcd
饧	xkup
骍	xkmx
硎	xkud
钘	xkj
瑆	xkw
婞	xkng
铏	xkjd
煋	xkh
𫰛	xknj
胸	xso
雄	xsu
凶	xsk
熊	xss
汹	xsd
匈	xsb
芎	xsc
讻	xsy
夐	xsdw
诇	xsyk
修	xq
秀	xqh
休	xqr
宿	xqb
羞	xqy
袖	xqp
绣	xqs
嗅	xqk
朽	xqm
锈	xqj
咻	xqkm
岫	xqu
貅	xqv
馐	xqui
庥	xqg
脩	xqro
溴	xqd
琇	xqw
髹	xqe
鸺	xqrn
珛	xqwo
滫	xqdo
臭	xqz
䗛	xqi
许	xu
续	xus
需	xuy
须	xup
虚	xuh
徐	xur
绪	xuso
序	xug
旭	xuj
叙	xury
吁	xuk
蓄	xuc
嘘	xuky
絮	xun
婿	xuno
恤	xux
栩	xum
墟	xut
诩	xuyx
煦	xuo
胥	xuz
戌	xuw
酗	xuyx
顼	xuwy
勖	xuol
圩	xuty
畜	xuxt
蓿	xucb
盱	xuoy
魆	xugl
洫	xud
溆	xudy
糈	xumo
谞	xuyo
欻	xuhq
媭	xupn
昫	xuoj
醑	xuyo
珝	xuwx
旴	xuoy
湑	xudo
垿	xuty
浒	xudu
㳚	xudd
冔	xuoy
𦈡	xuse
𬣙	xuyy
选	xr
玄	xrw
宣	xrb
旋	xrf
轩	xri
悬	xrq
喧	xrk
璇	xrwz
眩	xro
炫	xrh
萱	xrc
漩	xrd
绚	xrs
暄	xrod
渲	xrdd
煊	xrhd
泫	xrdx
铉	xrj
瑄	xrwd
烜	xrhd
癣	xrby
禤	xrp
谖	xry
儇	xrr
玹	xrwx
楦	xrm
碹	xru
晅	xrod
衒	xrrx
翾	xrsx
痃	xrbx
昡	xrox
咺	xrkd
券	xrjd
暶	xroz
愃	xrx
琄	xrwo
𫍽	xryy
𫓶	xrjo
𫠊	xrmx
学	xt
血	xtp
雪	xty
穴	xtb
薛	xtc
削	xtx
靴	xtg
谑	xtye
噱	xtk
踅	xtf
鳕	xtye
茓	xtcb
峃	xtxu
寻	xy
训	xyy
迅	xyz
巡	xyzv
讯	xyyu
询	xyyo
逊	xyzx
循	xyr
勋	xyk
熏	xyq
旬	xyb
驯	xym
荀	xyc
薰	xych
殉	xyd
醺	xyyh
洵	xydo
峋	xyu
巽	xys
珣	xyw
汛	xydu
徇	xyro
浔	xydc
埙	xyt
恂	xyx
荨	xycc
蕈	xycu
鲟	xyyc
郇	xybe
曛	xyo
獯	xyqh
噀	xykg
栒	xymo
浚	xydw
𫄸	xysh
𬊈	xyh
𬍤	xywc
𬘓	xysi
𬩽	xye
呀	ya
亚	yaa
压	yai
雅	yay
牙	yag
丫	yab
吖	yak
讶	yayy
涯	yad
哑	yaky
崖	yau
娅	yan
押	yaf
鸭	yaj
鸦	yayn
衙	yar
芽	yac
轧	yaiv
伢	yary
琊	yaw
桠	yam
睚	yao
垭	yat
岈	yauy
迓	yaz
蚜	yaiy
玡	yawy
揠	yafn
猰	yaq
氩	yaqy
砑	yauy
堐	yatt
眼	yj
言	yjw
严	yja
烟	yjh
演	yjd
验	yjm
研	yju
燕	yjc
颜	yjwy
掩	yjf
延	yjz
厌	yji
艳	yjfb
炎	yjhh
沿	yjdk
焰	yjhj
岩	yjuu
淹	yjdd
咽	yjk
宴	yjb
嫣	yjn
妍	yjnk
彦	yjwp
雁	yjiv
阎	yjmj
盐	yjt
焉	yjv
衍	yjr
檐	yjmk
奄	yjdd
砚	yjuj
焱	yjhh
俨	yjry
晏	yjo
胭	yjoy
蜒	yjiv
魇	yjig
阉	yjmd
湮	yjdt
琰	yjwh
筵	yjvv
偃	yjrn
闫	yjms
腌	yjod
阏	yjmd
恹	yjx
谚	yjy
兖	yjl
堰	yjtn
鄢	yjve
滟	yjdb
赝	yjib
唁	yjkk
鼹	yjj
芫	yjcy
郾	yjke
酽	yjyy
餍	yjig
厣	yjij
谳	yjyq
崦	yjud
弇	yjrc
黡	yjih
罨	yjs
渰	yjdc
掞	yjfh
嬿	yjnh
棪	yjmh
扊	yjhh
沇	yjdy
甗	yjhw
殷	yjp
铅	yjjk
䶮	yjlt
墕	yjth
戭	yjbg
漹	yjdh
虤	yjhj
蝘	yjin
觃	yjjz
𪩘	yjuq
𫄧	yjsv
𬙂	yjsb
𬸘	yjkn
样	yh
阳	yhe
杨	yhm
扬	yhf
养	yhb
洋	yhd
仰	yhr
央	yhk
羊	yhbf
痒	yhby
漾	yhdy
氧	yhq
恙	yhy
佯	yhry
鸯	yhyn
殃	yhdy
怏	yhx
秧	yhh
炀	yhhp
泱	yhdy
鞅	yhg
徉	yhry
烊	yhhy
疡	yhbp
旸	yho
飏	yhfp
羕	yhyy
蛘	yhi
垟	yht
玚	yhw
咉	yhky
钖	yhj
要	yc
摇	ycf
药	ycc
妖	ycn
腰	yco
咬	yck
遥	ycz
耀	ycx
瑶	ycw
姚	ycnv
邀	yczw
钥	ycj
夭	ycp
谣	ycy
幺	ycv
窑	ycb
尧	ycyw
吆	ycky
肴	ycxo
约	ycs
曜	ycov
窈	ycbl
杳	ycm
舀	ycvj
爻	ycxx
鹞	ycvn
徭	ycr
轺	yci
鳐	ycyf
崾	ycu
铫	ycjv
窅	ycbo
峣	ycuw
垚	yct
珧	ycwv
靿	ycg
疟	ycbe
猺	ycq
侥	ycrw
媱	ycnf
㙘	yctn
也	ye
业	yel
夜	yew
爷	yef
叶	yek
野	yely
液	yed
耶	yee
页	yea
曳	yey
冶	yedk
烨	yeh
噎	yekb
腋	yeo
靥	yei
椰	yem
掖	yefw
晔	yeou
邺	yeye
谒	yeyr
揶	yefe
咽	yeky
铘	yej
倻	yer
馌	yeu
一	yia
以	yil
意	yilx
衣	yiw
亿	yir
易	yio
依	yiry
义	yid
异	yij
疑	yib
议	yiy
医	yik
伊	yiry
移	yih
忆	yix
艺	yic
亦	yiwb
翼	yixg
遗	yiz
益	yibm
宜	yibq
椅	yim
仪	yiry
逸	yizt
姨	yin
怡	yixk
抑	yif
毅	yilu
役	yiru
译	yiyf
夷	yiar
溢	yidm
咦	yiky
倚	yirk
矣	yis
谊	yiyq
乙	yiv
蚁	yii
奕	yiwd
漪	yidk
疫	yibu
绎	yisf
裔	yiyk
揖	yife
颐	yiiy
驿	yimf
弈	yiwc
懿	yit
邑	yikb
熠	yihb
屹	yiu
沂	yidj
羿	yixc
诣	yiyo
翌	yixl
轶	yiif
呓	yikv
翊	yilx
蜴	yiiw
弋	yiyd
咿	yiky
尾	yium
旖	yifk
祎	yip
臆	yiox
彝	yihc
贻	yibk
噫	yikx
佚	yirf
迤	yizy
壹	yitb
荑	yicy
缢	yism
翳	yikx
胰	yioy
痍	yiby
薏	yicx
嶷	yiuz
饴	yiuk
苡	yicr
悒	yixb
猗	yiq
诒	yiyk
黟	yilx
峄	yiuf
镱	yijx
怿	yixf
眙	yiok
肄	yiby
铱	yijy
挹	yifb
乂	yipn
刈	yixd
癔	yibx
镒	yijm
埸	yitw
佾	yiro
圯	yits
瘗	yibt
燚	yihh
劓	yizd
殪	yidb
浥	yidb
扆	yihy
廙	yig
簃	yivx
嫕	yinx
舣	yivy
杙	yimy
钇	yijv
鹢	yibn
宧	yibi
洢	yidy
酏	yiyy
繄	yikx
裛	yiyb
椸	yimy
踦	yizk
扅	yihx
佁	yirk
勚	yiul
匜	yiky
鹝	yign
嗌	yikm
艾	yicx
㑊	yirb
枍	yimk
潩	yidg
螠	yiim
𫄷	yisx
𫖮	yiuy
𬟁	yicn
𬬩	yijy
𬺈	yivk
因	yb
音	ybl
引	ybg
隐	ybe
银	ybj
阴	ybeo
印	ybp
吟	ybk
饮	ybu
淫	ybd
姻	ybn
尹	ybep
殷	ybpu
茵	ybc
瘾	ybb
胤	ybeo
荫	ybco
寅	ybbb
垠	ybt
氤	ybq
蚓	ybi
喑	ybko
洇	ybdy
龈	ybv
鄞	ybce
夤	ybx
窨	ybbo
霪	yby
狺	ybqk
愔	ybxo
堙	ybtt
訚	ybm
吲	ybkl
铟	ybjy
嚚	ybkk
禋	ybpt
骃	ybmy
慭	yblx
硍	ybug
珢	ybw
茚	ybce
蟫	ybiu
龂	ybvj
崟	ybuj
溵	ybdu
歅	ybxq
䲟	ybye
𬘡	ybs
𬤇	ybyt
𬮱	ybmt
应	yk
影	yko
英	ykc
营	ykck
迎	ykz
硬	yku
鹰	ykg
赢	ykw
映	ykoy
莹	ykcy
盈	ykn
婴	ykb
樱	ykm
颖	ykby
莺	ykcn
蝇	yki
嬴	ykwn
萤	ykci
荧	ykch
萦	ykcx
瑛	ykwy
缨	yks
瀛	ykd
嘤	ykk
膺	ykgo
滢	ykdy
鹦	ykbn
罂	ykbf
璎	ykwn
郢	ykke
颍	ykby
荥	ykcu
茔	ykct
楹	ykmm
撄	ykf
潆	ykdx
媵	ykon
瘿	ykbn
锳	ykj
蓥	ykcj
溁	ykdm
媖	ykny
䓨	ykcf
用	ys
永	ysd
拥	ysf
勇	yss
涌	ysdy
佣	ysr
庸	ysg
泳	ysdy
雍	ysw
咏	ysk
甬	yssy
慵	ysx
俑	ysry
恿	yssx
臃	yso
蛹	ysi
邕	ysv
踊	ysz
墉	yst
镛	ysj
颙	ysty
痈	ysb
壅	yswt
饔	yswg
鳙	ysy
澭	ysdv
鄘	ysge
埇	ysty
栐	ysm
喁	yskd
㶲	ysh
鲬	ysyy
有	yzU
由	yzl
友	yzu
游	yzd
右	yzuk
优	yzr
犹	yzq
幽	yzuy
油	yzdy
尤	yzy
忧	yzx
悠	yzrx
诱	yzyn
幼	yzyl
哟	yzk
佑	yzrk
邮	yzye
黝	yzll
呦	yzkl
攸	yzrw
鱿	yzyy
酉	yzxa
繇	yzv
柚	yzm
祐	yzp
铀	yzj
猷	yzb
釉	yzc
莠	yzcn
囿	yzko
鼬	yzjy
宥	yzbo
莜	yzcw
疣	yzby
侑	yzro
牖	yzpf
蝣	yzi
蚴	yzil
羑	yzyj
蝤	yziy
蚰	yziy
莸	yzcy
卣	yzbk
麀	yzlb
耰	yzlw
浟	yzdw
槱	yzmh
铕	yzjo
鲉	yzyy
𬨎	yziy
与	yuv
语	yuy
雨	yua
玉	yuw
余	yur
遇	yuz
欲	yug
羽	yux
宇	yub
鱼	yud
预	yuyy
育	yuwo
御	yure
郁	yuu
豫	yuyu
域	yut
狱	yuq
予	yus
愈	yurx
浴	yudg
誉	yuxk
愉	yuxd
愚	yutx
吁	yuk
於	yuf
裕	yup
娱	yun
瑜	yuwd
喻	yukd
寓	yubd
渔	yudy
虞	yuh
俞	yurd
禹	yupd
煜	yuhl
舆	yuj
谕	yuyd
逾	yuzd
榆	yum
屿	yuuy
钰	yujy
驭	yumy
渝	yudd
迂	yuzy
淤	yudd
毓	yupi
瑀	yuwy
妤	yuny
昱	yuo
隅	yue
禺	yutd
芋	yuc
聿	yuyg
臾	yujr
揄	yufd
峪	yuug
觎	yurj
妪	yunq
谀	yuyr
腴	yuor
盂	yuym
彧	yuga
庾	yugr
瘀	yubd
燏	yuhk
棫	yuma
蜮	yui
圄	yukk
竽	yuvy
喁	yukd
欤	yuyq
萸	yucr
鹬	yumn
鬻	yugg
龉	yuvk
窳	yubg
圉	yukg
纡	yusy
狳	yuqm
俣	yurt
燠	yuhd
瘐	yubr
伛	yurq
饫	yuuy
淯	yudo
阈	yuma
蝓	yuid
舁	yujc
遹	yuzk
雩	yuyk
鹆	yugn
窬	yubd
熨	yuuh
玙	yuwy
嵛	yuud
堉	yuto
褕	yupd
矞	yumk
畬	yurt
嵎	yuud
蓣	yucy
髃	yugd
滪	yudy
潏	yudk
悆	yurx
敔	yuww
邘	yuye
鄅	yuye
尉	yuuc
艅	yuvm
蔚	yucc
㺄	yuqd
原	yr
远	yrz
员	yrk
元	yra
院	yre
愿	yri
园	yrky
源	yrd
圆	yrkb
缘	yrs
怨	yrx
援	yrf
袁	yrt
辕	yriy
渊	yrdl
冤	yrb
媛	yrn
苑	yrc
猿	yrq
鸳	yrxn
垣	yrtd
鸢	yry
沅	yrdy
爰	yrv
瑗	yrw
芫	yrcy
塬	yrtx
鼋	yryd
掾	yrfu
垸	yrty
螈	yrix
橼	yrm
蜎	yrio
嫄	yrnx
箢	yrvv
湲	yrdy
眢	yrxo
涴	yrdv
妧	yrny
羱	yryx
圜	yrky
𫘪	yrmx
月	ytk
约	yts
跃	ytz
岳	ytq
悦	ytx
乐	ytp
曰	ytka
阅	ytm
粤	ytpk
玥	ytw
钺	ytj
钥	ytjo
樾	ytml
刖	yto
彟	yte
哕	ytkx
瀹	ytd
龠	ytr
爚	yth
籥	ytv
栎	ytml
𫐄	yti
𬸚	ytqn
云	yy
运	yyz
晕	yyo
允	yys
韵	yyl
芸	yyc
孕	yyn
蕴	yycm
匀	yyb
筠	yyv
陨	yye
酝	yyy
愠	yyx
氲	yyq
耘	yyly
昀	yyoy
纭	yysy
殒	yyd
熨	yyu
韫	yyw
郓	yybe
赟	yywb
恽	yyxi
鋆	yyt
郧	yyk
狁	yyqy
沄	yydy
妘	yyny
缊	yysm
煴	yyh
筼	yyvb
涢	yydb
员	yykb
馧	yyhm
𫖳	yyyy
咋	za
砸	zau
杂	zaj
咂	zak
匝	zakj
扎	zaf
臜	zao
拶	zafx
在	zdU
载	zdg
灾	zdb
宰	zdbx
栽	zdgm
哉	zdgk
仔	zdr
崽	zdu
甾	zdv
咱	zjk
暂	zji
攒	zjf
簪	zjv
瓒	zjw
錾	zjij
糌	zjm
趱	zjt
昝	zjwo
拶	zjfx
酂	zjn
寁	zjb
脏	zh
葬	zhc
藏	zhci
赃	zhb
臧	zhv
奘	zhp
牂	zhpy
驵	zhm
早	zc
造	zcz
遭	zczo
糟	zcm
澡	zcd
躁	zczm
燥	zch
凿	zck
噪	zckm
灶	zcht
枣	zcu
皂	zcb
藻	zcc
蚤	zci
唣	zckq
璪	zcw
慥	zcx
簉	zcv
𥖨	zcum
则	ze
责	zef
择	zeff
泽	zed
啧	zek
仄	zei
笮	zev
帻	zej
赜	zeib
昃	zeo
舴	zevv
箦	zevb
迮	zez
咋	zekv
贼	zw
鲗	zwy
怎	zf
谮	zfy
增	zg
赠	zgb
憎	zgx
曾	zgbo
锃	zgj
缯	zgs
甑	zgbw
罾	zgso
矰	zgu
鄫	zgbe
综	zgsu
䎖	zgbx
扎	va
炸	vah
眨	vao
诈	vay
乍	vap
喳	vak
渣	vad
栅	vam
札	vamv
闸	vamj
榨	vamv
吒	vakq
轧	vai
咤	vakq
蚱	vaiv
铡	vaj
楂	vamd
鲊	vayv
馇	vau
揸	vaf
砟	vauv
哳	vakj
奓	vadx
拃	vafv
挓	vafq
痄	vab
劄	vav
霅	vayk
咋	vakv
喋	vakm
柞	vamv
查	vamd
䃎	vaux
溠	vadg
鲝	vayy
齇	vaz
寨	vd
宅	vdb
摘	vdf
债	vdr
窄	vdbv
斋	vdw
翟	vdx
择	vdff
瘵	vdbu
祭	vdxu
豸	vdp
战	vjv
展	vju
占	vjb
斩	vji
沾	vjd
蘸	vjc
绽	vjs
粘	vjm
栈	vjmj
盏	vjj
詹	vjdk
湛	vjdb
崭	vjuj
瞻	vjo
辗	vjiy
毡	vjmv
旃	vjf
谵	vjy
搌	vjfy
飐	vjfv
鹯	vjw
偡	vjr
栴	vjmd
鳣	vjyd
𫗴	vjud
长	vh
张	vhg
章	vhl
掌	vhx
丈	vha
帐	vhj
仗	vhr
障	vhe
涨	vhd
杖	vhm
账	vhb
璋	vhw
胀	vho
彰	vhlp
蟑	vhi
瘴	vhbu
樟	vhmu
漳	vhdu
獐	vhq
嶂	vhu
幛	vhju
鄣	vhle
嫜	vhn
暲	vhou
仉	vhrj
找	vc
照	vco
招	vcf
赵	vct
召	vcd
罩	vcs
着	vcy
爪	vci
昭	vcok
兆	vce
朝	vcu
诏	vcyk
沼	vcdk
肇	vch
钊	vcj
棹	vcm
笊	vcv
曌	vcog
啁	vck
旐	vcfv
𬬿	vcjk
𬶐	vcyv
这	veZ
者	vel
折	vef
哲	vefk
遮	vez
浙	ved
辙	vei
辄	veiv
褶	vep
蛰	vefi
蔗	vec
蜇	vefi
鹧	veg
喆	vet
谪	vey
赭	veio
柘	vem
磔	veu
锗	vej
啫	vek
晢	vefo
詟	velk
䗪	vegi
真	vf
阵	vfe
震	vfy
镇	vfj
珍	vfw
针	vfju
振	vff
朕	vfo
侦	vfr
贞	vfb
枕	vfm
诊	vfyp
甄	vfx
帧	vfjb
斟	vfc
祯	vfp
臻	vfg
桢	vfmb
箴	vfv
缜	vfs
圳	vft
榛	vfmh
赈	vfbi
蓁	vfch
禛	vfpb
疹	vfbp
砧	vfu
鸩	vfbn
轸	vfi
稹	vfh
浈	vfd
瑧	vfwh
畛	vftp
胗	vfop
鬒	vfeb
袗	vfpp
葴	vfck
揕	vffb
昣	vfop
纼	vfsl
正	vg
整	vgu
政	vgv
争	vgd
证	vgy
征	vgr
郑	vgb
睁	vgo
挣	vgf
怔	vgx
症	vgbv
蒸	vgc
铮	vgj
筝	vgvy
狰	vgq
拯	vgfi
峥	vguy
钲	vgjv
诤	vgyy
烝	vgl
只	vi
知	viu
直	viuq
至	vig
之	vid
指	vif
值	vir
制	vin
支	viuy
志	vit
止	vil
治	vidk
质	vii
置	vis
致	vigw
职	vie
智	viuo
纸	visu
织	visv
执	vifw
枝	vim
植	vimq
旨	vib
芝	vic
吱	vik
肢	vio
侄	virt
脂	vioo
址	vitv
汁	vidu
滞	vidj
稚	vih
殖	vidq
掷	vife
秩	vihf
窒	vibt
芷	vicv
峙	viuc
挚	vifu
蜘	viik
帜	vij
炙	vix
趾	viz
咫	viiv
痣	vibx
徵	virw
雉	viuv
祗	vip
栀	vimv
痔	vibc
栉	vime
祉	vipv
桎	vimt
蛭	viit
鸷	vifn
郅	vige
豸	vipp
踯	vize
贽	vifb
陟	vieu
骘	viem
彘	vihb
跖	vizu
轾	viit
摭	vifh
枳	vimv
酯	viy
帙	vijf
禔	vipz
卮	viiv
沚	vidv
胝	viou
觯	vidu
絷	vifx
埴	vitq
轵	viiv
黹	viyx
踬	vizb
忮	vixv
晊	viot
畤	vitc
滍	vidi
稙	vihq
扺	vifu
铚	vijt
锧	vijb
疐	viuz
跱	vizc
庤	vigc
泜	vidu
氏	vipv
识	viyv
梽	vimx
榰	vimo
𦭜	vicv
𬃊	vimb
中	vs
种	vsh
重	vsq
终	vss
众	vsr
钟	vsj
忠	vsv
仲	vsrv
衷	vsy
肿	vso
冢	vsb
踵	vsz
盅	vsvm
锺	vsjv
舯	vsvv
螽	vsd
柊	vsm
茽	vsc
周	vz
州	vzd
皱	vzdp
洲	vzdv
咒	vzk
宙	vzb
舟	vzp
骤	vzm
粥	vzg
肘	vzo
轴	vzi
昼	vzid
帚	vze
胄	vzy
纣	vzs
绉	vzse
诌	vzye
妯	vzn
啁	vzkk
碡	vzu
籀	vzv
酎	vzyc
辀	vziv
赒	vzbk
鸼	vzvn
荮	vzc
婤	vznk
㑇	vzr
㤘	vzx
住	vu
主	vuw
注	vud
助	vuq
著	vuc
朱	vup
珠	vuww
诸	vuy
逐	vuz
竹	vug
猪	vuqo
祝	vupx
筑	vuv
柱	vum
驻	vumv
嘱	vuk
烛	vuh
煮	vul
蛛	vui
株	vumw
铸	vuj
诛	vuyw
竺	vuve
瞩	vuo
伫	vur
拄	vuf
侏	vurw
贮	vub
茱	vucw
洙	vudw
蛀	vuiv
渚	vudo
箸	vuvo
炷	vuhv
铢	vujw
躅	vuzi
苎	vucv
杼	vumy
翥	vulx
槠	vumo
麈	vulv
潴	vudo
舳	vuvy
邾	vupe
纻	vus
橥	vuqm
砫	vuu
柷	vumx
疰	vubv
蠋	vuii
瘃	vubu
术	vumd
𬣞	vuyv
抓	vx
爪	vxi
髽	vxe
拽	vk
转	vr
专	vrt
赚	vrb
传	vrr
砖	vru
撰	vrf
篆	vrv
馔	vrug
颛	vruy
啭	vrk
僎	vrrg
瑑	vrw
沌	vrd
䏝	vro
装	vl
状	vll
庄	vlg
撞	vlf
壮	vllt
妆	vlln
桩	vlm
幢	vlj
奘	vlp
戆	vllx
追	vv
坠	vve
缀	vvs
锥	vvj
惴	vvx
赘	vvf
椎	vvm
骓	vvmv
缒	vvsl
隹	vvr
准	vy
谆	vyy
肫	vyo
窀	vyb
衠	vyr
屯	vya
𬘯	vys
桌	vo
卓	vob
着	voy
捉	vof
琢	vow
灼	voh
拙	vofi
浊	vod
镯	voj
酌	voyu
啄	vok
茁	voc
涿	vodu
擢	vofv
斫	vou
濯	vodv
倬	vor
浞	vodz
诼	voyu
棁	vom
禚	vop
椓	vomu
晫	voo
叕	voyy
汋	vodu
焯	vohu
䓬	vocu
䦃	vojo
𬸦	vofn
子	zi
自	zip
字	zib
资	zid
紫	ziv
姿	zidn
滋	zidy
吱	zik
兹	ziby
姊	zin
仔	zir
咨	zidk
梓	zim
孜	ziz
渍	zidb
籽	zimz
恣	zidx
龇	zivb
辎	zii
淄	zidt
眦	zio
滓	zidx
嗞	ziky
髭	zie
孳	zibz
缁	zis
笫	zivd
锱	zij
秭	zih
赀	zivb
訾	zivk
觜	zivy
嵫	ziu
趑	zit
茈	zic
孖	zizz
粢	zidm
鲻	ziy
镃	zijy
耔	zil
鼒	zico
虸	ziiz
鄑	ziye
总	zs
宗	zsb
纵	zss
踪	zsz
综	zssu
棕	zsm
鬃	zse
粽	zsmu
偬	zsr
倧	zsru
鬷	zsg
腙	zso
枞	zsmr
疭	zsbr
走	zz
奏	zzi
揍	zzf
邹	zzd
诹	zzy
驺	zzm
陬	zze
鄹	zzee
鲰	zzyy
组	zu
足	zuk
族	zuf
祖	zup
阻	zue
租	zuh
卒	zuw
诅	zuy
俎	zur
镞	zuj
菹	zuc
崒	zuu
珇	zuwq
钻	zr
攥	zrf
纂	zrv
缵	zrs
躜	zrz
最	zv
嘴	zvk
罪	zvs
醉	zvy
蕞	zvc
咀	zvkq
槜	zvm
尊	zy
遵	zyz
樽	zym
鳟	zyy
撙	zyf
噂	zyk
僔	zyr
嶟	zyu
𨱔	zyj
做	zo
作	zor
坐	zot
左	zou
座	zog
昨	zoo
佐	zorg
琢	zow
撮	zof
祚	zop
嘬	zok
柞	zom
笮	zov
酢	zoy
怍	zox
胙	zoov
唑	zokr
捽	zofu
阼	zoe
岞	zouv
𤭢	cw
𰻝	bl
嬢	nln
薙	ticv
菈	lacl
卻	qtg
濛	mgd
诶	ei
凃	tudm
咲	xnkt
螓	qbih
珮	pww
睆	hroy
挼	rx
𤭢	cwww
𰻝	blzx
嬢	nlnf
薙	ticv
菈	lacl
卻	qtge
濛	mgdu
诶	eiyu
牠	tany
凃	tudm
咲	xnkt
螓	qbih
珮	pwwj
睆	hroy
挼	rxfn
