啊	aaKK
阿	aaek
吖	aaky
锕	aajk
腌	aaod
爱	aivy
艾	aicx
哎	aikx
唉	aiku
哀	aiyk
挨	aifu
埃	aitu
矮	aiun
碍	aiuc
暧	aioy
癌	aibu
蔼	aicr
隘	aiem
皑	aibj
霭	aiyr
嗳	aiky
嫒	ainy
毐	aitm
欸	aisq
叆	aiyy
瑷	aiwy
砹	aiux
锿	aijk
嗌	aikm
按	anfn
安	anbn
暗	anoo
案	anbm
岸	anug
俺	anrd
黯	anlo
庵	angd
鞍	angn
谙	anyo
氨	anqn
胺	anon
鹌	andn
桉	anmn
犴	anqg
唵	ankd
铵	anjn
埯	antd
盦	anrm
垵	antn
𩽾	anyn
昂	ahoe
肮	ahoj
盎	ahym
卬	ahpe
傲	aorw
奥	aopd
熬	aofh
敖	aofw
澳	aodd
凹	aola
懊	aoxd
嗷	aokw
拗	aofl
袄	aopy
鳌	aofy
翱	aobx
獒	aofq
骜	aofm
坳	aotl
鏖	aolj
遨	aozw
媪	aonm
螯	aofi
岙	aoyu
璈	aoww
鏊	aofj
聱	aofe
廒	aogw
奡	aobl
隩	aoed
薁	aocd
嶅	aofu
把	bafb
吧	baKB
八	bapn
爸	bafb
巴	basl
罢	basq
拔	bafy
霸	bayo
疤	babb
跋	bazy
扒	bafb
叭	bakb
芭	bacb
靶	bagb
坝	batb
耙	balb
笆	bavb
魃	bagy
粑	bamb
钯	bajb
灞	bado
捌	bafd
鲅	bayy
岜	baub
鲃	bayb
菝	bacy
蚆	baib
胈	baoy
羓	bayb
朳	bamb
妭	bany
白	bdpo
百	bdab
败	bdbw
摆	bdfq
拜	bduf
柏	bdmb
掰	bduu
伯	bdrb
佰	bdrb
稗	bdhu
捭	bdfu
半	bjbf
办	bjld
般	bjvu
板	bjmy
班	bjwl
伴	bjrb
版	bjpy
搬	bjfu
扮	bjff
斑	bjww
扳	bjfy
瓣	bjxg
绊	bjsb
颁	bjfy
拌	bjfb
阪	bjey
坂	bjty
瘢	bjbu
钣	bjjy
癍	bjbw
攽	bjfw
柈	bjmb
昄	bjoy
湴	bjdy
靽	bjgb
𨭉	bjwj
帮	bhfj
膀	bhof
邦	bhfe
棒	bhmf
绑	bhse
榜	bhmf
傍	bhrf
磅	bhuf
梆	bhme
镑	bhjf
谤	bhyf
蚌	bhif
浜	bhdb
蒡	bhcf
玤	bhwf
搒	bhff
塝	bhtf
𠳐	bhke
保	bcrm
报	bcfy
包	bcbs
宝	bcby
抱	bcfb
暴	bcou
爆	bchu
薄	bccc
堡	bcrt
饱	bcub
豹	bcvu
胞	bcob
剥	bced
鲍	bcyb
褒	bcym
刨	bcbd
苞	bccb
鸨	bcbn
曝	bcou
煲	bcrh
葆	bccm
雹	bcyb
褓	bcpm
炮	bchb
龅	bcvb
孢	bczb
趵	bczu
枹	bcmb
瀑	bcdu
被	bwpp
备	bwwt
北	bwlb
背	bwbo
呗	bwkb
杯	bwmb
辈	bwfi
悲	bwfx
贝	bwkr
倍	bwrk
卑	bwpu
惫	bwwx
碑	bwuu
狈	bwqb
蓓	bwck
悖	bwxz
孛	bwuz
焙	bwhk
邶	bwbe
陂	bwep
钡	bwjb
褙	bwpo
碚	bwuk
鞴	bwgy
鐾	bwuj
鹎	bwpn
棓	bwmk
糒	bwmy
琲	bwwf
椑	bwmu
臂	bwuo
鞁	bwgp
𬇙	bwdb
本	bfma
奔	bfdc
笨	bfvb
贲	bfub
苯	bfcb
锛	bfjc
畚	bfst
犇	bfnn
坌	bfft
倴	bfrc
栟	bfmk
夯	bfdl
崩	bguo
蹦	bgzo
绷	bgso
迸	bgzk
甭	bgby
嘣	bgko
泵	bguu
镚	bgjo
甏	bgtw
琫	bgwf
祊	bgpf
蚌	bgif
比	bibb
必	bixp
毕	bibu
笔	bivm
避	bizx
闭	bimc
鼻	bizw
逼	bizt
屄	biub
臂	biuo
壁	biut
彼	birp
碧	biwu
币	bipj
陛	biet
鄙	bike
蔽	bicw
匕	bipv
毙	bibb
辟	biux
婢	binu
弊	bixc
璧	biuy
庇	bigb
敝	bixw
痹	bibw
弼	bigb
贲	biub
俾	biru
裨	bipu
薜	bicx
哔	biku
愎	bixw
吡	bikb
跸	bizu
妣	binb
篦	bivb
荜	bicu
狴	biqt
毖	bibb
蓖	bicb
嬖	biun
筚	bivu
髀	bigu
荸	bicz
濞	bidw
畀	bitw
赑	bibb
秕	bihb
箅	bivw
芘	bicb
佛	birf
襞	biuy
苾	bicb
滗	bidm
铋	bijb
庳	bigu
萆	bicu
皕	bibb
咇	bikb
舭	bivb
沘	bidb
珌	biwb
觱	biwy
诐	biyp
邲	bibe
佖	birb
馝	bihb
坒	bibt
泌	bidb
秘	bihb
鲾	biyt
边	bmzl
便	bmrg
变	bmwy
遍	bmzc
编	bmsc
辩	bmxy
鞭	bmgg
辨	bmxl
扁	bmhc
辫	bmxs
贬	bmbf
蝙	bmic
匾	bmkc
卞	bmwb
汴	bmdb
弁	bmsc
砭	bmuf
煸	bmhc
褊	bmpc
笾	bmvl
鳊	bmyc
昪	bmoc
忭	bmxb
苄	bmcb
抃	bmfb
碥	bmuc
萹	bmcc
𨚕	bmse
表	bnfy
标	bnmu
镖	bnju
彪	bnhp
飙	bnqf
婊	bnny
骠	bnmu
镳	bnjh
膘	bnou
裱	bnpy
杓	bnmu
飑	bnfb
俵	bnry
鳔	bnyu
摽	bnfu
瘭	bnbu
熛	bnhu
藨	bnch
儦	bnrh
骉	bnmm
瀌	bndh
幖	bnju
脿	bnoy
别	bpkd
憋	bpxx
瘪	bpbl
鳖	bpxy
蹩	bpxz
癿	bpbv
宾	bbbb
彬	bbmp
斌	bbwv
滨	bbdb
鬓	bbeb
缤	bbsb
镔	bbjb
濒	bbdy
槟	bbmb
殡	bbdb
膑	bbob
摈	bbfb
玢	bbwf
傧	bbrb
豳	bbuu
邠	bbfe
髌	bbgb
并	bkbk
兵	bkqb
冰	bkdu
病	bkbn
柄	bkmn
饼	bkuk
禀	bkwu
秉	bkqr
丙	bkan
炳	bkhn
槟	bkmb
摒	bkfk
屏	bkuk
邴	bkbe
昺	bkon
栟	bkmk
蛃	bkin
波	bodp
伯	borb
博	bouc
薄	bocc
脖	booz
拨	bofy
播	boft
勃	boul
玻	bowp
膊	booc
柏	bomb
搏	bofc
驳	bomx
剥	boed
泊	bodb
簸	bovp
帛	bobj
钵	bojb
跛	bozp
渤	bodl
菠	bocp
礴	bouc
孛	bouz
啵	bokp
舶	bovb
卜	bold
饽	bouz
铂	bojb
钹	bojy
箔	bovb
亳	bowq
擘	bouu
趵	bozu
檗	boum
鹁	boun
僰	bour
踣	bozk
镈	bojc
砵	boub
鲌	boyb
哱	bokz
嶓	bout
浡	bodz
馞	bohz
艴	bofb
蕃	boct
欂	bomc
袯	bopy
𬭛	bojp
不	buab
部	bule
步	buvu
布	buuj
补	bupb
怖	buxj
捕	buff
卜	buld
簿	buvc
埔	butf
哺	bukf
埠	butf
卟	bukb
堡	burt
逋	buzf
钚	bujb
晡	buof
瓿	bulw
醭	buyf
蔀	buce
埗	butu
𬷕	bufn
擦	cafu
嚓	caku
才	cdup
菜	cdcc
彩	cdcp
采	cdvm
财	cdbc
材	cdmc
猜	cdqo
蔡	cdcu
裁	cdgy
踩	cdzc
睬	cdoc
偲	cdrx
参	cjsp
残	cjdj
惨	cjxp
餐	cjdg
灿	cjhu
惭	cjxj
蚕	cjti
璨	cjwm
粲	cjdm
骖	cjmp
黪	cjlp
䅟	cjhp
藏	chci
苍	chcv
仓	chrv
舱	chvv
沧	chdv
伧	chrv
鸧	chlh
草	cccu
操	ccfm
肏	ccrr
艹	ccal
曹	ccco
嘈	ccko
糙	ccmk
槽	ccmo
漕	ccdo
屮	cckl
芔	cccc
艚	ccvo
螬	ccio
𥕢	ccuo
测	cedd
侧	cerd
册	ceka
策	cevu
厕	ceid
恻	cexd
岑	cfuv
涔	cfdv
参	cfsp
曾	cgbo
层	cguy
蹭	cgzo
噌	cgko
嶒	cguo
差	iayg
查	iamd
察	iabu
茶	iacm
插	iafj
诧	iayq
叉	iayd
岔	iafu
嚓	iaku
茬	iact
衩	iapi
碴	iaud
姹	ianq
杈	iami
搽	iafm
刹	iaxd
檫	iamu
槎	iamg
汊	iadi
镲	iaju
锸	iajj
馇	iaud
垞	iatq
侘	iarq
猹	iaqd
蹅	iazd
嵖	iaud
喳	iakd
𥻗	iamd
拆	idfi
柴	idvm
钗	idji
差	idyg
豺	idvc
侪	idrq
茝	idci
虿	idwi
瘥	idbg
产	ijwi
颤	ijwy
缠	ijsl
禅	ijpu
蝉	ijiu
搀	ijfd
铲	ijji
婵	ijnu
掺	ijfp
阐	ijmu
忏	ijxq
馋	ijud
潺	ijdz
蟾	ijik
谄	ijyj
谗	ijyd
孱	ijuz
冁	ijby
澶	ijdd
觇	ijvj
镡	ijju
羼	ijuy
廛	ijgt
巉	ijut
蒇	ijcb
韂	ijgk
躔	ijzt
刬	ijjd
浐	ijdi
襜	ijpk
瀍	ijdt
骣	ijmz
镵	ijjt
旵	ijou
啴	ijku
梴	ijmv
儳	ijrt
单	ijbu
辿	ijzu
𬊤	ijhu
长	ihpn
常	ihxj
场	ihtp
唱	ihko
厂	ihap
尝	ihxy
昌	ihoo
畅	ihup
肠	ihop
偿	ihry
敞	ihxw
怅	ihxi
倡	ihro
娼	ihno
嫦	ihnj
猖	ihqo
昶	ihyo
徜	ihrk
氅	ihxm
伥	ihri
裳	ihxy
菖	ihco
苌	ihci
阊	ihmo
鬯	ihkb
惝	ihxk
鲳	ihyo
鲿	ihyy
𬬮	ihji
超	ictk
朝	icuo
潮	icdo
吵	icku
嘲	icko
抄	icfu
炒	ichu
巢	icvg
钞	icju
晁	icov
焯	ichu
耖	iclu
怊	icxk
弨	icgk
绰	icsu
车	ieau
彻	ierd
扯	iefv
撤	iefw
澈	iedw
掣	ienu
砗	ieui
坼	ieti
尺	ieun
㬚	ieow
沉	ifdj
陈	ifed
臣	ifkl
晨	ifoi
尘	ifxt
趁	iftp
辰	ifiy
衬	ifpc
嗔	ifkb
琛	ifwm
称	ifhx
宸	ifbi
忱	ifxe
抻	iffu
碜	ifup
谌	ifyb
谶	ifyj
郴	ifme
棽	ifmv
瞋	ifob
榇	ifmm
龀	ifvb
疢	ifbh
梣	ifmv
煁	ifhb
𬘭	ifsm
成	igwv
城	igti
程	ighw
称	ighx
承	igln
诚	igyi
盛	igim
乘	igqr
撑	igfu
呈	igkw
惩	igrx
丞	igla
澄	igdb
逞	igzw
橙	igmb
骋	igmk
瞠	igot
秤	ighp
铖	igji
塍	igot
琤	igwy
裎	igpw
澂	igdw
埕	igtw
柽	igmt
蛏	igit
酲	igyw
枨	igmi
珵	igww
赪	igib
偁	igrr
宬	igbi
牚	igxy
珹	igwi
憕	igxb
庱	iggw
噌	igko
晟	igoi
铛	igje
吃	iikv
持	iifc
迟	iizi
赤	iitb
痴	iibk
池	iidy
尺	iiun
齿	iivr
斥	iijd
驰	iimy
耻	iiev
翅	iivx
哧	iiki
炽	iihv
嗤	iiki
蚩	iici
叱	iikb
弛	iigy
侈	iirx
啻	iiwk
敕	iiuw
螭	iiin
魑	iign
饬	iiul
笞	iivk
匙	iiob
踟	iizk
墀	iitn
豉	iidv
媸	iini
褫	iipj
鸱	iiun
彳	iipr
茌	iict
篪	iivj
瘛	iibx
摛	iifn
眵	iiox
傺	iiru
漦	iiwu
胣	iioy
瓻	iixw
痓	iibt
𫄨	iisj
冲	isdv
充	iswy
重	isql
虫	isvd
崇	isuu
宠	isbl
忡	isxv
憧	isxl
铳	isjy
舂	isij
艟	isvl
翀	isxv
茺	iscy
珫	iswy
漴	isdu
涌	isdy
种	ishv
㳘	isdy
摏	isfj
抽	izfy
仇	izrj
臭	izzq
丑	izvt
愁	izhx
筹	izvc
瞅	izoh
酬	izyv
绸	izsk
畴	iztc
踌	izzc
惆	izxk
稠	izhk
俦	izrc
雠	izry
瘳	izbp
犨	izrn
帱	izjc
杻	izmi
侴	izrd
椆	izmk
出	iuUU
处	iuwb
楚	iumz
除	iuem
初	iupd
触	iudi
厨	iuic
础	iuui
储	iuro
畜	iuxt
褚	iupo
搐	iuft
橱	iumc
躇	iuzo
雏	iudv
锄	iujl
矗	iuuq
杵	iumu
楮	iumo
怵	iuxu
黜	iuli
绌	iusi
蜍	iuim
刍	iude
滁	iudm
樗	iumk
蹰	iuzc
憷	iuxz
亍	iuad
俶	iury
斶	iuji
摴	iufk
䝙	iuvq
䢺	iuie
濋	iudz
琡	iuwy
𬺓	iuvz
欻	ixhq
揣	ikfe
踹	ikze
搋	ikfj
啜	ikky
传	irrv
穿	irby
船	irvk
川	irpl
喘	irke
串	irkl
钏	irji
椽	irmu
舛	irxf
遄	irze
氚	irqi
床	ilgm
窗	ilbw
创	ilrd
疮	ilbv
闯	ilmm
怆	ilxv
幢	iljl
噇	ilkl
吹	ivkq
垂	ivqt
锤	ivjt
捶	ivft
炊	ivhq
槌	ivml
陲	ivet
棰	ivmt
倕	ivrt
圌	ivke
春	iyio
纯	iyst
唇	iyik
蠢	iyii
淳	iydz
醇	iyyz
椿	iymo
鹑	iywn
莼	iyct
蝽	iyio
瑃	iywo
䲠	iyyo
堾	iyto
𬭚	iyjz
戳	ioxg
啜	ioky
龊	iovz
辍	ioiy
绰	iosu
踔	iozu
惙	ioxy
逴	iozu
此	civb
次	cidq
刺	ciud
词	ciyk
辞	ciux
慈	cibx
赐	cibw
磁	ciuy
伺	cirk
瓷	cidw
茨	cicq
雌	civv
祠	cipk
呲	cikb
疵	cibb
泚	cidb
糍	cimy
鹚	cibn
茈	cicb
跐	cizb
玼	ciwb
佽	cirq
兹	ciby
差	ciyg
莿	cicd
𫚖	civy
从	csRR
匆	csbd
聪	csex
丛	csra
葱	cscx
琮	cswu
淙	csdu
囱	cspw
骢	csmx
苁	cscr
枞	csmr
璁	cswx
熜	cshx
悰	csxu
凑	czdt
辏	czit
腠	czot
粗	cumq
促	curz
醋	cuyo
簇	cuvu
猝	cuqu
蹙	cuwz
蹴	cuzy
卒	cuwu
徂	curq
殂	cudq
蔟	cucu
窜	crbi
蹿	crzi
篡	crvs
撺	crfi
攒	crfb
汆	crru
爨	crjh
镩	crji
脆	cvov
催	cvrv
翠	cvxu
崔	cvuv
摧	cvfv
粹	cvmu
悴	cvxu
璀	cvwv
啐	cvku
萃	cvcu
瘁	cvbu
淬	cvdu
榱	cvmv
毳	cvmm
漼	cvdv
缞	cvsv
存	cyuz
村	cymc
寸	cyud
忖	cyxc
皴	cyyp
邨	cyte
错	cojo
措	cofo
挫	cofr
搓	cofg
撮	cofy
磋	coug
蹉	cozg
锉	cojr
厝	coio
矬	cour
嵯	coug
痤	cobr
鹾	cobg
脞	coor
瑳	cowg
棤	como
莝	cocr
大	daar
打	dafd
答	davk
达	dazd
搭	dafk
哒	dakd
瘩	dabk
嗒	dakk
沓	dauo
耷	dade
鞑	dagd
靼	dagd
妲	dand
褡	dapk
跶	dazd
怛	daxd
笪	davd
垯	datd
溚	dadk
炟	dahd
荙	dacd
鿎	daud
𨱏	dajk
𫟼	dajd
带	ddcj
代	ddry
待	ddrc
呆	ddkm
袋	ddry
戴	ddgg
黛	ddrh
歹	ddax
贷	ddrb
逮	ddzl
怠	ddsx
殆	dddk
岱	ddru
玳	ddwy
呔	ddkt
傣	ddru
大	ddar
迨	ddzk
绐	ddsk
叇	ddyl
埭	ddtl
骀	ddmk
轪	ddid
垈	ddrt
但	djrd
单	djbu
淡	djdh
担	djfd
弹	djgu
丹	djkd
蛋	djzi
胆	djod
旦	djoa
诞	djyv
耽	djee
惮	djxu
石	djak
眈	djoe
澹	djdk
掸	djfu
郸	djbe
殚	djdu
啖	djkh
氮	djqh
儋	djrk
聃	djer
箪	djvu
亶	djwd
疸	djbd
萏	djcj
瘅	djbu
疍	djzd
赕	djbh
憺	djxk
膻	djod
𫢸	djru
𬘘	djse
当	dhxe
党	dhxx
荡	dhcp
挡	dhfe
档	dhme
铛	dhje
裆	dhpe
宕	dhbu
砀	dhup
珰	dhwe
凼	dhku
谠	dhyx
垱	dhte
菪	dhcu
筜	dhve
𣗋	dhmx
𬍡	dhdy
到	dcgd
倒	dcrd
道	dczz
刀	dcvp
导	dcsc
岛	dcnu
盗	dcdm
叨	dckd
蹈	dczj
祷	dcpc
捣	dcfu
稻	dchj
悼	dcxu
纛	dcfx
忉	dcxd
氘	dcql
捯	dcfd
鱽	dcyd
舠	dcvd
帱	dcjc
的	deBU
地	dety
得	derc
德	derx
嘚	dekc
锝	dejc
得	dwrc
嘚	dwkc
扽	dfft
等	dgvc
灯	dghd
登	dgbb
瞪	dgob
邓	dgye
凳	dgbj
蹬	dgzb
噔	dgkb
镫	dgjb
磴	dgub
澄	dgdb
戥	dgog
嶝	dgub
璒	dgwb
地	dity
第	divd
弟	dibd
底	digu
低	diru
帝	diwj
敌	diuw
抵	difu
递	dizd
迪	dizy
滴	didg
的	diBU
蒂	dicj
狄	diqh
笛	divy
嘀	dikg
堤	ditz
邸	diue
嫡	ding
棣	diml
缔	disj
谛	diyj
涤	didm
荻	dich
娣	dind
诋	diyu
氐	diud
砥	diuu
镝	dijg
睇	diod
坻	ditu
柢	dimu
鞮	digz
羝	diyu
觌	diuj
籴	dirm
骶	digu
碲	diuj
禘	dipj
翟	dixv
踶	dizz
菂	dicu
髢	diey
玓	diwu
杕	dimd
蹢	dizg
媂	dinj
提	difz
䃅	diuu
䗖	diij
茋	dicu
𤧛	diwj
𬱖	diyy
嗲	dxkx
点	dmvh
电	dmyv
店	dmgv
殿	dmuu
典	dmqb
颠	dmuy
垫	dmft
甸	dmbt
惦	dmxv
奠	dmbd
掂	dmfv
癫	dmby
巅	dmuy
淀	dmdz
滇	dmdb
玷	dmwv
踮	dmzv
佃	dmrt
靛	dmfz
碘	dmub
钿	dmjt
簟	dmvu
癜	dmbu
坫	dmtv
阽	dmev
扂	dmhv
琔	dmwz
掉	dnfu
调	dnyk
屌	dnuj
雕	dnkv
吊	dnkj
钓	dnju
刁	dnva
叼	dnkd
貂	dnvk
凋	dndk
碉	dnuk
鲷	dnyk
铫	dnjv
铞	dnjj
窎	dnbn
汈	dndd
爹	dpfx
蝶	dpim
跌	dpzf
叠	dpyq
碟	dpum
迭	dpzf
谍	dpym
喋	dpkm
牒	dppm
堞	dptm
耋	dplt
鲽	dpym
昳	dpof
蹀	dpzm
瓞	dpgf
垤	dptt
绖	dpst
楪	dpmm
𫶇	dpuj
定	dkbz
顶	dkdy
丁	dkal
盯	dkod
订	dkyd
叮	dkkd
鼎	dkpo
钉	dkjd
锭	dkjz
町	dktd
仃	dkrd
酊	dkyd
腚	dkoz
玎	dkwd
碇	dkuz
疔	dkbd
啶	dkkz
耵	dked
萣	dkcz
丢	dqpq
铥	dqjq
动	dsyl
东	dsax
洞	dsdk
懂	dsxv
冬	dswd
董	dscv
冻	dsdd
栋	dsmd
咚	dskd
峒	dsuk
胴	dsok
侗	dsrk
恫	dsxk
鸫	dsdn
垌	dstk
硐	dsuk
氡	dsqd
胨	dsod
岽	dsud
𬟽	dsid
都	dzle
斗	dzud
抖	dzfd
豆	dzab
逗	dzzb
兜	dzpe
陡	dzez
窦	dzbd
痘	dzbb
蚪	dzid
蔸	dzce
篼	dzve
钭	dzjd
读	dzyd
度	dugy
独	duqi
毒	dufm
读	duyd
杜	dumt
肚	duot
赌	dubo
督	duuo
渡	dudy
嘟	duke
堵	duto
妒	dunh
都	dule
睹	duoo
笃	duvm
渎	dudd
镀	dujy
犊	dund
牍	dupd
蠹	dugi
黩	duld
阇	dumo
芏	duct
椟	dumd
髑	dugi
厾	duvq
𬭊	dujt
断	drvj
段	drpu
短	drub
端	drle
锻	drju
缎	drsu
煅	drhu
椴	drmu
耑	drue
簖	drvj
塅	drtu
瑖	drwu
对	dvyc
队	dver
堆	dvtv
兑	dvbx
怼	dvyx
碓	dvuv
祋	dvpu
顿	dyty
盾	dyio
蹲	dyzc
敦	dyww
沌	dydt
遁	dyzo
吨	dykt
钝	dyjt
墩	dytw
炖	dyht
盹	dyot
惇	dyxz
趸	dywz
礅	dyuw
蹾	dyzw
砘	dyut
镦	dyjw
囤	dykt
多	doxx
躲	doum
朵	dojm
夺	dodc
堕	doet
哆	dokx
跺	dozm
踱	dozy
舵	dovb
咄	doki
度	dogy
剁	dojd
铎	dojf
惰	doxo
垛	dotm
掇	dofy
哚	dokm
裰	dopy
埵	dott
饳	doui
亸	dowu
剟	doyd
驮	domd
㙍	doty
饿	eeuw
呃	eekv
恶	eeyx
额	eeby
俄	eerw
愕	eexk
鹅	eewn
噩	eewk
娥	eenw
厄	eeiv
峨	eeuw
鄂	eeke
遏	eezr
扼	eefv
鳄	eeyk
蛾	eeiw
婀	eenk
讹	eeyb
阿	eeek
锷	eejk
颚	eeky
鹗	eekn
萼	eeck
屙	eeuk
谔	eeyk
垩	eeyt
腭	eeok
欸	eesq
莪	eecw
轭	eeiv
苊	eecv
锇	eejw
崿	eeuk
姶	eenk
涐	eedw
哦	eeKW
堨	eetr
𥔲	eeuk
𫫇	eekx
嗯	enkx
恩	enyx
摁	enfx
蒽	encx
而	erAL
儿	erpv
二	eraa
尔	erdx
耳	erol
饵	erue
迩	erzx
贰	eryb
洱	erde
珥	erwe
铒	erje
鸸	eren
陑	eree
鲕	erye
咡	erke
耏	erep
发	fafy
法	fadq
罚	fasd
乏	fapv
伐	farg
阀	famg
筏	favg
砝	fauq
珐	fawq
垡	fart
反	fjiy
饭	fjuy
翻	fjcx
烦	fjhy
凡	fjjd
犯	fjqv
范	fjcv
番	fjct
繁	fjpx
返	fjzy
泛	fjdf
帆	fjjf
贩	fjby
樊	fjmd
藩	fjct
梵	fjmf
蕃	fjct
幡	fjjt
蘩	fjcx
璠	fjwt
矾	fjuf
畈	fjty
燔	fjht
钒	fjjf
氾	fjdv
蹯	fjzt
墦	fjtt
𫔍	fjjt
𬸪	fjcn
放	fhfw
房	fhhf
防	fhef
方	fhwv
仿	fhrf
芳	fhcf
访	fhyf
妨	fhnf
坊	fhtf
纺	fhsf
肪	fhof
舫	fhvf
枋	fhmf
昉	fhof
鲂	fhyf
邡	fhfe
钫	fhjf
牥	fhnf
蚄	fhif
飞	fwvd
非	fwLS
费	fwfb
菲	fwcf
废	fwgy
妃	fwnj
肥	fwob
啡	fwkf
匪	fwkf
沸	fwdf
肺	fwou
绯	fwsf
斐	fwfw
霏	fwyf
翡	fwfx
扉	fwhf
吠	fwkq
诽	fwyf
蜚	fwfi
狒	fwqf
腓	fwof
悱	fwxf
淝	fwdb
芾	fwcu
痱	fwbf
榧	fwmf
鲱	fwyf
篚	fwvf
朏	fwoi
棐	fwfm
镄	fwjb
剕	fwfd
𬴂	fwmf
分	ffbd
份	ffrf
纷	ffsf
奋	ffdt
愤	ffxb
粉	ffmf
氛	ffqf
吩	ffkf
芬	ffcf
焚	ffmh
坟	fftw
忿	fffx
粪	ffmg
汾	ffdf
玢	ffwf
酚	ffyf
棼	ffmf
偾	ffrb
鲼	ffyb
棻	ffcm
鼢	ffjf
翂	ffxf
瀵	ffdg
坋	fftf
豮	ffub
𣸣	ffdb
风	fgjx
封	fgtc
凤	fgjy
峰	fguf
疯	fgbf
锋	fgjf
枫	fgmf
丰	fgsl
奉	fgif
冯	fgdm
缝	fgsf
逢	fgzf
讽	fgyf
蜂	fgif
烽	fghf
俸	fgrf
沣	fgdf
沨	fgdf
酆	fgue
葑	fgcc
唪	fgkf
砜	fguf
赗	fgbo
浲	fgdf
崶	fguc
佛	forf
否	fzbk
缶	fzpk
服	fuoy
夫	fuer
父	fubx
复	fupw
福	fupt
府	fugc
副	fuad
负	fudb
付	furc
富	fubt
妇	fune
附	fuec
伏	furq
傅	furc
浮	fudz
扶	fuff
抚	fufw
符	fuvc
肤	fuof
腹	fuow
幅	fujt
咐	fukc
覆	fuxw
腐	fugr
弗	fugl
赴	futb
斧	fufj
俯	furc
赋	fubv
辅	fuif
芙	fucf
拂	fuff
甫	fuuy
俘	furz
缚	fusc
蝠	fuit
敷	fufw
脯	fuof
佛	furf
袱	fupq
腑	fuoc
辐	fuit
孚	fuvz
驸	fumc
釜	fufb
苻	fucc
匐	fubt
宓	fubb
阜	fulu
孵	fulz
馥	fuhw
茀	fucf
涪	fudk
茯	fucq
凫	funj
蚨	fuif
拊	fufc
蝮	fuiw
讣	fuyb
黼	fuyf
芾	fucu
趺	fuzf
怫	fuxf
氟	fuqf
蜉	fuiz
黻	fuyy
麸	fuff
绂	fusy
跗	fuzc
鲋	fuyc
罘	fusb
滏	fudb
郛	fuve
菔	fucy
桴	fumz
幞	fujf
祓	fupy
呋	fukf
绋	fusf
莩	fucz
赙	fubc
鄜	fule
芣	fucb
洑	fudq
簠	fuvm
榑	fumc
稃	fuhz
韨	fuwy
玞	fuwf
砆	fuuf
垺	futz
艴	fufb
㕮	fukf
㳇	fudf
琈	fuwz
𫓧	fujf
𫖯	fuvy
尬	gayj
嘎	gakg
伽	gark
噶	gakr
旮	gajo
咖	gakk
尕	ganx
尜	gaxx
轧	gaiv
钆	gajv
戛	gabg
该	gdyr
改	gdjw
盖	gdym
概	gdmw
丐	gdav
钙	gdjg
溉	gddw
赅	gdbr
垓	gdtr
陔	gder
戤	gdng
荄	gdcr
晐	gdor
𬮿	gdej
感	gjwx
干	gjau
敢	gjew
赶	gjtg
甘	gjca
尴	gjym
杆	gjmg
肝	gjog
竿	gjvg
橄	gjmw
赣	gjlb
秆	gjhg
柑	gjmg
擀	gjfg
玕	gjwg
淦	gjdj
泔	gjdg
矸	gjug
坩	gjtg
绀	gjsg
苷	gjcg
旰	gjog
疳	gjbg
酐	gjyg
澉	gjdw
虷	gjig
鳡	gjyx
㽏	gjdg
刚	ghkd
港	ghds
钢	ghjx
岗	ghux
冈	ghkx
缸	ghfg
纲	ghsx
罡	ghsv
杠	ghmg
肛	ghog
筻	ghvg
冮	ghdg
矼	ghug
堽	ghtv
戆	ghlx
扛	ghfg
㭎	ghmx
鿍	ghtf
高	gcwk
告	gcnk
搞	gcfk
糕	gcmh
稿	gchk
膏	gcwo
羔	gcyh
皋	gcbu
镐	gcjk
睾	gcpg
篙	gcvk
诰	gcyk
槁	gcmk
杲	gcom
缟	gcsk
锆	gcjk
郜	gcne
藁	gccm
槔	gcmu
筶	gcvk
个	geRL
哥	gekk
各	gewk
格	gemk
歌	gekq
革	gecu
隔	geeg
阁	gemk
葛	gecr
割	gebd
胳	geok
戈	geyp
搁	gefk
鸽	gern
疙	gebv
骼	gegk
嗝	gekg
硌	geuk
咯	gekk
铬	gejk
盖	geym
鬲	geal
圪	getv
蛤	geik
舸	gevk
膈	geog
虼	geiv
袼	gepk
哿	gelk
镉	gejg
仡	gerv
饹	geuk
塥	getg
滆	gedg
合	gerk
给	gwsk
跟	gfzg
根	gfmg
亘	gfad
艮	gfoy
哏	gfkg
茛	gfcg
更	ggan
耿	ggeh
哽	ggkg
耕	gglj
羹	ggyd
庚	gggr
梗	ggmg
赓	gggb
埂	ggtg
鲠	ggyg
绠	ggsg
浭	ggdg
暅	ggod
颈	ggjy
鹒	gggn
𬒔	gguo
公	gsbs
工	gsaa
功	gsgl
攻	gsgw
宫	gsbk
共	gscb
供	gsrg
恭	gsgx
弓	gsvv
贡	gsgb
躬	gsug
拱	gsfg
龚	gslg
巩	gsgf
蚣	gsig
觥	gsde
汞	gsgu
肱	gsos
珙	gswg
䢼	gsge
硔	gsug
够	gzjx
狗	gzqj
构	gzmg
勾	gzbs
购	gzbg
沟	gzdg
钩	gzjg
苟	gzcj
垢	gztk
篝	gzvr
佝	gzrj
媾	gznr
枸	gzmj
诟	gzyk
彀	gztu
缑	gzsu
遘	gzzr
鞲	gzgr
笱	gzvj
觏	gzfj
岣	gzuj
姤	gznk
雊	gzjv
耇	gzlj
句	gzbk
古	guuk
故	gugw
顾	guiy
股	guou
姑	gung
骨	gugo
孤	guzg
谷	gubk
鼓	gutv
固	gukg
估	gurg
咕	gukg
辜	gugx
雇	guhv
蛊	guim
菇	gucg
汩	gudo
箍	guvj
锢	gujg
沽	gudg
贾	guxb
鹘	gugn
臌	guov
牯	gung
轱	guig
鸪	gugn
梏	gumk
痼	gubg
钴	gujg
毂	gutu
崮	guug
诂	guyg
瞽	guto
菰	gucg
蛄	guig
羖	guyu
觚	gudg
嘏	gugy
罟	gusg
榖	gutu
酤	guyg
馉	guuo
牿	gunk
堌	gutg
蓇	guco
鲴	guyg
呱	gukg
鹄	gunn
瀔	gudu
𦙶	guog
挂	gxft
瓜	gxin
刮	gxud
寡	gxbf
卦	gxtb
呱	gxkg
褂	gxpb
剐	gxkd
鸹	gxun
诖	gxyt
栝	gxmu
胍	gxog
怪	gkxt
乖	gkqb
拐	gkfl
掴	gkfy
夬	gkvr
关	grbt
管	grvl
官	grbl
观	gryj
馆	grul
惯	grxb
冠	grbc
贯	grmb
灌	grdv
罐	grfv
棺	grml
倌	grrl
盥	grjm
掼	grfb
涫	grdl
鳏	gryx
鹳	grcn
瓘	grwv
祼	grpg
琯	grwl
毌	grml
筦	grvy
蒄	grcc
爟	grhv
纶	grsl
莞	grcy
鳤	gryl
光	glxe
广	gldi
逛	glzw
咣	glke
犷	glqg
胱	gloe
桄	glme
洸	glde
珖	glwe
垙	glte
𨐈	glie
鬼	gvps
贵	gvvb
规	gvfj
归	gvle
跪	gvzv
柜	gvmj
诡	gvyv
瑰	gvwg
桂	gvmt
龟	gvdd
轨	gvij
闺	gvmt
圭	gvtt
桧	gvmy
刽	gvrd
癸	gvbt
硅	gvut
妫	gvnw
珪	gvwt
皈	gvby
晷	gvok
鲑	gvyt
刿	gvud
鳜	gvyq
姽	gvnv
簋	gvvm
庋	gvgv
宄	gvbj
匦	gvkj
邽	gvte
鬶	gvfg
炅	gvoh
筀	gvvt
滚	gydg
棍	gymb
衮	gyyg
鲧	gyyx
磙	gyug
辊	gyib
绲	gysb
过	gozc
国	goky
果	gotm
郭	gowe
锅	gojn
裹	goyg
蝈	goiy
聒	goeu
帼	gojy
掴	gofy
椁	gomz
虢	govj
埚	gotn
呙	gokn
崞	gouz
腘	gooy
馘	goba
粿	gomg
蜾	goig
馃	goug
涡	godn
𬇹	gody
哈	hakk
蛤	haik
铪	hajk
还	hdzb
海	hddm
孩	hdzr
害	hdbk
骇	hdmr
嗨	hdkm
骸	hdgr
亥	hdwr
咳	hdkr
嗐	hdkk
氦	hdqr
醢	hdym
胲	hdor
咍	hdkk
汉	hjdy
寒	hjbd
喊	hjkk
韩	hjuw
汗	hjdg
含	hjrk
涵	hjdu
翰	hjux
憾	hjxx
罕	hjbg
撼	hjfx
悍	hjxg
瀚	hjdx
函	hjku
憨	hjex
旱	hjog
酣	hjyg
颔	hjry
邯	hjge
捍	hjfg
鼾	hjzg
晗	hjok
菡	hjcu
焊	hjhg
犴	hjqg
顸	hjgy
邗	hjge
焓	hjhk
蚶	hjig
扞	hjfg
撖	hjfw
虷	hjig
暵	hjot
浛	hjdk
琀	hjwk
㘎	hjkw
垾	hjtg
崡	hjuu
嵅	hjuk
蔊	hjcg
行	hhrd
航	hhvj
杭	hhmj
夯	hhdl
沆	hhdj
颃	hhwy
绗	hhsd
吭	hhkj
巷	hhgs
好	hcnz
号	hckk
毫	hcwm
豪	hcwu
浩	hcdk
耗	hclm
昊	hcot
郝	hcie
嚎	hcku
皓	hcbk
壕	hctu
嗥	hcku
颢	hcoy
濠	hcdu
蒿	hcck
灏	hcdy
貉	hcvk
蚝	hcim
薅	hccc
皞	hcbu
淏	hcdt
嚆	hckk
鄗	hcwe
镐	hcjk
和	heHK
何	herk
合	herk
喝	hekr
呵	hekk
河	hedk
赫	heii
核	hemr
贺	helb
盒	herm
荷	heck
鹤	hebn
禾	hepm
褐	hepr
嗬	hekk
壑	hebt
阖	hemm
吓	hekx
涸	hedg
劾	hewl
颌	hery
阂	hemr
诃	heyk
郃	here
纥	hesv
貉	hevk
龢	herh
鞨	hegr
翮	hegx
曷	heor
龁	hevv
盍	heqm
菏	heck
盉	hehm
饸	heuk
熇	hehk
鹖	heon
翯	hexk
垎	hetk
隺	hebv
𬌗	heyk
黑	hwlh
嘿	hwkh
𬭶	hwjh
很	hfrg
狠	hfqg
恨	hfxg
痕	hfbg
𬣳	hfyg
哼	hgkl
横	hgmh
衡	hgrd
恒	hgxd
亨	hgwl
蘅	hgcd
珩	hgwd
姮	hgnd
桁	hgmd
行	hgrd
鸻	hgrn
堼	hgtt
红	hssg
轰	hsiy
洪	hsdg
虹	hsig
宏	hsbs
鸿	hsdn
哄	hskg
弘	hsgs
烘	hshg
泓	hsds
闳	hsms
讧	hsyg
薨	hscb
訇	hsbk
荭	hscg
纮	hsss
吽	hskn
竑	hsls
蕻	hscg
翃	hsux
黉	hsxh
唝	hskb
玒	hswg
谼	hsgg
𫟹	hsjg
𬭎	hsjs
后	hzik
候	hzru
厚	hziz
吼	hzkv
侯	hzru
猴	hzqu
喉	hzku
逅	hzzk
篌	hzvu
瘊	hzbu
鲎	hzxy
堠	hztu
垕	hzit
齁	hzzj
骺	hzgk
糇	hzmu
郈	hzie
鲘	hzyk
𬭤	hzju
乎	hupl
呼	hukh
忽	huwx
护	hufh
胡	hugo
虎	huhj
湖	hudo
糊	humo
户	hudu
互	huah
狐	huqg
壶	huty
和	huHK
蝴	huio
惚	huxx
弧	hugg
唬	hukj
葫	huco
沪	hudh
扈	huhb
瑚	huwo
琥	huwj
浒	hudu
核	humr
鹄	hunn
鹘	hugn
斛	hudd
囫	hukw
祜	hupg
醐	huyo
唿	hukx
猢	huqo
笏	huvw
瓠	hudg
槲	humd
怙	huxg
煳	huho
鹕	hugn
滹	hudh
觳	hutu
岵	huug
烀	huhh
鄠	huye
戽	huhd
縠	hutu
冱	hudh
鹱	huny
淴	hudx
昒	huow
鳠	huyy
嫭	hunh
轷	huih
昈	huoh
话	hxyu
花	hxcb
化	hxrb
华	hxru
划	hxgd
画	hxat
滑	hxdo
哗	hxku
猾	hxqo
桦	hxmu
骅	hxmu
婳	hxnt
铧	hxju
砉	hxfu
觟	hxdt
坏	hktb
怀	hkxb
淮	hkdv
槐	hkmg
徊	hkrk
踝	hkzg
换	hrfd
缓	hrsy
还	hrzb
环	hrwb
幻	hryv
唤	hrkd
欢	hryq
患	hrix
焕	hrhd
桓	hrmd
鬟	hrey
宦	hrbi
寰	hrby
浣	hrdy
痪	hrbd
涣	hrdd
奂	hrdd
圜	hrky
豢	hrju
獾	hrqv
洹	hrdd
嬛	hrny
缳	hrsy
萑	hrcv
鲩	hryy
郇	hrbe
漶	hrdx
逭	hrzl
擐	hrfy
锾	hrjy
镮	hrjy
澴	hrdy
鹮	hrsn
貆	hrvd
峘	hrud
㬊	hroy
荁	hrcd
𤩽	hrwq
𬘫	hrsy
黄	hlcb
皇	hlbw
晃	hloe
慌	hlxi
荒	hlci
恍	hlxe
谎	hlyi
惶	hlxw
凰	hljw
煌	hlhw
簧	hlvh
徨	hlrw
蝗	hliw
幌	hlje
潢	hldh
璜	hlwh
遑	hlzw
磺	hluh
隍	hlew
肓	hlwo
湟	hldw
蟥	hlih
篁	hlvw
鳇	hlyw
滉	hlde
喤	hlkw
癀	hlbh
锽	hljw
艎	hlvw
瑝	hlww
媓	hlnw
㿠	hlbe
𨱑	hljh
会	hvry
回	hvkk
挥	hvfi
灰	hvuh
慧	hvfx
辉	hvxi
恢	hvxh
毁	hvju
悔	hvxm
惠	hvix
汇	hvdk
绘	hvsy
徽	hvrx
讳	hvyw
晖	hvoi
晦	hvom
贿	hvbo
秽	hvhx
卉	hvuc
麾	hvgm
诲	hvym
蕙	hvcx
彗	hvfe
诙	hvyh
喙	hvku
荟	hvcy
烩	hvhy
虺	hvwi
蛔	hvik
珲	hvwi
咴	hvkh
茴	hvck
恚	hvtx
洄	hvdk
袆	hvpw
隳	hvex
翚	hvxi
翙	hvux
浍	hvdy
蟪	hvix
硊	hvuv
橞	hvmx
哕	hvkx
桧	hvmy
溃	hvdb
㧑	hvfw
烠	hvho
𬤝	hvyx
𬭬	hvje
混	hydb
婚	hyno
魂	hyyg
昏	hyuo
浑	hydi
荤	hyci
馄	hyub
诨	hyyi
珲	hywi
阍	hymo
溷	hydu
惛	hyxo
碈	hyuo
或	hoga
活	hodu
火	hobr
伙	horh
获	hocq
惑	hogx
货	horb
祸	hopn
霍	hoyv
豁	hobg
和	hoHK
夥	hogx
嚯	hokv
藿	hocv
镬	hojy
蠖	hoiy
攉	hofv
钬	hojh
嚄	hoky
锪	hojx
劐	hocd
濩	hody
耠	holk
漷	hode
㸌	hohv
佸	horu
𬴃	homu
级	jisj
集	jirm
几	jipv
及	jipn
机	jimj
记	jiyj
季	jihz
击	jifk
急	jidx
鸡	jiyn
挤	jifq
系	jipx
即	jige
既	jigw
极	jimj
计	jiyu
激	jidw
继	jism
基	jict
寄	jibk
忌	jijx
己	jikv
际	jieu
纪	jisj
技	jifv
济	jidq
迹	jizb
吉	jitk
积	jihv
寂	jiby
疾	jibu
姬	jini
绩	jisb
祭	jixu
肌	jioj
辑	jiie
籍	jivo
圾	jitj
妓	jinv
嫉	jinu
饥	jiuj
剂	jiqd
奇	jidk
给	jisk
脊	jiro
稽	jiho
叽	jikj
唧	jike
讥	jiyj
藉	jico
冀	jibg
戟	jiug
棘	jiuu
缉	jise
悸	jixz
羁	jism
玑	jiwj
伎	jirv
霁	jiyq
矶	jiuj
髻	jiek
稷	jihw
岌	jiuj
汲	jidj
畸	jitk
笈	jivj
觊	jiuj
骥	jimg
嵇	jihu
蓟	jicd
箕	jivb
佶	jirk
瘠	jibo
畿	jigt
犄	jink
亟	jila
跻	jizq
殛	jida
暨	jigd
鲫	jiye
偈	jirr
齑	jiqj
蒺	jicu
芨	jicj
屐	jiuv
荠	jicq
楫	jime
赍	jiub
乩	jivv
麂	jilj
笄	jivk
芰	jicv
墼	jiit
鹡	jirn
剞	jidd
戢	jikg
虮	jiij
伋	jirj
垍	jitz
掎	jifk
洎	jidz
跽	jizx
嵴	jiuo
鲚	jiyq
蕺	jicg
罽	jisd
蹐	jizo
姞	jink
漈	jidu
穄	jihu
耤	jilo
觭	jidk
惎	jicx
期	jico
鱾	jiyj
㴔	jidx
堲	jigt
徛	jirk
枅	jimk
瀱	jidd
𪟝	jifl
𫌀	jipb
𫓯	jijt
𫓹	jijb
𬯀	jieq
𬶨	jigy
𬶭	jiyu
家	jxbu
加	jxlk
价	jxrj
假	jxry
架	jxlm
甲	jxtl
佳	jxrt
夹	jxar
贾	jxxb
嘉	jxtk
嫁	jxnu
驾	jxlm
颊	jxjy
迦	jxzk
伽	jxrk
茄	jxck
稼	jxhu
枷	jxmk
珈	jxwk
袈	jxly
戛	jxbg
葭	jxcy
浃	jxdj
胛	jxoj
痂	jxbk
笳	jxvk
岬	jxuj
槚	jxmb
钾	jxjj
荚	jxcj
郏	jxje
铗	jxjj
跏	jxzk
蛱	jxij
恝	jxfx
斝	jxkd
镓	jxju
瘕	jxby
泇	jxdk
𬂩	jxmj
见	jmke
间	jmmo
剑	jmqd
件	jmrn
建	jmzy
键	jmjy
渐	jmdj
简	jmvo
坚	jmlt
肩	jmho
箭	jmvd
舰	jmvj
尖	jmxd
监	jmlm
健	jmry
检	jmmq
减	jmdk
奸	jmng
艰	jmyg
兼	jmbb
鉴	jmlj
贱	jmbj
捡	jmfq
剪	jmbd
溅	jmdj
践	jmzj
荐	jmcz
歼	jmdq
拣	jmfd
煎	jmbh
俭	jmrq
涧	jmdo
茧	jmci
谏	jmyj
柬	jmur
笺	jmvj
缄	jmsk
戬	jmyg
锏	jmjo
碱	jmuk
睑	jmoq
翦	jmbx
饯	jmuj
蹇	jmbz
僭	jmro
菅	jmcl
毽	jmmy
腱	jmoy
謇	jmbk
蒹	jmcj
戋	jmga
槛	jmmm
鞯	jmgz
笕	jmvj
鹣	jmjn
搛	jmfj
缣	jmsj
鞬	jmgy
湔	jmdd
裥	jmpo
枧	jmmj
鲣	jmyt
趼	jmzk
谫	jmyd
踺	jmzy
楗	jmmy
暕	jmoj
牮	jmrn
篯	jmvj
犍	jmny
鳒	jmyj
𬣡	jmyj
将	jllc
江	jldg
讲	jlyj
降	jlef
蒋	jlcc
奖	jlld
僵	jlrj
姜	jlyn
疆	jlgj
匠	jlkj
浆	jllu
酱	jlly
缰	jlsj
绛	jlsf
桨	jllm
犟	jlgn
糨	jlmi
豇	jldg
茳	jlcg
礓	jluj
洚	jldf
耩	jllr
膙	jloi
鳉	jlyc
弶	jlgx
强	jlgi
虹	jlig
叫	jnkj
教	jnlw
交	jnwf
脚	jnoe
角	jndy
较	jnif
娇	jnnl
焦	jnrh
骄	jnml
轿	jnil
搅	jnfj
狡	jnqf
郊	jnwe
胶	jnof
觉	jnxj
嚼	jnkc
绞	jnsf
剿	jnvd
浇	jndw
缴	jnsw
蛟	jnif
椒	jnmy
侥	jnrw
矫	jnul
饺	jnuf
蕉	jnch
校	jnmf
礁	jnuh
皎	jnbf
窖	jnbk
跤	jnzf
佼	jnrf
姣	jnnf
酵	jnyz
鲛	jnyf
艽	jncj
湫	jndh
醮	jnyh
铰	jnjf
峤	jnul
茭	jncf
徼	jnrf
鹪	jnrn
敫	jnbw
噍	jnkh
僬	jnrh
峧	jnuf
滘	jndk
燋	jnhh
藠	jncb
皦	jnbw
斠	jnfd
璬	jnww
皭	jnbc
恔	jnxf
䴔	jnwn
漖	jndw
接	jpfn
解	jpdn
姐	jpnq
结	jpsk
界	jptj
节	jpce
杰	jpmh
街	jprt
借	jpro
介	jprl
阶	jpej
洁	jpdk
戒	jpgc
皆	jpbb
劫	jpql
截	jpgv
捷	jpfz
揭	jpfr
竭	jplr
届	jpuy
藉	jpco
婕	jpnz
睫	jpoz
诫	jpyc
桀	jpxm
芥	jpcj
桔	jpmk
诘	jpyk
价	jprj
颉	jpty
嗟	jpkg
孑	jpla
羯	jpyr
拮	jpfk
秸	jphk
玠	jpwj
碣	jpur
讦	jpyg
疥	jpbj
喈	jpkb
蚧	jpij
疖	jpbe
絜	jpfx
檞	jpmn
劼	jptl
骱	jpgj
鲒	jpyk
褯	jppj
湝	jpdb
岊	jpbu
楷	jpmb
㛃	jpfn
悈	jpxc
蜐	jpil
进	jbzj
今	jbrv
金	jbrb
紧	jblx
近	jbzj
尽	jbid
仅	jbry
禁	jbmu
劲	jbjl
锦	jbjj
巾	jbkl
筋	jbvl
津	jbdy
晋	jbyo
斤	jbil
谨	jbyw
浸	jbdy
襟	jbpu
矜	jbmv
瑾	jbww
烬	jbhd
靳	jbgj
噤	jbku
觐	jbcj
妗	jbnv
缙	jbso
堇	jbcw
槿	jbmw
衿	jbpv
荩	jbcd
馑	jbuw
卺	jblv
瑨	jbwo
廑	jbgw
琎	jbwj
赆	jbbd
溍	jbdo
祲	jbpy
浕	jbdd
墐	jbtw
殣	jbdw
珒	jbwy
𬬱	jbjj
经	jksj
惊	jkxx
竟	jkle
静	jkfy
精	jkmo
睛	jkoo
警	jkck
京	jkwx
境	jkte
景	jkox
敬	jkcw
镜	jkje
晶	jkoo
净	jkdy
径	jkrj
竞	jklx
井	jkca
颈	jkjy
靖	jklo
荆	jkcd
菁	jkco
阱	jkej
兢	jkux
憬	jkxx
婧	jkno
鲸	jkyx
劲	jkjl
茎	jkcj
丼	jkjd
旌	jkfu
痉	jkbj
泾	jkdj
迳	jkzj
璟	jkwx
胫	jkoj
儆	jkrw
靓	jkfj
粳	jkmg
獍	jkqe
刭	jkjd
腈	jkoo
肼	jkoj
倞	jkrx
璥	jkww
麖	jklx
鼱	jkjo
猄	jkqx
䴖	jkfn
汫	jkdj
竫	jkly
囧	jskk
炯	jshk
窘	jsbk
迥	jszk
炅	jsoh
颎	jsby
扃	jshk
冏	jskk
坰	jstk
泂	jsdk
䌹	jssk
𬳶	jsmk
就	jqWY
九	jqpv
酒	jqdy
久	jqdn
旧	jqlo
救	jqqw
究	jqbj
舅	jqjl
纠	jqsj
疚	jqbj
揪	jqfh
咎	jqwk
鹫	jqwn
鸠	jqjn
啾	jqkh
臼	jqpa
灸	jqjh
赳	jqtj
厩	jqiw
柩	jqmj
玖	jqwj
韭	jqfa
阄	jqmd
僦	jqry
鬏	jqeh
桕	jqmj
氿	jqdj
㠇	jquy
巨	jukk
举	juxf
居	juug
局	juuk
具	juqb
据	jufg
句	jubk
聚	jueu
剧	juud
距	juzj
惧	juxb
拒	jufj
俱	jurb
车	juau
矩	juuj
菊	jucm
拘	jufj
沮	judq
鞠	jugm
狙	juqq
橘	jumk
驹	jumj
飓	jufb
锯	jujg
咀	jukq
桔	jumk
踞	juzg
炬	juhj
掬	jufm
遽	juzu
倨	jurg
雎	juqv
钜	jujj
踽	juzy
裾	jupg
琚	juwg
疽	jubq
莒	juck
車	juuu
龃	juvq
苣	jucj
榉	jumf
讵	juyj
苴	jucq
鞫	jugk
焗	juhk
椐	jumg
锔	jujk
筥	juvk
屦	juun
窭	jubn
醵	juyu
蒟	jucj
犋	junb
澽	judu
娵	juny
秬	juhj
崌	juug
岠	juuj
砠	juuq
腒	juog
弆	juqc
泃	judj
岨	juuq
枸	jumj
柜	jumj
趄	jutq
䴗	juon
𬶋	juyj
卷	jrjv
娟	jrno
倦	jrrv
捐	jrfo
眷	jrjo
绢	jrso
鹃	jrkn
涓	jrdo
圈	jrkv
隽	jrrn
镌	jrjn
蠲	jrbi
狷	jrqo
鄄	jrxe
锩	jrjv
桊	jrjm
焆	jrho
觉	jtxj
绝	jtsb
决	jtdg
爵	jtvc
诀	jtyg
嚼	jtkc
掘	jtfi
角	jtdy
厥	jtiq
倔	jtri
撅	jtfq
珏	jtwy
崛	jtui
抉	jtfg
噘	jtkq
攫	jtfy
谲	jtyk
獗	jtqq
蹶	jtzq
傕	jtrv
蕨	jtcq
矍	jtoy
橛	jtmq
镢	jtjq
玦	jtwg
孓	jtln
桷	jtmy
觖	jtdg
爝	jthc
劂	jtid
玃	jtqy
砄	jtug
㵐	jtdq
𫔎	jtjk
𫘝	jtmg
均	jyty
君	jyyk
军	jybi
俊	jyrw
郡	jyye
峻	jyuw
钧	jyjy
骏	jymw
菌	jych
竣	jylw
浚	jydw
珺	jywk
麇	jylh
皲	jybp
焌	jyhw
葰	jycw
捃	jyfk
畯	jytw
莙	jyck
晙	jyow
筠	jyvy
隽	jyrn
鲪	jyyk
龟	jydd
䐃	jyoh
卡	kaub
咖	kakk
喀	kakk
咔	kakb
咯	kakk
胩	kaob
开	kdac
凯	kduj
慨	kdxw
铠	kdjj
楷	kdmb
恺	kdxj
揩	kdfb
锴	kdjb
忾	kdxq
闿	kdmj
剀	kdud
垲	kdtj
锎	kdjk
炌	kdhj
蒈	kdcb
看	kjuo
堪	kjtb
砍	kjuq
刊	kjgd
侃	kjri
坎	kjtq
勘	kjcl
槛	kjmm
阚	kjmw
瞰	kjow
龛	kjrl
戡	kjcg
崁	kjuq
莰	kjcq
衎	kjrg
磡	kjul
嵁	kjub
墈	kjtl
抗	khfj
康	khgl
扛	khfg
亢	khwj
炕	khhj
慷	khxl
糠	khml
伉	khrj
钪	khjj
闶	khmj
𡐓	khtl
𩾌	khyl
靠	kcnf
考	kclk
烤	kchk
铐	kcjk
拷	kcfk
犒	kcnk
尻	kcuj
栲	kcmk
㸆	kchf
洘	kcdk
可	keDK
刻	kewd
克	keux
客	kebk
科	kehd
课	keyg
颗	kegy
咳	kekr
渴	kedr
柯	kemk
棵	kemg
壳	ketj
氪	keqx
磕	keum
嗑	kekm
珂	kewk
苛	keck
轲	keik
瞌	keom
坷	ketk
恪	kexk
蝌	keid
颏	kewy
窠	kebg
稞	kehg
溘	kedm
疴	kebk
岢	keuk
锞	kejg
髁	kegg
骒	kemg
缂	kesg
牁	kepk
匼	kekk
炣	kehk
剋	kwud
肯	kfvo
恳	kfgx
啃	kfko
垦	kfgt
裉	kfpg
坑	kgtj
吭	kgkj
铿	kgjt
硁	kguj
空	ksbg
恐	ksgx
控	ksfg
孔	kszv
崆	ksug
箜	ksvg
倥	ksrg
硿	ksug
埪	kstg
口	kzla
扣	kzfk
寇	kzby
叩	kzke
抠	kzfq
蔻	kzcy
芤	kzcv
筘	kzvk
眍	kzoq
𫸩	kzgq
苦	kucg
哭	kukq
酷	kuyk
库	kugi
裤	kupi
枯	kumg
骷	kugg
窟	kubi
绔	kusk
喾	kuxk
刳	kudd
矻	kuuv
圐	kukf
夸	kxdk
跨	kxzk
垮	kxtk
胯	kxok
挎	kxfk
侉	kxrk
姱	kxnk
快	kkxg
块	kktg
筷	kkvg
会	kkry
蒯	kkcd
哙	kkky
侩	kkry
脍	kkoy
狯	kkqy
郐	kkre
鲙	kkyy
浍	kkdy
㧟	kkfk
宽	krbj
款	krtq
髋	krgj
况	kldx
狂	klqw
矿	klug
旷	klog
眶	klow
框	klmw
匡	klkw
筐	klvw
哐	klkw
邝	klge
诳	klyw
诓	klyw
圹	kltg
纩	klsg
贶	klbx
夼	kldi
洭	kldw
𫛭	klqn
亏	kvak
愧	kvxg
溃	kvdb
盔	kvum
魁	kvgd
窥	kvbj
奎	kvdt
葵	kvct
傀	kvrg
睽	kvot
馈	kvub
逵	kvzt
馗	kvjz
匮	kvkb
喟	kvko
夔	kvbw
篑	kvvb
岿	kvue
揆	kvft
聩	kveb
跬	kvzt
愦	kvxb
悝	kvxl
蝰	kvit
暌	kvot
蒉	kvcb
櫆	kvmd
骙	kvmt
喹	kvkt
煃	kvht
戣	kvbg
𫠆	kvvy
困	kykm
昆	kyob
坤	kytu
捆	kyfm
鲲	kyyb
琨	kywb
锟	kyjb
髡	kyew
阃	kymm
悃	kyxm
堃	kyft
焜	kyhb
壸	kyty
鹍	kyon
裈	kypi
醌	kyyb
婫	kynb
括	kofu
扩	kofg
阔	komu
廓	koge
蛞	koiu
啦	lakl
拉	lafl
辣	laxu
垃	latl
腊	laoo
喇	lakd
蜡	laio
落	lack
剌	laud
邋	lazv
旯	laoj
瘌	labd
砬	laul
镴	lajv
蝲	laid
鞡	lagl
𬶟	layd
来	ldam
莱	ldcl
赖	ldub
籁	ldvb
睐	ldol
癞	ldbb
濑	lddb
徕	ldrl
崃	ldul
涞	lddl
赉	ldlb
俫	ldrl
铼	ldjl
梾	ldml
蓝	ljcm
烂	ljhl
懒	ljxb
拦	ljfl
篮	ljvm
岚	ljuf
兰	ljbs
栏	ljml
览	ljlj
澜	ljdj
揽	ljfj
滥	ljdm
婪	ljmn
阑	ljmj
榄	ljmj
斓	ljwj
缆	ljsj
褴	ljpm
谰	ljyj
罱	ljsg
襕	ljpj
镧	ljjj
漤	ljdn
𬒗	ljuj
狼	lhql
浪	lhdl
郎	lhle
朗	lhlo
廊	lhge
螂	lhie
琅	lhwl
啷	lhke
榔	lhme
锒	lhjl
阆	lhml
烺	lhhl
蒗	lhcl
莨	lhcl
稂	lhhl
崀	lhul
㫰	lhol
㮾	lhlm
埌	lhtl
塱	lhlt
桹	lhml
筤	lhvl
蓢	lhco
老	lclb
劳	lccl
牢	lcbn
姥	lcnl
捞	lcfl
唠	lckl
佬	lcrl
烙	lchk
落	lcck
酪	lcyk
涝	lcdl
崂	lcul
嫪	lcnp
痨	lcbl
醪	lcyp
栳	lcml
铑	lcjl
耢	lcll
荖	lccl
铹	lcjl
络	lcsk
𫭼	lctl
了	leAL
乐	lepx
勒	legl
叻	lekl
饹	leuk
泐	ledl
鳓	leyl
仂	lerl
簕	levl
嘞	lekl
雷	lwyt
类	lwmd
泪	lwdo
累	lwtx
勒	lwgl
嘞	lwkl
蕾	lwct
磊	lwuu
垒	lwst
擂	lwft
肋	lwol
儡	lwrt
镭	lwjt
羸	lwwy
檑	lwmt
耒	lwfr
诔	lwyl
嫘	lwnx
酹	lwyc
缧	lwsx
礌	lwut
罍	lwtf
藟	lwct
癗	lwbt
冷	lgds
愣	lgxf
楞	lgmf
棱	lgmw
塄	lgtf
崚	lguw
堎	lgtw
里	litt
力	livp
理	liwl
李	limz
立	liwb
离	liwn
利	lihd
梨	lihm
丽	liad
历	liil
礼	lipv
厉	liiw
例	lird
莉	licd
黎	lihu
璃	liwn
励	liil
哩	likl
狸	liql
粒	liml
隶	liyu
吏	lign
栗	lixm
漓	lidn
雳	liyl
厘	liil
俐	lird
笠	livl
沥	lidl
篱	livn
戾	lihq
鲤	liyl
犁	lihn
砾	liul
荔	licl
砺	liuw
郦	lile
藜	licu
骊	limd
俪	lird
鹂	liln
蠡	lihi
栎	liml
唳	likq
喱	likl
罹	lisv
痢	libd
莅	licl
俚	lirl
逦	lizd
呖	likl
蛎	liiw
猁	liqd
澧	lidb
醴	liyb
娌	linl
蓠	licn
詈	lisk
黧	lihh
蜊	liid
鬲	lial
缡	lisn
傈	lirm
枥	liml
溧	lidm
坜	litl
疠	libw
粝	limw
嫠	liwn
锂	lijl
篥	livm
轹	liil
鲡	liyd
疬	libl
苈	licl
浬	lidl
跞	lizl
浰	lidd
鳢	liyb
醨	liyn
凓	lidm
朸	liml
㰀	limu
珕	liwl
𫵷	liul
𬍛	liwl
俩	lxrl
连	lmzi
脸	lmoq
联	lmet
练	lmsd
恋	lmwx
怜	lmxs
炼	lmhd
莲	lmci
链	lmji
帘	lmbj
廉	lmgj
敛	lmqw
涟	lmdi
镰	lmjj
琏	lmwi
濂	lmdj
潋	lmdw
殓	lmdq
奁	lmdq
裢	lmpi
楝	lmmj
裣	lmpq
鲢	lmyi
梿	lmmi
蠊	lmij
蔹	lmcw
瑓	lmwj
浰	lmdd
𬶠	lmyj
两	llar
量	llol
亮	llwj
良	lldg
凉	lldx
梁	lldm
辆	llil
粮	llml
谅	llyx
踉	llzl
靓	llfj
晾	llox
粱	lldm
魉	llgl
椋	llmx
莨	llcl
辌	llix
墚	lltm
悢	llxl
俍	llrl
俩	llrl
𫟅	llsx
𬜯	llcl
聊	lnee
料	lnmd
疗	lnbl
辽	lnzl
廖	lngp
撩	lnfx
寥	lnbp
僚	lnrx
缭	lnsx
燎	lnhx
撂	lnfk
獠	lnqx
潦	lndx
镣	lnjx
嘹	lnkx
瞭	lnox
寮	lnbx
蓼	lncp
尥	lnyu
鹩	lndn
嫽	lnnx
髎	lngp
钌	lnjl
蹽	lnzx
漻	lndp
憭	lnxx
簝	lnvx
橑	lnmx
了	lnAL
𪤗	lntp
列	lpdd
裂	lpdy
猎	lpqo
咧	lpkd
烈	lpdh
劣	lpul
冽	lpdd
趔	lptd
洌	lpdd
鬣	lpev
捩	lpfq
埒	lptc
躐	lpzv
峛	lpud
脟	lpoc
䴕	lpdn
𫚭	lpyv
林	lbmm
临	lblk
琳	lbwm
淋	lbdm
邻	lbre
麟	lblf
凛	lbdu
拎	lbfs
霖	lbym
鳞	lbyf
吝	lbwk
躏	lbzv
粼	lbmv
磷	lbuf
嶙	lbuf
蔺	lbcv
赁	lbrb
懔	lbxu
辚	lbif
遴	lbzf
廪	lbgu
潾	lbdf
檩	lbmu
璘	lbwf
啉	lbkm
瞵	lbof
膦	lbof
翷	lbmx
箖	lbvm
𬭸	lbjf
𬴊	lbmf
令	lkrs
灵	lkeh
领	lkry
另	lkkl
凌	lkdw
玲	lkws
零	lkys
龄	lkvs
铃	lkjs
陵	lkew
岭	lkus
菱	lkcw
伶	lkrs
聆	lkes
翎	lkrx
绫	lksw
〇	lkvv
羚	lkys
呤	lkks
苓	lkcs
泠	lkds
棂	lkmh
瓴	lkrw
酃	lkye
囹	lkks
鲮	lkyw
蛉	lkis
鸰	lkrn
柃	lkms
舲	lkvs
澪	lkds
昤	lkos
祾	lkpw
姈	lkns
棱	lkmw
㥄	lkxw
坽	lkts
流	lqdi
刘	lqwd
留	lqpt
六	lqwb
柳	lqme
溜	lqdt
琉	lqwi
榴	lqmt
浏	lqdd
瘤	lqbt
硫	lqui
遛	lqzt
陆	lqej
绺	lqsk
鎏	lqdj
馏	lqut
骝	lqmt
镏	lqjt
旒	lqfi
镠	lqjp
锍	lqji
熘	lqht
鹨	lqxn
飗	lqft
瑬	lqdy
珋	lqwe
罶	lqst
鹠	lqpn
疁	lqtp
碌	lquu
咯	lokk
龙	lsyp
隆	lseu
笼	lsvl
拢	lsfl
胧	lsol
珑	lswl
咙	lskl
聋	lsle
垄	lslt
窿	lsbu
陇	lsel
泷	lsdl
茏	lscl
眬	lsol
栊	lsml
砻	lslu
哢	lskc
昽	lsol
癃	lsbu
漋	lsdu
弄	lswc
𬕂	lsvb
楼	lzmn
搂	lzfn
漏	lzdy
髅	lzgn
露	lzyk
陋	lzen
喽	lzkn
娄	lzmn
篓	lzvn
镂	lzjn
偻	lzrn
蝼	lzin
耧	lzln
蒌	lzcn
瘘	lzbn
嵝	lzun
溇	lzdn
䁖	lzon
剅	lzdd
𦝼	lzon
𪣻	lztn
路	luzk
露	luyk
陆	luej
鲁	luyo
录	lueu
撸	lufo
卢	lubu
鹿	lugb
炉	luhh
碌	luuu
芦	luch
禄	lupu
虏	luhl
璐	luwk
噜	luko
戮	luxg
颅	luby
庐	lugh
漉	ludl
掳	lufl
辘	luil
赂	lubk
麓	luml
卤	lubx
鹭	luzn
泸	ludu
潞	ludk
橹	lumo
辂	luik
箓	luvu
胪	luou
鲈	luyu
轳	luiu
垆	lutu
渌	ludu
逯	luzu
鸬	lubn
甪	lupy
蕗	luck
舻	luvu
栌	lumu
簏	luvl
菉	lucu
氇	lumo
僇	lurp
琭	luwu
镥	lujo
勠	luxl
稑	luht
绿	lusu
澛	ludo
𫘧	lumu
𬬻	luju
乱	lruv
卵	lrpd
鸾	lrwn
峦	lrwu
挛	lrwu
銮	lrwj
孪	lrwz
栾	lrwm
滦	lrdm
脔	lrwr
娈	lrwn
论	lyyl
伦	lyrl
轮	lyil
仑	lyrb
沦	lydl
抡	lyfl
纶	lysl
囵	lykl
𫭢	lytl
𬬭	lyjl
落	lock
罗	losx
洛	lodk
络	losk
裸	lopg
逻	lozx
骆	lomk
萝	locx
螺	loix
锣	lojx
啰	lokx
珞	lowk
骡	lomx
摞	lofx
雒	lowv
荦	locn
箩	lovx
椤	lomx
咯	lokk
烙	lohk
猡	loqx
蠃	lowi
脶	loon
漯	lodx
倮	lorg
捋	lofc
瘰	lobx
泺	lodl
蓏	locg
绿	lvsu
律	lvry
率	lvwu
旅	lvfy
吕	lvkk
缕	lvsn
侣	lvrk
驴	lvmh
屡	lvun
履	lvuw
捋	lvfc
滤	lvdx
虑	lvhx
褛	lvpn
铝	lvjk
闾	lvmk
榈	lvmk
氯	lvqu
膂	lvfo
稆	lvhk
葎	lvcy
垏	lvty
偻	lvrn
梠	lvmk
𦝼	lvon
略	lttk
掠	ltfx
锊	ltjc
䂮	ltfu
圙	ltkm
吗	maKM
马	mava
妈	manm
麻	magm
嘛	makm
骂	makm
码	maum
玛	mawm
抹	mafw
蚂	maim
蟆	maid
犸	maqm
杩	mamm
祃	mapm
摩	magu
买	mdad
卖	mdud
埋	mdtl
脉	mdoy
麦	mdfw
迈	mdzw
霾	mdyl
劢	mdwl
唛	mdkw
荬	mdcd
鿏	mdjw
满	mjdl
慢	mjxy
漫	mjdy
曼	mjoy
蛮	mjwi
瞒	mjol
蔓	mjcy
馒	mjuy
幔	mjjy
谩	mjyy
鳗	mjyy
缦	mjsy
嫚	mjny
墁	mjty
颟	mjcy
螨	mjil
鞔	mjge
镘	mjjy
鬘	mjey
埋	mjtl
𬜬	mjck
忙	mhxw
芒	mhcw
茫	mhcw
氓	mhwm
莽	mhcc
盲	mhwo
蟒	mhic
邙	mhwe
漭	mhdc
牤	mhnw
硭	mhuw
尨	mhlp
牻	mhnp
厖	mhip
杧	mhmw
毛	mcpv
冒	mcoo
貌	mcve
猫	mcqt
矛	mcyp
帽	mcjo
贸	mcpb
茂	mccw
茅	mccm
冇	mcuk
髦	mcem
卯	mcpe
锚	mcjt
袤	mcym
瑁	mcwo
懋	mcmx
牦	mcnm
铆	mcje
昴	mcoe
耄	mclm
蟊	mcmi
峁	mcue
旄	mcfm
楙	mcmm
泖	mcde
瞀	mcmo
茆	mcce
蝥	mcmi
芼	mccm
眊	mcom
鄚	mcce
么	meps
没	mwdu
美	mwyd
每	mwpm
妹	mwnw
眉	mwuo
梅	mwmm
媚	mwno
魅	mwgw
玫	mwww
枚	mwmw
媒	mwnm
霉	mwym
昧	mwow
煤	mwhm
寐	mwbw
嵋	mwuo
莓	mwcm
湄	mwdo
袂	mwpg
楣	mwmo
酶	mwym
镁	mwjd
郿	mwue
浼	mwde
鹛	mwun
镅	mwjo
渼	mwdd
糜	mwgm
媄	mwnd
瑂	mwwo
们	mfrm
门	mfdv
闷	mfmx
懑	mfdx
扪	mffm
焖	mfhx
钔	mfjm
呇	mfuk
𫞩	mfwl
梦	mgmx
猛	mgqm
蒙	mgcu
孟	mgzm
盟	mgom
朦	mgou
萌	mgco
懵	mgxo
檬	mgmu
蜢	mgim
勐	mgzl
虻	mgiw
艨	mgvu
锰	mgjm
幪	mgju
艋	mgvm
蠓	mgiu
瞢	mgco
甍	mgcw
獴	mgqu
礞	mguu
㠓	mguu
鹲	mgcn
𫑡	mgke
密	mibu
米	mibm
迷	mizm
秘	mihb
弥	migx
蜜	mibi
眯	miom
咪	mikm
谜	miym
觅	mivj
靡	migf
泌	midb
糜	migm
谧	miym
宓	mibb
祢	mipx
芈	micf
麋	milm
弭	mige
汨	mido
猕	miqx
幂	mibj
縻	migx
蘼	micf
醚	miym
祕	mipb
敉	mimw
嘧	miku
蓂	micl
脒	miom
洣	midm
醾	miym
面	mmao
免	mmde
勉	mmdl
绵	mmsj
眠	mmom
棉	mmmj
缅	mmsm
冕	mmoe
腼	mmom
娩	mmne
湎	mmdm
沔	mmdg
渑	mmdd
眄	mmog
丏	mmgl
勔	mmml
愐	mmxm
偭	mmrm
𩾃	mmye
妙	mnnu
秒	mnhu
描	mnft
苗	mnct
庙	mngy
渺	mndu
瞄	mnot
淼	mnuu
喵	mnkt
缈	mnsu
藐	mnce
邈	mnze
眇	mnou
杪	mnmu
鹋	mncn
缪	mnsp
灭	mpah
蔑	mpcd
乜	mpvv
咩	mpky
篾	mpvd
民	mbvv
敏	mbpw
抿	mbfm
悯	mbxw
闵	mbmw
珉	mbwm
泯	mbdm
闽	mbmi
皿	mbka
岷	mbum
旻	mbow
缗	mbso
愍	mbmx
湣	mbdo
黾	mbkd
忞	mbwx
鳘	mbpy
苠	mbcm
明	mkoo
名	mkxk
命	mkre
鸣	mkkn
冥	mkbl
铭	mkjk
茗	mkck
瞑	mkol
溟	mkdl
酩	mkyk
暝	mkol
螟	mkil
洺	mkdk
谬	mqyp
缪	mqsp
魔	mogg
莫	mocd
默	molq
模	momd
摸	mofd
摩	mogu
磨	mogu
末	moam
漠	modd
抹	mofw
墨	molt
没	modu
麽	mogm
陌	moeb
寞	mobd
蓦	mocm
沫	modw
膜	mood
茉	mocw
嬷	monm
蘑	mocu
摹	mocu
馍	moud
谟	moyd
嫫	mond
秣	mohw
殁	modu
貊	movb
靺	mogw
貘	movd
镆	mojd
瘼	mobd
耱	molu
万	moav
无	moay
脉	mooy
藦	mocu
𬙊	most
某	mzgm
谋	mzym
眸	mzon
缪	mzsp
牟	mzsn
哞	mzkn
鍪	mzmj
侔	mzrn
蛑	mzin
目	muke
母	mumd
木	muur
模	mumd
慕	mucx
幕	mucj
姆	munm
穆	muhp
牧	munw
墓	muct
沐	mudm
暮	muco
拇	mufm
牡	munt
亩	muwt
募	mucl
睦	muot
苜	muco
呒	mukw
钼	mujo
毪	mumn
仫	murm
牟	musn
𧿹	muzm
𬭁	mujm
那	nave
哪	nake
拿	naru
娜	nane
纳	nasn
呐	nakn
捺	nafu
衲	napn
钠	najn
肭	naon
镎	naju
乸	naym
南	naug
𦰡	nace
奶	ndnn
奈	nddu
耐	ndec
乃	ndvp
鼐	ndno
氖	ndqn
萘	ndcu
艿	ndcn
柰	ndmu
佴	ndre
迺	ndzx
耏	ndep
难	njyv
男	njtl
南	njug
喃	njkg
楠	njmg
囡	njkn
赧	njiy
腩	njog
蝻	njig
萳	njcg
婻	njng
囊	nhgy
囔	nhky
馕	nhuy
攮	nhfy
曩	nhox
齉	nhzy
脑	ncox
闹	ncmj
恼	ncxx
挠	ncfw
瑙	ncwx
孬	ncbz
呶	ncky
淖	ncdu
猱	ncqm
铙	ncjw
垴	nctx
蛲	nciw
硇	ncux
臑	ncoe
峱	ncqu
呢	nekb
讷	neyn
哪	neke
内	nwkr
馁	nwun
嫩	nfnw
恁	nfrx
能	ngsb
你	niRX
尼	niub
妮	ninb
泥	nidb
逆	nizn
拟	nifr
腻	niob
倪	nire
霓	niye
匿	nikk
溺	nidg
昵	niob
睨	nioe
旎	nifb
怩	nixb
猊	niqe
鲵	niye
伲	nirb
坭	nitb
铌	nijb
麑	nile
薿	nicz
呢	nikb
𨺙	niee
𫐐	niie
𫠜	nive
年	nmpf
念	nmrx
黏	nmhv
拈	nmfv
捻	nmfx
碾	nmuy
撵	nmfi
蔫	nmch
廿	nmca
辇	nmfi
鲇	nmyv
鲶	nmyx
埝	nmtx
粘	nmmv
娘	nlnl
酿	nlyl
鸟	nnna
尿	nnuu
袅	nnny
茑	nncn
脲	nnou
捏	npft
聂	npey
孽	npcz
涅	npdt
蹑	npzy
嗫	npky
啮	npkr
臬	npzm
镊	npjy
镍	npjm
蘖	npcm
颞	npey
糵	npcm
陧	npet
乜	npvv
嵲	npum
菍	npcx
𫔶	npmm
您	nbrx
宁	nkbd
凝	nkdz
狞	nkqd
拧	nkfd
柠	nkmd
咛	nkkd
泞	nkdd
佞	nkrn
甯	nkby
苧	nkcd
聍	nked
牛	nqpu
扭	nqfi
纽	nqsi
妞	nqni
钮	nqji
拗	nqfl
忸	nqxi
狃	nqqi
杻	nqmi
弄	nswc
农	nsby
浓	nsdy
哝	nsky
侬	nsry
脓	nsoy
秾	nshy
𬪩	nsyy
耨	nzlc
怒	nunx
努	nunl
奴	nuny
弩	nung
驽	nunm
孥	nunz
傉	nurc
胬	nunr
砮	nunu
笯	nuvy
暖	nroy
诺	noyk
挪	nofe
懦	noxe
喏	nokk
糯	nome
娜	none
傩	norv
搦	nofg
锘	nojk
𦰡	noce
女	nvva
钕	nvjn
恧	nvex
衄	nvpi
虐	nthe
疟	ntbe
哦	ooKW
噢	ookd
喔	ookt
欧	ouqq
偶	ourd
呕	oukq
殴	ouqu
鸥	ouqn
藕	oucd
区	oukx
怄	ouxq
瓯	ouqw
讴	ouyq
沤	oudq
耦	ould
𠙶	oukl
𬉼	ouhq
怕	paxb
爬	pavb
帕	pajb
啪	pakb
趴	pazb
扒	pafb
琶	pawb
耙	palb
葩	pacb
杷	pamb
筢	pavb
舥	pavb
潖	padb
派	pddy
排	pdff
拍	pdfb
牌	pdpu
徘	pdrf
湃	pddf
俳	pdrf
哌	pdky
簰	pdvu
蒎	pdcy
迫	pdzb
盘	pjvm
判	pjbd
叛	pjby
盼	pjof
潘	pjdt
攀	pjmu
畔	pjtb
蹒	pjzl
磐	pjvu
蟠	pjit
槃	pjvm
爿	pjvl
泮	pjdb
袢	pjpb
磻	pjut
襻	pjpu
番	pjct
胖	pjob
旁	phwf
胖	phob
庞	phgl
彷	phrf
乓	phqd
螃	phif
滂	phdf
逄	phzf
雱	phyf
磅	phuf
耪	phlf
鳑	phyf
膀	phof
跑	pczb
炮	pchb
泡	pcdb
抛	pcfl
袍	pcpb
咆	pckb
刨	pcbd
庖	pcgb
狍	pcqb
疱	pcbb
匏	pcdb
脬	pcoz
陪	pwek
配	pwYJ
佩	pwrj
培	pwtk
赔	pwbk
裴	pwfy
沛	pwdu
呸	pwkp
胚	pwop
帔	pwjp
辔	pwsk
霈	pwyu
旆	pwfu
醅	pwyk
锫	pwjk
衃	pwpb
喷	pfkb
盆	pffm
湓	pfdm
碰	pguy
朋	pgoo
鹏	pgon
捧	pgff
砰	pgup
蓬	pgcf
篷	pgvf
彭	pgtp
棚	pgmo
膨	pgop
澎	pgdp
怦	pgxp
嘭	pgkp
烹	pgwh
抨	pgfp
芃	pgcf
硼	pguo
蟛	pgip
堋	pgto
椪	pgmy
弸	pggo
淜	pgdo
搒	pgff
皮	pipy
批	pifb
屁	piub
疲	pibp
匹	pike
劈	piud
披	pifp
脾	piou
啤	piku
辟	piux
僻	pirx
霹	piyx
痞	pibk
譬	piuk
噼	pikx
琵	piwb
癖	pibx
媲	pinb
丕	piba
毗	pitb
坯	pitp
纰	pisb
裨	pipu
睥	piou
邳	pibe
砒	piub
陂	piep
貔	pivb
枇	pimb
罴	pish
圮	pitj
鼙	pitu
蚍	piib
铍	pijp
郫	pipe
仳	pirb
伾	pirp
蜱	piiu
埤	pitu
嚭	pitk
陴	pieu
淠	pidw
甓	piuw
狉	piqp
澼	pidx
椑	pimu
否	pibk
鲏	piyp
䴙	piun
苉	picp
𬳵	pimp
片	pmpv
偏	pmrc
骗	pmmc
篇	pmvc
翩	pmhx
便	pmrg
骈	pmmk
蹁	pmzc
谝	pmyc
胼	pmok
犏	pmnc
楩	pmmg
扁	pmhc
㛹	pmng
𡎚	pmtc
飘	pnxf
漂	pndu
票	pnxu
瞟	pnou
嫖	pnnu
瓢	pnxg
缥	pnsu
剽	pnxd
骠	pnmu
朴	pnmb
殍	pndz
嘌	pnku
螵	pniu
蔈	pncu
薸	pncu
撇	ppfw
瞥	ppxo
苤	ppcp
氕	ppqp
𬭯	ppjw
品	pbkk
拼	pbfk
贫	pbfb
频	pbvy
聘	pbek
嫔	pbnb
颦	pbvu
姘	pbnk
牝	pbnb
玭	pbwb
𬞟	pbcy
平	pkau
凭	pkrj
评	pkyp
瓶	pkbw
屏	pkuk
萍	pkcp
苹	pkcp
坪	pktp
乒	pkqp
娉	pknk
枰	pkmp
鲆	pkyp
俜	pkrk
泙	pkdp
洴	pkdk
帡	pkjk
荓	pkck
冯	pkdm
蚲	pkip
涄	pkdk
玶	pkwp
破	poup
婆	podn
迫	pozb
颇	popy
坡	potp
魄	pobg
泼	pody
泊	podb
珀	powb
叵	pokk
鄱	poce
粕	pomb
笸	povk
皤	pobt
钋	pojb
钷	pojk
桲	pomz
朴	pomb
繁	popx
陂	poep
䥽	pojy
酦	poyy
剖	pzld
抔	pzfb
裒	pzyj
掊	pzfk
普	pubo
扑	pufb
铺	pujf
朴	pumb
仆	purb
谱	puyo
葡	pucf
菩	puck
噗	pukf
浦	pudf
瀑	pudu
蒲	pucf
埔	putf
濮	pudf
璞	puwf
圃	pukf
溥	pudc
匍	pubf
莆	pucf
堡	purt
脯	puof
蹼	puzf
曝	puou
氆	pumo
潽	pudo
酺	puyf
镨	pujo
镤	pujf
蒱	pucf
墣	putf
穙	puhf
起	qitj
气	qipv
其	qicb
奇	qidk
期	qico
七	qiav
器	qikk
骑	qimk
齐	qiwl
弃	qiwc
妻	qiun
企	qirv
启	qihk
旗	qifb
欺	qicq
岂	qiuj
汽	qidq
棋	qimb
琪	qiwb
泣	qidl
凄	qidn
漆	qidu
戚	qiwx
契	qifd
乞	qipv
祈	qipj
麒	qilb
歧	qivv
琦	qiwk
祁	qipe
绮	qisk
栖	qimx
炁	qiwh
淇	qidb
崎	qiuk
砌	qiud
蹊	qizd
祺	qipb
迄	qizv
杞	qimj
岐	qiuv
脐	qioq
颀	qijy
沏	qidd
跂	qizv
憩	qiux
萋	qicn
嘁	qikx
耆	qilo
芑	qicj
蜞	qiib
讫	qiyv
祇	qipu
鳍	qiyo
亓	qiaw
葺	qice
柒	qidm
綦	qicx
蕲	qicj
畦	qitt
芪	qicu
圻	qitj
萁	qicb
骐	qimb
欹	qidq
碛	qiub
汔	qidv
锜	qijk
槭	qimx
蛴	qiiq
屺	qiuj
亟	qila
玘	qiwj
桤	qimj
埼	qitk
棨	qihm
郪	qiue
磜	qiuu
鲯	qiyb
愭	qixo
碶	qiud
俟	qiru
婍	qink
洓	qidu
稽	qiho
缉	qise
荠	qicq
䓫	qick
𨙸	qive
𬨂	qiiu
卡	qxub
恰	qxxk
掐	qxfj
洽	qxdk
拤	qxfb
葜	qxcd
袷	qxpk
髂	qxgk
前	qmbd
钱	qmjj
千	qmpu
潜	qmdo
牵	qmdn
倩	qmro
浅	qmdj
签	qmvq
歉	qmjq
欠	qmdr
乾	qmuv
谦	qmyj
迁	qmzq
遣	qmzl
茜	qmcx
芊	qmcq
嵌	qmuq
虔	qmhw
铅	qmjk
谴	qmyl
钳	qmjg
黔	qmlv
堑	qmit
骞	qmbm
佥	qmra
仟	qmrq
缱	qmsl
纤	qmsq
阡	qmeq
钎	qmjq
钤	qmjv
掮	qmfo
芡	qmcq
荨	qmcc
扦	qmfq
愆	qmrx
悭	qmxt
搴	qmbu
慊	qmxj
褰	qmby
汧	qmdk
肷	qmoq
蒨	qmco
靬	qmgg
椠	qmim
杄	qmmq
鹐	qmdn
岍	qmuk
圲	qmtq
犍	qmny
伣	qmrj
墘	qmtv
磏	qmuj
𬘬	qmso
强	qlgi
枪	qlmv
墙	qltk
抢	qlfv
腔	qlog
呛	qlkv
跄	qlzv
蔷	qlck
锵	qljc
羌	qlyv
戕	qlpg
戗	qlrg
襁	qlpi
嫱	qlnk
樯	qlmk
镪	qlji
炝	qlhv
羟	qlyj
蜣	qliv
玱	qlwv
锖	qljo
蔃	qlci
巧	qngk
悄	qnxo
瞧	qnoh
敲	qnwy
桥	qnml
乔	qnyl
俏	qnro
翘	qnyx
窍	qnbk
鞘	qngo
憔	qnxh
峭	qnuo
跷	qnzw
侨	qnrl
樵	qnmh
撬	qnfm
锹	qnjh
壳	qntj
谯	qnyh
橇	qnmm
诮	qnyo
荞	qncl
峤	qnul
愀	qnxh
劁	qnrd
硗	qnuw
鞒	qngl
硚	qnul
缲	qnsm
雀	qnxv
且	qpoa
切	qpqd
窃	qpbd
怯	qpxq
妾	qpln
茄	qpck
惬	qpxj
趄	qptq
锲	qpjd
伽	qprk
挈	qpfu
箧	qpvj
慊	qpxj
郄	qpxe
亲	qblm
秦	qbih
琴	qbwv
侵	qbry
勤	qbcl
寝	qbby
擒	qbfn
钦	qbjq
芹	qbcj
沁	qbdx
禽	qbrn
覃	qbxu
噙	qbkn
衾	qbry
揿	qbfq
芩	qbcv
溱	qbdh
吣	qbkx
嗪	qbkh
锓	qbjy
檎	qbmn
骎	qbmy
慬	qbxw
嵚	qbuq
梣	qbmv
请	qkyo
轻	qkij
清	qkdo
青	qkfo
情	qkxo
庆	qkgd
晴	qkoo
倾	qkry
卿	qkpg
擎	qkcu
顷	qkby
蜻	qkio
箐	qkvo
氢	qkqj
罄	qktf
磬	qktu
亲	qklm
綮	qkhx
氰	qkqo
黥	qklx
檠	qkcm
鲭	qkyo
苘	qkck
圊	qkko
碃	qkuo
庼	qkgy
勍	qkwl
倩	qkro
穷	qsbl
琼	qswx
穹	qsbg
茕	qscu
邛	qsge
筇	qsve
蛩	qsgi
銎	qsgj
䓖	qscl
求	qqud
球	qqwq
秋	qqhh
丘	qqja
邱	qqqe
囚	qqkr
裘	qqqy
酋	qqby
仇	qqrj
虬	qqiv
糗	qqmq
鳅	qqyh
蚯	qqiq
俅	qqrq
泅	qqdr
遒	qqzy
逑	qqzq
湫	qqdh
楸	qqmh
犰	qqqj
萩	qqch
蝤	qqiy
璆	qqwp
巯	qqji
赇	qqbq
鹙	qqhn
鞧	qqgy
鼽	qqzj
訄	qqjk
龟	qqdd
𨱇	qqjq
去	quTS
取	quey
区	qukx
趣	quty
曲	qukc
屈	quui
躯	quuq
驱	qumq
娶	quen
趋	qute
渠	qudm
觑	quhj
瞿	quov
岖	quuq
蛐	quiq
蛆	quiq
衢	qurv
祛	qupq
黢	qulw
癯	qubv
苣	qucj
阒	qumq
龋	quvy
蕖	qucm
蘧	qucu
朐	quoj
璩	quwu
劬	qujl
磲	quum
诎	quyi
蠼	quiy
焌	quhw
袪	qupq
氍	quom
鸲	qujn
麹	qufm
胠	quoq
灈	qudv
鼩	qujj
竘	qulj
岨	quuq
戌	quwa
㭕	qumq
䓛	quci
坥	qutq
𪨰	quuq
𫭟	qutq
全	qrrw
权	qrmy
拳	qrju
圈	qrkv
劝	qryl
泉	qrbu
犬	qrdd
券	qrjd
蜷	qriv
痊	qrbw
诠	qryw
荃	qrcw
颧	qrcy
绻	qrsv
铨	qrjw
筌	qrvw
鬈	qrev
醛	qryw
悛	qrxw
佺	qrrw
畎	qrtq
棬	qrmv
鳈	qryu
辁	qriw
婘	qrnv
瑔	qrwu
𨟠	qroe
却	qtqe
确	qtuy
缺	qtfg
雀	qtxv
瘸	qtbr
鹊	qtcn
阙	qtmq
阕	qtmt
榷	qtmv
炔	qthg
悫	qttx
碏	qtuo
埆	qtty
𬒈	qtxu
群	qyyy
裙	qypk
逡	qyzw
麇	qylh
囷	qykh
然	rjxh
染	rjdm
燃	rjhh
冉	rjkt
髯	rjer
苒	rjcr
蚺	rjir
䎃	rjrx
让	rhyu
嚷	rhkx
壤	rhtx
攘	rhfx
瓤	rhxg
禳	rhpx
穰	rhhx
瀼	rhdx
蘘	rhcx
儴	rhrx
绕	rcsw
扰	rcfy
饶	rcuw
娆	rcnw
桡	rcmw
荛	rccw
热	refh
惹	recx
人	rfPN
任	rfrt
认	rfyr
忍	rfrx
仁	rfre
刃	rfdd
韧	rfwr
壬	rfpt
饪	rfut
仞	rfrr
纫	rfsr
稔	rfhx
荏	rfct
妊	rfnt
衽	rfpt
轫	rfir
纴	rfst
讱	rfyr
葚	rfcb
仍	rgrn
扔	rgfn
日	rika
驲	rimo
容	rsbg
荣	rscm
融	rsgi
蓉	rscg
绒	rssu
溶	rsdg
戎	rsgu
榕	rsmg
茸	rsce
熔	rshg
冗	rsbj
嵘	rsum
镕	rsjg
蝾	rsim
狨	rsqu
瑢	rswg
肉	rznr
柔	rzmm
揉	rzfm
蹂	rzzm
糅	rzmm
鞣	rzgm
𫐓	rzim
如	runk
入	rupn
辱	ruic
乳	ruvv
儒	rure
茹	ruck
汝	rudn
蠕	ruie
孺	ruze
褥	rupc
嚅	ruke
濡	rude
缛	rusc
襦	rupe
溽	rudc
蓐	rucc
洳	rudk
薷	ruce
颥	ruyy
嬬	rune
铷	rujk
软	rriq
阮	rrey
堧	rrtd
瓀	rrwe
媆	rrnd
瑞	rvwe
锐	rvjx
蕊	rvcx
睿	rvbo
芮	rvcn
蚋	rvin
蕤	rvcu
枘	rvmn
汭	rvdn
润	rydw
闰	rymw
若	rock
弱	rogg
偌	rork
箬	rovk
婼	ronk
爇	roch
蒻	rocg
鄀	roce
撒	safw
洒	sadx
飒	salf
仨	sars
萨	saci
卅	saai
靸	sagj
挲	sadu
潵	sadw
脎	saom
赛	sdbb
塞	sdbt
腮	sdox
噻	sdkt
鳃	sdyx
三	sjae
散	sjcw
伞	sjru
叁	sjss
馓	sjuw
毵	sjsm
糁	sjmp
丧	shty
桑	shym
嗓	shkm
搡	shfm
颡	shyy
磉	shum
扫	scfe
骚	scmi
嫂	scny
搔	scfi
臊	scom
瘙	scbi
缫	scsg
埽	sctj
溞	scdi
色	sedb
瑟	sewb
涩	sedv
塞	sebt
啬	setk
穑	sehk
铯	sejb
璱	sewb
森	sfmm
僧	sgro
啥	uakg
傻	uarw
杀	uaxm
刹	uaxd
莎	uacu
煞	uadh
纱	uasu
沙	uadu
厦	uaiw
霎	uayn
砂	uauu
鲨	uady
裟	uady
铩	uajm
嗄	uakw
歃	uaqq
痧	uabu
唼	uakn
挲	uadu
杉	uamp
晒	udox
筛	udvj
色	uddb
山	ujkl
删	ujcd
闪	ujmr
善	ujyk
扇	ujhx
衫	ujpp
珊	ujwc
擅	ujfd
姗	ujnc
讪	ujyu
杉	ujmp
陕	ujej
煽	ujhx
膳	ujok
跚	ujzc
潸	ujdo
缮	ujsk
汕	ujdu
禅	ujpu
膻	ujod
赡	ujbk
鳝	ujyk
舢	ujvu
苫	ujcv
嬗	ujnd
鄯	ujye
骟	ujmx
蟮	ujik
墡	ujtk
剡	ujhd
疝	ujbu
芟	ujcu
埏	ujtv
钐	ujjp
嶦	ujuk
晱	ujoh
单	ujbu
栅	ujmc
烻	ujhv
𫮃	ujtu
上	uhba
伤	uhrl
商	uhwk
尚	uhxk
赏	uhxb
晌	uhok
裳	uhxy
殇	uhdp
觞	uhdp
熵	uhhk
墒	uhtk
绱	uhsk
垧	uhtk
少	ucxp
烧	uchw
稍	ucho
绍	ucsk
哨	ucko
邵	ucde
勺	ucbd
梢	ucmo
韶	uclk
劭	ucdl
捎	ucfo
芍	uccu
苕	ucck
艄	ucvo
筲	ucvo
潲	ucdo
蛸	ucio
睄	ucoo
召	ucdk
鞘	ucgo
柖	ucmk
玿	ucwk
射	ueuc
设	ueyu
舍	uerg
蛇	ueib
舌	ueqk
涉	uedu
摄	uefy
社	uept
奢	uedo
慑	uexy
赦	ueiw
折	uefj
佘	ueru
麝	uelc
赊	uebu
畲	uert
猞	ueqg
歙	uerq
阇	uemo
滠	uedy
厍	ueii
拾	uefk
𪨶	ueui
谁	uwyv
神	ufpu
深	ufdm
身	ufzc
甚	ufcb
什	ufru
伸	ufru
沈	ufde
审	ufbu
申	uftl
慎	ufxb
呻	ufku
渗	ufdp
婶	ufnu
绅	ufsu
肾	uflo
参	ufsp
莘	ufcx
珅	ufwu
蜃	ufii
哂	ufkx
谌	ufyb
娠	ufni
燊	ufhm
瘆	ufbp
椹	ufmb
葚	ufcb
砷	ufuu
糁	ufmp
棽	ufmv
诜	ufye
甡	ufuu
谂	ufyx
矧	uful
胂	ufou
侁	ufre
瞫	ufou
鲹	ufyp
屾	ufuu
𬬹	ufju
𬳽	ufme
生	ugpf
声	ugtu
圣	ugyt
胜	ugou
升	ugpc
省	uguo
剩	ugqd
盛	ugim
绳	ugsd
牲	ugnu
笙	ugvu
晟	ugoi
甥	ugul
昇	ugoc
乘	ugqr
嵊	ugur
眚	uguo
陞	uget
是	uiOZ
时	uioc
事	uigy
实	uibd
十	uial
师	uilj
使	uirl
屎	uium
世	uicv
始	uink
失	uipf
士	uiua
湿	uidy
石	uiak
识	uiyv
视	uipj
势	uifl
市	uiwj
室	uibt
式	uiyg
示	uiex
试	uiyg
史	uikn
食	uirg
施	uify
适	uizu
释	uicf
诗	uiyc
尸	uivp
氏	uipv
侍	uirc
拾	uifk
饰	uiuj
誓	uifk
驶	uimu
逝	uizj
狮	uiqj
匙	uiob
噬	uikr
仕	uirt
矢	uipd
拭	uifg
嗜	uiko
似	uirr
蚀	uiui
恃	uixc
柿	uimj
弑	uixg
轼	uiig
虱	uivi
谥	uiym
舐	uiuu
媞	uinz
什	uiru
豕	uiau
莳	uicc
筮	uivr
蓍	uico
螫	uiii
炻	uihu
鲥	uiyc
奭	uidb
湜	uidz
埘	uitc
酾	uiyd
祏	uipu
栻	uimg
贳	uiub
铈	uijj
鲺	uiyi
鼫	uiju
邿	uite
鸤	uiun
嘘	uiky
峙	uiuc
殖	uidq
浉	uidj
襫	uipb
䏡	uiou
䴓	uibn
𫚕	uiyj
𬤊	uiyz
手	uzpy
受	uzvy
收	uzjw
首	uzbz
守	uzbc
熟	uzwh
兽	uzbk
授	uzfy
瘦	uzby
售	uzrk
寿	uzfc
狩	uzqc
绶	uzsy
艏	uzvz
书	uuvd
数	uumw
术	uumd
树	uumc
属	uuuy
熟	uuwh
叔	uuuy
束	uugr
舒	uury
输	uuid
述	uuzu
殊	uudw
鼠	uujv
疏	uuvi
淑	uudy
竖	uull
署	uuso
墅	uult
梳	uumi
蜀	uusi
恕	uunx
倏	uurq
暑	uuoo
庶	uugh
漱	uudq
赎	uubd
姝	uunw
枢	uumq
蔬	uuci
薯	uuco
曙	uuoo
抒	uufy
孰	uuww
戍	uuwd
塾	uuwt
纾	uusy
澍	uudc
黍	uuhu
沭	uudu
秫	uuhu
殳	uujy
菽	uucy
腧	uuod
毹	uurm
摅	uufx
婌	uuny
鄃	uure
隃	uued
陎	uuew
𬬸	uuju
刷	uxud
耍	uxen
唰	uxkd
帅	uklj
摔	ukfu
甩	ukyv
衰	ukyv
率	ukwu
蟀	ukiu
栓	urmw
拴	urfw
涮	urdd
闩	urma
腨	uroe
双	ulyy
爽	uldx
霜	ulyo
孀	ulno
鹴	ulyn
骦	ulmo
礵	uluo
泷	uldl
漴	uldu
水	uvln
谁	uvyv
睡	uvot
税	uvhx
帨	uvjx
说	uvyx
顺	uyiy
瞬	uyof
吮	uyky
舜	uyvf
楯	uymo
说	uoyx
烁	uohl
硕	uouy
朔	uono
铄	uojl
槊	uonm
搠	uofo
妁	uonu
蒴	uoco
数	uomw
死	sidb
四	sike
思	sitx
似	sirr
斯	sicj
司	sivk
丝	sisa
私	sihs
寺	sitc
撕	sifj
肆	siey
嘶	sikj
厮	siij
伺	sirk
祀	sips
嗣	sikk
饲	siuk
俟	siru
巳	sikv
泗	sids
咝	siks
姒	sinr
汜	sids
驷	sims
鸶	sisn
兕	siae
涘	sidu
缌	sisx
蛳	siij
澌	sidj
锶	sijx
笥	sivk
耜	sill
飔	sifx
凘	sidj
虒	siij
㟃	siuk
楒	simx
送	sszt
松	ssmg
宋	ssbm
耸	ssre
诵	ssyy
怂	ssrx
𪨊	ssur
颂	ssgy
嵩	ssuk
悚	ssxu
讼	ssyg
忪	ssxg
淞	ssdg
崧	ssug
竦	sslu
凇	ssdg
菘	sscg
娀	ssnu
㧐	ssfy
搜	szfy
艘	szvy
嗽	szkq
嗖	szky
叟	szjy
飕	szfy
擞	szfw
馊	szuy
薮	szcw
廋	szgy
溲	szdy
嗾	szku
锼	szjy
瞍	szoy
蒐	szcg
螋	sziy
诉	suyi
速	suzu
苏	sucb
素	sufx
宿	subb
俗	surg
肃	suyb
塑	sunt
酥	suyh
簌	suvq
粟	suxm
稣	suyh
溯	sudo
愫	suxx
夙	sujd
谡	suyw
窣	subu
蔌	sucq
涑	sudu
嗉	sukx
僳	surm
觫	sudu
骕	sumb
甦	sugu
鹔	suyn
傃	surx
蹜	suzb
缩	susb
𫗧	suuu
算	srVC
酸	sryw
蒜	srcu
狻	srqw
虽	svki
随	sveo
岁	svux
碎	svuu
遂	svzu
隋	sveo
髓	svgo
祟	sviu
穗	svhx
邃	svzu
隧	sveu
绥	svsn
燧	svhu
尿	svuu
睢	svov
眭	svot
荽	svcn
谇	svyu
濉	svdv
穟	svhu
璲	svwu
襚	svpu
旞	svfu
𫟦	sviu
𬭼	svju
孙	syzx
损	syfb
笋	syvy
隼	syru
荪	sycx
狲	syqx
榫	symu
飧	syxg
所	sohj
索	soux
缩	sosb
锁	sojb
嗦	sokx
梭	somw
琐	sowb
唆	sokw
娑	sodn
蓑	socv
桫	somu
唢	sokb
睃	soow
嗍	soko
挲	sodu
葰	socw
羧	soyw
溹	sodx
莎	socu
他	taRY
她	tany
它	tabb
塔	tatk
踏	tazo
拓	tafu
塌	tatx
榻	tamx
蹋	tazx
沓	tauo
遢	tazx
挞	tafd
趿	tazj
獭	taqb
祂	tapy
闼	tamd
鳎	tayx
铊	tajb
溻	tadx
阘	tamx
褟	tapx
鞳	tagk
鿎	taud
太	tddd
台	tdsk
态	tdtx
抬	tdfk
泰	tdiu
胎	tdok
汰	tddt
苔	tdck
跆	tdzk
钛	tdjt
邰	tdse
薹	tdct
肽	tdot
炱	tdsh
骀	tdmk
酞	tdyt
鲐	tdyk
谈	tjyh
叹	tjky
弹	tjgu
探	tjfm
坦	tjtd
贪	tjrb
坛	tjty
摊	tjfv
滩	tjdv
谭	tjyu
潭	tjdu
瘫	tjbv
毯	tjmh
炭	tjuh
忐	tjux
檀	tjmd
痰	tjbh
碳	tjuh
袒	tjpd
昙	tjoy
坍	tjtd
覃	tjxu
郯	tjhe
镡	tjju
倓	tjrh
锬	tjjh
钽	tjjd
璮	tjwd
惔	tjxh
菼	tjch
澹	tjdk
榃	tjmt
磹	tjuu
躺	thuk
汤	thdp
糖	thmk
趟	thtk
烫	thdh
堂	thxt
唐	thgk
膛	thot
倘	thrk
淌	thdk
棠	thxm
塘	thtk
搪	thfk
螳	thit
傥	thrx
瑭	thwk
镗	thjt
帑	thnj
樘	thmt
蹚	thzt
嘡	thkt
溏	thdk
螗	thik
羰	thyh
镋	thjx
耥	thlk
埫	thtk
铴	thjp
䣘	thxe
鄌	thge
套	tcds
逃	tczv
讨	tcyc
桃	tcmv
涛	tcdc
掏	tcff
陶	tcef
滔	tcdj
萄	tccf
淘	tcdf
韬	tcwj
焘	tcfh
啕	tckf
饕	tckg
绦	tcsm
叨	tckd
洮	tcdv
梼	tcmc
绹	tcsf
弢	tcgy
鼗	tcvv
慆	tcxj
𫘦	tcmf
特	tenc
忑	texx
慝	tekx
铽	tejx
忒	teyx
忒	twyx
疼	tgbd
腾	tgom
藤	tgcu
滕	tgou
誊	tgjk
螣	tgoi
縢	tgox
熥	tghy
䲢	tgoy
提	tifz
题	tioy
体	tirb
替	tifo
踢	tizw
梯	timd
蹄	tizj
惕	tixw
涕	tidd
啼	tikj
剔	tiod
屉	tiuu
剃	tibd
嚏	tikz
倜	tirk
缇	tisz
逖	tizh
荑	ticy
醍	tiyz
悌	tixd
媞	tinz
鹈	tibn
绨	tisd
锑	tijd
裼	tipw
趯	titv
遆	tizj
鳀	tiyz
擿	tifg
䏲	tiod
䴘	tiin
瑅	tiwz
𫘨	timz
天	tmad
田	tmku
甜	tmug
添	tmdx
填	tmtb
舔	tmux
恬	tmxu
腆	tmob
阗	tmmb
殄	tmdp
忝	tmtx
湉	tmdu
畋	tmtw
觍	tmqj
瑱	tmwb
掭	tmfx
盷	tmoy
淟	tmdb
晪	tmob
沺	tmdt
黇	tmhv
条	tnwm
调	tnyk
跳	tnzv
挑	tnfv
眺	tnov
迢	tnzk
窕	tnbv
佻	tnrv
笤	tnvk
祧	tnpv
髫	tnek
粜	tnim
龆	tnvk
蜩	tnik
鲦	tnym
朓	tnov
苕	tnck
嬥	tnnv
铁	tpjf
贴	tpbv
帖	tpjv
餮	tpdg
萜	tpcv
听	tkkj
停	tkrd
厅	tkid
挺	tkft
庭	tkgt
廷	tkzt
婷	tknd
亭	tkwd
艇	tkvt
霆	tkyt
汀	tkdd
蜓	tkit
铤	tkjt
葶	tkcd
莛	tkct
珽	tkwt
梃	tkmt
烃	tkhj
渟	tkdd
颋	tkzy
桯	tkmw
侹	tkrt
䗴	tkit
圢	tktd
烶	tkht
𬘩	tkst
同	tskk
通	tszy
痛	tsby
统	tssy
童	tsll
铜	tsjk
筒	tsvk
桶	tsmy
捅	tsfy
瞳	tsol
桐	tsmk
佟	tsrd
彤	tsdp
恸	tsxl
潼	tsdl
嗵	tsky
僮	tsrl
酮	tsyk
仝	tsrg
茼	tsck
曈	tsol
砼	tsug
烔	tshk
垌	tstk
橦	tsml
哃	tskk
穜	tshl
鲖	tsyk
峒	tsuk
洞	tsdk
㛚	tsny
峂	tsud
𦒍	tslx
𫍣	tsyk
头	tzdd
投	tzfu
偷	tzrd
透	tzzn
骰	tzgu
突	tubq
图	tukd
土	tuua
徒	turz
吐	tukt
途	tuzm
涂	tudm
屠	tuuo
兔	tudd
秃	tuhj
凸	tula
荼	tucm
菟	tuct
钍	tujt
堍	tutt
酴	tuym
稌	tuhm
腯	tuoo
葖	tucq
梌	tumm
㻬	tuwk
𬳿	tumm
团	trkc
湍	trde
抟	trfv
彖	trhu
疃	trtl
猯	trqe
煓	trhe
推	tvfv
退	tvzg
腿	tvog
颓	tvhy
褪	tvpg
忒	tvyx
蜕	tvix
煺	tvhg
魋	tvgv
𬯎	tveb
吞	tytk
屯	tyav
臀	tyuo
豚	tyou
囤	tykt
饨	tyut
暾	tyow
鲀	tyyt
坉	tytt
忳	tyxt
焞	tyhz
褪	typg
拖	tofy
脱	toox
托	tofq
妥	tovn
拓	tofu
陀	toeb
驼	tomb
唾	tokt
驮	tomd
佗	torb
椭	tomo
坨	totb
沱	todb
砣	toub
鸵	tonb
跎	tozb
柁	tomb
酡	toyb
橐	togm
柝	tomi
侂	torq
鼍	tokd
庹	togi
箨	tovf
萚	tocf
铊	tojb
圫	totq
𬶍	toyb
哇	wakt
瓦	waad
娃	want
挖	wafv
袜	wapw
蛙	wait
娲	wann
洼	wadt
佤	warw
窊	wabg
腽	waom
坬	watg
凹	wala
畖	watg
外	wdxb
歪	wdbv
崴	wdun
完	wjby
万	wjav
晚	wjoe
玩	wjwy
弯	wjwg
碗	wjuv
湾	wjdg
婉	wjnv
挽	wjfe
腕	wjov
宛	wjbv
顽	wjyy
丸	wjld
卍	wjvl
惋	wjxv
莞	wjcy
蜿	wjiv
琬	wjwv
纨	wjsw
婠	wjnl
皖	wjby
绾	wjsl
剜	wjbd
菀	wjcv
豌	wjdv
畹	wjtv
烷	wjhy
脘	wjoy
芄	wjcw
塆	wjtg
椀	wjmv
蔓	wjcy
𬇕	wjdw
王	what
望	whww
往	whrv
忘	whwx
网	whkx
亡	whwv
汪	whdw
妄	whwn
旺	whow
枉	whmw
惘	whxw
罔	whkw
魍	whgw
尢	whuv
辋	whiw
尪	whyw
为	wwld
位	wwrl
微	wwrj
未	wwam
围	wwkw
卫	wwea
威	wwwn
味	wwkw
维	wwsv
危	wwdv
委	wwhn
伟	wwrw
谓	wwyo
唯	wwkv
慰	wwux
尾	wwum
喂	wwky
魏	wwhg
薇	wwcj
惟	wwxv
违	wwzw
韦	wwfv
畏	wwty
伪	wwrw
尉	wwuc
胃	wwto
巍	wwug
蔚	wwcc
偎	wwry
萎	wwcn
苇	wwcw
炜	wwhw
玮	wwww
猥	wwqy
娓	wwnm
帷	wwjv
纬	wwsw
渭	wwdo
桅	wwmv
嵬	wwug
猬	wwqo
隗	wweg
葳	wwcn
痿	wwbn
闱	wwmw
煨	wwhy
诿	wwyn
韪	wwow
逶	wwzn
帏	wwjw
圩	wwty
潍	wwdv
溦	wwdj
鲔	wwyo
艉	wwvm
隈	wwey
洧	wwdo
沩	wwdw
廆	wwgg
霨	wwyc
涠	wwdw
亹	wwwq
碨	wwuy
煟	wwho
琟	wwwv
硙	wwuj
薳	wwcy
峗	wwuv
崴	wwun
洈	wwdv
螱	wwui
鳂	wwyy
鳚	wwyc
𣲗	wwdw
𫇭	wwcw
𬀩	wwow
𬱟	wwdy
𬶏	wwyv
问	wfmk
文	wfwx
温	wfdm
闻	wfme
稳	wfhx
吻	wfkw
纹	wfsw
雯	wfyw
蚊	wfiw
芠	wfcw
瘟	wfbm
紊	wfwx
汶	wfdw
玟	wfww
刎	wfwd
炆	wfhw
璺	wfjy
阌	wfmy
辒	wfim
榅	wfmm
蕰	wfcm
鳁	wfym
𫘜	wfmw
翁	wggx
嗡	wgkx
瓮	wggw
蓊	wgcx
蕹	wgcv
滃	wgdx
鹟	wggn
𬭩	wgjx
我	woGA
握	woft
窝	wobn
卧	woib
沃	wody
喔	wokt
倭	worn
涡	wodn
龌	wovt
蜗	woin
渥	wodt
斡	woud
幄	wojt
挝	wofc
莴	wocn
硪	wouw
肟	wook
偓	wort
涴	wodv
踒	wozn
无	wuay
物	wunw
五	wuaw
武	wugv
务	wuwl
屋	wuut
舞	wupf
吴	wukt
午	wupu
误	wuyt
雾	wuyl
乌	wupa
悟	wuxk
伍	wurw
呜	wukw
巫	wugr
吾	wuwk
污	wudk
捂	wufk
勿	wubp
兀	wuae
恶	wuyx
侮	wurm
唔	wukk
梧	wumk
妩	wunw
芜	wucw
诬	wuyr
坞	wutw
毋	wump
晤	wuok
蜈	wuit
邬	wuwe
鹉	wugn
戊	wugp
忤	wuxu
骛	wumm
鹜	wumn
仵	wuru
婺	wumn
钨	wujw
杌	wumw
焐	wuhk
庑	wugw
寤	wubk
鋈	wudj
痦	wubk
怃	wuxw
牾	wunk
圬	wutk
浯	wudk
芴	wucw
迕	wuzu
鼯	wujk
旿	wuou
靰	wugw
洿	wudk
鹀	wugn
郚	wuwe
屼	wuuw
珷	wuwv
铻	wujk
峿	wuuk
珸	wuwk
𣲘	wudw
西	xiak
喜	xitk
系	xipx
息	xizx
细	xist
希	xixj
习	xivd
吸	xikj
戏	xiyg
洗	xide
惜	xixo
席	xigj
袭	xily
悉	xicx
嘻	xikk
析	ximj
稀	xihj
熙	xiih
夕	xipd
晰	xioj
溪	xidd
兮	xibk
牺	xinx
膝	xiou
媳	xinx
茜	xicx
隙	xieo
昔	xico
锡	xijw
嬉	xink
熄	xihx
犀	xiun
曦	xiok
禧	xipk
皙	ximb
玺	xidy
汐	xidx
蹊	xizd
蜥	xiij
奚	xivd
唏	xikj
羲	xiyk
淅	xidj
徙	xirz
熹	xith
蟋	xiix
翕	xirx
檄	ximw
僖	xirk
窸	xibx
铣	xije
郗	xixe
晞	xioj
烯	xihj
歙	xirq
屃	xiub
浠	xidj
阋	xime
樨	ximn
傒	xird
醯	xiym
隰	xieh
螅	xiix
爔	xihk
屣	xiuz
硒	xiux
釐	xiwl
葸	xicx
咥	xikt
豨	xiuj
禊	xipd
饩	xiuq
郤	xige
觋	xigj
穸	xibx
嶲	xiuk
裼	xipw
舄	xijh
舾	xivx
谿	xivg
恓	xixx
蓰	xicz
鼷	xijd
粞	ximx
巇	xiug
憙	xitx
绤	xisg
菥	xicj
枲	xism
潟	xidh
肸	xiou
酅	xiue
睎	xioj
觿	xidk
嶍	xiub
暿	xiok
俙	xirj
熻	xihx
饻	xiuy
鳛	xiyb
𠅤	xiwx
𫘬	ximd
𬭳	xijk
𬶮	xiyk
下	xxab
吓	xxkx
夏	xxbw
侠	xxrj
霞	xxyy
瞎	xxok
狭	xxqj
暇	xxoy
峡	xxuj
虾	xxix
辖	xxik
匣	xxkj
瑕	xxwy
遐	xxzy
黠	xxlk
呷	xxkj
狎	xxqj
厦	xxiw
罅	xxfh
硖	xxuj
柙	xxmj
叚	xxuy
翈	xxjx
先	xmne
现	xmwj
显	xmoy
线	xmsj
险	xmeq
仙	xmru
咸	xmwk
鲜	xmyy
限	xmeg
闲	xmmm
陷	xmej
县	xmqs
献	xmuq
贤	xmlb
嫌	xmnj
纤	xmsq
羡	xmyq
弦	xmgx
掀	xmfq
宪	xmbe
见	xmke
衔	xmrj
娴	xmnm
涎	xmdv
馅	xmuj
舷	xmvx
腺	xmou
暹	xmzv
苋	xmcj
冼	xmde
洗	xmde
藓	xmcy
锨	xmjq
霰	xmyw
跹	xmzq
忺	xmxq
痫	xmbm
祆	xmpt
岘	xmuj
酰	xmye
跣	xmze
燹	xmuh
狝	xmqx
蚬	xmij
猃	xmqq
籼	xmmu
鹇	xmmn
筅	xmve
莶	xmcq
氙	xmqu
挦	xmfc
崄	xmuq
缐	xmsu
孅	xmnj
伭	xmrx
禒	xmpu
㬎	xmoh
𪾢	xmoj
𫍯	xmyk
𬀪	xmoj
𬸣	xmbn
想	xlmx
向	xlpk
相	xlmo
像	xlru
象	xldu
响	xlkk
香	xlho
降	xlef
项	xlgy
乡	xlvp
享	xlwz
翔	xlyx
箱	xlvo
祥	xlpy
详	xlyy
湘	xldo
巷	xlgs
厢	xlio
襄	xlyf
镶	xljx
橡	xlmu
饷	xluk
骧	xlmx
飨	xlxg
庠	xlgy
缃	xlso
芗	xlcx
鲞	xljy
瓖	xlwx
葙	xlco
珦	xlwk
𬙋	xlsx
小	xnLB
笑	xnvy
消	xndo
校	xnmf
晓	xnow
萧	xncb
效	xnww
销	xnjo
肖	xnxo
啸	xnkb
孝	xnlz
逍	xnzo
潇	xndb
削	xnxd
嚣	xnkk
霄	xnyo
宵	xnbo
哮	xnkz
箫	xnvb
筱	xnvw
枭	xnnm
硝	xnuo
骁	xnmw
淆	xndo
魈	xngo
绡	xnso
哓	xnkw
鸮	xnkn
崤	xnuo
枵	xnmk
猇	xnqj
洨	xndf
翛	xnrx
虓	xnjj
蛸	xnio
涍	xndz
蟏	xnib
敩	xnxw
滧	xndw
皛	xnbb
𫍲	xnyy
些	xpve
血	xppm
谢	xpyc
写	xpby
邪	xpye
协	xpub
鞋	xpgt
斜	xprd
泄	xpdu
胁	xpob
歇	xpoq
屑	xpuo
械	xpmc
携	xpfn
谐	xpyb
卸	xpve
挟	xpfj
泻	xpdy
懈	xpxn
蝎	xpir
蟹	xpdi
解	xpdn
亵	xpyw
邂	xpzn
偕	xprb
榭	xpmc
燮	xphy
楔	xpmd
撷	xpfy
瀣	xpdj
獬	xpqn
勰	xplx
廨	xpgn
缬	xpsy
躞	xpzy
绁	xpsu
絜	xpfx
渫	xpdm
薤	xpcj
榍	xpmo
揳	xpfd
澥	xpdn
薢	xpcn
叶	xpku
颉	xpty
㙦	xprt
偰	xprd
𤫉	xpwy
𬹼	xpvj
新	xblj
心	xbdd
信	xbrk
欣	xbjq
辛	xblu
馨	xbto
薪	xbcj
歆	xblq
昕	xboj
衅	xbpb
芯	xbcx
鑫	xbjj
忻	xbxj
锌	xbjx
炘	xbhj
囟	xbpx
镡	xbju
伈	xbrx
莘	xbcx
䜣	xbyj
𫷷	xbgq
行	xkrd
性	xkxu
星	xkou
形	xkkp
兴	xkxb
醒	xkyu
幸	xktg
型	xkkt
姓	xknu
刑	xkkd
腥	xkou
杏	xkmk
猩	xkqu
惺	xkxu
邢	xkke
悻	xkxg
省	xkuo
荥	xkcu
擤	xkfw
陉	xkej
荇	xkcd
饧	xkup
骍	xkmx
硎	xkud
钘	xkjk
瑆	xkwu
婞	xkng
铏	xkjd
煋	xkhu
𫰛	xknj
兄	xske
胸	xsox
雄	xsuv
凶	xskx
熊	xssh
汹	xsdx
匈	xsbx
芎	xscg
讻	xsyx
夐	xsdw
诇	xsyk
修	xqrp
秀	xqhn
休	xqrm
宿	xqbb
羞	xqyi
袖	xqpy
绣	xqsn
嗅	xqkq
朽	xqmk
锈	xqjn
咻	xqkm
岫	xquy
貅	xqvm
馐	xqui
庥	xqgm
脩	xqro
溴	xqdq
琇	xqwn
髹	xqem
鸺	xqrn
珛	xqwo
滫	xqdo
臭	xqzq
䗛	xqio
许	xuyu
续	xusd
需	xuye
须	xupy
虚	xuhy
徐	xurm
绪	xuso
序	xugy
旭	xujo
叙	xury
吁	xuky
蓄	xuct
嘘	xuky
絮	xunx
婿	xuno
恤	xuxm
栩	xumx
墟	xuty
诩	xuyx
煦	xuoh
胥	xuzo
戌	xuwa
酗	xuyx
顼	xuwy
勖	xuol
圩	xuty
畜	xuxt
蓿	xucb
盱	xuoy
魆	xugl
洫	xudm
溆	xudy
糈	xumo
谞	xuyo
欻	xuhq
媭	xupn
昫	xuoj
醑	xuyo
珝	xuwx
旴	xuoy
湑	xudo
垿	xuty
浒	xudu
㳚	xudd
冔	xuoy
𦈡	xuse
𬣙	xuyy
选	xrze
玄	xrwy
宣	xrbd
旋	xrfz
轩	xrig
悬	xrqx
喧	xrkd
璇	xrwz
眩	xrox
炫	xrhx
萱	xrcd
漩	xrdz
绚	xrso
暄	xrod
渲	xrdd
煊	xrhd
泫	xrdx
铉	xrjx
瑄	xrwd
烜	xrhd
癣	xrby
禤	xrpx
谖	xryy
儇	xrry
玹	xrwx
楦	xrmd
碹	xrud
晅	xrod
衒	xrrx
翾	xrsx
痃	xrbx
昡	xrox
咺	xrkd
券	xrjd
暶	xroz
愃	xrxd
琄	xrwo
𫍽	xryy
𫓶	xrjo
𫠊	xrmx
学	xtxz
血	xtpm
雪	xtye
穴	xtbb
薛	xtcx
削	xtxd
靴	xtgb
谑	xtye
噱	xtku
踅	xtfz
鳕	xtye
茓	xtcb
峃	xtxu
寻	xyec
训	xyyi
迅	xyzu
巡	xyzv
讯	xyyu
询	xyyo
逊	xyzx
循	xyro
勋	xykl
熏	xyqh
旬	xybo
驯	xymi
荀	xyco
薰	xych
殉	xydo
醺	xyyh
洵	xydo
峋	xyuo
巽	xysg
珣	xywo
汛	xydu
徇	xyro
浔	xydc
埙	xytb
恂	xyxo
荨	xycc
蕈	xycu
鲟	xyyc
郇	xybe
曛	xyoh
獯	xyqh
噀	xykg
栒	xymo
浚	xydw
𫄸	xysh
𬊈	xyhc
𬍤	xywc
𬘓	xysi
𬩽	xyee
呀	yaky
亚	yaay
压	yaid
雅	yayv
牙	yagp
丫	yabl
吖	yaky
讶	yayy
涯	yadt
哑	yaky
崖	yaut
娅	yany
押	yafj
鸭	yajn
鸦	yayn
衙	yark
芽	yacy
轧	yaiv
伢	yary
琊	yawe
桠	yamy
睚	yaot
垭	yaty
岈	yauy
迓	yazy
蚜	yaiy
玡	yawy
揠	yafn
猰	yaqd
氩	yaqy
砑	yauy
堐	yatt
眼	yjog
言	yjwk
严	yjai
烟	yjhy
演	yjdb
验	yjmq
研	yjuk
燕	yjch
颜	yjwy
掩	yjfd
延	yjzv
厌	yjiq
艳	yjfb
炎	yjhh
沿	yjdk
焰	yjhj
岩	yjuu
淹	yjdd
咽	yjky
宴	yjbn
嫣	yjnh
妍	yjnk
彦	yjwp
雁	yjiv
阎	yjmj
盐	yjtm
焉	yjvh
衍	yjrd
檐	yjmk
奄	yjdd
砚	yjuj
焱	yjhh
俨	yjry
晏	yjon
胭	yjoy
蜒	yjiv
魇	yjig
阉	yjmd
湮	yjdt
琰	yjwh
筵	yjvv
偃	yjrn
闫	yjms
腌	yjod
阏	yjmd
恹	yjxq
谚	yjyp
兖	yjly
堰	yjtn
鄢	yjve
滟	yjdb
赝	yjib
唁	yjkk
鼹	yjjn
芫	yjcy
郾	yjke
酽	yjyy
餍	yjig
厣	yjij
谳	yjyq
崦	yjud
弇	yjrc
黡	yjih
罨	yjsd
渰	yjdc
掞	yjfh
嬿	yjnh
棪	yjmh
扊	yjhh
沇	yjdy
甗	yjhw
殷	yjpu
铅	yjjk
䶮	yjlt
墕	yjth
戭	yjbg
漹	yjdh
虤	yjhj
蝘	yjin
觃	yjjz
𪩘	yjuq
𫄧	yjsv
𬙂	yjsb
𬸘	yjkn
样	yhmy
阳	yheo
杨	yhmp
扬	yhfp
养	yhbl
洋	yhdy
仰	yhre
央	yhkr
羊	yhbf
痒	yhby
漾	yhdy
氧	yhqy
恙	yhyx
佯	yhry
鸯	yhyn
殃	yhdy
怏	yhxy
秧	yhhy
炀	yhhp
泱	yhdy
鞅	yhgy
徉	yhry
烊	yhhy
疡	yhbp
旸	yhop
飏	yhfp
羕	yhyy
蛘	yhiy
垟	yhty
玚	yhwp
咉	yhky
钖	yhjp
要	ycxn
摇	ycff
药	yccu
妖	ycny
腰	ycon
咬	yckf
遥	yczf
耀	ycxv
瑶	ycwf
姚	ycnv
邀	yczw
钥	ycjo
夭	ycpd
谣	ycyf
幺	ycvs
窑	ycbf
尧	ycyw
吆	ycky
肴	ycxo
约	ycsu
曜	ycov
窈	ycbl
杳	ycmo
舀	ycvj
爻	ycxx
鹞	ycvn
徭	ycrf
轺	ycik
鳐	ycyf
崾	ycun
铫	ycjv
窅	ycbo
峣	ycuw
垚	yctt
珧	ycwv
靿	ycgl
疟	ycbe
猺	ycqf
侥	ycrw
媱	ycnf
㙘	yctn
也	yevv
业	yela
夜	yeww
爷	yefe
叶	yeku
野	yely
液	yedw
耶	yeee
页	yeab
曳	yeyp
冶	yedk
烨	yehu
噎	yekb
腋	yeow
靥	yeim
椰	yeme
掖	yefw
晔	yeou
邺	yeye
谒	yeyr
揶	yefe
咽	yeky
铘	yeje
倻	yere
馌	yeum
一	yiaa
以	yilr
已	yikv
意	yilx
衣	yiwy
亿	yirv
易	yiow
依	yiry
义	yidx
异	yijc
疑	yibz
议	yiyy
医	yiku
伊	yiry
移	yihx
忆	yixv
艺	yicv
亦	yiwb
翼	yixg
遗	yizb
益	yibm
宜	yibq
椅	yimk
仪	yiry
逸	yizt
姨	yiny
怡	yixk
抑	yife
毅	yilu
役	yiru
译	yiyf
夷	yiar
溢	yidm
咦	yiky
倚	yirk
矣	yisu
谊	yiyq
乙	yivv
蚁	yiiy
奕	yiwd
漪	yidk
疫	yibu
绎	yisf
裔	yiyk
揖	yife
颐	yiiy
驿	yimf
弈	yiwc
懿	yitx
邑	yikb
熠	yihb
屹	yiuv
沂	yidj
羿	yixc
诣	yiyo
翌	yixl
轶	yiif
呓	yikv
翊	yilx
蜴	yiiw
弋	yiyd
咿	yiky
尾	yium
旖	yifk
祎	yipw
臆	yiox
彝	yihc
贻	yibk
噫	yikx
佚	yirf
迤	yizy
壹	yitb
荑	yicy
缢	yism
翳	yikx
胰	yioy
痍	yiby
薏	yicx
嶷	yiuz
饴	yiuk
苡	yicr
悒	yixb
猗	yiqk
诒	yiyk
黟	yilx
峄	yiuf
镱	yijx
怿	yixf
眙	yiok
肄	yiby
铱	yijy
挹	yifb
乂	yipn
刈	yixd
癔	yibx
镒	yijm
埸	yitw
佾	yiro
圯	yits
瘗	yibt
燚	yihh
劓	yizd
殪	yidb
浥	yidb
扆	yihy
廙	yigg
簃	yivx
嫕	yinx
舣	yivy
杙	yimy
钇	yijv
鹢	yibn
宧	yibi
洢	yidy
酏	yiyy
繄	yikx
裛	yiyb
椸	yimy
踦	yizk
扅	yihx
佁	yirk
勚	yiul
匜	yiky
鹝	yign
嗌	yikm
艾	yicx
㑊	yirb
枍	yimk
潩	yidg
螠	yiim
𫄷	yisx
𫖮	yiuy
𬟁	yicn
𬬩	yijy
𬺈	yivk
因	ybkd
音	yblo
引	ybgl
隐	ybex
银	ybjg
阴	ybeo
印	ybpe
吟	ybkv
饮	ybuq
淫	ybdt
姻	ybny
尹	ybep
殷	ybpu
茵	ybcy
瘾	ybbx
胤	ybeo
荫	ybco
寅	ybbb
垠	ybtg
氤	ybqy
蚓	ybil
喑	ybko
洇	ybdy
龈	ybvg
鄞	ybce
夤	ybxb
窨	ybbo
霪	ybyt
狺	ybqk
愔	ybxo
堙	ybtt
訚	ybmk
吲	ybkl
铟	ybjy
嚚	ybkk
禋	ybpt
骃	ybmy
慭	yblx
硍	ybug
珢	ybwg
茚	ybce
蟫	ybiu
龂	ybvj
崟	ybuj
溵	ybdu
歅	ybxq
䲟	ybye
𬘡	ybsy
𬤇	ybyt
𬮱	ybmt
应	ykga
影	ykop
英	ykcy
营	ykck
迎	ykze
硬	ykug
鹰	ykgn
赢	ykwb
映	ykoy
莹	ykcy
盈	yknm
婴	ykbn
樱	ykmn
颖	ykby
莺	ykcn
蝇	ykid
嬴	ykwn
萤	ykci
荧	ykch
萦	ykcx
瑛	ykwy
缨	yksn
瀛	ykdn
嘤	ykkn
膺	ykgo
滢	ykdy
鹦	ykbn
罂	ykbf
璎	ykwn
郢	ykke
颍	ykby
荥	ykcu
茔	ykct
楹	ykmm
撄	ykfn
潆	ykdx
媵	ykon
瘿	ykbn
锳	ykjy
蓥	ykcj
溁	ykdm
媖	ykny
䓨	ykcf
用	yskf
永	ysdu
拥	ysfy
勇	yssl
涌	ysdy
佣	ysry
庸	ysgo
泳	ysdy
雍	yswv
咏	ysky
甬	yssy
慵	ysxo
俑	ysry
恿	yssx
臃	ysov
蛹	ysiy
邕	ysvb
踊	yszy
墉	ysto
镛	ysjo
颙	ysty
痈	ysby
壅	yswt
饔	yswg
鳙	ysyo
澭	ysdv
鄘	ysge
埇	ysty
栐	ysmy
喁	yskd
㶲	yshy
鲬	ysyy
有	yzUO
又	yzvn
由	yzlt
友	yzuy
游	yzdz
右	yzuk
优	yzry
犹	yzqy
幽	yzuy
油	yzdy
尤	yzyd
忧	yzxy
悠	yzrx
诱	yzyn
幼	yzyl
哟	yzku
佑	yzrk
邮	yzye
黝	yzll
呦	yzkl
攸	yzrw
鱿	yzyy
酉	yzxa
繇	yzvx
柚	yzmy
祐	yzpk
铀	yzjy
猷	yzbq
釉	yzcy
莠	yzcn
囿	yzko
鼬	yzjy
宥	yzbo
莜	yzcw
疣	yzby
侑	yzro
牖	yzpf
蝣	yziz
蚴	yzil
羑	yzyj
蝤	yziy
蚰	yziy
莸	yzcy
卣	yzbk
麀	yzlb
耰	yzlw
浟	yzdw
槱	yzmh
铕	yzjo
鲉	yzyy
𬨎	yziy
与	yuva
于	yuau
语	yuyk
雨	yuad
玉	yuwd
余	yurm
遇	yuzd
欲	yugq
羽	yuxx
宇	yuby
鱼	yuda
预	yuyy
育	yuwo
御	yure
郁	yuue
豫	yuyu
域	yuta
狱	yuqq
予	yusl
愈	yurx
浴	yudg
誉	yuxk
愉	yuxd
愚	yutx
吁	yuky
於	yufd
裕	yupg
娱	yunt
瑜	yuwd
喻	yukd
寓	yubd
渔	yudy
虞	yuht
俞	yurd
禹	yupd
煜	yuhl
舆	yujb
谕	yuyd
逾	yuzd
榆	yumd
屿	yuuy
钰	yujy
驭	yumy
渝	yudd
迂	yuzy
淤	yudd
毓	yupi
瑀	yuwy
妤	yuny
昱	yuol
隅	yued
禺	yutd
芋	yucy
聿	yuyg
臾	yujr
揄	yufd
峪	yuug
觎	yurj
妪	yunq
谀	yuyr
腴	yuor
盂	yuym
彧	yuga
庾	yugr
瘀	yubd
燏	yuhk
棫	yuma
蜮	yuia
圄	yukk
竽	yuvy
喁	yukd
欤	yuyq
萸	yucr
鹬	yumn
鬻	yugg
龉	yuvk
窳	yubg
圉	yukg
纡	yusy
狳	yuqm
俣	yurt
燠	yuhd
瘐	yubr
伛	yurq
饫	yuuy
淯	yudo
阈	yuma
蝓	yuid
舁	yujc
遹	yuzk
雩	yuyk
鹆	yugn
窬	yubd
熨	yuuh
玙	yuwy
嵛	yuud
堉	yuto
褕	yupd
矞	yumk
畬	yurt
嵎	yuud
蓣	yucy
髃	yugd
滪	yudy
潏	yudk
悆	yurx
敔	yuww
邘	yuye
鄅	yuye
尉	yuuc
艅	yuvm
蔚	yucc
㺄	yuqd
原	yrix
远	yrzy
员	yrkb
元	yraw
院	yrey
愿	yrix
园	yrky
源	yrdx
圆	yrkb
缘	yrsu
怨	yrxx
援	yrfy
袁	yrty
辕	yriy
渊	yrdl
冤	yrbt
媛	yrny
苑	yrcv
猿	yrqy
鸳	yrxn
垣	yrtd
鸢	yryn
沅	yrdy
爰	yrvy
瑗	yrwy
芫	yrcy
塬	yrtx
鼋	yryd
掾	yrfu
垸	yrty
螈	yrix
橼	yrmu
蜎	yrio
嫄	yrnx
箢	yrvv
湲	yrdy
眢	yrxo
涴	yrdv
妧	yrny
羱	yryx
圜	yrky
𫘪	yrmx
越	yttl
月	ytke
约	ytsu
跃	ytzy
岳	ytqu
悦	ytxx
乐	ytpx
曰	ytka
阅	ytmx
粤	ytpk
玥	ytwo
钺	ytjl
钥	ytjo
樾	ytml
刖	ytod
彟	ytey
哕	ytkx
瀹	ytdc
龠	ytrc
爚	ythc
籥	ytvc
栎	ytml
𫐄	ytiw
𬸚	ytqn
云	yyas
运	yyzy
晕	yyoi
允	yyse
韵	yyly
芸	yycy
孕	yynz
蕴	yycm
匀	yybd
筠	yyvy
陨	yyeb
酝	yyyy
愠	yyxm
氲	yyqm
耘	yyly
昀	yyoy
纭	yysy
殒	yydb
熨	yyuh
韫	yywm
郓	yybe
赟	yywb
恽	yyxi
鋆	yytj
郧	yyke
狁	yyqy
沄	yydy
妘	yyny
缊	yysm
煴	yyhm
筼	yyvb
涢	yydb
员	yykb
馧	yyhm
𫖳	yyyy
咋	zakv
砸	zauj
杂	zajm
咂	zakj
匝	zakj
扎	zafv
臜	zaob
拶	zafx
在	zdUT
再	zdar
载	zdgi
灾	zdbh
宰	zdbx
栽	zdgm
哉	zdgk
仔	zdrz
崽	zdux
甾	zdvt
咱	zjkz
赞	zjnb
暂	zjio
攒	zjfb
簪	zjvo
瓒	zjwb
錾	zjij
糌	zjmo
趱	zjtb
昝	zjwo
拶	zjfx
酂	zjne
寁	zjbz
脏	zhot
葬	zhcc
藏	zhci
赃	zhbt
臧	zhvi
奘	zhpd
牂	zhpy
驵	zhmq
早	zcou
造	zczk
遭	zczo
糟	zcmo
澡	zcdm
躁	zczm
燥	zchm
凿	zckg
噪	zckm
灶	zcht
枣	zcud
皂	zcbq
藻	zccm
蚤	zcii
唣	zckq
璪	zcwm
慥	zcxk
簉	zcvk
𥖨	zcum
则	zebd
责	zefb
择	zeff
泽	zedf
啧	zekb
仄	zeir
笮	zevv
帻	zejb
赜	zeib
昃	zeor
舴	zevv
箦	zevb
迮	zezv
咋	zekv
贼	zwbu
鲗	zwyd
怎	zfvx
谮	zfyo
增	zgto
赠	zgbo
憎	zgxo
曾	zgbo
锃	zgjw
缯	zgso
甑	zgbw
罾	zgso
矰	zguo
鄫	zgbe
综	zgsu
䎖	zgbx
扎	vafv
炸	vahv
眨	vaof
诈	vayv
乍	vape
喳	vakd
渣	vadd
栅	vamc
札	vamv
闸	vamj
榨	vamv
吒	vakq
轧	vaiv
咤	vakq
蚱	vaiv
铡	vajd
楂	vamd
鲊	vayv
馇	vaud
揸	vafd
砟	vauv
哳	vakj
奓	vadx
拃	vafv
挓	vafq
痄	vabv
劄	vavd
霅	vayk
咋	vakv
喋	vakm
柞	vamv
查	vamd
䃎	vaux
溠	vadg
鲝	vayy
齇	vazq
寨	vdbm
宅	vdbq
摘	vdfg
债	vdrb
窄	vdbv
斋	vdwe
翟	vdxv
择	vdff
瘵	vdbu
祭	vdxu
豸	vdpp
站	vjlv
战	vjvg
展	vjuy
占	vjbk
斩	vjij
沾	vjdv
蘸	vjch
绽	vjsz
粘	vjmv
栈	vjmj
盏	vjjm
詹	vjdk
湛	vjdb
崭	vjuj
瞻	vjok
辗	vjiy
毡	vjmv
旃	vjfd
谵	vjyk
搌	vjfy
飐	vjfv
鹯	vjwn
偡	vjrb
栴	vjmd
鳣	vjyd
𫗴	vjud
长	vhpn
张	vhgi
章	vhlu
掌	vhxu
丈	vhan
帐	vhji
仗	vhrv
障	vheu
涨	vhdi
杖	vhmv
账	vhbi
璋	vhwu
胀	vhoi
彰	vhlp
蟑	vhiu
瘴	vhbu
樟	vhmu
漳	vhdu
獐	vhqu
嶂	vhuu
幛	vhju
鄣	vhle
嫜	vhnu
暲	vhou
仉	vhrj
找	vcfg
照	vcoh
招	vcfk
赵	vctx
召	vcdk
罩	vcsu
着	vcyo
爪	vcin
昭	vcok
兆	vced
朝	vcuo
诏	vcyk
沼	vcdk
肇	vchy
钊	vcjd
棹	vcmu
笊	vcvv
曌	vcog
啁	vckk
旐	vcfv
𬬿	vcjk
𬶐	vcyv
这	veZW
着	veyo
者	velo
折	vefj
哲	vefk
遮	vezh
浙	vedj
辙	veiw
辄	veiv
褶	vepb
蛰	vefi
蔗	vech
蜇	vefi
鹧	vegn
喆	vetk
谪	veyg
赭	veio
柘	vemu
磔	veum
锗	vejo
啫	veko
晢	vefo
詟	velk
䗪	vegi
真	vfub
阵	vfei
震	vfyi
镇	vfjb
珍	vfwp
针	vfju
振	vffi
朕	vfot
侦	vfrb
贞	vfbb
枕	vfme
诊	vfyp
甄	vfxw
帧	vfjb
斟	vfcd
祯	vfpb
臻	vfgh
桢	vfmb
箴	vfvk
缜	vfsb
圳	vfti
榛	vfmh
赈	vfbi
蓁	vfch
禛	vfpb
疹	vfbp
砧	vfuv
鸩	vfbn
轸	vfip
稹	vfhb
浈	vfdb
瑧	vfwh
畛	vftp
胗	vfop
鬒	vfeb
袗	vfpp
葴	vfck
揕	vffb
昣	vfop
纼	vfsl
正	vgav
整	vguv
政	vgvw
争	vgdy
证	vgyv
征	vgrv
郑	vgbe
睁	vgoy
挣	vgfy
怔	vgxv
症	vgbv
蒸	vgch
铮	vgjy
筝	vgvy
狰	vgqy
拯	vgfi
峥	vguy
钲	vgjv
诤	vgyy
烝	vglh
只	vikb
知	viuk
直	viuq
至	vigt
之	vidn
指	vifo
值	virq
制	vind
支	viuy
志	vitx
止	vilb
治	vidk
质	viib
置	visq
致	vigw
职	viev
智	viuo
纸	visu
织	visv
执	vifw
枝	vimv
植	vimq
旨	vibo
芝	vicv
吱	vikv
肢	viov
侄	virt
脂	vioo
址	vitv
汁	vidu
滞	vidj
稚	vihv
殖	vidq
掷	vife
秩	vihf
窒	vibt
芷	vicv
峙	viuc
挚	vifu
蜘	viik
帜	vijv
炙	vixh
趾	vizv
咫	viiv
痣	vibx
徵	virw
雉	viuv
祗	vipu
栀	vimv
痔	vibc
栉	vime
祉	vipv
桎	vimt
蛭	viit
鸷	vifn
郅	vige
豸	vipp
踯	vize
贽	vifb
陟	vieu
骘	viem
彘	vihb
跖	vizu
轾	viit
摭	vifh
枳	vimv
酯	viyo
帙	vijf
禔	vipz
卮	viiv
沚	vidv
胝	viou
觯	vidu
絷	vifx
埴	vitq
轵	viiv
黹	viyx
踬	vizb
忮	vixv
晊	viot
畤	vitc
滍	vidi
稙	vihq
扺	vifu
铚	vijt
锧	vijb
疐	viuz
跱	vizc
庤	vigc
泜	vidu
氏	vipv
识	viyv
梽	vimx
榰	vimo
𦭜	vicv
𬃊	vimb
中	vskl
种	vshv
重	vsql
终	vssd
众	vsrr
钟	vsjv
忠	vsvx
仲	vsrv
衷	vsyv
肿	vsov
冢	vsbu
踵	vszv
盅	vsvm
锺	vsjv
舯	vsvv
螽	vsdi
柊	vsmd
茽	vscv
周	vzkk
州	vzdl
皱	vzdp
洲	vzdv
咒	vzkj
宙	vzby
舟	vzpd
骤	vzmu
粥	vzgm
肘	vzoc
轴	vziy
昼	vzid
帚	vzej
胄	vzyo
纣	vzsc
绉	vzse
诌	vzye
妯	vzny
啁	vzkk
碡	vzum
籀	vzvt
酎	vzyc
辀	vziv
赒	vzbk
鸼	vzvn
荮	vzcc
婤	vznk
㑇	vzre
㤘	vzxe
住	vurv
主	vuwt
注	vudv
助	vuql
著	vuco
朱	vupw
珠	vuww
诸	vuyo
逐	vuzu
竹	vugg
猪	vuqo
祝	vupx
筑	vuvf
柱	vumv
驻	vumv
嘱	vuky
烛	vuhi
煮	vulh
蛛	vuiw
株	vumw
铸	vujc
诛	vuyw
竺	vuve
瞩	vuoy
伫	vurv
拄	vufv
侏	vurw
贮	vubv
茱	vucw
洙	vudw
蛀	vuiv
渚	vudo
箸	vuvo
炷	vuhv
铢	vujw
躅	vuzi
苎	vucv
杼	vumy
翥	vulx
槠	vumo
麈	vulv
潴	vudo
舳	vuvy
邾	vupe
纻	vusv
橥	vuqm
砫	vuuv
柷	vumx
疰	vubv
蠋	vuii
瘃	vubu
术	vumd
𬣞	vuyv
抓	vxfv
爪	vxin
髽	vxer
拽	vkfy
转	vriv
专	vrts
赚	vrbj
传	vrrv
砖	vruv
撰	vrfg
篆	vrvu
馔	vrug
颛	vruy
啭	vrkv
僎	vrrg
瑑	vrwu
沌	vrdt
䏝	vrov
装	vlly
状	vllq
庄	vlgt
撞	vlfl
壮	vllt
妆	vlln
桩	vlmt
幢	vljl
奘	vlpd
戆	vllx
追	vvzl
坠	vvet
缀	vvsy
锥	vvjv
惴	vvxe
赘	vvfb
椎	vvmv
骓	vvmv
缒	vvsl
隹	vvrv
准	vydv
谆	vyyz
肫	vyot
窀	vybt
衠	vyrb
屯	vyav
𬘯	vysz
桌	vobm
卓	vobu
着	voyo
捉	vofz
琢	vowu
灼	vohu
拙	vofi
浊	vodi
镯	voji
酌	voyu
啄	voku
茁	voci
涿	vodu
擢	vofv
斫	vouj
濯	vodv
倬	voru
浞	vodz
诼	voyu
棁	vomx
禚	voph
椓	vomu
晫	voou
叕	voyy
汋	vodu
焯	vohu
䓬	vocu
䦃	vojo
𬸦	vofn
子	zila
自	zipo
字	zibz
资	zidb
紫	zivx
姿	zidn
滋	zidy
吱	zikv
兹	ziby
姊	zind
仔	zirz
咨	zidk
梓	zimx
孜	zizw
渍	zidb
籽	zimz
恣	zidx
龇	zivb
辎	ziit
淄	zidt
眦	ziob
滓	zidx
嗞	ziky
髭	zieb
孳	zibz
缁	zist
笫	zivd
锱	zijt
秭	zihd
赀	zivb
訾	zivk
觜	zivy
嵫	ziuy
趑	zitq
茈	zicb
孖	zizz
粢	zidm
鲻	ziyt
镃	zijy
耔	zilz
鼒	zico
虸	ziiz
鄑	ziye
总	zsbx
宗	zsbu
纵	zssr
踪	zszu
综	zssu
棕	zsmu
鬃	zseu
粽	zsmu
偬	zsrx
倧	zsru
鬷	zsgw
腙	zsou
枞	zsmr
疭	zsbr
走	zztz
奏	zzit
揍	zzft
邹	zzde
诹	zzyy
驺	zzme
陬	zzey
鄹	zzee
鲰	zzyy
组	zusq
足	zukz
族	zufu
祖	zupq
阻	zueq
租	zuhq
卒	zuwu
诅	zuyq
俎	zurq
镞	zuju
菹	zucq
崒	zuuu
珇	zuwq
钻	zrjv
攥	zrfx
纂	zrvx
缵	zrsb
躜	zrzb
最	zvoy
嘴	zvky
罪	zvsf
醉	zvyu
蕞	zvcy
咀	zvkq
槜	zvmn
尊	zybc
遵	zyzc
樽	zymc
鳟	zyyc
撙	zyfc
噂	zykc
僔	zyrc
嶟	zyuc
𨱔	zyjc
做	zorw
作	zorv
坐	zotr
左	zoug
座	zogr
昨	zoov
佐	zorg
琢	zowu
撮	zofy
祚	zopv
嘬	zoky
柞	zomv
笮	zovv
酢	zoyv
怍	zoxv
胙	zoov
唑	zokr
捽	zofu
阼	zoev
岞	zouv
