乒	rgtr
亳	hmbb
仄	dwii
仨	wdgg
仳	waxn
侉	wdgw
侑	wefg
倏	whty
偾	wfam
傣	wdwi
傥	wjqn
僻	wdah
冈	mrii
冗	pnbb
冶	uckg
刃	vyii
刭	cajh
刳	dgwj
剁	nsjh
剂	cjjh
剐	kmwj
剽	bijh
剿	vjsj
劢	gqlt
勰	llli
匏	dgwl
匚	agnn
卅	gjkk
卉	fajj
卒	yafj
卺	bigl
厝	dajd
厨	dafy
厶	cnyy
叭	kmyy
叽	knnn
吆	kxyy
吖	kuhh
呃	kdln
呕	karn
呤	kdyy
呦	kxlt
咁	kafg
咂	kabh
咎	thkf
咧	kbjh
哄	kryy
哆	kqyy
哑	kgog
唔	kskg
唠	kapl
啖	kooy
喃	khef
喉	kwnc
喟	kleg
喱	kdua
喳	ksjg
喵	kalg
喹	kdff
喾	iekf
嗉	kgxi
嗟	kpag
嗫	kboy
嗳	kjdc
嗵	kcep
嘞	kqlt
嘢	kuas
嘬	kjbc
噎	kfpu
噤	kmwm
噩	gxxd
噫	kxni
噱	kheu
嚏	kfpw
囿	lefd
圜	llre
圩	ffhh
圯	flnn
圹	fott
坍	fmyg
坤	fjhh
坷	fskg
垆	fhnt
埂	fgjr
埒	fefy
埴	ffeg
堞	fkds
塾	ybvf
墉	fowe
壅	yxtf
壑	hpgf
壬	qtgg
娑	iitv
娼	vjjg
媳	vtni
嫡	vedg
嬖	davf
嬴	yevn
孛	fpbf
孢	bqln
孥	vcbf
孽	atdb
宓	pnou
宕	pdff
宸	pdeu
寇	pfqc
寮	pdui
尕	eiuu
屹	msnn
岔	mvmj
岱	hymj
嵇	tdnm
嶷	mxcw
帔	bhcy
帙	brwy
帜	bkuy
庾	ovwi
廊	oyvb
弈	pajj
弧	xocy
彀	fpgx
彊	xglg
彗	dhdv
彝	xgoa
彦	utee
彪	hnee
徇	hqjg
徕	hxiy
徨	hkgg
忒	anii
忻	nrhh
怂	aniu
恁	wqni
恝	dhvi
恻	nmjh
悖	nfpb
悫	fpni
悴	nyaf
悻	nfuf
惝	njgg
惩	hgci
惬	naxw
愆	hiwi
慰	nwmi
慵	nowe
憔	nroy
憩	qtni
懦	nfdm
懿	fpgi
戆	xfti
戊	dxyi
戌	dxyi
戟	kxyy
戬	gojx
扃	omkd
扉	omxd
扩	rott
抒	rcsh
抔	rgyy
拧	rpsh
拱	rryy
挈	dhvc
挲	iith
挽	rlsn
捺	rdwm
捻	rdni
掐	rqvg
掠	ryiy
掴	rlby
揍	rdwd
揩	raxk
搀	rlsu
搴	pchj
搽	rawi
摭	rloy
撅	rduw
撰	rllr
撵	raal
撸	rcjg
擅	rylg
擎	asth
擞	rovt
攸	whty
敖	gtyy
斑	gcgg
斡	kwwh
晗	jdkg
曙	jlfj
曷	jqwn
朔	ubte
杓	sqyy
杲	jsuu
杳	sjff
杵	srhh
枇	saxn
柑	safg
柘	sdgg
柞	skfg
柠	spsh
桅	sqdl
桨	uqsu
梗	sgjq
梧	sskg
棘	eiei
棼	mmvr
椁	sybg
椟	sviw
椿	sdwj
楫	skbg
榘	cans
榛	sdwt
榨	spkf
榴	sqyl
榷	sprg
榻	sjng
槊	ubts
槲	sqew
樘	sjfg
樨	snip
樯	sfuk
橐	npds
橘	scmk
檠	asts
檩	sylm
欣	rqwy
欤	qqwy
欺	hqwy
殒	bkmy
毋	xdee
氍	hhrn
氟	exjk
氨	epvd
氰	eged
汝	ivgg
汩	ijgg
汰	iduy
沏	iavt
沐	isyy
沮	iegg
沱	ipxn
泸	ihnt
洇	ildy
洱	ibgg
洳	ivkg
洼	iffg
浏	icjy
浜	irgu
涔	imdn
涧	iujg
淝	iejn
淤	ipwu
渠	ians
渲	ipgg
渺	ihit
湃	imgf
湎	idlf
湓	imvl
湛	ihnn
湜	ijwy
湟	ikgg
湫	itoy
溷	ileu
滂	iupp
滟	idhj
滢	iapb
滦	ipsy
漓	iybc
漩	ipwy
漶	iski
漾	iugn
潢	ianu
潦	idui
潺	inbb
潼	iuua
澍	ifay
濉	ihrg
濑	iuqm
濒	icim
濞	itph
灞	ifqe
炷	obgg
炻	odgg
烜	ogjg
烽	otdh
焓	odkg
焙	oukg
熄	otni
熨	nwmo
熹	fako
牍	sviw
牒	skds
牖	soby
牟	cpjj
犟	xkjp
狃	vnfg
狙	vegg
狷	vkeg
猖	vjjg
猬	vleg
猱	vcss
猷	usdy
玑	gnnn
玷	gvgg
珂	gskg
珅	gjhh
珑	gdxn
珙	gryy
珩	ghwh
珺	gvtk
琮	gpwm
琰	gooy
瑜	gwwh
璧	dabf
瓒	geqm
瓠	dgwc
瓤	yxec
甍	alpy
畛	lwet
痔	uffi
痖	ugod
痞	ugkd
痤	uafd
皤	kmlg
盂	fhlf
瞑	hpju
瞢	alph
矍	hhrc
砉	dhdf
砌	davt
硅	dffg
磐	exdf
磬	fnhd
祎	ovnn
祟	bmwm
禀	ylkm
稔	tdni
稠	tmfk
穑	tfuk
穹	pxbb
窒	paff
窥	pams
笠	tuff
筠	tfqu
箅	tlpj
箝	traf
箸	tfjf
篙	thkf
篡	thdc
簌	tuqw
簧	tanu
粲	hqco
糕	ougo
綦	hxiu
繇	ermi
纫	xvyy
绅	xjhh
绚	xqjg
缈	xhit
缉	xkbg
缙	xgoj
缛	xdey
缜	xfeu
缟	xhkg
缴	xkpt
缸	rmag
罄	fnhm
羔	ugou
羹	ugod
羿	najj
翥	fjnf
耘	dicy
耦	dijc
肋	eltt
肮	eynn
胚	eggg
胤	txen
胫	ecag
胺	epvy
脓	epky
腈	egeg
腋	eywy
腐	owfi
腑	eowy
膊	ebfy
膺	owrf
臀	nrxe
舀	evff
舂	dwvf
芄	avyu
芊	aqjj
芟	axuu
芴	aqrr
苓	adyy
苕	avkf
苞	aqlb
苟	asff
苡	anwy
茈	acxb
茌	awff
茔	apff
茸	abff
荟	aocu
荤	aplj
荪	abiy
莅	awug
莆	abuu
莨	ayvu
莳	ajfy
莼	axba
菡	abib
萃	ayaf
萄	aqrm
葡	aqbi
葫	adef
葵	awgd
蒌	aovu
蒽	aldi
蓬	atdp
蓼	anwe
蔑	aldy
蔫	agco
蔷	afuk
蕊	anii
薤	abmg
薨	alpx
薯	alfj
藕	adic
蘖	atds
虔	hcii
蚌	jdhh
蛊	jlff
蜃	deji
蜥	jsrh
蜴	jjqr
蝴	jdeg
蝽	jdwj
螟	jpju
螫	fotj
螭	jybc
螽	tuju
蟪	jgji
蠊	jouo
蠲	uulj
衔	hqwh
衮	ucku
衲	bmwy
袅	qyki
裒	yvku
裟	iitk
裼	bjqr
襦	bfdm
觳	fpgx
詈	lyff
謦	fnhy
讦	yfhh
讫	ysnn
讴	yary
谂	ydni
谄	yqvg
谌	yhnn
谔	yxgw
谠	yjqn
谤	yupp
谵	yqdy
谶	yaxg
豉	gafc
赓	ovwm
赜	aygm
赝	dwrm
赭	fofj
趱	keqm
跷	lxpn
跸	laxf
蹙	dmtl
轲	lskg
遁	rfhp
遑	kgpi
遛	qyvp
遽	heup
邈	ekqp
邝	obhh
邬	qngb
邺	obhh
鄢	gcqb
酋	usff
酗	sbhh
酥	styy
醅	sukg
醮	sroy
醯	sycl
銮	pbuf
鋈	imyu
鎏	iycu
钏	qjhh
钐	qett
钽	qjgg
铖	qpxy
铢	qtsy
锑	quxt
锒	qyvy
锢	qldg
锴	qaxk
镏	qqyl
镒	quul
镭	qflg
镯	qlqj
闩	ugdd
阗	ufeu
阡	bqhh
陔	baoy
陲	bqag
隘	buul
隰	bjoo
隳	bday
霭	fyjn
霰	faet
靥	ddyf
鞘	qieg
颔	dkdm
颖	xtdm
颚	xgwm
颦	cidv
飨	xthy
饔	yxth
馀	hwiy
驭	ccyy
骘	bcic
骜	gtcf
骝	cqyl
髦	vecn
鬃	vepm
鬯	robx
魇	ddyc
鱿	cdnn
鲠	cgjr
鲶	cdni
鸳	qlqg
鹄	ekqg
鹊	ajqg
鹗	xgwg
鹣	uvog
鹦	mmvg
鹨	nweg
麝	sxyy
麾	vcnv
黉	ianu
黍	twiu
鼙	fafv
龇	cbcx
一	gio
丂	wgn
七	aoa
丅	kgh
丆	dgt
万	gqe
丈	gri
上	hao
下	ghi
丌	pgt
丏	gch
丐	gch
丑	nfd
专	vcu
丕	ggf
世	kdd
丘	rgd
丙	ewi
业	ohh
丛	agf
丝	xxg
丞	big
丢	tli
严	god
並	uof
丧	fue
丨	hee
丫	uhk
丬	uyg
丰	dhk
串	skd
丶	yee
丷	uyt
丸	vyi
丹	myd
为	lui
主	byg
丽	gyo
举	cvj
丿	too
乂	rty
乃	ent
乇	mtg
义	yri
之	ppp
乍	kfd
乎	tuh
乏	tpi
乐	qii
乓	rgy
乔	mjk
乖	qux
乙	nee
乚	nee
乛	coo
乜	nnv
乞	stg
习	nud
书	hby
乩	vnn
买	ciw
乳	ebn
乾	ksn
亂	ecm
予	csj
事	nvd
二	fio
亍	wgg
于	fhk
亏	gwb
互	gxg
亓	fjj
五	sio
井	xgg
亘	gjg
些	cxf
亟	bkc
亠	yyg
亡	yyg
亢	ynb
交	uru
亥	aoi
亦	pyg
亨	ybj
亩	ylf
享	ybf
京	yiu
亭	hsj
亲	uiu
亵	yhk
亶	ylk
亹	ywf
人	woa
亻	wth
亼	www
什	wfh
仂	wlt
仃	wsh
仅	wcy
仆	why
仇	wvn
仉	wnn
今	dty
介	wjk
仍	wet
仑	wxb
仓	wlb
仔	wbg
仕	wfg
他	wmn
仗	wgr
付	wfy
仙	wmh
仝	waf
仞	wvy
仟	wqh
仡	wsn
代	hyi
以	nwy
仪	wyr
仫	wog
们	wun
仰	wqb
仲	wsh
仵	wrh
份	wmv
仿	wpt
企	wcf
伉	wyn
伊	wvo
伍	wsg
伎	wfc
伐	wxy
休	wsy
伕	way
众	wau
优	wdn
伙	woy
会	ocu
伛	war
伞	wuh
传	wvc
伢	wrt
伤	wtl
伥	whs
伦	wwx
伧	wwl
伪	wlu
伫	wpg
伯	wkg
估	wdg
伲	wnx
伴	wvu
伶	wdy
伷	wng
伸	wjh
伺	wnr
似	wnw
伽	wvg
佃	wlg
佇	wps
位	wug
低	wsc
佐	wda
佑	wtr
佔	wvg
何	wsk
佗	wpx
佘	oiu
余	wii
佚	wrw
佛	wxj
作	wkf
佝	wsg
佞	wfv
佟	wtu
你	fiy
佢	wan
佣	weh
佤	wgn
佥	wqf
佧	wmy
佩	wnk
佬	wfx
佯	wph
佰	wdj
佴	wbg
佶	wfk
佷	wvy
佺	wox
佻	wiq
佼	wur
佾	wme
使	wrr
侃	wkq
侄	wag
來	sai
侈	wqy
例	wbj
侍	wff
侏	wts
侔	wcp
侗	wmg
依	wyk
侠	wxw
侣	wkk
侥	wxp
侦	whm
侨	wmj
侩	woc
侪	wcj
侬	wpk
侮	wxy
侯	wnc
侵	wvp
侽	wll
便	wgj
促	wly
俄	wry
俅	wfy
俊	wcm
俎	ieg
俏	wie
俐	wtj
俑	wce
俘	web
俚	wua
俜	wnw
保	mkd
俞	wwj
俟	wcc
信	wyg
俣	wkg
俦	wof
俨	wgo
俩	wea
俪	wgy
俭	wwq
俯	wow
俱	weu
俳	wmx
俸	wdw
俺	wdj
俾	wrv
倉	wor
個	wld
倌	wpd
倍	wuk
們	wug
倔	wnb
倕	wqa
倖	wfu
倘	wjg
候	whn
倚	wds
倜	wmf
倡	wjj
倥	wps
倦	wxl
倨	wnd
倩	wge
倪	wvq
倬	whv
倭	wtv
倮	wjs
倵	wga
债	wgm
值	wfe
倾	wad
偃	waj
假	wrn
偈	wjq
偊	wtk
偌	wat
偎	wle
偏	wom
偓	wna
偕	wax
做	wdt
停	whs
健	wwf
偫	whf
偬	wqr
偰	wdh
偲	wln
偶	wjm
偷	www
偻	wov
偿	wic
傀	wqc
傅	wbf
傈	wss
傍	wup
傒	wex
傕	wpr
傢	wpe
傧	wpr
储	wyf
傩	wcr
傪	wcc
催	wmr
傲	wgt
傺	www
傻	wtk
僖	wfa
僚	wdu
僦	wyi
僧	wlj
僬	wro
僭	wls
僮	wuu
僳	wso
僵	wgl
僾	wjn
儆	was
儇	wlr
儋	wqd
儒	wfd
償	wjm
儡	wll
儦	wsx
儵	wht
儿	qqq
兀	pgt
允	cqb
元	fqb
兄	kqb
充	ycq
兆	iqv
免	lsv
兑	dqb
兔	lsy
兕	gbg
兖	ucq
兜	qkn
兢	dqd
入	tyi
內	mty
八	moi
公	mcu
六	uoi
兮	mwb
共	rgh
关	syt
兴	coa
兵	rgu
典	mri
兹	uou
养	pjk
兽	ulr
冀	uxl
冁	ulf
冂	mhn
内	mwi
冇	egt
冉	mfd
册	ygd
冏	mrd
冑	nef
冒	jhf
冓	emf
冕	jls
冖	pyn
冘	psv
写	pqf
冚	pmj
军	plj
冠	pfq
冢	peu
冤	pls
冥	pju
冧	pmu
冫	uyg
冬	tuu
冮	uag
冯	ucg
冰	uhi
冱	ugx
冲	ush
决	uby
况	ukq
冻	uai
冼	ueq
冽	ubj
凄	ugw
准	urg
凇	usm
凈	ues
凉	uyi
凊	uge
凋	umf
凌	ufm
减	udr
凑	udw
凛	uyl
凝	uxc
凡	ntn
凤	nci
凫	qnv
凭	wqn
凰	nkg
凳	wga
凵	bnh
凸	gmg
凹	gbg
击	fmk
凼	hib
函	bib
凿	ouf
刀	vnt
刁	ngd
刂	jhh
分	mvr
切	avt
刈	rjh
刊	fjh
刍	qvf
刎	qrj
刑	ejh
划	xjh
刖	wtn
则	mjh
删	ygj
判	ojh
別	kqj
刨	qlj
利	tjg
别	vjh
到	ajh
刵	bjh
制	ljh
刷	nbj
券	xvr
刹	jjh
刺	eij
刻	aoj
刽	ocj
刿	mqj
剀	mlj
剃	uxj
剅	gaj
削	iej
剌	ujh
剑	wqj
剔	jqr
剕	mxj
剖	ukj
剜	pqb
剞	dsk
剡	ooj
剥	jij
剧	ndj
剩	tux
剪	uwv
副	rlj
割	jrj
剺	fit
劁	roj
劂	dub
劈	dav
劉	qyv
劏	jlj
劐	arc
劓	tpj
劚	nil
力	lao
劝	clt
办	lmi
功	alt
务	tlr
劣	itl
助	elt
努	vcl
劫	llt
劬	slt
劭	vkl
励	dql
劲	cal
劳	apl
劼	fkl
劾	aol
势	hlr
勃	fpb
勅	ult
勇	cel
勉	lsl
勋	kml
勍	yil
勐	bll
勒	qlt
勖	jhl
勘	hnl
募	slr
勣	gml
勤	qfl
勹	qtn
勺	qyi
勻	qfd
匀	qud
包	qlv
匆	qry
匈	qbk
匍	qbi
匐	qrl
匕	xtn
化	hth
匙	jwx
匝	abk
匞	aad
匠	ark
匡	agd
匣	auk
匦	alv
匪	amx
匮	axm
区	ari
医	aci
匾	aom
匿	aat
卄	agh
升	taj
午	rhk
半	vui
卍	nnv
华	mxv
协	flm
卐	ngh
卑	rvk
卓	hvj
博	fbf
卜	hhy
卞	yhu
卟	khy
占	vhg
卡	mhg
卣	vnd
卤	vri
卦	ffh
卧	ayh
卨	hmn
卩	bnh
卫	nxd
卮	flv
卯	qtb
印	sbh
危	qdl
即	vbh
却	lbh
卵	qyt
卷	xlb
卸	rcb
卿	qtv
厂	dgo
厄	dlv
历	dle
厉	dqe
厍	dlk
厓	dff
厕	dmj
厘	dua
厚	djb
厢	dtd
厣	ddy
厥	dub
厦	ddh
厩	dvl
厮	dhr
县	ecu
叁	cdd
参	cde
叉	cui
友	dci
双	oeo
反	rci
发	hdc
取	bcy
变	pcu
叚	rnc
叛	orc
叟	vhc
叠	cop
口	kkk
古	dgh
句	stn
另	vhn
叨	kvt
叩	nhn
叫	knh
召	vkf
叮	ksh
叱	kxn
叵	akd
号	kwb
司	nrd
叹	kcy
叻	klt
叼	kng
吁	kfh
吂	yyg
合	wty
吉	fkf
吋	kfy
名	qkd
吏	rri
吐	kfg
向	bkd
吒	kmn
吓	kgh
吔	kmn
吗	kcg
吜	knf
吝	ckf
吞	gdk
吟	kdn
吠	kdy
吡	kax
吣	kni
否	gkf
吨	kba
吩	kmv
含	dkf
听	krh
吭	kyn
吮	kcq
启	okd
吱	kfc
吲	kxh
吴	kgd
吵	kit
吶	kmt
吸	key
吹	kqw
吻	kqr
吼	kbn
吽	kph
呀	krt
呆	ksu
告	ekf
呋	kay
呎	knm
呐	kmw
呒	kfs
呓	kan
呔	kdu
呖	kdl
呙	kmw
呛	kwl
呜	kqn
呢	knx
呣	kxs
呬	klg
呯	kfu
呱	koc
呲	kcx
味	kfi
呴	ksg
呵	ksk
呶	kvc
呷	kuh
呸	kgg
呻	kjh
命	wnj
咀	keg
咄	kbm
咅	ukf
咆	kql
咋	kkf
咏	kyi
咐	kwf
咒	xnb
咔	kmy
咕	kdg
咖	kvg
咙	kdx
咚	ktu
咛	kps
咝	kxx
咢	xgw
咣	kkn
咤	kpm
咦	kgx
咨	kkf
咩	kph
咪	koy
咫	nmk
咬	kur
咭	kfk
咯	kog
咱	ktg
咳	kao
咴	kdo
咸	drx
咻	kws
咽	kld
咿	kwv
哀	yku
品	kxf
哂	ksg
哇	kff
哋	kfm
哌	krk
哎	kar
哏	kvy
哐	kag
哒	kdp
哓	kxp
哔	kax
哕	kmq
哗	kmx
哙	koc
哚	kns
哜	kcj
哝	kpk
哞	kcp
哟	kxq
哥	aoe
哦	kry
哧	kfo
哨	kie
哩	kua
哪	kob
哮	kfb
哲	rrk
哳	krr
哺	kby
哼	kyb
哽	kgj
哿	vsk
唁	kyg
唆	kcm
唇	dek
唉	kcc
唏	krd
唑	kaf
唛	kgt
唢	kim
唣	kka
唤	kqm
唧	kvb
唪	kdw
唬	khn
售	rkf
唯	krg
唰	knb
唱	kjj
唳	kod
唴	kpn
唵	kdj
唷	kyc
唸	kdn
唻	ksa
唼	kuv
唾	kqa
唿	kqr
啁	kmf
啃	kce
啄	keu
啇	edd
啉	kmy
啊	kbs
啐	kya
啕	kqr
啗	kqv
啜	koo
啡	kmx
啣	krc
啤	krv
啥	kbk
啦	kru
啧	kgm
啩	kff
啪	krk
啫	kfj
啬	ful
啭	klv
啮	kcb
啯	klb
啰	klq
啲	kkq
啵	kih
啶	kpw
啷	kyv
啸	kvi
啻	upb
啼	kup
啾	kto
喀	kpo
喁	kjm
喂	kle
善	pur
喆	fkf
喇	kuj
喈	kax
喊	kdr
喋	kkd
喏	kat
喑	kxg
喔	kna
喘	kmd
喙	kxe
喜	fak
喝	kjq
喧	kpg
單	xlf
喲	kxq
喷	kfa
喺	kwt
喻	kww
喽	kov
嗄	kdh
嗅	ktd
嗌	kuu
嗍	kub
嗐	kjr
嗑	kll
嗒	kaw
嗓	kco
嗔	kfe
嗖	kvh
嗛	kuv
嗜	kfx
嗝	krm
嗞	kuo
嗡	kmc
嗣	kma
嗤	kbg
嗥	kkd
嗦	kfp
嗨	kcu
嗪	kdw
嗬	kaw
嗲	kmq
嗷	kgt
嗽	kuq
嗾	kpc
嘀	ked
嘁	kdm
嘅	kvl
嘈	kem
嘉	fav
嘌	kbi
嘎	kdh
嘏	drn
嘘	kho
嘟	kfj
嘣	kme
嘤	kmm
嘦	kus
嘧	kpn
嘭	kfa
嘱	knt
嘲	kke
嘶	khr
嘹	kdu
嘻	kfa
嘿	kby
噌	klj
噍	kro
噏	kwn
噔	kwg
噗	koa
噘	kdu
噙	kwy
噜	kcj
噢	kbo
噥	kka
器	xdy
噪	kkx
噬	kta
噶	kaj
噹	kjl
噺	kui
噻	kpf
噼	kda
嚁	knr
嚃	kli
嚅	kfd
嚆	kah
嚇	kfo
嚎	khe
嚓	kpw
嚘	kde
嚟	ktq
嚣	xdm
嚤	kvc
嚩	kxb
嚭	fak
嚮	xty
嚯	kfr
嚷	kyx
嚼	kel
囊	npx
囍	fak
囓	kdh
囔	knp
囗	lhn
囚	lwi
四	lii
囝	lbd
囟	tkr
因	ldi
囡	lvd
团	lft
囤	lba
囧	lmm
囫	lqr
园	lfq
囮	lhv
困	lsi
囱	tkt
囵	lwx
囹	ldy
固	ldd
图	ltu
圃	lbi
圄	lsk
圈	lxl
圉	lfu
圊	lge
圡	fyi
圪	fsn
圬	fgw
圭	fff
圮	fln
地	fmn
圳	fjh
圻	frh
圾	fey
址	fcg
坂	frc
均	fqu
坊	fpt
坌	mvf
坎	fqw
坏	fgy
坑	fyn
坜	fdl
坝	fmy
坞	fqn
坟	fcy
坠	bwf
坡	fhc
坣	iff
坦	fjg
坨	fpx
坩	faf
坪	ffu
坫	fvg
坭	fnx
坯	fgg
坳	fxl
坶	fxs
坻	fsc
坼	fry
垂	qag
垃	fug
垄	dxf
垅	fdx
垌	fmg
垒	ccc
垓	fao
垚	fff
垛	fns
垠	fvy
垡	wxf
垢	ffk
垣	fgj
垤	fag
垦	vff
垧	fbk
垩	gof
垫	hff
垭	fgo
垮	fdg
垲	fml
垴	fyb
垸	fpf
埃	fcc
埋	fua
埏	ftc
埔	fby
埕	fkg
埘	fjf
埙	fkm
埚	fkm
埝	fdn
域	fxk
埠	ftd
埤	frv
埭	fvi
埯	fdj
埶	fmf
埸	fjq
埽	fvp
堀	fnb
堃	ppf
堆	frg
堇	qfd
堉	fyc
堋	fee
堍	fls
堑	lrf
堕	bef
堙	fsf
堠	fwn
堡	mkf
堤	fjw
堪	fhn
堬	fww
堰	faj
堵	ffj
塄	flp
塅	fnx
塊	fqc
塌	fjn
塍	exf
塑	ubt
塔	faw
塘	fow
塚	fpe
塞	pff
塥	frm
填	ffe
塬	fdk
塰	cuf
墀	fni
墁	fjl
境	fxq
墅	uac
墒	fer
墓	sff
墙	ffu
墚	fiv
增	flj
墟	fho
墩	fyb
墬	bxe
墼	lbx
壁	daf
壓	dje
壕	fhe
壤	fyx
士	fgh
壮	ufg
壯	ufg
壳	fpn
壴	faf
壶	fpo
壸	fpg
壹	fpg
壻	few
夂	ttn
处	tgi
夆	tdh
备	ofk
夏	dht
夐	qmw
夔	qcl
夕	qtn
夙	nbi
多	qoe
夜	ywt
夤	qpg
夥	jsq
大	doa
天	gdu
太	dui
夫	aaa
夭	myi
央	mdi
夯	dlr
失	rwi
夷	gxw
夸	dgw
夹	xwi
夺	dfy
夼	djj
奁	dar
奂	qmd
奄	djn
奈	dwm
奉	dwv
奋	dlf
奎	dff
奏	dwg
契	dhv
奔	dfa
奕	pdu
奖	uqd
套	dvu
奘	ufd
奚	exd
奠	usd
奢	dfj
女	vvv
奴	vcy
她	vmn
好	vbg
妁	vqy
妃	vln
妄	yvf
妆	uvg
妇	vvg
妊	vqg
妍	veh
妒	vot
妓	vfc
妖	vmy
妗	vdn
妙	vit
妞	vnf
妡	vrh
妣	vax
妤	vcs
妥	evf
妨	vpt
妩	vfs
妪	var
妫	vlu
妬	vdg
妮	vnx
妯	vng
妲	vjg
妳	vqi
妹	vfi
妺	vgs
妻	gwv
妾	uvf
姀	vty
姁	vsg
姃	vgc
姆	vxs
姊	vtn
始	vck
姑	vdg
姒	vnw
姓	vpg
姗	vyg
姘	vue
姚	viq
姜	ugv
姝	vts
姞	vfk
姣	vur
姥	vfx
姨	vgx
姬	vay
姮	vgj
姹	vpm
姻	vld
姿	kvf
威	dvx
娄	ovf
娅	vgo
娆	vxp
娇	vmj
娈	pvf
娉	vnw
娌	vua
娒	vxy
娓	vnc
娘	vyv
娚	vll
娜	vob
娟	vke
娠	vde
娣	vux
娥	vry
娩	vls
娬	vga
娱	vkg
娲	vkm
娴	vus
娶	bcv
娺	voo
婀	vbs
婄	vuk
婆	ihc
婉	vpq
婊	vgk
婕	vgv
婚	vsn
婛	vyi
婜	ayc
婞	vfu
婠	vpd
婢	vrv
婧	vge
婪	mvf
婴	mmv
婵	vul
婶	vpj
婷	vhs
婺	ctv
婿	vwe
媒	vaf
媚	vnh
媛	veg
媪	vjl
媲	vtk
媵	exv
媸	vbf
媾	vem
媿	vqc
嫁	vpe
嫂	vvh
嫉	vuc
嫋	vxu
嫌	vuv
嫑	gsv
嫒	vjd
嫔	vpr
嫖	vbi
嫘	vlx
嫚	vjl
嫜	vxf
嫠	fit
嫣	vgc
嫦	vjb
嫩	vut
嫫	vsy
嫱	vfu
嬅	vag
嬉	vfa
嬗	vyl
嬛	vlr
嬤	vvx
嬲	llv
嬷	voo
孀	vft
孃	vyx
子	boe
孑	bnh
孓	byi
存	dhb
孙	biy
孚	ebf
孜	bty
孝	fbd
孟	blf
季	tbf
孤	boc
孩	bao
孪	pbf
孬	gvb
孰	ybv
孱	nbb
孳	uob
孵	qyt
孺	bfd
宀	pyy
宁	psj
宄	pvb
宅	pmb
宇	pfh
守	pfy
宏	pdc
宗	pwm
官	pdf
宙	pnf
宛	pql
宝	pbu
实	piw
宠	pdx
审	pjh
客	pof
宣	pgj
室	paf
宥	pef
宦	pay
宪	peq
宫	pkk
宰	paj
害	jrf
宴	pjv
宵	pie
容	prf
宽	pam
宾	prg
宿	pwd
寂	pmt
寄	pds
寅	pgn
富	prl
寐	puf
寒	puu
寓	pjm
寔	pjw
寝	puv
寞	psu
察	pww
寡	pde
寤	pus
寥	pnw
寨	piu
寬	pah
寰	plr
寸	fyi
对	eny
寺	ffy
寻	vfy
导	lfy
寽	efy
寿	ofy
将	uqf
尉	nwm
小	iii
少	ite
尒	wiu
尔	qiu
尗	mte
尘	iff
尚	jao
尜	idi
尝	icu
尢	dnv
尤	dnv
尥	dnq
尧	xpb
尨	dne
尪	dng
尬	dnw
尴	dnj
尸	nng
尹	vte
尺	nmi
尻	nvv
尼	nxv
尾	ncn
尿	nhi
局	nsd
屁	nax
屄	npi
屈	nbm
屉	nkd
届	nnd
屋	nad
屌	nkb
屎	noi
屏	nue
屐	nhf
屑	nie
展	nae
屙	nbs
屝	nmx
属	ntk
屠	nfj
屡	nov
屣	nhc
履	nht
屦	nho
屮	bhk
屯	bav
山	mmm
屺	mln
屿	mqg
岂	mlb
岈	mrt
岌	mey
岍	meh
岐	mfc
岑	mdb
岖	mar
岗	mmr
岘	mms
岙	mym
岚	mnr
岛	qmk
岜	mjb
岞	mkf
岡	mum
岢	msk
岣	msg
岨	meg
岫	mng
岬	muh
岭	mdy
岳	rgm
岵	mdg
岷	mne
岸	mdf
岽	mai
岿	mjv
峁	mqt
峃	imj
峄	mcv
峇	mwf
峋	mqj
峒	mmg
峙	mff
峡	mxw
峤	mmj
峥	mqs
峦	pmj
峨	mry
峪	mmk
峭	mie
峰	mtd
峻	mcm
崁	mfq
崂	map
崃	mxi
崆	mps
崇	mpw
崎	mds
崐	mja
崑	mja
崓	mld
崔	mrf
崖	mdf
崙	mwm
崚	mfm
崛	mnb
崞	myb
崟	mbu
崤	mre
崦	mdj
崧	msm
崩	mee
崭	mlr
崮	mld
崴	mdv
崻	mhf
崽	mln
崾	msv
嵁	mhn
嵊	mtu
嵋	myh
嵌	maf
嵘	map
嵛	mww
嵝	mov
嵩	mhk
嵫	muo
嵬	mqc
嵯	mpa
嵴	miw
嶂	mxf
嶙	mob
嶝	mwg
巅	mfe
巉	mla
巍	mtv
巛	vnn
州	jii
巢	vjs
左	dad
巧	awn
巨	and
巩	any
巫	aai
巭	ala
差	pad
巯	cay
己	lll
巳	lng
巷	rlb
巸	ayl
巽	llr
巾	bhn
巿	gbk
币	tbk
市	vmv
布	dbk
帅	jbh
帆	bny
帏	bvn
帐	bhs
帑	vcb
帖	bvg
帘	pbj
帚	vpb
帛	kbj
帟	pbj
带	mpb
帧	bhm
帨	bdq
席	lbk
帱	bof
帷	brg
帻	bgm
帼	blb
帽	bjh
幂	pjd
幄	bna
幅	brl
幌	bjk
幔	bjl
幕	sbj
幛	bxf
幞	boa
幡	bml
幢	buu
幪	bap
并	uej
幷	tft
幸	fuf
幹	kwf
幺	xnn
幼	xlt
幽	xmx
广	oty
庀	oxv
庆	odi
庇	oax
床	osi
庋	ofc
庐	ooe
庑	ofs
库	olk
庖	oql
庚	ovw
府	owf
庞	odx
废	ohd
庠	opk
庥	ows
度	lci
庭	oqp
庳	orv
庵	odj
庶	loi
康	owi
庸	owe
庹	lnm
廆	oqc
廈	odh
廉	ouv
廑	oqf
廒	ogt
廓	oyb
廖	onw
廛	ola
廝	ohr
廣	oan
廥	owl
廨	oqe
廪	oyl
廰	obl
廱	ovk
廴	pny
延	tcp
建	wfp
廾	agt
廿	agh
开	eoa
弁	caj
异	laj
弃	yca
弄	gaj
弅	mva
弇	waj
弊	ota
弋	agn
弑	jaa
弓	xng
引	xhh
弗	xjk
弘	xcy
弛	xmn
弜	xxn
弝	xjn
弟	uxr
张	xhs
弥	xqi
弦	xac
弨	xvk
弩	vcx
弪	xca
弭	xbg
弯	pxb
弹	xul
弼	xdj
弿	pxf
彐	vng
归	jvg
录	jiu
彖	xeu
彘	xga
彙	xpj
彟	vfy
彡	ett
形	eet
彣	cee
彤	mye
彧	akg
彩	ese
彬	met
彭	fae
彰	xfe
彳	htt
彷	hpt
役	hxy
彻	hav
彼	hhc
彿	hxj
征	hgc
徂	heg
径	hca
徉	hph
徊	hlk
律	hwf
後	hxt
徐	hwi
徑	hgv
徒	hky
得	hxh
徘	hmx
徙	hcc
徜	hjg
御	hrc
徦	hrn
復	htj
循	hrf
徬	hup
徭	her
徳	hln
徵	hmg
德	hlg
徹	hyc
徼	hkp
徽	hmg
心	nii
忄	nyy
忆	nnn
忉	nvn
忌	lni
忍	vyn
忏	nqh
忐	hni
忑	ghn
忖	nfy
忘	yni
忙	nyn
忝	gdi
忞	cni
忠	sni
忡	nsh
忤	nrh
忧	ndn
忪	nmc
快	nby
忭	nyh
忮	nfc
忱	nps
忳	nba
念	dni
忸	nnf
忽	qrn
忾	nen
忿	mvn
怀	ngy
态	dun
怃	nfs
怄	nar
怅	nhs
怆	nwl
怊	nvk
怍	nkf
怎	kfn
怏	nmd
怒	vcn
怔	ngc
怖	ndb
怙	ndg
怛	njg
怜	ndy
怠	ckn
怡	nck
急	qvn
怦	nfu
怨	qln
怩	nnx
怪	ncf
怫	nxj
怬	nlg
怯	nly
怵	nsy
怼	eni
怽	nfi
怿	ncv
恂	nqj
恃	nff
恋	pni
恍	nkn
恐	ann
恒	ngj
恕	vkn
恙	ugn
恚	ffn
恢	ndo
恣	kni
恤	ntl
恧	dmn
恨	nvy
恩	ldn
恪	nog
恫	nmg
恬	nqg
恭	riy
息	tni
恰	nwg
恳	vni
恶	gon
恸	ncl
恹	ndd
恺	nml
恼	nyb
恽	npl
恿	cen
悃	nls
悉	mni
悌	nux
悍	njf
悒	nkj
悔	nxy
悕	nrd
悚	nuy
悛	ncm
悝	nua
悠	wht
患	skn
悦	ndq
您	fin
悬	ecn
悭	ntf
悯	nuc
悰	npw
悱	nmx
悲	mxn
悶	uni
悸	ntb
悼	nhv
悽	ngw
情	nge
惆	nmf
惇	nyb
惊	nyi
惋	npq
惑	xkg
惓	nxl
惕	njq
惘	nmu
惚	nqr
惛	nsn
惜	naj
惟	nrg
惠	gjc
惦	nok
惧	neu
惨	ncd
惫	ofn
惭	nlr
惮	nul
惯	nxf
惰	nda
惴	nmd
惵	nkd
惶	nkg
惹	atr
惺	njp
愀	nto
愁	ton
愈	wwn
愉	nww
愍	net
愎	ntj
意	xni
愔	nxg
愕	nxg
愛	jni
愠	njl
愣	nlp
愤	nfa
愦	nxm
愧	nqc
愫	ngx
愬	ube
愿	dki
慁	leu
慄	nss
慈	uon
慊	nuv
慌	nay
慎	nfe
慑	nbo
慔	nsy
慕	siy
慝	aat
慧	dhd
慨	nvl
慷	now
憋	otn
憎	nlj
憝	ybt
憧	nuu
憨	nbt
憬	nki
憯	nls
憷	nmw
憾	ndr
懂	naq
懃	qfl
懈	nqe
懊	nbo
懋	mcn
懑	iae
懒	nuq
懔	nyl
懨	ndj
懮	nde
懵	nal
懶	nuq
懹	nyx
戈	xgn
戋	gxi
戍	dyx
戎	xde
戏	cxy
戒	xak
戕	uxy
戗	wlx
戚	dmt
戛	dhx
戡	hnx
戢	kbx
戤	ecl
戥	jpg
截	jrd
戮	nwe
戲	hga
戳	nrx
戴	jlr
戶	ltt
戼	nag
戽	owk
戾	ody
房	ope
扆	oyk
扇	ond
扈	okj
手	chk
扌	rrr
才	fte
扎	rnn
扑	rhy
扒	rmy
打	rsh
扔	ret
托	rmn
扛	rag
扞	rfh
扣	rkg
扦	rqh
执	hgh
扪	run
扭	rnf
扮	rmv
扯	rcg
扰	rdn
扳	rrc
扶	ray
扼	rdl
承	bdi
技	rfc
抄	rit
抉	rby
把	rjn
抐	rmw
抑	rqb
抓	roh
投	rxy
抖	rwh
抗	ryn
折	rrh
抚	rfs
抛	rvl
抟	rvc
抠	rar
抡	rwx
抢	rwl
抨	rfu
披	rhc
抬	rck
抱	rql
抵	rsc
抹	rgs
抻	rjh
押	ruh
抽	rng
抿	rne
拂	rxj
拃	rkf
拄	rbg
担	rjg
拇	rxs
拈	rvg
拉	rug
拊	rwf
拋	rdn
拌	rvu
拎	rdy
拏	vcc
拐	rvo
拒	ran
拔	rdc
拖	rtm
拗	rxl
拘	rsg
拙	rbm
拚	rca
拜	mgd
拟	rnw
拢	rdx
拣	rai
拥	reh
拦	ruf
拨	rhd
择	rcv
括	rqg
拭	raa
拮	rfk
拯	rbi
拳	xch
拴	rox
拶	rvq
拷	rfw
拼	rue
拽	rjx
拾	rwg
拿	wch
挂	rff
按	rpv
挌	rog
挎	rdg
挏	rmg
挑	riq
挖	rpn
挚	hch
挛	pch
挝	rfy
挞	rdp
挟	rxw
挠	rxp
挡	riv
挢	rmj
挣	rqs
挤	rcj
挥	rpl
挨	rcc
挩	rrq
挪	rob
挫	raf
振	rde
挸	rhq
挹	rkj
挺	rqp
捀	rtd
捂	rsk
捃	rvt
捅	rce
捆	rls
捉	rly
捋	ref
捌	rvj
捍	rjf
捎	rie
捏	rjf
捐	rke
捞	rap
损	rkm
捡	rwq
捣	rqm
捧	rdw
捨	rbk
捩	rod
捭	rrv
据	rnd
捱	rdf
捶	rqa
捷	rgv
捽	rya
掀	rrq
掂	rok
掇	roo
授	rjc
掉	rhv
掊	ruk
掌	jch
掎	rds
掏	rqr
排	rmx
掖	ryw
掘	rnb
採	res
探	ros
掣	ljc
控	rps
推	rrg
掩	rdj
措	raj
掬	rqo
掭	rgd
掮	roe
掯	rce
掰	mgm
掳	rhl
掷	rsb
掸	rul
掺	rcd
掼	rxf
掾	rxe
揄	rww
揆	rwg
揉	rcs
揎	rpg
描	ral
提	rjw
揖	rkb
揞	rxg
揠	raj
握	rna
揣	rmd
揪	rto
揭	rjq
揲	rkd
援	reg
揶	rbb
揸	rsj
揽	rjm
揿	rqq
搁	ruo
搂	rov
搅	rim
搋	rrh
搌	rna
搏	rbf
搐	rac
搓	rpa
搔	rcu
搛	ruv
搜	rvh
搠	rub
搡	rco
搥	rtd
搦	rxu
搧	ron
搪	row
搬	rex
搭	raw
搮	rss
携	rre
搿	mgw
摀	rqo
摁	rld
摄	rbo
摅	rhn
摆	rll
摇	rer
摈	rpr
摊	rcr
摒	rnu
摔	rac
摘	red
摛	ryb
摞	rlx
摤	rdi
摧	rmr
摩	vch
摸	rsy
摹	sch
摺	rnk
摽	rbi
撂	rlo
撄	rmm
撇	rot
撐	rjr
撑	rjc
撒	rae
撕	rhr
撖	rnb
撙	rus
撚	rqd
撞	ruu
撢	rsv
撤	ryc
撩	rdu
撬	rcn
播	rml
撮	rjb
撷	rfk
撺	rps
撼	rdr
擀	rkw
擂	rfl
操	rkx
擐	rlr
擒	rwy
擗	rda
擘	dac
擢	rnr
擤	rtp
擦	rpw
擿	red
攀	mid
攉	rfr
攒	req
攘	ryx
攤	rak
攥	rth
攧	rfe
攫	rhh
攮	rnp
攴	hcu
攵	ttg
攷	wty
攻	aty
放	pty
政	gct
效	urt
敉	oty
敌	qty
敏	xty
救	fty
敔	skt
敕	uty
敗	mty
教	fbt
敛	wqt
敝	oty
敞	jty
散	aet
敦	ybt
敫	kpt
敲	hkh
整	utg
敷	bpt
斁	lfu
文	cyg
斋	cdm
斌	cga
斐	mxc
斓	cus
斗	wyy
料	owh
斛	qew
斜	wiw
斝	xpw
斟	hnw
斤	rtt
斥	ryi
斧	mrj
斩	lrh
斫	drh
斯	hrh
新	uir
於	pwu
施	pmv
旁	upp
旃	pmy
旄	pcn
旅	pqu
旆	pgb
旉	bpr
旋	pwi
旌	ppg
旎	pnx
族	pci
旐	piq
旒	pyc
旖	pds
旗	phi
旛	pml
无	fsv
旦	jgf
旨	xjf
旬	qjd
旭	vjd
旮	vjf
旯	jvb
旰	jfh
旲	jdu
时	jfy
旷	jot
旺	jgg
旻	jcu
旿	jrh
昀	jqu
昂	jqb
昃	jdw
昆	jax
昇	jta
昉	jpt
昊	jgd
昌	jjf
昏	snj
昕	jrh
昙	jcu
昝	thj
映	jmd
昧	jfi
昨	jkf
昩	jgs
昭	jvk
是	jwu
昱	juf
昳	jrw
昴	jqt
昵	jnx
昶	yin
昼	nmj
显	jof
晁	jiq
時	jff
晃	jkb
晋	goj
晌	jbk
晏	jpv
晒	jsg
晓	jxp
晔	jmx
晖	jpl
晞	jrd
晟	jpx
晡	jby
晢	rrj
晤	jsk
晦	jxy
晨	jde
晫	jhv
普	uoj
景	kiu
晰	jsr
晱	joo
晳	srj
晴	jge
晶	jjj
晷	jth
智	ckj
晾	jyi
暂	lrj
暄	jpg
暇	jrn
暌	jwg
暐	jwk
暑	jfj
暗	jxg
暝	jpj
暧	jjd
暨	vls
暪	jab
暫	lrj
暮	sjf
暲	jxf
暴	jri
暸	hdu
暹	jrp
暾	jyb
曈	juu
曉	jff
曌	jep
曛	jqb
曜	jnr
曝	jjr
曣	jau
曦	jug
曧	jrm
曩	jyx
曲	kak
曳	jxe
更	gjr
曼	jlc
曾	ljf
替	aaj
最	jbc
朁	lsl
有	efd
朊	efq
朋	eeg
服	eiy
朐	esg
朕	esy
﨩	bqm
朙	lmm
朦	eap
木	sss
朩	igh
未	fii
末	gsi
札	snn
朱	tsi
朴	shy
朵	nsu
朽	swn
杂	viu
杄	sqh
杆	sfh
杈	scu
杉	set
杌	spn
李	sbf
杏	skf
材	sft
村	sfy
杖	sgr
杞	sln
束	ugh
杠	sag
条	tiu
来	xii
杨	svt
杩	scg
杪	sit
杭	syn
杮	sgb
杯	sgy
東	sjd
杷	sjn
杻	snf
杼	scs
松	smc
板	src
枉	sgg
枋	spt
析	srh
枒	srt
枕	sps
林	meo
枘	smw
枚	sty
枝	sfc
枞	say
枟	scy
枢	sar
枣	eiu
枥	sdl
枧	sms
枨	shs
枪	swl
枫	snr
枭	qsi
枯	sdg
枰	sfu
枳	sku
枵	skw
架	vsu
枷	svg
枸	ssg
柁	spx
柃	sdy
柄	sew
柏	skg
柒	ias
染	ivs
柔	csu
柙	suh
柚	sng
柜	san
柝	sry
柟	smf
柢	ssc
查	sjg
柩	saq
柬	sld
柯	ssk
柰	swm
柱	sbg
柳	sqt
柴	cxs
柶	slg
柷	skq
柽	scf
柿	svm
栀	sfl
栅	syg
栈	sgx
栉	sab
栊	sdx
栋	sai
栌	shn
栎	sqi
栏	suf
树	sey
栓	sox
栖	ssg
栗	ssu
栘	sqy
栝	sqg
校	sur
栢	sdj
栩	sng
株	sts
栲	sfw
栳	sfx
样	sph
根	svy
栽	jsi
栾	psu
桀	bsu
桁	shw
桂	sff
桃	siq
桄	skn
框	sag
案	pvs
桉	spv
桊	xsu
桌	hjs
桎	sag
桐	smg
桑	cos
桓	sgj
桔	sfk
桕	svg
桖	stl
桠	sgo
桡	sxp
桢	shm
档	siv
桤	sml
桥	smj
桦	smx
桧	soc
桩	sof
桫	sii
桴	seb
桶	sce
桷	sqe
梃	sqp
梆	sob
梏	sek
梓	sah
梢	sie
梨	tjs
梭	scm
梯	sux
械	sxa
梳	syc
梵	mnu
梶	snc
梼	sof
梿	slp
检	swq
棂	svo
棉	skb
棍	sja
棒	sdw
棕	spw
棗	eie
棚	see
棟	sgj
棠	jsu
棣	svi
棧	sxx
棰	sqa
棱	sfm
棵	sjs
棹	shv
棺	spd
棻	amv
椅	sds
椋	syi
植	sfe
椎	srg
椐	snd
椒	smt
椠	lrs
椤	slq
椪	suo
椭	sbe
椰	sbb
椴	snx
椹	shn
椽	sxe
楂	ssj
楔	sdh
楗	swf
楙	scs
楚	mwu
楝	ssl
楞	slp
楠	she
楣	snh
楦	spg
楮	sfj
楱	sdw
楷	sax
楸	sto
楹	sec
楼	sov
楾	skh
榀	skx
概	svl
榄	sjm
榆	sww
榇	sui
榈	suk
榉	scv
榍	sni
榔	syv
榕	spr
榖	fpt
榜	sup
榧	sam
榫	srf
榭	syf
榱	syg
槁	shk
槃	exs
槅	srm
槌	std
槎	spa
槐	sqc
槑	ksk
槔	srd
槚	ssm
槛	sjl
槟	spr
槠	syf
槭	sdm
槽	sem
槿	sqf
樁	sdw
樊	mid
樑	siv
樗	sfg
樟	sxf
模	ssy
樫	say
樱	smm
樵	sro
樽	sus
樾	ska
橄	snb
橇	scn
橙	swg
橛	sdu
橡	sle
橥	vfj
橱	sda
橹	scj
橼	sxx
檀	syl
檄	skp
檎	swy
檐	sqd
檑	sfl
檗	das
檪	suk
檫	spw
檬	sap
檮	ffc
檵	sno
檷	sgm
檻	say
檼	sea
檽	sfd
檿	dje
櫃	sax
櫈	swg
櫌	sde
櫏	ssd
櫑	sll
櫗	sal
櫰	syl
欘	sni
欠	qwu
欢	cqw
欲	mrq
欷	rdb
欸	ccq
欹	dsk
款	fwm
歃	qvq
歆	xqw
歉	uvo
歎	aka
歔	hoq
歙	wnq
止	chg
正	gcd
此	cxn
步	cir
歧	cfc
歪	ggc
歷	dtt
歹	bgt
死	bxv
歼	bqh
殁	bxy
殂	beg
殃	bmd
殄	bwe
殆	bck
殇	btv
殉	bqj
殊	bts
残	bgx
殍	beb
殓	bwq
殖	bfe
殘	bxx
殚	bul
殛	bbk
殡	bpr
殪	bfp
殭	bgl
殳	xtn
殴	arx
殷	rvn
殽	ref
毀	vfx
毂	fpl
毅	ueu
母	xsi
毐	fxd
毓	xyc
毖	axn
毗	lax
毙	axb
毛	cnv
毡	cnv
毪	cnc
毫	hcn
毯	cno
毳	cnc
毵	cdc
毹	wwc
毽	cnw
氅	jtc
氆	cnu
氇	cnc
氉	kxs
氏	snv
氐	sci
民	nev
氓	yna
气	etg
氕	ete
氖	eee
氘	ejk
氙	emk
氚	ejk
氛	emv
氡	etu
氢	eca
氤	eld
氦	eao
氧	epk
氩	ego
氪	edq
氮	eoo
氯	eji
氲	ejl
水	hii
氵	iyy
氹	hin
氺	ihy
氽	whi
氾	iln
汀	ish
汁	ifh
求	foa
汃	imy
汆	tyh
汇	ian
汊	icu
汐	iqy
汔	isn
汕	imh
汛	inf
汜	iln
汞	ahi
江	iag
池	imn
污	igw
汨	ijg
汪	igg
汲	iey
汴	iyh
汶	icy
汹	ibh
汽	ien
汾	imv
沁	ini
沂	irh
沅	ifq
沆	iyn
沈	ips
沉	ipn
沌	iba
沓	hij
沔	igc
沛	igb
沟	iqc
沢	inm
沣	idh
沤	iar
沥	idl
沦	iwx
沧	iwl
沩	ilu
沪	iot
沫	igs
沭	isy
沲	itm
河	isk
沷	idc
沸	ixj
油	ing
治	ick
沼	ivk
沽	idg
沾	ivg
沿	ink
泄	ikd
泅	ilw
泉	khi
泊	ikg
泌	ino
泐	ibl
泓	ixc
泔	iaf
泖	iqt
泗	ilg
泚	icx
泛	itp
泞	ips
泠	idy
泡	iql
泣	iug
泥	inx
注	ibg
泪	ihg
泫	iac
泮	ivu
泯	ine
泰	dwi
泱	imd
泳	iyi
泵	dhi
泶	ihi
泷	idx
泺	iqi
泻	ipq
泼	ihd
泽	icv
泾	ica
洁	ifk
洄	ilk
洋	iph
洌	ibj
洎	itg
洒	isg
洙	its
洚	ita
洛	iog
津	iwf
洧	ief
洨	iur
洩	ijx
洪	iry
洫	itl
洮	iiq
洲	iji
洵	iqj
洸	ikn
洹	igj
活	iqg
洽	iwg
派	irk
浃	ixw
浅	igx
浆	uqh
浇	ixp
浈	ihm
浉	ijk
浊	ijy
测	imj
浍	ioc
济	icj
浐	iut
浑	ipl
浒	iyt
浓	ipk
浔	ivf
浙	irr
浚	icm
浞	ily
浠	ird
浡	ifp
浣	ipf
浥	ikj
浦	iby
浪	iyv
浬	iua
浮	ieb
浯	isk
浴	imr
浸	ivp
浼	ils
涂	iwi
涅	ijf
消	iie
涉	ici
涌	ice
涎	itc
涑	iuy
涓	ike
涕	iux
涛	iof
涝	iap
涞	ixi
涟	ilp
涠	ilv
涡	ikm
涣	iqm
涤	iti
涨	ixh
涩	ivy
涪	iuk
涫	ipd
涮	inb
涯	idf
液	iyw
涵	ibi
涷	isj
涸	ild
涿	ieu
淀	ipw
淄	ivl
淅	isr
淆	ire
淇	ihy
淋	imy
淌	ijg
淑	imt
淖	ihv
淘	iqr
淙	ipw
淞	ism
淠	ilp
淦	ibu
淫	ieq
淬	iya
淮	irg
深	ios
淳	iyb
混	ija
淹	idj
添	igd
淼	hih
渃	iat
清	ige
渊	ito
渌	iji
渍	igm
渎	ivi
渐	ilr
渑	ikj
渔	icg
渖	ipj
渗	icd
渚	ifj
渝	iww
渡	ilc
渣	isj
渤	ifp
渥	ina
渫	ikd
渭	ile
港	irl
渴	ijq
游	ipb
湄	inh
湆	ixg
湉	inq
湍	imd
湔	iuw
湘	itg
湮	isf
湲	ieg
湾	ipx
湿	ijo
溃	ixm
溅	img
溆	iwi
溉	ivl
溍	igo
溏	iow
源	idk
溘	ill
溜	iqy
溝	iem
溟	ipj
溢	iuu
溥	ibf
溧	iss
溪	iex
溫	ikw
溯	iub
溱	idw
溲	ivh
溴	itd
溶	ipr
溺	ixu
溻	ijn
溽	ide
滁	ibw
滇	ife
滉	ijk
滋	iuo
滌	iwh
滏	imf
滑	ixg
滓	ipu
滔	iev
滕	exi
滗	itc
滘	ips
滚	iuc
滜	ikd
滞	imp
滠	ibo
滤	ihn
滥	ijl
滨	ipr
滩	icr
滴	ied
滹	iht
漀	fnh
漂	ibi
漆	isw
漉	isx
漏	inm
演	ipg
漕	iem
漠	isy
漤	imv
漪	ivd
漭	iad
漯	ilx
漱	iuq
漳	ixf
潆	iap
潇	iav
潋	iwq
潍	ixr
潘	iml
潜	iaa
潞	ilo
潭	isv
潲	iti
潴	ivf
潸	ime
潽	iuo
潾	iob
澄	iwg
澈	iyc
澉	inb
澌	ihr
澎	ifa
澐	ifc
澔	ike
澜	ius
澡	ikx
澣	ikw
澥	iqe
澧	ika
澳	ibo
澶	iyl
澹	iqd
澺	ixn
激	ikp
濁	ilq
濂	iou
濅	ipv
濊	icd
濛	iap
濠	ihe
濡	ifd
濪	ige
濮	iwo
濯	inr
瀑	ijr
瀚	ikw
瀛	iye
瀣	ihq
瀰	ixm
瀵	iol
瀹	iwx
灌	iax
灏	iki
火	oyt
灬	oyy
灭	goi
灯	osh
灰	doi
灱	ovt
灵	vou
灶	ofg
灸	qyo
灼	oqy
灾	pou
灿	omh
炀	ovt
炁	lso
炅	jou
炆	ocy
炉	oot
炊	oqw
炎	oou
炒	oit
炔	oby
炕	oyn
炖	oba
炘	orh
炙	qoi
炜	ovn
炝	owl
炤	ovk
炫	oac
炬	oan
炭	mdo
炯	omk
炱	cko
炳	oew
為	ytb
炼	oai
炽	oku
烀	otu
烁	oqi
烃	oca
烈	bjo
烊	oph
烔	omg
烘	ory
烙	oog
烛	ojy
烟	old
烤	ofw
烦	odm
烧	oxp
烨	omx
烩	ooc
烫	ivo
烬	onm
热	hou
烯	ord
烷	opf
烹	ybo
烿	omy
焉	gcq
焊	ojf
焐	osk
焕	oqm
焖	oun
焗	ons
焘	ofo
焚	mou
焦	rou
焯	ohv
焰	oqv
焱	ooo
煅	onx
煊	opg
煌	okg
煎	uwo
煜	oju
煞	qvt
煤	oaf
煦	jso
煨	ole
煮	fjo
煲	mko
煳	ode
煸	oom
煺	ovp
煽	oon
熊	jxx
熏	qbu
熔	opr
熘	oqy
熙	ayl
熠	onk
熬	gto
熳	ojl
熵	oer
熾	oxx
燃	oqd
燉	oyb
燊	ooo
燎	odu
燔	oml
燠	obo
燥	okx
燧	oue
燮	oyo
燹	eue
爆	ojr
爎	opd
爝	oel
爨	wfm
爪	ohk
爬	ohj
爭	esj
爰	egd
爱	jdc
爲	etn
爵	elv
爷	mbj
爸	mjb
爹	mqu
爺	mbb
爻	ieo
爽	dii
爾	gmb
爿	unh
牂	uph
牆	ufa
片	sth
牌	srv
牙	rte
牛	ptg
牜	ntg
牝	nxn
牠	nmn
牡	nfg
牢	ppj
牤	nyg
牦	ncn
牧	nty
牮	hyp
牯	ndg
牲	npg
牴	nsc
牵	dpp
牺	nsg
牾	nsk
牿	nek
犀	nip
犁	tjp
犄	nds
犊	nvi
犋	neu
犍	nwf
犎	fff
犏	nom
犒	nhk
犬	dyi
犭	vtn
犰	vvn
犴	vfh
状	udy
犷	vot
犸	vcg
狁	vcq
狂	vgg
狄	voy
狈	vmy
狍	vql
狎	vuh
狐	voc
狒	vxj
狓	vhc
狖	vpy
狗	vsg
狝	vqi
狞	vps
狠	vvy
狡	vur
狨	vxd
狩	vpf
独	vjy
狭	vxw
狮	vjk
狯	voc
狰	vqs
狱	vyd
狲	vbi
狳	vwi
狴	vax
狸	vua
狺	vyg
狻	vcm
猁	vtj
猃	vwq
猊	vvq
猎	vaj
猓	vjs
猕	vxq
猗	vds
猛	vbl
猝	vya
猞	vbk
猡	vlq
猢	vde
猥	vle
猩	vjp
猪	vfj
猫	val
猴	vwn
猸	vnh
猹	vsj
猾	vxg
猿	vfk
獍	vxq
獎	uqf
獏	vsy
獐	vxf
獒	gtd
獕	vmr
獗	vdu
獚	van
獠	vdu
獬	vqe
獭	vuq
獯	vqb
獱	vpg
獾	vax
玉	bgg
玎	gsh
玕	gfh
玖	gqy
玘	gln
玛	gcg
玟	gcy
玠	gwj
玡	grt
玢	gmv
玥	geg
玦	gby
玨	ggg
玩	gfq
玫	gty
玮	gvn
环	ggy
现	gms
玲	gdy
玳	ghy
玺	qib
玻	ghc
珀	gkc
珈	gvg
珉	gne
珊	gyg
珋	gqt
珍	gwe
珏	gby
珐	gly
珞	gog
珠	gts
珡	ggw
珣	gqj
珥	gbg
珧	giq
珪	gff
珮	gnk
珰	giv
珲	gpl
珵	gkg
珷	gga
珹	gpx
球	gfy
琅	gyv
理	gua
琇	gte
琉	gyc
琊	grt
琍	gtj
琎	gxp
琏	glp
琐	gim
琚	gnd
琛	gos
琢	geu
琥	ghn
琦	gds
琨	gja
琪	ghy
琬	gpq
琭	gji
琯	gpd
琳	gmy
琴	ggd
琵	gga
琶	ggj
琹	ggs
琼	gyi
瑁	gjh
瑄	gpg
瑒	gjg
瑕	grn
瑗	geg
瑙	gvt
瑚	gde
瑛	gam
瑞	gmd
瑟	ggn
瑢	gpr
瑭	gow
瑯	gyv
瑰	gqc
瑱	gfe
瑶	ger
瑷	gjd
瑾	gqf
璀	gmr
璁	gtl
璃	gyb
璇	gpw
璋	gxf
璎	gmm
璐	glo
璜	gan
璞	goa
璟	gki
璠	gml
璨	ghq
璩	ghe
璪	gkx
璺	wfm
瓘	gax
瓛	ghr
瓜	oci
瓞	ocr
瓢	bio
瓣	aoc
瓮	mcg
瓯	arg
瓴	dyg
瓶	ueg
瓷	kgn
瓿	ukg
甄	sfg
甏	fae
甑	ljg
甓	dag
甕	yxt
甘	afd
甙	aaf
甚	hnv
生	pgd
甡	pgp
甥	pgl
甦	gjr
甩	env
甪	tek
甫	bgh
甬	cej
甭	gej
甯	pni
由	nao
甲	uhn
申	jhk
电	jnv
甸	qld
町	lsh
画	glb
甾	vlf
畀	lpj
畅	jhv
畈	lrc
畋	lty
界	lwj
畎	ldy
畏	leu
畐	rlf
畔	lvu
畚	cdl
畜	acl
畠	klf
畤	lff
畦	lff
番	mlf
畫	wfl
畬	oil
畲	oil
畴	lof
畸	lds
畹	lpq
畿	xxx
疃	luu
疄	lob
疆	xfg
疋	wch
疏	ccy
疑	xcc
疒	uyg
疔	usk
疖	ubk
疗	ubk
疙	usn
疚	uqy
疝	umk
疟	uag
疠	ugq
疡	uve
疣	udn
疤	ujv
疥	uwj
疫	uxi
疬	udl
疮	uwl
疰	ubd
疱	uql
疲	uhc
疳	uaf
疴	usk
疵	ucx
疸	ujg
疹	uwe
疼	utu
疽	ued
疾	uci
痂	uvd
痃	uac
痄	ukf
病	uew
症	ugc
痈	uek
痉	uca
痊	uox
痍	ugx
痒	upk
痕	uvi
痘	uga
痛	uce
痢	utj
痣	ufn
痦	usk
痧	uii
痨	uap
痪	uqm
痫	uus
痰	uoo
痱	umx
痴	uck
痹	ulp
痼	uld
痿	utv
瘀	upw
瘁	uya
瘃	uey
瘅	uul
瘊	uwn
瘌	uuj
瘏	ufj
瘐	uvw
瘕	urn
瘖	oxd
瘗	uxw
瘘	uov
瘙	ucu
瘛	udh
瘟	ujl
瘠	uiw
瘢	uex
瘤	uqy
瘥	upa
瘦	uvh
瘩	uaw
瘪	utw
瘫	ucr
瘭	ubi
瘰	ulx
瘳	unw
瘴	uxf
瘵	uww
瘸	uvm
瘼	usi
瘾	ubq
瘿	umm
癀	uan
癃	ubt
癌	ukx
癍	ugc
癔	uxn
癖	uda
癜	unr
癞	uuq
癣	ucp
癫	ufe
癯	uhh
癸	wgd
百	djf
皂	kab
皆	axk
皇	kgf
皈	krc
皋	kdf
皎	kur
皑	kml
皓	kek
皖	kpf
皙	srk
皜	khk
皝	kgk
皞	kkd
皠	kmr
皦	kkp
皧	kjn
皮	hci
皱	qvh
皲	plh
皴	cmt
皿	lhn
盃	glf
盅	slf
盆	mvl
盈	ecl
益	uul
盍	llf
盎	mdl
盏	gxl
盐	fhl
监	jlf
盒	wlf
盔	dol
盖	ugl
盗	klf
盘	elf
盛	pxy
盟	jel
盥	shi
盫	wsl
目	hhn
盯	hsh
盱	hfh
盲	yhf
相	tgh
盹	hba
盼	hmv
盾	rfh
省	ith
眄	hgc
眇	hit
眈	hps
眉	nhh
看	med
眍	har
眙	hck
眚	pgh
眛	hfi
眜	hgs
眠	hne
眢	qlh
眦	hcx
眨	htp
眩	hac
眬	hdx
眭	hff
眯	hoy
眵	hqq
眶	hag
眷	xhf
眸	hcp
眺	hiq
眼	hvy
眾	lwa
着	phd
睁	hqs
睃	hcm
睇	hux
睌	hls
睏	hls
睐	hxi
睑	hwq
睒	hoo
睚	hdf
睛	hge
睡	hqa
睢	hrg
督	mtc
睥	hrv
睦	hfm
睨	hvq
睫	hgv
睬	hes
睹	hfj
睽	hwg
睾	tlf
睿	hpg
瞀	cth
瞄	hal
瞅	hto
瞌	hll
瞍	hvh
瞎	hjr
瞒	hae
瞓	hyj
瞟	hbi
瞠	hjf
瞥	oth
瞧	hro
瞩	hnt
瞪	hwg
瞬	hjb
瞭	hdu
瞰	hnb
瞳	huu
瞵	hob
瞻	hqd
瞽	faf
瞿	hhr
矇	hap
矗	fef
矘	hjb
矛	cny
矜	cdn
矞	cmr
矢	ctg
矧	cxh
矩	can
矫	cmj
矬	caf
矶	dnn
矸	dfh
矽	dqy
矾	dny
矿	dot
砀	dvt
码	dcg
砂	dit
砍	dqw
砑	drt
砒	dax
研	deh
砖	dvc
砗	dlh
砘	dba
砚	dms
砜	dnr
砝	dly
砟	dkf
砢	dsk
砣	dpx
砥	dsc
砦	cxd
砧	dvg
砩	dxj
砬	dug
砭	dtp
砰	dfu
破	dhc
砷	djh
砸	dab
砹	dar
砺	ddq
砻	dxd
砼	dwa
砾	dqi
础	dbm
硁	dca
硇	dtk
硌	dog
硎	dej
硐	dmg
硒	dsg
硕	ddm
硖	dxw
硗	dxp
硚	dmj
硝	die
硪	dry
硫	dyc
硬	dgj
硭	day
硰	iit
硷	dwq
硼	dee
碁	hdf
碇	dpw
碉	dmf
碌	dji
碍	dxh
碎	dya
碑	drv
碓	drg
碗	dpq
碘	dmr
碚	duk
碛	dgm
碜	dcd
碟	dkd
碡	dgx
碣	djq
碥	dom
碧	gkd
碱	ddr
碲	dup
碳	dmd
碴	dsj
碹	dpg
碾	dna
磁	duo
磅	dup
磉	dco
磊	ddd
磋	dpa
磔	dqa
磕	dll
磙	duc
磨	vdd
磲	dia
磴	dwg
磷	dob
磺	dan
磻	dml
磾	dxl
磿	dtt
礁	dro
礅	dyb
礌	dfl
礓	dgl
礞	dap
礤	daw
礴	dai
示	wmi
礻	oyn
礼	onn
礽	oet
祀	oln
祁	obh
祂	omn
祆	ogd
祇	osn
祈	orh
祉	ocg
祐	otr
祓	odc
祗	osc
祚	okf
祛	oly
祜	odg
祝	okq
祠	onr
祢	oqi
祧	oiq
票	biu
祭	wwm
祯	ohm
祷	oof
祸	okm
祹	oqr
祺	ohy
祼	ojs
禁	mwm
禄	oji
禅	oul
禇	ofj
禊	odh
禍	omn
福	orl
禚	oug
禧	ofa
禳	oyx
禹	tkm
禺	jmc
禽	wyb
禾	ttt
秀	ter
私	tcy
秃	tnb
秆	tfh
秉	tvd
秋	toy
种	tsh
秒	tit
秕	tax
秘	tno
租	teg
秣	tgs
秤	tfu
秦	dwt
秧	tmd
秩	trw
秫	tsy
秭	ttn
积	tku
称	tqi
秸	tfk
移	tqy
秽	tmq
秾	tpk
稀	trd
稂	tyv
稃	teb
稆	tkk
稍	tie
税	tdq
稗	trv
稚	trg
稜	tfm
稞	tjs
稣	cty
稳	tqv
稷	tlm
稹	tfe
稻	tev
稼	tpe
稽	tdn
稿	thk
穆	tki
穗	tgj
穩	tea
穰	tyx
穴	pyy
究	pvb
穸	pqu
空	psf
穿	prt
窀	oba
突	pdy
窃	pav
窄	pkf
窆	ptp
窈	pxl
窍	paw
窑	prm
窕	piq
窖	pek
窗	ptk
窘	pvt
窜	psk
窝	pkm
窟	pnb
窠	pjs
窣	pya
窦	pvi
窨	pxf
窬	pww
窭	pov
窳	poc
窷	pbq
窸	pmn
窿	pbt
立	uuu
竖	tuf
竞	ukq
竟	xqb
竣	ucm
童	uua
竦	uuy
竭	ujq
端	umd
競	ukq
竺	tff
竽	tfh
竾	tmb
竿	tfj
笃	tcf
笄	tej
笆	tjb
笈	tey
笊	toh
笋	tvt
笏	tqr
笑	tmy
笔	tcn
笕	tms
笙	tpg
笛	tnf
笞	tck
笤	tvk
笥	tnr
符	twf
笨	tjf
笪	tjg
笫	ttn
第	txr
笮	tkf
笱	tsf
笳	tvf
笸	tak
笺	tgx
笼	tdx
笾	tlp
筅	teq
筇	tab
筋	tel
筌	tox
筏	twx
筐	tag
筑	tan
筒	tmf
策	tei
筘	trk
筚	tax
筛	tjk
筝	tqs
筢	trj
筮	taa
筱	twh
筲	tie
筵	ttc
筷	tnb
筹	tof
筻	tgj
签	twq
简	tuj
箍	tra
箐	tge
箓	tji
箔	tik
箕	thu
算	tha
箜	tps
管	tpd
箢	tpq
箦	tgm
箧	tax
箨	trc
箩	tlq
箪	tul
箫	tvi
箬	tat
箭	tuw
箱	ttf
箴	tdr
節	tvb
篁	tkg
篆	txe
篇	tom
篌	twn
篑	txm
篓	tov
篚	tam
篝	tem
篥	tss
篦	ttk
篪	trh
篮	tjl
篱	tyb
篷	ttd
篼	tqk
篾	tld
簇	tpc
簋	tvl
簏	tsx
簖	ton
簟	tsv
簦	twg
簪	tls
簰	tsr
簸	thh
簿	tib
籀	trq
籁	tuq
籍	tdi
籴	tyo
籼	omh
籽	obg
粃	oax
粉	omv
粑	ojn
粒	oug
粕	okg
粗	oeg
粘	ovg
粜	bmo
粝	odq
粞	osg
粟	sou
粢	kou
粤	tko
粥	xox
粦	obu
粪	oru
粮	oyv
粱	ivm
粳	ogj
粹	oya
粼	obb
粽	opw
精	oge
糁	ocd
糅	ocs
糇	own
糈	owe
糊	ode
糌	oth
糍	ouo
糗	otd
糙	oek
糜	voi
糟	oem
糠	oow
糨	oxk
糯	ofd
糸	xiu
紊	cxi
級	xey
紥	rnx
紧	txi
紫	cxx
紬	xng
累	lxi
絜	dhv
給	xwg
絮	vkx
絷	hxi
綄	xpf
綟	xod
綤	vkb
綮	otx
編	xom
緬	xdl
縻	vxi
繁	xtx
繐	xgj
纂	thd
纛	gxs
纟	xnn
纠	xnh
纡	xfh
红	xag
纣	xfy
纤	xqh
纥	xsn
约	xqy
级	xey
纨	xvy
纩	xot
纪	xln
纬	xvn
纭	xcy
纮	xdc
纯	xba
纰	xax
纱	xit
纲	xmr
纳	xmw
纵	xay
纶	xwx
纷	xmv
纹	xco
纺	xpt
纻	xpg
纽	xnf
纾	xcs
线	xgx
绀	xaf
绁	xkd
绂	xdc
练	xai
细	xlg
织	xku
终	xtu
绉	xqv
绊	xvu
绋	xxj
绌	xbm
绎	xcv
绐	xck
绑	xob
绒	xxd
结	xfk
绔	xdg
绕	xxp
绖	xag
绗	xhw
绘	xoc
给	xwg
绛	xta
络	xog
绝	xqj
绞	xur
绠	xgj
绡	xie
绢	xke
绣	xte
绥	xev
绦	xti
继	xon
绨	xux
绩	xgm
绪	xfj
绫	xfm
续	xvi
绮	xds
绯	xmx
绰	xhv
绱	xjg
绲	xja
绳	xkj
维	xrg
绵	xkb
绶	xjc
绷	xee
绸	xmf
绹	xqr
绺	xth
绻	xxl
综	xpw
绽	xpw
绾	xpd
绿	xji
缀	xoo
缁	xvl
缂	xqh
缃	xtg
缄	xdr
缅	xdl
缆	xjm
缇	xjw
缊	xjl
缋	xxm
缌	xln
缍	xqa
缎	xnx
缏	xwg
缑	xwn
缒	xtd
缓	xeg
缔	xup
缕	xov
编	xom
缗	xna
缘	xxe
缚	xbf
缝	xtd
缞	xyg
缠	xou
缡	xyb
缢	xuu
缣	xuv
缤	xpr
缥	xbi
缦	xjl
缧	xlx
缨	xmm
缪	xnw
缫	xvj
缬	xfk
缭	xdu
缮	xpu
缯	xlj
缰	xgl
缱	xxn
缲	xkx
缳	xlr
缵	xeq
缶	rmk
缺	rmb
罂	mmr
罅	rmh
罍	lll
罐	rma
罔	muy
罕	ofj
罘	lgu
罙	oyn
罚	lyj
罟	ldf
罡	lgc
罢	llu
罨	ldj
罩	lhv
罪	lmx
置	lfe
罱	lhe
署	lfj
罴	llo
罹	lnr
罾	llj
羁	lqc
羊	pyt
羌	pnv
羙	ugo
羚	pdy
羝	psc
羞	pnf
羟	pca
羡	ugk
羧	pcm
羯	pjq
羰	pmd
羲	ugt
羸	yep
羼	npp
羽	neo
翀	nsh
翃	dcn
翅	fcn
翊	ung
翌	nuf
翎	dyn
翔	png
翕	wnf
翘	xpn
翙	mqn
翚	npl
翛	wht
翟	nrf
翠	nya
翡	mxn
翣	nuv
翦	uwn
翩	oma
翮	rmu
翰	kwn
翱	kdf
翳	acx
耀	knr
老	fxv
考	fwv
耄	fxc
者	fjd
耆	fxj
耋	fxa
耍	dmv
耒	dii
耔	dib
耕	dix
耖	dii
耗	dic
耙	dij
耜	did
耠	diw
耢	dia
耥	dij
耧	dio
耨	did
耩	die
耪	diu
耱	div
耵	bsh
耶	bbh
耷	dbf
耸	abf
耻	bcg
耽	bps
耿	boy
聂	bou
聃	bmf
聆	bdy
聊	bqt
聋	dxb
职	bku
聍	bps
聒	bqg
联	bsy
聘	bnw
聚	bcw
聩	bxm
聪	bdn
聬	bmc
聱	gtb
聿	wfd
肀	wng
肃	vij
肄	xcw
肆	vwf
肇	otw
肉	mii
肊	enn
肌	enn
肏	tym
肓	yef
肖	ief
肘	efy
肚	efg
肛	eag
肜	eet
肝	efh
肟	egw
肠	evt
股	exy
肢	efc
肤	eay
肥	ejn
肩	oed
肪	ept
肫	eba
肭	emw
肱	edc
肴	ref
肷	eqw
肸	emf
肺	egb
肼	exh
肽	edu
肾	tef
肿	esh
胀	ehs
胁	elm
胂	ejh
胃	lef
胄	nef
胆	ejg
背	uxe
胍	eoc
胎	eck
胖	evu
胗	ewe
胙	ekf
胛	euh
胜	epg
胝	esc
胞	eql
胡	deg
胥	wef
胧	edx
胨	eai
胩	emy
胪	ehn
胬	vcm
胭	eld
胯	edg
胰	egx
胱	ekn
胲	eao
胳	eog
胴	emg
胶	eur
胸	eqb
胼	eue
脂	exj
脆	eqd
脉	eyi
脊	iwe
脍	eoc
脎	ejy
脏	eof
脐	ecj
脑	eyb
脒	eoy
脔	pmi
脖	efp
脘	epf
脚	elb
脞	eaf
脤	ede
脩	wht
脫	erq
脬	eeb
脯	eby
脲	enh
脶	ekm
脷	etj
脸	ewq
脾	erv
腆	emr
腊	eaj
腌	edj
腓	emx
腔	eps
腕	epq
腙	epw
腚	epw
腠	edw
腥	ejp
腧	eww
腩	ehe
腭	exg
腮	eln
腰	esv
腱	ewf
腴	evw
腹	etj
腺	ekh
腼	edl
腽	ejl
腾	exc
腿	evp
膀	eup
膂	pke
膈	egl
膏	hke
膑	epr
膘	ebi
膛	ejf
膝	esw
膣	epa
膦	eob
膨	efa
膩	eaf
膪	eup
膳	epu
膻	eyl
臁	eou
臂	dae
臃	eyx
臆	exn
臊	ekx
臌	efa
臑	efd
臜	eeq
臟	eau
臣	ayk
臧	uay
自	tth
臬	tsu
臭	tdy
臻	adw
臼	vth
臾	vwi
舁	vaj
舄	vqo
舅	vll
舆	wfl
舌	qtg
舍	bkf
舐	qsn
舔	qgd
舗	wfk
舛	btn
舜	jbj
舞	rlg
舟	ett
舡	eag
舢	emh
舣	eyr
舨	erc
航	eyn
舫	ept
舭	exx
舯	esh
舰	ems
舱	ewl
舳	eng
舴	ekf
舵	epx
舶	ekg
舷	eac
舸	esk
船	enk
舻	ehn
舾	esg
艄	eie
艇	eqp
艉	enc
艋	ebl
艏	eqg
艘	evh
艚	eem
艟	euu
艨	eap
艮	vng
良	yvu
艰	cvy
艳	dhq
艴	xjq
艹	agh
艽	avb
艾	aru
艿	aer
节	abj
芃	anu
芈	ghh
芋	afh
芍	aqy
芎	axb
芏	aff
芑	alb
芒	ayb
芗	axt
芘	aax
芙	aau
芜	afs
芝	apu
芡	aqw
芤	abn
芥	awj
芦	aor
芨	aey
芩	adb
芪	asn
芫	afq
芬	amv
芭	ajb
芮	amw
芯	ani
芰	afc
花	ahn
芷	acf
芸	acu
芹	arj
芽	art
芾	agb
苁	aau
苄	ayh
苇	avn
苈	adl
苊	adl
苋	ams
苌	ahs
苍	awl
苎	apg
苏	alm
苑	aql
苒	amf
苔	ack
苗	alf
苘	amk
苛	ask
苜	ahf
苠	ane
苣	aan
苤	agg
苦	adf
苫	avf
苯	ajf
英	amd
苴	aef
苷	aaf
苹	afu
苻	awf
苽	aoc
苾	ano
茀	axj
茁	abm
茂	adx
范	ail
茄	avf
茅	acr
茆	aqt
茇	adc
茉	ags
茍	gjg
茎	aca
茏	adx
茑	aqg
茕	apn
茗	aqk
茚	asb
茛	avu
茜	asf
茧	aju
茨	aku
茫	aiy
茬	adj
茭	aur
茯	awd
茱	ats
茳	aia
茴	alk
茵	ald
茶	awi
茷	awx
茹	avk
茺	ayc
茼	amf
荀	aqj
荃	aox
荆	aej
荇	ahw
草	avj
荏	awq
荐	adh
荑	agx
荒	ayq
荔	all
荚	axw
荛	axp
荜	aax
荞	amj
荠	acj
荡	aiv
荣	aps
荥	aph
荦	app
荧	apo
荨	avf
荩	anm
荫	abe
荬	aci
荭	axa
荮	axf
药	axq
荷	aws
荸	afp
荻	avo
荼	awi
荽	aev
莉	atj
莎	aii
莒	akk
莓	axu
莘	auj
莛	aqp
莜	awh
莞	apf
莠	ate
莩	aeb
莪	ary
莰	afq
莱	axi
莲	alp
莴	akm
莶	awq
莸	avd
莹	apb
莺	apq
莽	ady
莾	adf
菀	apq
菁	age
菅	apd
菇	avd
菊	aqo
菋	akf
菌	alt
菏	ais
菐	oau
菑	avl
菓	ajs
菔	aei
菖	ajj
菘	asm
菚	axx
菜	aes
菝	ard
菟	als
菠	aih
菥	asr
菩	auk
菪	apd
菫	arg
菬	iav
菰	abo
菱	afm
菸	apw
菹	aie
菽	amt
萁	ahu
萆	arv
萋	agw
萌	aje
萍	aif
萎	atv
萏	aqv
萑	arf
萘	adw
萜	abv
萝	alq
萤	apj
营	apk
萦	apx
萧	avi
萨	abu
萱	apg
萸	avw
萼	axg
落	aio
葆	amk
葎	ahw
葑	aff
葖	apd
著	afj
葙	atf
葚	ahn
葛	ajq
葜	adh
董	aqu
葨	ale
葩	akj
葬	abx
葭	arn
葱	aqr
葳	adv
葶	ahs
葸	aln
葺	akb
蒂	aup
蒇	adm
蒈	aax
蒉	axm
蒎	air
蒐	aqc
蒗	aiy
蒜	awm
蒡	aup
蒯	aee
蒲	aib
蒴	aub
蒸	abi
蒹	auv
蒺	auc
蒿	ahk
蓁	adw
蓄	aac
蓉	apr
蓊	amc
蓍	afx
蓐	ade
蓑	ayg
蓓	awu
蓖	atk
蓟	acj
蓠	ayb
蓣	acs
蓥	apb
蓦	scf
蓰	acc
蓱	aiu
蓳	aqf
蓿	apw
蔌	auq
蔓	ajl
蔗	alo
蔚	anw
蔟	apc
蔡	aww
蔢	aih
蔬	acc
蔸	aqk
蔹	awq
蔺	aur
蔻	apf
蔼	ayj
蔽	aot
蕃	aml
蕈	asv
蕉	aro
蕖	aia
蕙	agj
蕞	ajb
蕤	aeu
蕥	art
蕨	adu
蕲	aul
蕴	axj
蕹	ayx
蕺	akb
蕻	avr
蕾	afl
薅	avd
薇	ahm
薏	axn
薛	atd
薜	ada
薪	aui
薮	aov
薰	aqb
薷	afd
薹	afk
薾	agm
藁	ahk
藉	adi
藏	aua
藐	aek
藓	acp
藜	atq
藤	aex
藥	axk
藩	aim
藻	aik
藿	afr
蘅	ahc
蘑	avd
蘧	ahe
蘩	axt
蘸	asr
蘼	avm
虍	hhg
虏	hle
虐	hvd
虑	hni
虙	hno
虚	hod
虞	hkg
虢	efy
虧	hrg
虫	jhn
虬	jnn
虮	jnn
虱	ntj
虳	jqy
虹	jag
虺	pji
虻	jyn
虼	jsn
虽	kju
虾	jgh
虿	gqj
蚀	hjy
蚁	jyr
蚂	jcg
蚊	jcy
蚋	jmw
蚍	jax
蚓	jxh
蚕	gdj
蚜	jrt
蚝	jcn
蚡	jmv
蚣	jmc
蚤	cuj
蚧	jwj
蚨	jay
蚩	bgj
蚪	jwh
蚬	jms
蚯	jrg
蚰	jng
蚱	jkf
蚴	jxl
蚵	jsk
蚶	jaf
蚺	jmf
蛀	jbg
蛄	jdg
蛆	jeg
蛇	jpx
蛉	jdy
蛋	wju
蛎	jdq
蛏	jcf
蛐	jka
蛑	jcp
蛔	jlk
蛘	jph
蛙	jff
蛛	jts
蛞	jqg
蛟	jur
蛤	jwg
蛩	anj
蛭	jag
蛰	hju
蛱	jxw
蛲	jxp
蛳	jjk
蛴	jcj
蛸	jie
蛹	jce
蛾	jry
蜀	lqj
蜂	jtd
蜇	rrj
蜈	jkg
蜉	jeb
蜊	jtj
蜍	jwi
蜒	jtc
蜓	jqp
蜕	jdq
蜗	jkm
蜘	jck
蜚	mxj
蜜	pno
蜞	jhy
蜡	jaj
蜢	jbl
蜣	jpn
蜩	jmf
蜮	jxk
蜱	jrv
蜷	jxl
蜻	jge
蜾	jjs
蜿	jpq
蝇	jkj
蝈	jlb
蝉	jul
蝌	jtw
蝎	jjq
蝓	jww
蝗	jkg
蝙	jom
蝠	jrl
蝣	jpb
蝤	jus
蝥	ctj
蝮	jtj
蝰	jdf
蝶	jkd
蝻	jhe
蝼	jov
蝾	jap
螂	jyv
螃	jup
螅	jtn
螈	jdk
螋	jvh
融	rmu
螓	jdw
螗	jow
螨	jae
螬	jem
螯	gtj
螳	jjf
螵	jbi
螺	jlx
蟀	jac
蟆	jsy
蟊	cjj
蟋	jmn
蟑	jxf
蟒	jad
蟓	jle
蟛	jfa
蟠	jml
蟥	jan
蟮	jpu
蟹	qev
蟾	jqd
蠃	yej
蠓	jap
蠔	jhe
蠕	jfd
蠖	jar
蠙	jpg
蠛	jal
蠡	xej
蠢	dwj
蠹	npd
蠼	jhh
衄	tln
衅	tlv
行	hwh
衍	hiw
衙	hsk
衡	hcw
衢	hhh
衤	byn
表	gku
衩	bcu
衫	bet
衬	bfy
衰	ygk
衷	vkk
衽	bqg
衾	dyk
衿	bdn
袁	fkk
袂	bby
袄	bmy
袈	vyk
袊	bdy
袋	hyy
袍	bql
袒	bjg
袓	beg
袖	bng
袜	bgs
袠	yrw
袢	bvu
袤	yck
袪	bly
袭	dxy
袱	bwd
袴	bdg
袷	bwg
袼	bog
裁	jyk
裂	bjy
装	ufy
裆	biv
裉	bvy
裎	bkg
裔	ykm
裕	bmr
裘	fyk
裙	bvt
裡	bua
裢	blp
裣	bwq
裤	bol
裥	buj
裨	brv
裰	boo
裱	bgk
裳	jyk
裴	mxy
裸	bjs
裹	yjs
裾	bnd
褂	bff
褊	bom
褐	bjq
褒	ymk
褓	bmk
褔	brl
褙	bux
褚	bfj
褛	bov
褡	baw
褢	yqc
褥	bde
褪	bvp
褫	brh
褰	pyk
褴	bjl
褶	bnk
襁	bxk
襄	yxe
襞	day
襟	bmw
襻	bmi
要	svu
覃	svj
覆	sht
观	cms
规	ams
视	oms
觇	vms
览	jms
觉	ims
觊	mlm
觋	aam
觌	viw
觎	wwm
觏	emf
觐	qfm
觑	hom
觖	qeb
觚	qeo
觜	cxq
觞	qet
觥	qek
触	qej
觫	qeu
觯	qeu
觿	qem
言	yyy
訄	vyd
訇	qyd
訚	uyd
訢	yrh
訾	cxy
詝	yps
詟	dxy
詠	yyi
詧	wyf
詫	ypm
詹	qdm
詻	yog
誉	cyf
誊	xyf
誓	rry
說	ydq
謇	pyf
謩	syf
警	ast
譬	day
讚	yeq
讠	yyn
计	yfh
订	ysh
讣	yhy
认	ywy
讥	ynn
讧	yag
讨	yfy
让	yhg
讪	ymh
讬	ymn
训	yjh
议	yyr
讯	ynf
记	yln
讲	yxh
讳	yvn
讵	yan
讶	yrt
讷	ymw
许	yrh
讹	yhn
论	ywx
讼	ymc
讽	ynr
访	ypt
诀	yby
证	ygc
诂	ydg
诃	ysk
评	yfu
诅	yeg
诈	ykf
诉	yry
诊	ywe
诋	ysc
诌	yqv
诎	ybm
诏	yvk
诐	yhc
译	ycv
诒	yck
诓	yag
诔	ydi
诖	yff
诘	yfk
诙	ydo
诚	ypx
诛	yts
诜	yeq
话	yqg
诞	ytc
诟	yfk
诠	yox
诡	yqd
询	yqj
诣	yxj
诤	yqs
该	yao
详	yph
诧	ypm
诨	ypl
诩	yng
诫	yxa
诬	yaa
诮	yie
误	ykg
诰	yek
诱	yte
诲	yxy
诳	yvg
说	ydq
诵	yce
诶	ycc
请	yge
诸	yfj
诹	ybc
诺	yat
读	yvi
诼	yeu
诽	ymx
诿	ytv
谀	yvw
谁	yrg
调	ymf
谅	yyi
谆	yyb
谇	yya
谈	yoo
谊	ype
谋	yaf
谍	ykd
谎	yay
谏	ysl
谐	yax
谑	yhv
谒	yjq
谓	yle
谕	yww
谖	yeg
谗	yls
谘	ykk
谙	yxg
谚	yut
谛	yup
谜	yop
谝	yom
谞	ywe
谟	ysy
谡	ylm
谢	yyf
谣	yer
谥	yuu
谦	yuv
谧	yno
谨	yqf
谩	yjl
谪	yed
谫	yuw
谬	ynw
谭	ysv
谮	yls
谯	yro
谰	yus
谱	you
谲	ycm
谳	yhe
谴	yxn
谷	mrd
豁	jrm
豆	gaf
豇	gag
豊	kag
豌	gap
豕	eui
豚	eeu
豢	xeu
豪	heu
豫	csl
豳	eum
豸	ety
豹	eqy
豺	eft
貂	evk
貅	ews
貉	eog
貊	edj
貌	ekq
貔	etk
貘	esy
貪	dmu
賃	wqm
賒	moi
賽	pmu
贞	hmi
负	qmu
贡	amu
财	mft
责	gmo
贤	tmu
败	mty
账	mhs
质	rfm
贩	mrc
贪	dmu
贫	mvm
贬	mtp
购	mqc
贮	mpg
贯	xfm
贰	afm
贱	mgx
贲	fam
贳	kdm
贴	mvg
贵	xmu
贶	mkq
贷	hym
贸	qyv
贺	vmu
贻	mck
贼	mxd
贽	hmu
贾	smu
贿	mef
赀	cxm
赁	wqm
赂	mog
赃	mof
资	kmu
赅	mao
赆	mnm
赇	mfy
赈	mde
赉	xim
赊	moi
赋	mga
赌	mfj
赍	fap
赎	mvi
赏	jmu
赐	mjq
赔	muk
赕	moo
赖	uqm
赘	gtm
赙	mbf
赚	muv
赛	pmu
赞	eqe
赟	cga
赠	mlj
赡	mqd
赢	yem
赣	xft
赤	fou
赦	fot
赧	foi
赫	fof
赳	kjk
赵	kri
赶	kfk
趁	kwe
趄	ked
超	kvk
趋	kqv
趑	kki
趔	kbj
趟	kjd
趣	kbc
趨	kqb
趴	lmy
趵	lqy
趸	gql
趺	lay
趼	leh
趾	lcg
趿	ley
跂	lfc
跄	lwl
跆	lck
跋	ldc
跎	lpx
跏	lvg
跑	lql
跖	ldg
跗	lwf
跚	lyg
跛	lhc
距	lan
跞	lqi
跣	leq
跤	lur
跨	ldg
跪	lqd
跫	anl
跬	lff
跳	liq
践	lgx
跶	ldp
跹	lqp
跺	lns
跻	lcj
跽	lln
踅	rrl
踉	lyv
踊	lce
踌	lof
踏	lhi
踔	lhv
踝	ljs
踞	lnd
踟	lck
踠	lpq
踢	ljq
踣	luk
踩	les
踪	lpw
踬	lrf
踮	lok
踯	lsb
踱	llc
踵	lqu
踹	lmd
踺	lwf
踽	ltk
蹀	lkd
蹁	lom
蹂	lcs
蹄	lup
蹇	plu
蹈	lev
蹉	lpa
蹊	lex
蹋	ljn
蹐	liq
蹑	lbo
蹒	lae
蹓	lqy
蹘	lnw
蹚	ljf
蹦	lme
蹧	lem
蹩	otl
蹬	lwg
蹭	llj
蹯	lml
蹰	lda
蹲	lus
蹴	lyi
蹶	ldu
蹼	loa
蹿	lps
躁	lkx
躅	llq
躇	laf
躏	lau
躐	lvk
躔	lou
躜	leq
躞	loy
身	yth
躬	yxn
躯	yar
躲	yns
躺	yjg
軎	lkf
輶	lus
輾	lna
车	lgn
轧	lnn
轨	lvn
轩	lfh
轫	lvy
转	lvc
轭	ldl
软	lqw
轰	lou
轱	ldg
轳	lhn
轵	lku
轶	lrw
轷	ltu
轸	lwe
轹	lqi
轺	lvk
轻	lca
轼	laa
载	jld
轾	lag
轿	lmj
辁	lox
辂	log
辄	lbn
辅	lby
辆	lea
辇	aal
辈	mxl
辉	kpl
辊	lja
辋	lmu
辍	loo
辎	lvl
辏	ldw
辐	lrl
辑	lkb
输	lww
辔	xlx
辕	lfk
辖	ljr
辗	lna
辘	lsx
辙	lyc
辚	lob
辜	daj
辟	dah
辣	auy
辨	ava
辩	aya
辫	axa
辰	dei
辱	def
辶	pyn
边	lpi
辽	bpi
达	dpi
迂	fhp
迄	spi
迅	nfp
过	fyp
迈	gqp
迍	bap
迎	qbp
运	cpi
近	rpi
迒	ynp
迓	rtp
返	rcp
迕	rhp
还	gpi
进	xpi
违	vnp
迟	nmp
迢	vkp
迤	tmp
迥	mkp
迦	vpi
迨	ckp
迩	qip
迪	npi
迫	kpi
迭	rwp
迮	kfp
述	syp
迳	cap
迴	lkp
迶	efp
迷	opi
迸	uep
迹	ppi
迺	spi
迻	qpi
追	tdp
适	qpi
逃	iqp
逄	tah
逅	fkp
逊	bip
逋	bpi
逍	iep
透	tep
逐	eup
逑	fpi
递	uxp
途	wip
逖	vop
逗	gap
這	ypi
通	cep
逛	vgp
逝	rrp
逞	kgp
速	upi
造	ekp
逡	cmt
逢	tdh
逦	gyp
逭	pdp
逮	vip
逯	jip
逵	fmf
逶	tvp
逻	lqp
逼	rlp
逾	wwp
遄	mdm
遏	jqw
遐	rnc
遒	usp
遗	xmp
遘	emf
遢	jnp
遣	xdp
遥	erm
遨	gtp
遭	emj
遮	lop
遴	obp
遵	usf
避	dap
邀	kpt
邂	qev
邃	pue
邋	vkr
邌	tqt
邑	kjb
邕	vkj
邗	fbh
邙	ybh
邛	abh
邞	abh
邠	mvb
邡	pbh
邢	ebh
邨	bab
邪	rtb
邮	nbh
邯	afb
邰	ckb
邱	rgb
邳	ggb
邴	ewb
邵	vkb
邶	uxb
邸	scb
邹	qvb
邻	dyb
邽	ffb
邾	tsb
郁	efb
郃	wbh
郄	rdc
郅	abh
郇	qjb
郊	urb
郎	yvb
郏	xwb
郐	ocb
郓	plb
郗	rdb
郛	ebb
郜	ekb
郝	fob
郡	vtk
郢	kgb
郦	gyb
郧	kmb
部	ukb
郫	rvb
郭	ybb
郯	oob
郴	mbh
郸	ulf
都	fjb
郾	ajv
郿	nhb
鄂	xgw
鄄	sfb
鄙	kdk
鄞	qfb
鄠	fgw
鄣	xfb
鄩	vak
鄯	pur
鄱	mlb
鄹	bcw
酃	fxk
酆	dhm
酉	sgh
酊	ssh
酌	sqy
酎	sfy
酏	smn
酐	sfh
酚	smv
酝	scy
酞	sdu
酡	spx
酢	skf
酣	saf
酤	sdg
酩	sqk
酪	sog
酬	sji
酮	smg
酯	sxj
酰	seq
酱	uqs
酲	skg
酴	swi
酵	sfb
酶	sxy
酹	sef
酽	sgd
酾	sgy
酿	syv
醇	syb
醉	sya
醋	saj
醌	sja
醍	sjw
醐	sde
醑	swe
醒	sjp
醚	sop
醛	sao
醢	str
醣	sow
醪	snw
醭	soa
醴	ska
醵	she
醺	sqb
釁	wfm
釆	mty
采	esu
釉	mng
释	mcv
量	jgu
金	buf
釒	qty
釜	mfu
釣	qqy
鉥	qsy
鉮	qjh
鉴	jbu
銎	anb
銧	qkn
鋐	qpd
鋪	qby
錵	qah
錾	lrb
鍪	ctb
鎋	qjr
鎯	qyv
鏊	gtb
鏖	sxb
鐭	qbo
鐾	dab
鑫	bub
鑰	qwx
鑱	qla
钃	qni
钅	qtg
钆	qnn
钇	qnn
针	qfh
钉	qsh
钊	qjh
钋	qhy
钌	qbh
钍	qfg
钎	qqh
钒	qny
钓	qqy
钔	qun
钕	qvg
钖	qvt
钗	qcu
钘	qeh
钙	qgc
钚	qgy
钛	qdu
钜	qan
钝	qba
钞	qit
钠	qmw
钡	qmy
钢	qmr
钣	qrc
钤	qdn
钥	qeg
钦	qqw
钧	qqu
钨	qqn
钩	qqc
钪	qyn
钫	qpt
钬	qoy
钭	qwh
钮	qnf
钯	qjn
钰	qby
钱	qgx
钲	qgc
钳	qaf
钴	qdg
钵	qjg
钶	qsk
钷	qak
钸	qdb
钹	qdc
钺	qax
钼	qhg
钾	quh
钿	qlg
铀	qng
铁	qrw
铂	qkg
铃	qdy
铄	qqi
铅	qnk
铆	qqt
铈	qvm
铉	qac
铊	qpx
铋	qno
铌	qnx
铍	qhc
铎	qcv
铏	qej
铐	qfw
铑	qfx
铒	qbg
铓	qay
铕	qef
铗	qxw
铘	qrt
铙	qxp
铛	qiv
铜	qmg
铝	qkk
铞	qkb
铟	qld
铠	qml
铡	qmj
铣	qeq
铤	qqp
铥	qtl
铧	qmx
铨	qox
铩	qjy
铪	qwg
铫	qiq
铬	qog
铭	qqk
铮	qqs
铯	qqj
铰	qur
铱	qyk
铲	qut
铳	qyc
铴	qiv
铵	qpv
银	qvy
铷	qvk
铸	qof
铹	qap
铼	qxi
铽	qan
链	qlp
铿	qtf
销	qie
锁	qim
锂	qla
锃	qkg
锄	qel
锅	qkm
锆	qek
锇	qry
锈	qte
锉	qaf
锊	qef
锋	qtd
锌	qah
锍	qyc
锎	que
锏	quj
锐	qdq
锓	qvp
锔	qns
锕	qbs
锖	qge
锗	qfj
锘	qat
错	qaj
锚	qal
锛	qdf
锜	qds
锝	qxh
锞	qjs
锟	qja
锡	qjq
锣	qlq
锤	qqa
锥	qrg
锨	qrq
锩	qxl
锪	qqr
锫	quk
锬	qoo
锭	qpw
键	qwf
锯	qnd
锰	qbl
锱	qvl
锲	qdh
锵	quq
锶	qln
锷	qxg
锸	qqv
锹	qto
锺	qqu
锻	qnx
锼	qvh
锾	qeg
锿	qyk
镀	qlc
镁	qug
镂	qov
镄	qxj
镅	qnh
镆	qsy
镇	qfe
镉	qrm
镊	qbo
镌	qre
镍	qts
镎	qwc
镐	qhk
镑	qup
镓	qpe
镔	qpr
镕	qpr
镖	qbi
镗	qjf
镘	qjl
镙	qlx
镚	qme
镛	qow
镜	qxq
镝	qed
镞	qpc
镟	qpw
镠	qnw
镡	qsv
镢	qdu
镣	qdu
镤	qoa
镥	qcj
镦	qyb
镧	qus
镨	quo
镩	qps
镪	qxk
镫	qwg
镬	qar
镰	qou
镱	qxn
镲	qpw
镳	qsx
镶	qyx
镸	vgh
长	hsi
閒	ued
閵	urd
闇	uxd
闏	uni
门	uyh
闪	uwi
闫	udd
闭	uft
问	ukd
闯	ucd
闰	ugd
闱	uvn
闳	udc
间	ujd
闵	uci
闶	uyn
闷	uni
闸	uuk
闺	uff
闼	udp
闽	uji
闾	rkk
阀	uwx
阁	uod
阂	uao
阃	uls
阄	uqj
阅	udq
阆	uyv
阈	uxk
阉	udj
阊	ujj
阋	uvq
阌	ujc
阍	usn
阎	uqv
阏	upw
阐	uul
阑	usl
阒	uhd
阔	uiq
阕	uwg
阖	ull
阙	uub
阚	unb
阜	tdf
阝	bnh
队	bwy
阢	bpn
阪	brc
阮	bfq
阱	bxh
阵	blh
阶	bwj
阻	beg
阼	bkf
阽	bvg
阿	bsk
陀	bpx
陂	bhc
际	bwm
陇	bdx
陈	bai
陉	bca
陋	bew
陌	bdj
降	bta
陕	bxw
陛	bax
陟	bci
陡	bky
院	bpf
除	bwi
陧	bjf
陨	bkm
险	bwq
陪	buk
陬	bbc
陱	bqo
陳	bsj
陴	brv
陵	bfm
陶	bqr
陷	bqv
陸	bfm
陹	bta
険	bwk
陻	bsf
陼	bfj
陽	bjg
陾	bdm
陿	bad
隀	bqu
隁	baj
隂	bwv
隃	bww
隄	bjw
隅	bjm
隆	btp
隇	bdv
隈	ble
隉	bva
隊	bue
隋	bda
隌	bxg
隍	bkg
階	bax
隑	bmg
隒	buv
隓	bda
隔	brm
隕	bkm
隖	bqo
隗	bqc
隙	bij
隚	bjf
際	bww
障	bxf
隝	bqo
隞	bgt
隟	bvj
隠	bev
隡	bup
隢	bff
隣	bob
隤	bxm
隥	bwg
隦	bda
隧	bue
隨	bda
隩	bbo
險	bwx
隫	bfa
隬	bgm
隭	bfd
隮	byf
隯	bfc
隱	bea
隲	bit
隴	bue
隵	bhg
隶	vii
隷	fwm
隸	swm
隹	rth
隺	prd
隻	rcu
隼	rfj
隽	rer
隿	xrg
雀	irf
雁	dwr
雂	drg
雃	erg
雄	dcr
雅	rtr
集	mbg
雈	gjg
雉	ccr
雊	srg
雋	rgb
雌	cxr
雍	yxt
雎	erg
雏	qvr
雐	hrd
雑	vir
雒	org
雓	wir
雔	rrg
雕	mfk
雖	kjr
雗	ktr
雘	mya
雙	rrc
雚	axr
雛	qbt
雜	yai
雝	vkj
雞	exd
雟	btr
雠	ryr
雡	new
離	ybm
難	aka
雤	wfi
雥	rrr
雦	rrr
雧	rrr
雩	fgw
雪	fvf
雫	fgh
雬	fsu
雭	fey
雮	fcn
雯	fcu
雰	fmv
雱	fpr
雲	fcu
雳	fdl
雴	fuf
雵	fmd
零	fdy
雷	flf
雸	faf
雹	fql
雺	fcr
電	fjn
雼	fdf
雽	ftu
雾	ftl
雿	fiq
霁	fcj
霂	fis
霄	fie
霅	fyf
霆	fqp
震	fde
霈	fig
霉	fxu
霊	ffo
霋	fgw
霌	fmf
霍	frf
霎	fuv
霏	fmx
霐	fix
霑	fiv
霒	fcd
霓	fvq
霔	fib
霕	fcb
霖	fmu
霗	fid
霘	fim
霙	fam
霚	fct
霛	fxx
霜	ftf
霝	fxk
霞	frn
霟	fir
霠	fud
霡	fey
霢	fer
霣	fkm
霤	fnl
霥	fpg
霦	fme
霧	fct
霨	fnw
霩	fyb
霪	fie
霫	fnk
霬	flr
霮	fih
霯	fwg
霱	fcm
露	flo
霳	fbt
霴	fcv
霵	fkb
霶	fiu
霷	fjj
霸	fqe
霹	fda
霺	fhm
霻	fka
霼	fce
霽	fyf
霾	feu
霿	fct
靀	fap
靁	fll
靂	fdt
靃	frr
靄	fyj
靅	fcx
靆	fcv
靇	fue
靈	fxk
靉	fcj
靊	fdh
靋	fid
靌	fpg
靍	frq
靎	fbu
靏	fpr
靐	flf
靑	gmx
青	gef
靓	gem
靔	gee
靕	gcg
靖	uge
靗	gek
靘	geq
静	geq
靚	geh
靛	gep
靜	gee
靝	gee
靟	mxc
靠	ekm
靡	vmx
面	dlj
靣	dlk
靤	dlj
靦	dlj
靧	dlj
靨	qje
革	qgh
靪	qsh
靫	qcu
靬	qfh
靭	qvy
靮	qqy
靯	qfg
靰	qpn
靱	qvy
靲	qdn
靳	qrh
靴	qhn
靵	qnf
靶	qjn
靷	qxh
靸	qey
靹	qmw
靺	qgs
靻	qeg
靼	qjg
靽	qvu
靾	qkd
靿	qxl
鞀	qvk
鞁	qhc
鞂	qty
鞃	qxc
鞄	qql
鞅	qmd
鞆	qew
鞇	qld
鞈	qwg
鞉	qiq
鞊	qfk
鞋	qff
鞌	pvq
鞍	qpv
鞎	qvy
鞏	anq
鞐	qhg
鞑	qdp
鞒	qmj
鞓	qkg
鞔	qls
鞕	qgj
鞖	qev
鞗	wht
鞙	qke
鞚	qps
鞛	quk
鞜	qhi
鞝	qjg
鞞	qrv
鞟	qyb
鞠	qqo
鞡	qru
鞢	qkd
鞣	qcs
鞤	fff
鞥	qwa
鞦	qto
鞧	qus
鞨	qjq
鞩	qie
鞪	ctq
鞫	qqy
鞬	qwf
鞭	qwg
鞮	qjw
鞯	qad
鞰	qjl
鞱	qev
鞲	qem
鞳	qaw
鞴	qat
鞵	qex
鞶	exq
鞷	rmu
鞹	qyb
鞺	qjf
鞼	qxm
鞽	qmy
鞿	qxx
韀	qon
韁	qgl
韂	qqd
韃	qfp
韄	qar
韅	qjx
韆	qsd
韇	qfl
韈	qal
韉	qao
韊	qau
韙	jww
韧	vnv
韨	vnd
韩	kvn
韪	jwv
韫	vnj
韬	vne
韭	mxg
韮	amx
韯	jmx
韰	hqc
韱	axm
韲	yvu
音	xyg
韴	xkm
韵	xqu
韶	xvk
韷	xbm
韸	xtd
韹	xkg
韺	xam
韻	xkm
韼	xtd
韽	dsx
韾	fnh
響	xty
頀	xar
頁	dmu
頂	sdm
頃	adm
頄	vdm
項	adm
順	jdm
頇	fdm
須	edm
頉	cdm
頊	gdm
頋	dbd
頌	mcd
頍	fcd
頎	rdm
頏	ynd
預	csd
頑	fqd
頒	mvd
頓	bad
頔	ndm
頕	vdm
頖	odm
頗	hcd
領	dyd
頙	gcd
頚	cfd
頛	did
頜	wdm
頝	urd
頞	pvd
頟	odm
頠	qdb
頡	fkd
頢	qdm
頣	ayd
頤	ayd
頥	hay
頦	aod
頧	tdd
頨	ndm
頩	ued
頪	odm
頫	iqd
頬	xwd
頭	gad
頮	hia
頯	qad
頰	dad
頱	efy
頲	qpd
頳	fod
頴	xwm
頵	vtk
頶	ekd
頷	dkd
頸	gva
頹	tqd
頺	ted
頻	cid
頼	udm
頽	tnd
頾	edm
頿	ecx
顀	rdm
顁	pwd
顂	sdm
顃	ood
顄	bid
顅	oed
顆	jsd
顇	yaf
顈	xxi
顉	bud
顊	tdf
顋	lni
題	jwd
額	pod
顎	xgw
顏	cde
顐	pld
顑	drx
顒	jmc
顓	mdm
顔	ute
顕	jod
顖	tkr
顗	mga
願	dki
顙	cos
顚	xhn
顛	feu
顜	emf
顝	xdm
類	ody
顟	new
顠	bid
顡	ueu
顢	abt
顣	dmt
顤	fff
顥	kid
顦	rod
顧	ord
顨	dmd
顩	wxa
顪	cdi
顫	ylk
顬	fdm
顭	alp
顮	pgi
顯	jxx
顰	cid
顱	hll
顲	ooy
顳	bbb
顴	axr
顷	adm
顸	fdm
顺	jdm
须	edm
顼	gdm
顽	fqd
顾	dbd
顿	bad
颀	rdm
颁	mvd
颂	mcd
颃	ynd
预	csd
颅	hnd
颇	hcd
颈	cad
颉	fkd
颊	xwd
颋	qpd
颌	wdm
颍	xhi
颎	xod
颏	aod
颐	ayd
频	cid
颒	hia
颓	tnd
颕	xwm
颗	jsd
题	jwd
颙	jmd
颛	mdm
颜	ute
额	pod
颞	bod
颟	aea
颠	feu
颡	cos
颢	kid
颣	oxi
颤	ylk
颥	fdm
颧	axr
風	ntn
颩	nee
颪	ghn
颫	nai
颬	nrt
颭	nvd
颮	nql
颯	uny
颰	ndc
颱	nck
颲	nbj
颳	nqd
颴	ntw
颵	nie
颶	neu
颷	noo
颸	nln
颹	nwk
颺	njg
颼	nvh
颽	mga
颾	ncu
颿	cny
飀	nnl
飁	nkn
飂	nnw
飃	nbi
飄	bin
飆	dyd
飇	ndy
飈	noo
飉	ndu
飊	ooo
飋	ngg
飌	axr
飍	nnn
风	nri
飏	nrv
飐	nrv
飑	nrq
飒	unr
飓	nre
飔	nrl
飕	nrv
飗	nrn
飘	bin
飙	dyd
飚	nro
飛	nut
飜	mln
飝	nut
飞	nui
飠	hty
飡	uhy
飢	hnn
飣	hsh
飤	hwy
飥	hmn
飦	hfh
飧	qhy
飩	hba
飪	hqg
飫	hmy
飬	xyv
飭	htl
飮	wyr
飯	hrc
飰	hyh
飱	bhy
飲	hky
飳	hbg
飴	hck
飵	hkf
飶	hno
飷	heg
飸	kwh
飹	hqt
飺	cxh
飻	hwe
飼	hnr
飽	hql
飾	htb
飿	hbm
餀	har
餁	hwq
餂	hqg
餃	hur
餄	hwg
餅	hue
餆	hiq
餇	hmg
餈	khu
餉	hbk
養	udh
餋	xhu
餌	hbg
餍	ddy
餎	hog
餏	hyk
餐	hqc
餑	hfp
餒	hev
餓	hry
餔	hby
餕	hcm
餖	hga
餗	huy
餘	hwi
餙	hrd
餚	hre
餛	hja
餜	hjs
餝	hap
餞	hxx
餟	hoo
餠	htf
餡	hqv
餢	huk
餣	hdj
餤	hoo
餥	mxh
餦	hvt
餧	htv
館	hpd
餩	hwa
餪	hdm
餫	hpl
餬	hde
餭	hkg
餮	bwe
餰	hhi
餱	hwn
餲	hjq
餳	hjg
餴	hdf
餵	hle
餶	hxg
餷	hsj
餸	hsp
餹	how
餺	hbf
餻	hug
餼	heo
餽	hqc
餾	hnl
餿	hvh
饀	hev
饁	hll
饂	hjl
饃	hsy
饄	hjf
饅	hjl
饇	hak
饈	hpn
饉	hqf
饊	hae
饋	hxm
饌	hll
饍	hpu
饎	hfa
饏	nbt
饐	hfp
饑	hxx
饒	hff
饓	hjs
饕	kwh
饖	hcd
饗	xty
饘	hyl
饙	hfa
饚	hal
饛	hap
饜	dje
饝	hvd
饞	hla
饟	hyx
饠	hlx
饡	heq
饢	hnp
饣	htn
饤	hsh
饥	hnn
饦	hmn
饧	hvt
饨	hba
饩	hen
饪	hqg
饫	hmy
饬	htl
饯	hgx
饰	htb
饱	hql
饲	hnr
饳	hbm
饴	hck
饵	hbg
饶	hxp
饷	hbk
饸	hwg
饹	hog
饺	hur
饻	hyk
饼	hue
饽	hfp
饾	hga
饿	hry
馁	hev
馂	hcm
馃	hjs
馄	hja
馅	hqv
馆	hpd
馇	hsj
馈	hxm
馉	hxg
馊	hvh
馋	hls
馌	hll
馍	hsy
馎	hbf
馏	hqy
馐	hpn
馑	hqf
馒	hjl
馓	hae
馔	hll
馕	hnp
馗	vqd
馘	qxk
馚	tmv
馛	tjd
馜	tnx
馝	tjn
馞	tfp
馟	teb
馠	tjd
馡	tjm
馢	txx
馣	tjd
馤	tjj
馥	tjt
馦	tju
馧	tjl
馨	fnh
馩	tjf
馪	tjp
馫	tjt
馬	cgh
馭	ccy
馮	ucy
馯	cfh
馰	cqy
馱	cdy
馲	cmn
馳	cmn
馴	cjh
馵	caj
馶	cfc
馷	cgb
馸	crh
馹	cjg
馺	cey
馻	ccq
馼	ccy
馽	csj
馾	cps
馿	cot
駀	cdn
駁	ciy
駂	xfc
駃	cby
駄	cdu
駅	cnm
駆	car
駇	cty
駈	crg
駉	cmk
駊	chc
駋	cvk
駌	qlc
駍	cfu
駎	cng
駏	can
駐	cbg
駑	vcc
駒	csg
駓	cgg
駔	ceg
駕	vcu
駖	cdy
駗	cwe
駘	cck
駙	cwf
駚	cmd
駛	ckr
駜	cno
駝	cpx
駞	ctm
駟	clg
駠	cqt
駡	xcu
駢	cue
駣	ciq
駤	cag
駥	cxd
駦	xcu
駧	cmg
駨	cqj
駩	cox
駪	ceq
駫	ckn
駬	cbg
駭	cao
駮	cur
駯	cts
駰	cld
駱	cog
駲	cji
駳	ctc
駴	cxa
駶	cns
駷	cuy
駸	cvp
駺	cyv
駻	cjf
駼	cwi
駽	cke
駾	cdq
駿	ccm
騀	cry
騁	cnw
騂	cah
騃	ccc
騄	cji
騅	crg
騆	cmf
騇	cbk
騈	ctf
騉	cja
騋	csa
騌	cpw
騍	cjs
騎	cds
騏	chy
騐	cdn
騑	cmx
騒	ccj
験	cww
騔	cjq
騕	csv
騖	ctc
騗	oma
騘	cqr
騙	com
騚	cuw
騛	cnu
騜	ckg
騝	cwf
騞	cdh
騟	cww
騠	cjw
騡	ckh
騢	crn
騣	cbm
騤	cwg
騥	ccs
騦	cln
騧	cmn
騨	cil
騩	cqc
騪	cvh
騫	pcu
騬	cqu
騭	bci
騮	cnl
騯	cup
騰	exc
騱	cex
騲	cav
騳	ccy
騴	cjp
騵	cdk
騶	cqb
騷	ccu
騸	con
騹	cqf
騺	fuf
騻	cdi
騼	csx
騽	cnk
騾	clx
騿	cxf
驀	scu
驁	gtc
驂	ccc
驃	cbi
驄	ctk
驅	cak
驇	fmf
驈	ccm
驉	cho
驋	cwx
驍	cff
驎	cob
驏	cnb
驐	cyb
驒	cxl
驓	clj
驔	csv
驕	cmy
驖	cjk
驗	cwx
驘	yec
驙	cyl
驚	ast
驛	clf
驜	cop
驝	cfp
驞	cpg
驟	cbc
驠	cau
驡	ueq
驢	chl
驣	cxc
驤	cyx
驥	cux
驦	cft
驧	cqq
驨	cmr
驩	cax
驪	cgg
驫	ccc
驮	cdy
驯	cjh
驰	cmn
驱	car
驲	cjg
驳	ciy
驴	cot
驵	ceg
驶	ckr
驷	clg
驸	cwf
驹	csg
驺	cqv
驻	cbg
驼	cpx
驽	vcc
驾	vcf
驿	ccv
骀	cck
骁	cxp
骂	xcf
骃	cld
骄	cmj
骅	cmx
骆	cog
骇	cao
骈	cue
骉	ccc
骊	cgy
骋	cnw
验	cwq
骍	cah
骎	cvp
骏	ccm
骐	chy
骑	cds
骒	cjs
骓	crg
骔	cpw
骕	cvi
骖	ccd
骗	com
骙	cwg
骚	ccu
骛	ctc
骞	pcf
骟	con
骠	cbi
骡	clx
骢	ctl
骣	cnb
骤	cbc
骥	cux
骦	cft
骧	cyx
骨	xhn
骩	xvn
骪	xny
骫	xvy
骬	xfh
骭	xfh
骮	xxy
骯	xyn
骰	xxy
骱	xwj
骲	xql
骳	xhc
骴	xcx
骵	xjg
骶	xsc
骷	xdg
骸	xao
骹	xur
骺	xfk
骻	xdg
骼	xog
骽	xev
骾	xgj
骿	xue
髀	xrv
髁	xjs
髂	xpo
髃	xjm
髄	xef
髅	xov
髆	xbf
髇	xhk
髈	xup
髉	xpr
髊	xpa
髋	xpa
髌	xpr
髍	xvy
髎	xnw
髐	xff
髑	xlq
髒	xab
髓	xda
體	xka
髕	xpg
髖	xpa
髗	xhl
高	hkd
髚	hky
髛	hkn
髜	hkj
髝	hko
髞	hkk
髟	vet
髠	ven
髡	vep
髢	vem
髣	vep
髤	ves
髥	vem
髧	vep
髨	vef
髩	veg
髪	ved
髫	vev
髬	veg
髭	vec
髮	ved
髯	vem
髰	vek
髱	veq
髲	veh
髳	vec
髴	vex
髵	ved
髶	veb
髷	vek
髸	ver
髹	vew
髺	veq
髻	vef
髼	vet
髽	vea
髾	vei
髿	vei
鬀	veu
鬁	vet
鬂	ver
鬄	vej
鬅	vee
鬆	ves
鬇	veq
鬈	vex
鬉	veb
鬊	ved
鬋	veu
鬌	ved
鬍	ved
鬎	veu
鬏	vet
鬐	vef
鬑	veu
鬒	vef
鬓	vep
鬔	vet
鬕	ves
鬖	vec
鬗	vea
鬘	vej
鬙	vel
鬚	vee
鬛	vek
鬜	veu
鬝	veu
鬞	vek
鬟	vel
鬠	vew
鬡	vep
鬢	vep
鬣	vev
鬤	vey
鬰	sip
鬲	rmu
鬳	hrm
鬴	rmu
鬵	lsl
鬶	ams
鬷	rmu
鬸	rmu
鬹	ahq
鬺	rmu
鬻	xox
魁	qcw
魂	cqc
魃	qcd
魄	kqc
魅	qcf
魆	qca
魈	qci
魉	qce
魍	qcm
魏	tvq
魑	qcy
魔	vqc
魘	dke
魙	ilr
魚	ctn
魛	cvt
魜	cwy
魝	cjh
魞	cty
魟	cag
魠	cmn
魡	cqy
魢	cln
魣	ccs
魤	chn
魥	cey
魦	cit
魧	cyn
魨	cba
魩	cqr
魪	cwj
魫	cps
魬	crc
魭	cfq
魮	cax
魯	cjf
魰	ccy
魲	cot
魳	ckm
魴	cpt
魵	cmv
魶	cmw
魷	cdn
魸	csn
魹	ccn
魺	csk
魻	cuh
魼	cly
魽	caf
魾	cgg
魿	cdy
鮀	cpx
鮁	cdc
鮂	clw
鮃	cfu
鮄	cxj
鮅	cno
鮆	cxc
鮇	cfi
鮈	csg
鮉	cvk
鮊	ckg
鮋	cng
鮌	cac
鮍	chc
鮎	cvg
鮏	cpg
鮐	cck
鮑	cql
鮒	cwf
鮓	ckf
鮔	can
鮕	cdg
鮖	cdg
鮗	ctu
鮘	chy
鮙	cny
鮚	cfk
鮛	cmt
鮜	cfk
鮝	xcu
鮞	cdm
鮟	cpv
鮠	cqd
鮡	ciq
鮢	cts
鮣	csb
鮤	bjc
鮥	cog
鮦	cmg
鮧	cgx
鮨	cxj
鮩	cue
鮪	cef
鮫	cur
鮬	cdg
鮭	cff
鮮	cph
鮯	cwg
鮰	clk
鮱	cfx
鮲	cwd
鮳	cfw
鮴	cws
鮵	cdq
鮶	cvt
鮷	cux
鮸	cls
鮹	cie
鮺	pci
鮻	ccm
鮼	cvp
鮽	cwi
鮾	cev
鮿	cbn
鯀	ctx
鯁	cgj
鯂	csg
鯃	csk
鯄	cfy
鯅	ctc
鯆	cby
鯇	cpf
鯈	wht
鯉	cua
鯊	iit
鯋	cii
鯌	cek
鯍	cyc
鯎	cpx
鯏	ctj
鯐	cky
鯑	crd
鯒	cce
鯓	cyt
鯔	cvl
鯕	chy
鯖	cge
鯴	cnt
鯵	ccd
鰡	cqy
鰩	cer
鰱	clp
鰲	gtc
鰳	cql
鰴	cmg
鰵	ctc
鰶	cww
鰷	cwh
鰸	cak
鰹	cay
鰺	ccc
鰻	cjl
鰼	cnk
鰽	cem
鰾	cbi
鰿	cgm
鱀	vlc
鱁	ceu
鱂	cuq
鱃	cpn
鱄	crf
鱅	cow
鱆	cxf
鱇	cow
鱈	cfv
鱼	ctn
鲁	cjf
鲂	cpt
鲅	cdc
鲆	cfu
鲇	cvg
鲈	chn
鲊	ckf
鲋	cwf
鲍	cql
鲎	icf
鲐	cck
鲑	cff
鲒	cfk
鲔	cef
鲕	cdm
鲙	coc
鲚	ccj
鲛	cur
鲜	cph
鲞	ucf
鲟	cvf
鲡	cgy
鲢	clp
鲣	ctf
鲤	cua
鲥	cjf
鲦	cti
鲧	ctx
鲨	iit
鲩	cpq
鲫	cvb
鲬	cce
鲭	cge
鲮	cfm
鲯	chy
鲰	cbc
鲱	cmx
鲲	cja
鲳	cjj
鲴	cld
鲵	cvq
鲷	cmf
鲸	cyi
鲺	cnt
鲻	cvl
鲼	cfa
鲽	ckd
鳃	cln
鳄	cxg
鳅	cto
鳆	ctj
鳇	ckg
鳊	com
鳋	ccu
鳌	gtc
鳍	cfx
鳎	cjn
鳏	cli
鳐	cer
鳓	cql
鳔	cbi
鳕	cfv
鳖	otc
鳗	cjl
鳘	xtc
鳙	cov
鳜	cdu
鳝	cpu
鳞	cob
鳟	cus
鳢	cka
鳴	kqo
鳵	nfq
鳶	aqo
鳷	fcq
鳸	oqo
鳹	dqo
鳺	aqo
鳻	mvq
鳼	cqo
鳽	eqo
鳾	kmq
鳿	gqo
鴀	gqo
鴁	myq
鴂	bqo
鴨	uqo
鴱	arq
鴳	pvq
鵪	djq
鵫	hvq
鵬	eeq
鵭	qqo
鶉	ybq
鷁	uuq
鷣	svq
鷦	roq
鸌	qoa
鸍	gmb
鸎	mmq
鸏	apg
鸐	nrq
鸑	vyd
鸒	wfq
鸓	lll
鸔	qoj
鸕	hll
鸖	frq
鸗	ueq
鸘	ftq
鸙	wxk
鸚	mmv
鸛	axr
鸜	hhr
鸝	ggy
鸠	vqg
鸡	cqg
鸢	aqg
鸣	kqg
鸤	nqg
鸥	arq
鸦	rtq
鸧	wlq
鸨	xfq
鸩	psq
鸪	dqg
鸫	aiq
鸬	hnq
鸭	uqg
鸮	kwq
鸯	mdq
鸱	scq
鸲	sqg
鸵	qgp
鸶	xxg
鸷	hqg
鸸	dmq
鸹	qqg
鸺	wsq
鸽	wqg
鸾	pqg
鸿	iaq
鹁	fpb
鹂	gyq
鹃	keq
鹅	ryq
鹆	mrq
鹇	usq
鹈	uxq
鹉	gac
鹋	alq
鹌	djn
鹍	jaa
鹎	rvq
鹏	eeq
鹑	ybq
鹕	deq
鹘	xqg
鹙	toq
鹚	uoq
鹛	nhq
鹜	ctq
鹝	rmu
鹞	erm
鹟	mcn
鹡	iwe
鹢	uul
鹤	prq
鹧	loq
鹩	duj
鹪	roq
鹫	yid
鹬	cmr
鹭	loq
鹮	lrk
鹰	owr
鹱	qga
鹳	axr
鹾	vrp
鹿	sxv
麂	sxn
麇	sxt
麈	sxb
麋	sxo
麒	sxh
麓	msx
麟	sxo
麤	sxs
麥	saq
麦	gtu
麩	saq
麴	fat
麸	gqa
麼	vxi
麽	vog
黄	anu
黎	tqt
黏	twi
黑	bbb
黔	bdn
黛	hyb
黜	bbm
黝	bxl
點	bvg
黟	bqy
黠	bfk
黡	ddy
黢	bcm
黣	bxy
黤	bdj
黥	byi
黦	bpq
黧	tqt
黨	jbu
黩	bvi
黪	bcd
黫	bsf
黯	bxg
黹	ooi
黻	ood
黼	oob
黾	kjn
鼋	fqk
鼌	jrj
鼍	xlr
鼎	hus
鼏	phu
鼐	ehu
鼑	hhu
鼒	fth
鼓	faf
鼔	fah
鼕	faf
鼖	faf
鼗	iqf
鼘	faf
鼚	faf
鼛	faf
鼜	faf
鼞	faf
鼟	faf
鼠	vub
鼡	inv
鼢	vum
鼣	vud
鼤	vuc
鼥	vud
鼦	vuv
鼧	vup
鼨	vut
鼩	vus
鼪	vup
鼫	vud
鼬	vun
鼭	vuf
鼮	vuq
鼯	vus
鼰	vum
鼱	vug
鼲	vup
鼳	vuh
鼴	vua
鼵	vup
鼶	vur
鼷	vue
鼸	vuu
鼹	vuj
鼺	vul
鼻	tpj
鼼	tpn
鼽	tpv
鼾	tpf
鼿	tpp
齀	tpg
齁	tps
齂	tpv
齃	tpj
齄	tps
齅	tpt
齆	tpv
齇	tph
齈	tpk
齉	tpn
齐	cjj
齑	cjm
齒	cij
齓	cin
齔	cix
齕	cis
齖	cir
齗	cir
齘	ciw
齙	ciq
齚	cik
齛	cik
齜	cic
齝	cic
齞	cik
齟	cie
齠	civ
齡	cid
齢	cbo
齣	cis
齤	xci
齥	cij
齦	civ
齧	dhv
齨	civ
齩	ciu
齪	cil
齫	cil
齬	cis
齭	cil
齮	cid
齯	civ
齰	cia
齱	cib
齲	cit
齳	cip
齴	ciu
齵	cij
齶	cix
齷	cin
齸	ciu
齹	pac
齺	ciq
齻	cif
齼	cim
齽	cim
齾	hrm
齿	cbj
龀	cbx
龁	cbs
龂	cbr
龃	cbe
龄	cbd
龅	cbq
龆	cbv
龈	cbv
龉	cbs
龊	cbl
龋	cbt
龌	cbn
龍	ueq
龎	duq
龏	ueq
龐	oue
龑	ueq
龒	ueq
龓	efu
龔	ueq
龕	wue
龖	ueq
龘	ueq
龙	dxv
龚	dxr
龛	wdx
龠	wxk
龡	wxk
龢	wxk
龣	wxk
龤	wxk
龥	wxk
丁	sg
三	di
不	gn
与	qn
且	eh
东	ai
两	ea
个	ot
中	sh
临	jt
久	qy
么	og
乌	qn
乘	tu
九	vo
也	ma
乡	xt
乱	qn
了	bn
争	qs
云	cg
亚	go
产	ut
亮	hn
亿	wn
仁	wf
从	ao
令	dy
件	wp
价	ww
任	wq
伏	wd
伟	wv
但	wj
住	wb
体	wj
佳	wf
供	wr
侧	wm
俗	wm
修	wh
倒	wa
借	wa
像	wl
先	eq
光	kh
克	dq
党	jq
全	ox
兰	uf
其	hg
具	eu
兼	uv
再	ke
农	pk
冷	ud
净	uq
几	nt
凯	ml
凶	bt
出	bm
列	bj
刘	cj
刚	mr
创	wl
初	bv
刮	qj
前	uw
加	vn
动	cl
勾	qc
勿	qr
北	ux
匹	aq
十	fo
千	qt
单	ul
卖	vi
南	he
卢	hn
厅	ds
压	df
厌	dd
原	dk
去	lh
又	cn
及	ey
叔	mt
受	jc
叙	wi
只	ku
可	sk
台	ck
史	kr
右	tr
叶	kf
吃	ks
各	oa
吊	kb
同	ma
后	fk
吕	kk
君	vt
吧	kj
吾	sk
呈	kg
呗	km
员	km
周	mf
呼	kt
和	tk
哈	kw
哉	jk
响	kb
哭	xd
唐	ow
商	er
嗯	kl
嘛	kv
嘴	kc
回	lk
围	lv
国	lb
圆	lk
土	ff
圣	cf
在	dj
场	fv
坐	af
块	fb
坚	tf
坛	fc
型	ej
城	fp
培	fu
基	hf
堂	jf
墨	bf
声	fn
复	tj
外	qh
够	sq
头	iw
奇	ds
奥	bo
奶	ve
奸	vf
如	vk
妈	vc
姐	ve
委	tv
娃	vf
孔	bn
孕	eb
字	pb
学	ib
它	px
安	pv
宋	ps
完	pf
定	pw
宜	pe
家	pe
密	pn
封	ff
射	yf
尊	us
尖	id
就	yi
尽	nm
层	nc
居	nd
岁	mq
岩	md
川	jt
巡	vp
工	ag
已	ly
巴	jn
师	jk
希	rd
帕	bk
帝	up
帮	ob
常	jb
干	fg
平	fu
年	ak
幻	xn
庄	of
序	oc
应	oq
底	os
店	ok
庙	on
座	oa
廷	qp
式	aa
弱	xu
强	xk
当	iv
影	ki
往	hb
待	hf
很	hv
微	hm
必	no
志	fn
怕	nk
思	ln
性	np
总	dn
悄	ni
悟	ns
想	tn
愚	jm
感	dr
慢	nj
成	px
我	ry
或	xk
战	vx
户	oo
所	lr
扁	om
扫	rv
扬	rv
批	ra
找	rx
护	ro
报	ri
拆	rr
拍	rk
拓	rd
招	rv
持	rf
指	rx
捕	rb
换	rq
接	ru
插	rq
搞	rh
支	fc
收	nh
改	lt
故	dt
敢	nb
敬	as
数	ov
断	on
方	py
既	vl
日	ja
旧	hj
早	vh
旱	jf
明	je
易	jq
昔	aj
星	jp
春	dw
晕	jp
晚	jl
暖	je
曰	jh
曹	em
月	ee
望	ye
朝	ke
期	he
本	jj
术	sy
机	sn
杀	jt
权	sc
杜	sf
杰	so
极	se
构	sq
果	js
某	af
标	sw
核	sa
格	so
梁	iv
梅	sx
梦	mq
棋	sh
森	sm
横	sa
次	ky
欧	ar
歇	jq
歌	aq
武	ga
段	nx
殿	nr
毁	va
每	xx
毒	gx
比	ax
毕	ax
永	yi
汉	ic
汗	if
汤	iv
沃	im
沙	ii
没	ix
法	il
波	ih
洗	ie
洞	im
流	iy
浩	ie
海	cu
润	iu
淡	io
温	ij
湖	id
满	ia
漫	ij
潮	ik
炮	oq
炸	ok
点	vo
烂	ou
然	qd
照	jv
熟	yb
燕	au
父	mt
版	sr
物	nq
特	nf
犯	vl
犹	vd
狼	vy
猜	vg
献	he
玄	ac
率	ac
王	gg
班	gv
瓦	gn
甜	qa
用	eh
田	lh
男	ll
留	qy
略	lo
疯	un
登	wg
白	kt
的	kq
直	fe
真	fe
矣	cc
知	ck
短	cg
矮	ct
石	dd
确	dq
碰	du
社	of
祖	oe
神	oj
祥	op
离	yb
科	tw
程	tk
穷	pl
站	uv
章	xf
竹	tt
等	tf
答	tw
米	oa
类	od
糖	oo
系	tx
素	gx
索	fp
纸	xs
组	xe
绍	xv
经	xc
统	xy
缩	xp
网	md
罗	lq
美	ug
群	vt
翁	mc
翻	ml
翼	nl
而	dm
耐	dm
耳	bg
肯	ce
育	yc
能	jx
脱	ed
腻	ea
膜	es
至	ag
致	at
舒	bk
般	ex
色	qj
艺	an
芳	ap
若	at
莫	sg
获	av
菲	am
蒋	au
蒙	ap
蓝	aj
薄	ai
虎	hn
蛮	pj
血	tl
街	hf
衣	yk
补	bh
被	bh
西	sg
见	ms
觅	em
角	qe
解	qe
设	yx
识	yk
词	yn
试	ya
诗	yf
语	ys
课	yj
象	le
贝	mh
货	hm
费	xj
走	kg
赴	kh
起	kl
越	ka
足	lh
跃	lm
跌	lr
跟	lv
路	lo
轮	lw
轴	ln
较	lu
辛	ay
辞	qa
迁	qp
这	cp
远	fq
连	lp
退	vp
送	sp
逆	ub
选	eq
逸	ls
遂	ue
遇	jm
遍	om
道	qp
邓	cb
那	ob
邦	ob
郑	sb
配	sl
酒	is
酷	se
酸	sc
里	ua
重	qu
野	ua
钟	qs
钻	qv
铺	qb
锦	qk
闲	us
闹	uv
闻	ub
防	bp
阳	bj
阴	be
附	bw
陆	bf
限	bv
随	be
隐	bq
难	cr
雇	or
雨	mk
需	fd
非	mx
韦	vn
页	dm
顶	sd
项	ad
领	dy
食	hh
饭	hr
饮	hq
首	qy
香	tj
马	co
鬼	qc
鸟	qg
麻	vy
默	bd
龟	qj
