的	d
我	w
是	u
了	l
你	n
在	z
和	h
都	dz
不	b
有	y
就	j
也	yt
好	hb
个	g
人	r
说	uo
用	ya
他	t
这	v
来	lf
要	yx
去	q
会	hc
看	k
中	vs
想	x
没	m
啊	a
那	nl
吧	ba
给	gr
能	nh
对	dc
上	ug
到	dx
多	do
吗	ma
里	lp
被	bq
做	zi
又	ym
过	gi
让	rg
还	hf
她	ta
打	dd
把	bd
而	e
着	ve
大	dl
从	c
它	tab
写	xw
再	zs
字	zu
得	de
搞	gb
狗	gc
猫	mc
一	yi
真	vf
下	xz
但	dh
叫	jb
很	hh
比	bp
呢	ne
最	zc
更	gf
地	du
地	det
等	dj
吃	i
像	xk
后	hm
时	uoo
只	vp
点	dxl
先	xm
话	hz
与	yn
快	kj
玩	wk
当	dhx
已	yp
问	wd
完	wkb
以	ypv
将	jl
您	nn
找	vb
爱	au
太	ts
谁	ue
才	cf
年	nz
新	xb
跟	gfz
别	bqk
学	xy
哇	wa
按	ab
哎	ai
前	qz
睡	uc
加	jx
所	s
为	we
可	kt
出	iu
嗯	ef
该	gd
向	xkp
却	qr
哦	o
小	xzl
天	tm
高	gcw
买	mg
呀	yak
刚	gh
事	uu
好	hxn
坏	hj
发	f
全	qt
开	kd
万	wh
之	vi
心	xbd
帮	bh
回	hbk
得	dri
牛	nw
家	jxb
长	ij
月	yr
卖	ms
岁	sc
成	ih
唉	auk
跑	p
走	zct
早	zb
连	lz
滴	di
越	yrt
无	wi
阿	aa
送	sa
分	ff
黑	hw
额	er
妈	man
换	he
们	mf
难	nk
同	td
祝	vy
恩	en
干	gha
算	se
路	ly
并	bj
呗	bw
少	ub
猜	cd
放	fg
擦	ca
转	vyi
错	ci
脸	lx
贴	tp
陪	pe
带	ds
笑	xbv
敢	gl
谱	po
拿	ns
二	ee
煮	vo
鸡	ji
或	hi
书	uuv
每	mr
画	hza
坐	zir
咯	kdk
掉	db
讲	js
梦	mfm
冷	lj
花	hx
于	yb
手	ucp
咋	zd
哟	yo
爆	bx
站	vh
变	bn
看	kju
哥	ge
版	bl
水	un
起	qp
图	ti
弄	na
住	vyr
啦	la
够	gm
咩	mp
累	lq
倒	dxr
肉	rm
毛	mv
神	ugp
请	qa
拉	laf
肿	vfo
听	tk
内	nq
噢	oo
唱	ig
骂	ml
装	vl
三	sj
蛮	mk
腿	tn
正	vfa
瘦	um
卤	lo
俺	az
老	lb
俩	lv
抱	bxf
忙	mj
超	ic
疼	th
胖	pg
喔	wo
车	ie
某	mcg
第	duv
教	jn
中	val
进	jv
假	jvr
差	il
忘	wg
热	rw
选	xyz
啥	us
微	ww
求	qw
若	ri
些	xp
久	je
苦	ko
米	mpd
约	yts
飞	fw
吓	xzk
亲	qb
照	vx
赢	yl
饿	ew
读	diy
秒	mz
信	xv
另	ljk
儿	et
靠	kx
聊	lm
远	yy
懂	df
羯	jq
低	dir
呆	ddk
晒	uso
追	vv
见	jnk
跳	tb
挂	gz
哪	nd
鸟	nzw
呃	ewk
挺	taf
贵	gcv
元	yte
摩	mpg
疯	fgb
张	vhg
萌	mh
头	tx
活	hp
行	xl
哒	da
次	cu
本	bha
骗	pn
店	dn
考	kb
歌	gea
喂	wq
强	qag
死	sp
收	uz
噗	pu
恨	hd
撸	lu
喵	mn
亮	lk
弱	rig
破	pi
哼	hg
拍	pd
躺	tku
抢	qs
吐	to
日	ru
谈	tky
饭	fh
帅	uj
离	low
号	hxk
闹	nx
办	bhl
还	htz
养	yk
红	hds
猪	vu
刷	ux
呐	nlk
姐	jw
洗	xpd
种	va
喝	hek
菜	cs
如	rin
赞	zh
丢	dq
捏	np
非	fwl
粉	fhm
怕	pl
坑	kg
网	wkk
总	zf
曾	ch
爹	dp
蛋	dhv
型	xlk
咱	zk
屎	up
纸	vps
杀	ua
自	zup
白	bf
急	jo
催	cv
吖	aak
改	gg
特	tw
包	bc
愿	ye
妹	mq
唔	wik
受	ump
抓	vxf
钱	qzj
者	vt
喷	pf
鱼	ybd
瞎	xx
此	cp
乱	le
滚	gid
呦	yz
晚	wl
留	lw
晕	yyo
风	fgj
抽	iz
块	kjt
怪	gj
度	dy
戳	io
往	wki
便	bnr
楼	lxm
党	dk
咬	ybk
吹	iv
练	ln
删	ujc
条	tmw
耶	yre
丫	yab
系	xu
君	jy
丑	icv
件	jnr
近	jvz
两	ls
雨	yna
力	luv
面	mna
球	qww
重	id
火	hq
爬	ps
脚	jz
管	gy
偶	oor
黄	ha
嘴	zn
戴	dsu
情	ql
各	gw
门	mgd
卡	kdu
倒	dbr
跪	gcz
道	dxz
病	bjb
边	bm
搜	sz
短	dyu
混	ht
指	vpf
翻	fj
词	co
招	vc
尿	nb
摸	mo
嘤	ykk
撒	sd
毁	hn
顶	dad
马	md
喊	hl
由	yxl
悲	bwf
组	zo
帖	twj
则	zr
爪	vvp
配	pq
乃	ng
斤	jbp
秀	xph
伤	uh
喽	lzk
蓝	lkc
及	jop
谢	xo
泡	px
未	wqa
款	ky
定	djb
深	uf
渣	vad
粗	cum
咔	ka
爸	blb
输	uui
床	ia
碗	wlu
外	ws
宅	vfb
纯	ius
熊	xd
汗	hhd
搭	daf
药	yxc
使	upr
感	glx
宫	gs
双	ul
演	yld
木	my
粑	bam
班	bjw
赚	vek
货	hir
亿	yu
拼	pb
嗨	hdk
其	qo
名	mlx
类	lqm
棒	bg
王	wj
骑	qom
片	pnp
金	jbr
茶	is
处	iy
砸	zsu
查	ism
气	qu
枪	qlm
句	jc
扔	rgf
试	uuy
嫁	jzn
且	qwl
切	qoq
醒	xa
惹	rt
停	tl
树	uy
爽	usd
台	tf
口	kc
半	bhd
鞋	xq
雪	xuy
任	rd
摔	uk
接	jp
操	cc
娶	qn
入	ry
提	tof
狠	hhq
背	bwl
挖	waf
烂	lh
级	jos
间	jm
乖	gk
达	dsz
云	yue
冲	isd
团	tt
瓶	plb
主	vod
踢	tiz
硬	yj
嘞	lwk
女	nnv
动	dae
线	xn
叔	uuu
念	nnr
表	bz
挑	tnf
致	vua
槽	cvm
满	mld
甩	uak
油	yxd
皆	jpb
捡	jxf
省	uju
八	bap
皮	pov
子	zp
酒	jed
救	jpq
穷	qd
亦	yuw
忍	rh
妞	nqn
反	fl
呜	wu
部	by
借	jor
插	iaf
街	jpi
烦	fk
关	grb
草	cb
诗	ui
直	vou
踩	cg
嘿	hwk
课	kw
臭	im
城	iht
票	pbx
剩	ufq
趣	qc
握	wif
李	lpm
嘛	mak
撞	vk
汤	thd
刀	dcv
挤	jpf
替	tu
夜	yw
扯	it
懒	ll
腰	yc
房	fjh
香	xlh
安	an
奔	bfd
穿	ir
凭	plr
咦	yok
杯	bwm
泪	lqd
慢	mhx
虐	nr
逛	gkz
碎	scu
既	ju
痘	dm
题	too
舔	txq
即	jog
凉	lad
准	vid
占	vhl
屁	puu
记	juy
胸	xs
摆	bgf
国	gp
蛇	ur
派	psd
称	igh
盘	pk
控	kaf
血	xwp
忒	tv
味	wqk
交	jnw
四	su
投	txf
偷	tz
涨	vkd
躲	dqu
推	tvf
抹	mqf
副	fy
搬	bjf
咪	mi
尽	jvi
堵	dot
藏	cj
山	ujl
虎	ho
乐	lwp
左	zq
吵	ib
岂	qpe
欠	qnd
传	itr
笨	bdv
寄	jub
修	xqr
烧	uch
眼	ylo
机	jim
相	xlm
套	txd
撑	igf
蝎	xpi
落	li
绿	lc
折	vr
甜	tzq
糖	tj
奥	aip
鬼	gn
份	fd
烤	kbh
命	mjr
补	bo
象	xkd
节	jpc
惨	cl
熟	uxw
瞧	qm
群	quy
海	hgd
墙	qat
鸭	yaj
样	yg
圆	ytk
嫌	xzn
身	ufp
逗	dmz
旧	jpl
断	dem
歪	wdb
段	dep
罗	lps
窝	wob
盖	gsy
羊	yjb
闲	xzm
美	mry
夹	jca
觉	jyx
炒	ibh
仍	rhr
莫	mic
排	pff
五	woa
傻	ud
篇	pm
性	xj
租	zuh
几	jpp
周	vz
桥	qmm
区	qv
队	dce
碰	pfu
蹭	cfz
哈	hak
拆	idf
哭	ku
卷	jyj
场	ik
吻	whk
男	nkt
应	ykg
哄	hfk
签	qmv
法	fdd
色	sw
需	xvy
流	lwd
杨	yjm
逼	bi
娃	wsn
劝	qe
圈	qrk
语	yny
涂	tid
平	pla
期	qi
暖	ny
座	zig
缺	qtf
矮	ap
空	ks
软	ryi
憋	bpd
肥	fe
退	tc
扑	puf
耍	uv
牌	pfp
烟	yjh
狼	ljq
减	jxd
抄	icf
理	lpw
劈	piu
印	yv
望	wgw
陈	ige
整	vj
郭	go
蹲	dyz
恋	lnw
兔	ty
知	viu
娘	nan
驴	lbm
辣	lll
偏	pmr
噶	gsk
据	jcf
数	uym
清	qk
粮	lam
归	gv
灰	hv
姓	xjn
绝	jys
么	me
欲	ycb
豆	dma
剧	jcu
待	dsi
待	ddi
那	nav
师	uil
犯	fhq
位	wqr
捉	vof
扣	km
较	jbi
齐	qow
灯	dg
明	mlo
酸	sr
帝	duw
值	vor
论	lt
季	juh
土	tou
右	ymu
啃	kh
熬	apf
揍	zm
赶	glt
银	ynj
合	hr
细	xus
厚	hmi
西	xi
南	nku
朝	ivu
狂	kaq
随	sb
瞅	ico
界	jot
盯	dko
趁	idt
淡	dhd
轻	qki
岛	dbp
嗷	apk
拔	bs
猛	mjq
扒	baf
宝	bb
方	fhd
刮	gx
费	fq
遍	bnz
抠	kz
霜	uly
零	lly
星	xko
夸	kxd
邮	yxy
睇	duo
汪	whd
取	qne
菇	gu
易	yuo
蒸	vg
愁	ix
化	hzr
足	zik
揉	rx
佛	fp
码	mdu
龙	ld
糗	qem
馋	iku
刘	lww
服	fi
蟹	xod
牙	ys
富	fyb
吾	wiw
冰	bk
七	qia
常	ijx
底	dpg
仅	jmr
习	xov
粘	vjm
奖	jsd
妆	vld
爷	yrb
吼	hck
弯	wjw
炖	dt
嫩	ndn
基	jiq
经	jk
坨	tpt
射	uw
薄	bv
隔	gre
史	upl
伞	sl
搓	cof
跌	dpz
雾	wy
必	bu
呸	pw
捧	pj
似	sur
困	ktk
掰	bdu
令	ljr
怎	zhv
刺	cua
答	dsv
冒	mx
凶	xsx
船	itv
酱	jkd
趴	pa
闪	ulm
昂	aj
紧	jml
贼	ze
电	dnl
声	ugu
具	jcq
压	yai
雷	ley
钻	zrj
湿	uid
登	dgv
啪	pak
百	bga
终	vss
哆	dok
酷	kyy
波	bod
林	lnm
治	vud
醉	zcy
唯	wek
弹	tkg
砍	kl
原	yti
咳	kr
猿	ytq
秤	if
害	hs
甚	udq
锅	goj
遭	zcz
怒	nyn
炸	vlh
飘	pnx
胡	hiu
村	cy
仔	zpr
解	jwd
订	djy
卧	wii
捂	wof
播	bof
伐	fs
割	geb
淘	tvd
埋	mft
塞	sdb
略	lr
淫	ynd
宽	krb
透	tmz
凑	cm
劲	jvv
重	vap
届	jou
倍	bqr
胃	wqt
嬛	xr
举	jnx
灭	moa
残	ck
封	fgt
属	uou
粥	vzg
脑	nbo
福	fip
扫	sbf
韩	hk
废	fqg
煎	jmb
征	vgi
捞	lcf
罚	fss
慌	hlx
价	jzr
叠	dqy
饼	bau
母	mov
勒	lwg
存	cuu
杜	dym
胜	ufo
虽	sv
毒	dif
妖	ycn
叼	dnk
根	gfm
负	fyd
春	iyf
虾	xxi
迷	moz
啰	lok
寸	ct
体	tpr
供	gsr
抛	pc
烫	tg
拽	vjf
炮	pxh
防	fje
编	bms
侠	xc
勿	wyb
共	ga
纹	wgs
闻	wgm
北	br
守	ucb
挡	dkf
拌	bhf
甄	vfx
牵	qmd
发	flv
克	kwu
摄	uwf
布	byu
降	jke
怂	sf
笔	bpv
奶	ngn
霾	mfy
颗	ke
九	jep
泥	no
於	ybf
瑟	sww
遮	vez
澡	zbd
痒	ykb
锁	sq
吸	xik
敷	fu
德	dr
踹	ijz
吊	dbk
舞	wop
含	hkr
浓	ndd
蹦	bfz
嘎	gak
潮	ivd
现	xnw
长	vkp
壳	kru
调	dby
调	tmy
罪	zcs
证	vfy
亏	kv
剃	tub
摇	yvf
素	sy
肾	udl
填	tzt
精	jkm
沾	vjd
盒	hrr
闷	mdm
犬	qy
通	tsz
架	jzl
腻	nu
公	gsb
露	lmy
著	vyc
晃	hko
铺	puj
潘	pjd
砖	vru
孔	kf
乳	ro
食	uor
建	jnz
垫	dnf
键	jnj
捅	tff
饱	bbu
欧	ou
伪	wr
兽	umb
盼	ph
滑	hcd
运	ytz
绕	rxs
缠	iks
散	slc
散	shc
拜	bsu
嘘	xvk
枰	plm
赵	vxt
脏	zho
屏	plu
页	ywa
范	fhc
逃	tvz
结	jqs
馆	gyu
领	lar
巨	jck
处	iow
言	ykw
梗	gjm
攒	zl
翘	qba
挠	nv
市	uuw
伴	bhr
分	fdb
初	iup
啧	zrk
利	luh
针	vfj
掐	qx
啵	bok
博	bpu
否	fc
虚	xvh
造	zx
巧	qzg
寻	xue
蠢	ii
朵	dqj
逆	nuz
骚	scm
层	chu
测	cw
局	jbu
剁	dij
般	bjv
代	dsr
诺	ni
叶	ywk
均	jyt
肌	jio
东	dsa
端	drl
宠	ifb
容	rdb
斯	si
物	wyn
录	lye
丽	lua
盐	ykt
败	bsk
咸	xzx
摘	vd
矣	yps
众	var
惊	jkx
竟	jj
敲	qnw
嗲	dv
干	gja
漏	lmd
湖	hid
沉	igd
截	jqu
朱	vup
付	fyr
醋	cyy
撕	sif
获	hic
朕	vdo
冥	mlb
丝	siv
轮	lui
河	hrd
炫	xe
塔	tdt
袁	ytt
喜	xpu
魂	hu
挣	vff
赔	pek
耳	ey
撤	iw
碧	buw
贪	tjr
扛	kjf
镇	vdj
肺	fqo
祸	hip
果	gq
嚯	hik
拱	gff
顺	ut
器	quk
秋	qq
孙	syz
巴	bas
捐	jr
屋	wuu
沪	hy
猴	hxq
夏	xza
龟	gvd
转	vei
耐	nse
仨	sar
争	vgd
肯	khv
歇	xpo
板	blm
极	jom
案	abb
扭	nef
观	gry
卸	xop
设	uwy
趟	tgt
攻	gsg
抖	dcf
静	jjf
除	iie
旁	pjw
稳	whh
董	dfc
逢	fhz
浅	qxd
环	htw
申	ufl
遇	ycz
绑	bks
乘	ihq
缩	so
泰	tsf
紫	zpv
认	rdy
串	iel
痣	vub
沙	uad
友	ycu
尼	nou
臀	tuu
丁	dka
股	goo
步	byv
档	dgm
鼻	boz
识	uoy
限	xne
幅	fij
响	xsk
旅	lnf
跨	kzz
意	yul
崔	cve
侬	ndr
哩	lik
威	wwx
糕	gcm
赛	ss
麻	msg
瓜	gxp
拧	naf
室	uub
愣	lfx
显	xxo
尊	zy
寒	hkb
广	gsd
率	lcw
品	pmk
凹	ao
维	wes
裤	kyp
蒙	mhc
搂	lzf
苏	suc
免	mxd
居	jvu
餐	cjl
染	rl
轰	hsi
唐	tjg
幂	mu
婚	hyn
摊	tjf
瑕	xcw
皂	zxb
桶	tfm
立	luw
客	kwb
枕	vhm
扶	fif
尾	wru
千	qmp
震	vdy
粽	za
叹	thk
古	gou
灵	lle
堆	dvt
恶	ewy
呼	huk
虫	idv
展	vlu
善	uhy
芙	fic
狮	uiq
抗	kgf
科	keh
松	ssm
徐	xbi
乡	xlv
充	isw
嗒	dak
弄	law
拎	lbf
须	xvp
衫	ujp
尖	jmx
森	sfm
扎	vaf
膜	mpo
晴	qlo
婊	bzn
衣	yiw
迟	ioz
酥	suy
僧	sg
产	ill
竖	uyl
横	hhm
聚	jce
娇	jnn
十	uoa
宋	sab
尚	ugx
依	yir
瞄	mm
旺	wgo
妙	mb
甘	gjn
啾	jqk
膘	bno
田	tzk
噜	luk
悬	xt
距	jcz
己	jpv
青	qkf
郎	ljd
糟	zcm
雅	yd
惯	gex
噻	sdk
麦	msf
侃	klr
钓	dbj
罢	bls
京	jkw
添	tmd
丹	djp
曲	qnl
扇	uhh
嚼	jmk
芯	xbc
许	xny
赖	lsu
音	ybl
葱	csc
丸	wkp
搁	gef
娜	nln
揪	jqf
榜	bkm
遛	lpz
宰	zg
俩	lsr
赏	ukx
谷	gob
曝	bxo
赐	cuk
黏	nzh
腹	fyo
桌	vol
蜜	mub
消	xnd
勺	uvb
辞	coq
江	jld
兵	bkq
裙	qup
蝶	dqi
侧	cwr
告	gxn
寺	sut
仙	xmr
甲	jvl
赴	fyt
角	jzd
钗	idj
薛	xtc
止	vpl
磕	keu
港	gkd
曹	cva
崽	zge
评	ply
坎	klt
巾	jbl
勾	gzb
窗	ilb
艾	auc
咖	kak
斗	dmd
凡	fkj
继	jus
刻	kww
保	bbr
厄	ewi
蕾	lrc
驻	vym
弟	dub
喘	iyk
皱	vm
喇	ldk
扎	zaf
唰	uxk
格	grm
附	fye
失	uip
暗	abo
野	ytl
橙	ihm
裸	lqp
蘸	vhc
桑	sh
嘉	jxu
沟	gzd
民	mnv
厂	ika
疤	bab
靴	xtg
涅	nod
弃	quw
列	lod
梨	loh
灌	ged
净	jjd
温	wf
批	pif
互	hya
罩	vxs
尔	eyd
帐	vgj
圣	ufy
馅	xnu
粪	fdm
挫	cif
曼	mho
肝	gjo
然	rk
仇	ixr
邪	xqy
扁	bxh
翔	xay
肩	jmh
液	ywd
掏	tcf
末	mia
院	yee
杠	ggm
姜	jly
谨	jmy
瓦	wda
湾	wjd
堂	tjx
智	vuu
湘	xld
钟	vsj
辆	lki
莎	uac
联	lze
瞪	dfo
祭	jup
项	xkg
奇	qod
枚	mem
兮	xib
颜	yki
薇	wwc
镜	jjj
拐	gaf
兜	dzb
俄	err
优	yzr
贺	hwl
景	ja
余	ybr
崩	bge
工	gsa
剥	bce
吞	tyt
盗	dxd
窄	vgb
军	jyb
携	xqf
痴	iib
影	yao
煲	bcr
当	dgx
舌	urq
衰	ukw
骨	gol
铅	qmj
划	hcg
礼	lpp
裹	gqw
饶	rv
顿	dtt
鼠	uoj
砂	uau
盆	pgb
恕	uyn
搅	jzf
专	vra
拦	lkf
浪	lg
卯	mbp
菊	jbc
沈	uhd
判	phb
引	ymg
复	fyp
漂	pnd
彩	cgp
族	zif
稿	gbh
漫	mhd
摁	eb
绛	jks
核	hrm
郝	hbt
挨	aif
挨	aof
脉	mso
妮	nin
标	bnm
创	ikr
鹅	erw
哔	buk
颤	ihw
乔	qmy
睁	vgo
梳	uum
思	sit
舒	uur
凸	tul
移	yoh
框	kk
泼	pod
邓	dfy
俗	sir
恰	qzx
阴	ybe
鲜	xma
患	hei
帽	mxj
柳	lem
磅	bgu
斩	vli
忌	juj
鲍	bxa
侯	hxr
熏	xyp
彭	phu
册	cwp
晾	lko
掌	vkx
玉	ycw
弦	xzg
楞	lhm
业	ywl
社	uwp
塌	tat
骆	lim
吨	dyk
坡	pot
懵	mjx
蒜	sec
财	cfk
赠	zfk
持	iof
怨	yex
涮	ued
墨	mih
注	vyd
庙	mbg
呲	cik
券	qej
迎	ylz
玻	bow
筋	jbv
霍	hiy
嗑	kwk
视	uup
洒	sdd
乜	mpv
译	yuy
夫	fua
铲	ilj
柴	ifv
蒋	jsc
悟	wyx
兰	lkb
茬	isc
漆	qid
恤	xcx
华	hcr
垮	kvt
孤	guz
箭	jnv
屯	tua
削	xnx
叉	iay
普	pob
英	ykc
州	vzd
商	uhw
禁	jvm
厅	tki
私	sih
浇	jnd
腚	djo
户	hyd
独	diq
脆	cco
瞒	mko
蒂	duc
壹	yiu
徒	tii
胎	tdo
欸	eo
世	uua
简	jxv
佬	lbr
锤	ibj
亚	yla
蛆	qvi
嘚	dek
唇	iui
捶	ibf
宁	nlb
增	zgt
禅	ikp
县	xnq
忧	yzx
仿	fkr
铊	taj
葬	zgc
权	qtm
龚	gsl
劫	jqt
童	tdl
希	xix
蹬	dgz
癖	pp
职	voe
瘫	tjb
粒	lum
渡	dyd
绣	xps
欺	qiq
敌	doq
毕	bub
实	uob
腐	fo
杂	zsj
仗	vgr
藕	ooc
糊	him
讯	xty
墓	myc
萱	xrc
浮	fid
哉	zdu
源	ytd
织	vis
籽	zpm
岗	gke
蒙	mgc
喃	nkk
扬	yjf
备	bqw
雄	xdu
眠	mzo
牢	lvb
迈	msz
漂	pbd
焖	mdh
严	yky
奏	zmf
续	xcs
沃	wid
呈	ihk
押	yaf
种	vfh
购	gmk
倩	qnr
愈	ycr
憨	hjv
脖	bpo
嫖	pmn
川	irp
鹿	lyg
嗦	sok
窜	ce
撅	jt
樱	ykm
皇	hab
镐	gbj
忆	yux
挽	wlf
讨	tby
庆	qj
胶	jno
敬	jjc
润	rtd
永	yf
咒	vmk
棍	gt
袭	xol
井	jaa
俊	jtr
噎	yek
嘭	pgk
陶	tve
厝	cii
嗅	xpk
痰	tkb
乌	wup
险	xxe
甭	bhb
俾	bpr
邱	qqq
钢	ghj
坤	kyt
碳	thu
伸	ufr
孟	mfz
缓	hys
蚝	hvi
咽	yh
纵	zas
卒	ziw
吱	vik
钙	gsj
翅	iuu
耗	hxl
雀	qru
棵	kem
彼	bpi
挪	npf
始	upn
皿	mml
钉	dkj
冬	dsw
洋	yjd
苗	mmc
盛	ufi
袜	wlp
纳	nls
茧	jxc
啤	pok
暂	zhi
妥	tq
盲	mjw
误	wyy
菌	jyc
浴	ycd
勇	yfs
孽	noc
枉	wkm
峰	fge
晏	yho
嚷	rkk
研	yku
库	kyg
榛	vfm
叽	jik
噔	dgk
陌	mie
吒	vak
护	hyf
闭	bum
贾	jvx
捎	ucf
垵	ant
抵	dpf
莲	lzc
肚	dyo
臣	igk
椒	jnm
葛	grc
仓	chr
朗	lkd
义	yud
尸	uiv
辛	xbl
唠	lvk
唠	lxk
轴	vxi
煞	uld
胆	dlo
枣	zba
稀	xih
晨	igo
仁	rgr
庄	vlg
撩	lmf
秃	tuh
临	lnl
嗔	ifk
婶	uhn
灸	jej
鲁	loa
宴	yhb
币	bup
索	squ
佳	jxr
姬	jin
咕	guk
返	flz
禾	hrp
链	lnj
誓	uuf
眯	mio
瓷	cod
绘	hcs
恃	uux
吕	lnk
探	thf
番	fjp
哀	aiw
乎	hup
蛙	wai
置	vus
氪	kwq
掀	xmf
埃	ait
芊	qmc
裆	dhp
镁	mrj
卢	lil
兑	dcb
阔	ki
谜	moy
昏	hyu
谓	wqy
承	ihv
忠	vsv
潜	qzd
瞟	pz
驼	tpm
欢	hry
巫	wug
悔	hnx
诚	ihy
崴	wge
呛	qlk
呛	qkk
涩	swd
曾	zgb
轶	yui
递	duz
烙	lxh
棉	mzm
霸	bly
缝	fhs
缝	ffs
切	qpq
祛	qvp
舟	vzp
鞭	bmg
瘾	ymb
亭	tlw
荼	tic
呕	ook
顾	gyi
雇	gyh
舍	utr
镶	xlj
巷	xkc
背	bql
剂	juw
渴	ktd
昨	zpo
叮	dkk
姚	yvn
御	yci
乍	vlp
谎	hsy
阳	yje
亲	qjl
荤	hyc
忽	huw
账	vgk
枝	vim
剥	boe
舍	uwr
桃	tvm
勤	qnn
畔	pht
荡	dgc
嗝	grk
嘟	duk
奉	fff
桩	vlm
挑	tzf
售	umr
拳	qtj
犊	din
徕	lfi
助	vyq
铜	tdj
泡	pcd
泯	mmd
盾	dtp
焉	yjv
悦	yrx
夺	dpd
伦	lur
诸	vuy
瑞	rc
萧	xnc
宜	yob
跶	daz
拾	uof
珠	vuw
凤	ffj
揽	llf
圭	gvt
弓	gsv
池	iod
境	jjt
钩	gzj
阅	yrm
莪	erc
匿	nuk
审	uhb
隆	lde
妾	qol
硅	gvu
咻	xqk
叭	bak
触	iyd
喏	nik
缸	ghf
坊	fht
嚓	cak
旗	qof
窦	dmb
颠	dmu
莱	lfc
孩	hfz
嗡	wgk
哑	ydk
裁	cfu
淌	tkd
吆	yck
危	wwd
硕	uiu
颈	jav
倔	jyr
荣	rdc
泉	qtb
卵	lyp
钵	boj
谣	yvy
债	vsr
恒	hhx
嚎	hvk
肠	ijo
拴	urf
垂	ibp
伏	fir
撬	qbf
妃	fwn
恐	kfg
媛	ytn
菲	fwc
矗	iyu
晓	xzo
搏	bpf
抡	lyf
睿	rcl
腌	yjo
程	ihh
撇	pwf
筒	tfv
鸣	mlk
淋	lnd
娟	jrn
搽	isf
目	myk
拷	kbf
彪	bnh
兹	zib
绳	uhs
脾	poo
囤	dtk
姆	mon
蒽	enc
涌	yfd
洁	jqd
踏	tlz
迁	qmz
姨	yon
秦	qnf
序	xcg
异	yus
束	uya
康	khg
嗓	sk
觅	mup
篮	lkv
营	ylc
镑	bgj
俏	qbr
掺	ijf
珊	ujw
螨	mli
贫	pnb
傍	bgr
崖	yse
芭	bac
嘣	bgk
传	ver
叁	sjs
豹	bxv
辨	bnl
兆	vxe
瘪	bwb
枯	kum
芮	rcc
犹	yxq
誉	ycx
蜡	lli
涛	tcd
僵	jlr
阵	vde
府	fog
坛	tkt
煨	wwh
吡	bpk
幸	xjt
栋	dam
刨	bxb
刨	pvb
努	non
赫	hwt
椅	ypm
袄	aq
玛	mdw
晋	jvy
氧	ykq
吽	hsk
作	zor
瘟	wfb
矬	cpu
卫	wqe
俱	jcr
坠	vce
蜀	uos
捣	dbf
柚	ymm
辱	roi
吟	ynk
轩	xri
廖	lbg
竹	vip
祖	zop
棕	zsm
咚	dsk
洪	hdd
斋	vdw
浑	hud
眉	mev
穴	xyb
卿	qkp
燥	zxh
佑	ymr
奔	bdd
尘	igx
校	xbm
扎	vsf
迪	doz
雌	cov
姿	zid
馊	szu
沿	ykd
栏	lkm
席	xog
胯	kzo
擤	xaf
嗖	szk
燕	yhn
遂	scz
逾	ybz
兴	xjx
咿	yik
焗	jbh
摞	lif
应	yjg
炕	kgh
奸	jmn
避	buz
贰	eey
缁	zis
汝	rod
厌	yhi
颓	tbh
殿	dnu
隐	yme
掂	dmf
宣	xrb
呱	gxk
馍	mpu
绮	qps
荒	hlc
驱	qvm
掖	ywf
累	let
魏	wqh
豪	hvw
糙	ccm
妍	ykn
砰	pgu
砌	quu
瑜	ybw
翁	wgb
瘸	qyb
飙	bnq
畅	igu
预	ycs
腮	sdo
宇	ynb
蛹	yfi
空	kab
刹	uax
施	uif
唬	hok
袅	nzp
糯	nim
参	cjs
嫂	sbn
艘	szv
阮	rye
拥	ysf
嬴	ylw
倾	qkr
扩	kif
叨	tck
挥	hvf
豁	hob
啷	lhk
楚	iom
莉	luc
遁	dtz
厮	sii
滩	tjd
辽	lmz
貂	dnv
玄	xtw
歼	jmd
噌	cgk
耙	bll
脂	vio
捋	lof
积	jih
醇	iuy
幺	ycv
卦	gzt
纱	uas
蚊	wgi
隋	sbe
痕	hgb
数	uom
齁	hzz
玮	wrw
霉	mey
杆	glm
栓	urm
炝	qkh
珂	kew
裱	bzp
苯	bhc
厨	iii
筐	klv
寨	vsb
铰	jzj
岭	lae
享	xsw
濯	vpd
璐	lyw
囊	nj
籍	jov
符	fiv
煤	meh
幼	ymy
蔫	nm
呷	xxk
怡	yox
辈	bqf
斌	bbw
蛊	goi
激	jid
佟	tdr
酿	nky
歉	qnb
衬	idp
覆	fyx
访	fky
埸	yut
仪	yor
浩	hxd
谋	mxy
掩	ylf
遵	zyz
谤	bgy
簋	gnv
尿	svu
辟	buu
妇	fyn
杏	xjm
耸	sfr
啖	dhk
碑	bwu
坪	plt
贬	bxk
嗜	uuk
皎	jzb
珞	liw
蝉	iki
姑	gun
钦	qbj
帘	lzb
耽	dje
恼	nbx
倚	ypr
筛	udv
碘	dxu
棚	phm
缇	tos
蚺	rki
町	dkt
态	tst
绞	jzs
扰	rb
笛	dov
苑	yec
笼	ldv
傲	air
尺	ip
劳	lvc
磡	khu
茨	coc
穆	myh
巢	ivv
寝	qmb
涠	wed
蕉	jnc
粤	yrp
闰	rtm
沐	myd
帕	plj
佐	zqr
葵	kbc
刊	kjg
跋	bsz
讹	ery
岸	abe
绷	bgs
荷	hrc
堕	die
凯	kge
攀	pjm
亨	hgw
绒	rds
棣	dum
矫	jzu
幽	yze
愚	yby
鹏	pho
咏	yfk
碍	auu
虹	hdi
洛	lid
妓	jun
岩	yke
焕	heh
警	jac
啄	vpk
癌	aob
霆	tly
祇	qop
悌	tux
碾	nxu
拘	jvf
脓	ndo
膈	gro
杖	vgm
腾	tho
匪	fr
葡	pic
津	jbd
碇	dju
膝	xio
拈	nmf
蹄	toz
灾	zdb
绊	bhs
惧	jcx
嘬	zok
硌	gwu
浣	hed
晶	jko
掷	vuf
弧	hig
谗	iky
郡	jty
幻	hey
卜	bol
羹	ggy
孬	nc
铬	gwj
宿	syb
奈	nsd
窃	qob
哏	ggk
杰	jqm
稠	ixh
擀	glf
嘈	cvk
舱	chv
馕	nju
攥	zef
肘	vco
辰	igi
茎	jkc
箍	guv
吠	fqk
尻	kcu
导	dbs
谴	qxy
钻	zej
惟	wex
验	yhm
粿	gqm
婆	ppd
犟	jkg
玫	mew
钛	tsj
息	xiz
鳄	ewa
弹	dhg
溶	rdd
捯	dvf
锥	vvj
叙	xcr
慎	udx
渊	yrd
撵	nxf
逝	uuz
浸	jvd
昆	kyo
陀	tpe
疣	yxb
泽	zrd
屈	qvu
察	isb
炸	vsh
艳	yhf
仔	zgr
溺	nud
嘶	sik
啐	cck
翠	ccx
种	idh
栖	qim
闵	mmm
肛	gho
皖	wlb
媚	mqn
抻	iff
咣	glk
坞	wyt
掘	jyf
估	gur
逑	qwz
逐	viz
诉	syy
哲	vrf
炎	ykh
允	yis
烩	hch
萎	wrc
袖	xpp
聂	noe
羽	ynx
律	lci
芽	ysc
俯	for
瘤	lwb
娥	ern
赤	iut
禹	ynp
毯	tlm
钞	icj
咂	zak
仰	ykr
喧	xrk
瀑	py
宏	hdb
廋	szg
丰	fga
剖	pzl
暨	jug
黍	uoh
盈	yln
苍	chc
尹	ymv
夕	xip
熨	ytu
鑫	xbj
蔻	kmc
吭	kgk
苔	tfc
湉	tzd
铛	igj
藤	thc
宗	zsb
叩	kmk
螺	lpi
褪	tcp
锯	jcj
薜	buc
锦	jmj
竞	jjl
浙	vw
啫	vtk
邹	zz
韦	wea
藓	xxc
澳	aid
炜	wrh
鲸	jka
匀	yub
媒	men
曝	pyo
囡	njk
溪	xid
朴	pom
杭	hjm
鳓	lwa
遗	yoz
屙	eeu
楹	ylm
魅	mqg
伙	hqr
倪	nor
屑	xou
殴	ouk
磐	pkv
瘀	yvb
艋	mjv
燃	rkh
聋	ldl
规	gvf
狐	hiq
盏	vlj
瓢	pmx
论	luy
脐	qoo
寰	htb
茜	xic
镕	rdj
候	hmr
庵	ang
鸠	jqj
狷	jeq
炆	wgh
赋	fyk
宾	bbb
抹	maf
宵	xnb
姝	uun
蟒	mki
鼬	ymj
皓	hxb
瘆	udb
逸	yuz
煸	bmh
肱	gso
蚶	hji
礁	jnu
孰	uiw
俚	lpr
延	ykz
落	lxc
薰	xyc
壳	qbu
戚	qiw
翟	dox
倦	jer
氢	qkq
诵	say
模	mpm
烘	hsh
渍	zud
决	jyd
跃	yrz
锉	cij
艺	yuc
匹	ppk
敝	bud
霏	fwy
韬	tcw
政	vfv
貌	mxv
担	djf
釉	ymp
铺	pyj
酌	vpy
匙	ioo
暇	xco
淑	uud
硪	wiu
蓬	phc
巳	suv
痧	uab
炅	jf
丧	sgu
逄	pjz
柏	bgm
寿	umf
舅	jpj
汞	gfg
滥	lhd
蘼	moc
昕	xbo
儒	rir
庭	tlg
函	hkl
廊	ljg
鲤	lpa
怜	lzx
坦	tlt
攒	ctf
汰	tsd
秆	glh
炉	lih
齿	ipv
幢	vkj
玖	jew
肋	lqo
翘	qma
伢	ysr
嗄	ulk
窥	kvb
啼	tok
樊	fkm
屡	lnu
溜	lpd
固	gyk
缀	vcs
径	jji
墩	dyt
泵	bfu
箸	vyv
斧	fob
绾	wls
吮	uik
耻	ipe
淤	yvd
掴	gkf
屠	tiu
嘁	qik
腊	llo
赣	ghl
辉	hvx
违	wez
慧	hcf
偈	jur
蟑	vhi
萋	qic
击	jia
竿	gjv
纲	ghs
寐	mqb
陋	lme
蚤	zbi
埵	dqt
珍	vfw
钝	dtj
耄	mxl
胚	pwo
垢	gmt
灿	chh
耒	lrf
昙	tko
婵	ikn
聘	pv
坍	tjt
肽	tso
敛	lxr
饵	eyu
伍	wor
促	cyr
琛	ifw
嗤	iik
枭	xnp
舀	ybp
缰	jls
频	pnv
沫	mid
砣	tpu
迩	eyz
秾	ndh
锡	xij
莓	mec
惠	hca
寮	lmb
遥	yvz
狸	loq
铢	vuj
阻	zoe
诈	vly
涉	uwd
统	tfs
孑	jqv
睬	cgo
牧	myn
乾	qzu
蹿	cr
卅	sla
剐	gvk
央	yhl
焐	wyh
涯	ysd
祢	mop
锕	aaj
丘	qqp
琼	qdw
烹	pgw
壕	hvt
樽	zym
煽	ujh
幌	hsj
糍	com
醍	toy
凝	nld
技	juf
铃	llj
轨	gni
脊	jpd
崇	ide
鉴	jnl
菖	ihc
戆	vkl
驳	bpm
凳	dfv
敏	mmp
荫	yvc
蕊	rn
挞	tlf
垚	yvt
蠃	lqw
炼	lnh
融	rda
哐	klk
瑾	jmw
婷	tln
榴	lwm
鱿	yxa
舵	div
昌	iho
锰	mjj
鼯	wij
缅	mxs
佩	pqr
槛	klm
灞	bld
骟	uhm
菲	frc
讷	nwy
姘	pbn
泫	xed
抿	mmf
查	vam
玥	yrw
旋	xtf
枫	fgm
黯	abh
务	wyw
棘	joa
唵	azk
乜	nov
橹	lom
碌	lyu
嗫	nok
匠	jkk
孵	ful
萝	lpc
箩	lpv
泷	ldd
昇	ugo
濂	lzd
鼎	dao
启	qph
胤	yvp
锐	rcj
销	xnj
检	jxm
躁	zxz
泠	lld
龄	llv
驿	yum
台	tds
骁	xnm
寞	mib
搋	ikf
甯	njb
窘	jfb
尧	yva
濮	pid
酮	tdy
糁	slm
筷	kjv
朔	uib
漂	pzd
绗	hjs
择	zrf
狙	jvq
闸	vsm
娼	ihn
唛	msk
诡	gny
橘	jbm
挎	kzf
陕	ule
谛	duy
铭	mlj
祥	xap
馨	xbu
茅	mvc
亩	mow
褶	vtp
综	zss
爰	ytp
埂	gjt
丙	baa
剌	llu
壬	rgq
企	qpr
霖	lny
冏	jfk
蛛	vui
逊	xtz
彧	yca
岗	ghe
阶	jpe
矛	mvs
巡	xuz
厕	cwi
楠	nkm
昵	nuo
龌	wiv
垒	lrs
蛾	eri
援	ytf
旱	hho
淼	mzu
膳	uho
澄	ihd
嫣	yjn
纽	nes
婕	jqn
邵	uxd
袍	pvp
矿	kku
渗	udd
效	xbw
倡	igr
鲞	xsj
跺	diz
巅	dme
怵	iyx
蹉	coz
鹤	hwd
摧	cvf
哞	mzk
锈	xpj
嚼	jyk
褒	bcw
疾	job
寇	kmb
缕	lns
策	cwv
糜	mog
繁	fkp
悯	mmx
矜	jbs
娜	npn
磁	cou
怯	qox
趾	vpz
钾	jvj
豚	tuo
炳	bah
黔	qzh
腺	xno
苷	gjc
蚕	ckt
饥	jiu
钠	nlj
呒	mik
喋	dqk
钚	byj
株	vum
鳞	lna
蜂	fgi
夷	yoa
贩	fhk
剔	tio
蓄	xcc
庸	ysg
芋	ycc
睹	doo
亥	hsw
芬	ffc
嗟	jpk
雯	wgy
腩	nlo
拢	lff
仆	pir
梯	tim
绫	lls
伟	wrr
坯	pit
澈	iwd
汾	fgd
葩	pac
霞	xcy
堤	dit
哂	uhk
邻	lnr
寡	gvb
莰	klc
浒	hod
苟	gcc
鸽	ger
斗	dcd
蜷	qti
旦	dho
旭	xcj
裘	qwq
恭	gsc
韧	rdw
猾	hcq
炊	ivh
馁	nru
肤	fuo
慰	wqu
绢	jes
愉	ybx
诓	kly
姊	zpn
缈	mzs
恪	kwx
炷	vyh
镌	jrj
湜	uod
裴	pef
狱	ycq
箫	xnv
焊	hhh
沁	qvd
猹	isq
芝	vic
瞻	vjo
哝	ndk
蔷	qac
莳	uuc
璞	piw
趸	diw
凿	zv
瑶	yvw
梭	som
搔	scf
阙	qrm
盖	gty
瓤	rj
谶	idy
裕	ycp
庹	tqg
妲	dsn
召	vxd
廉	lzg
昧	mqo
暧	auo
钼	myj
仄	zw
锝	drj
瑷	auw
璟	jaw
蚁	ypi
檀	tkm
簪	zj
岚	lke
鬓	bva
沸	fqd
漪	yid
鹃	jrk
萁	qoc
稻	dxh
冉	rll
涝	lxd
痞	ppb
揩	kdf
焯	ich
糠	khm
兀	wya
彬	bbm
瞭	lbo
槿	jmm
跎	tpz
耕	ggl
腆	txo
穗	sch
玲	llw
苛	kec
跷	qnz
筠	yuv
钣	blj
擅	uhf
缚	fys
腕	who
渺	mzd
贯	gev
爻	yvx
陆	lpe
蜇	vef
冀	jul
抚	fof
卑	bwp
铐	kxj
锄	iij
慑	uwx
辑	joi
芥	joc
芈	mpl
狨	rdq
耨	nml
淞	ssd
悭	qmx
岳	yrq
珑	ldw
契	quf
革	grn
杉	ujm
涡	wod
熹	xiu
呋	fuk
肇	vxh
枞	csm
域	yct
衔	xzi
乏	fsp
贡	gag
培	pet
况	kkd
坝	blt
艮	gde
椰	yem
苕	uvc
秘	muh
帆	fjj
镖	bnj
储	ior
迫	piz
泣	qud
姥	lbn
滤	lcd
萍	plc
髻	jua
窟	kub
述	uyz
渠	qbd
霓	noy
盹	dio
蒿	hcc
痿	wrb
诌	vzy
茗	mlc
斐	frf
胧	ldo
齉	ngz
茑	nzc
禀	baw
磊	lru
丛	cdr
耀	yxx
锣	lpj
艇	tav
横	hfm
蜱	poi
氨	anq
遣	qxz
瞬	uto
耿	gje
噪	zxk
概	gsm
闺	gvm
钮	nej
蹼	poz
瑰	gvw
伶	llr
昱	yco
淳	iud
庥	xqg
锵	qlj
予	yns
拓	tif
漾	ygd
蔚	wqc
恬	tzx
酣	hjy
嘱	vok
踝	hlz
欸	aps
欸	eps
琅	ljw
耪	pkl
戟	jpu
鞠	jvg
庞	pjg
矢	upp
炭	the
靶	bdg
囚	qwk
虑	lch
济	jud
篓	lcv
乞	qpp
削	xtx
稚	vuh
舜	utp
茄	qqc
敦	dyw
圜	htk
尕	gdn
涐	erd
琶	psw
臊	sco
抑	yuf
蝇	yli
愤	fdx
眺	tbo
戌	xvw
峡	xce
栾	ltw
载	zgu
翕	xir
肓	hlw
芒	mjc
硫	lwu
橱	iim
辅	foi
祠	cop
辙	vri
禅	uhp
杳	ybm
贞	vfl
恺	kgx
龊	iiv
铊	tpj
洹	htd
枳	vpm
材	cfm
示	uue
镀	dyj
獾	hrq
氮	dhq
憎	zgx
翀	isx
楸	qqm
亟	jol
豳	bbe
尢	whu
昴	mbo
簇	cyv
振	vdf
赦	uwt
岑	cge
甑	zfb
栗	lux
嘲	ivk
珰	dhw
怖	byx
涵	hkd
氟	fiq
卞	bnd
诀	jyy
污	wud
灼	vph
镰	lzj
雍	ysw
绺	les
冈	ghk
鲜	xxa
赟	yyw
纬	wrs
铎	dpj
髋	krg
侨	qmr
钡	bqj
撮	zqf
茕	qdc
铪	haj
剜	wjb
慈	cob
笙	ugv
甫	foa
筝	vgv
掣	iwp
衮	giw
厥	jyi
麓	lym
沦	lud
沌	dtd
彤	tdd
畀	but
遢	taz
虞	ybh
佘	urr
婢	bun
掸	dlf
擂	lqf
暄	xro
彘	vuv
扼	ewf
叟	scp
蹚	thz
旷	kko
咆	pvk
绯	fws
协	xqu
铂	bpj
鲎	hmx
岫	xpe
攮	nkf
芷	vpc
圙	lrk
鹀	wig
蹙	cyw
啸	xbk
筹	ixv
谅	lky
茂	mxc
梢	ucm
漱	uyd
箕	jiv
兴	xkx
跛	bqz
庚	ggg
卉	hcu
沽	gud
啡	fwk
摹	mpc
滨	bbd
疱	pxb
圐	kuk
旮	gaj
玚	yjw
觜	ziv
褚	iop
扉	fwh
嗽	sm
铀	yxj
嫉	jon
镊	noj
婧	jjn
羔	gcy
琯	gyw
佺	qtr
忻	xbx
迹	juz
巽	xts
蚌	bgi
障	vge
椎	vvm
盛	ihi
扫	sxf
绅	ufs
焙	bqh
脯	pio
糊	hym
址	vpt
媳	xon
柬	jxa
纨	wks
啰	lpk
孖	ziz
昊	hxo
躬	gsu
循	xui
絮	xcn
氦	hsq
芡	qnc
汲	jod
榕	rdm
贾	gox
猩	xkq
桓	htm
菌	jtc
葛	gtc
舐	uuq
逍	xnz
蓑	soc
嚷	rhk
乸	ndy
瑄	xrw
茴	hbc
怼	dcy
趋	qvt
锚	mvj
呶	nvk
殉	xtd
苞	bcc
愠	ytx
晖	hvo
堡	bor
堃	kyf
腋	ywo
妤	ybn
湄	med
侪	ifr
岬	jve
祼	gep
蕖	qbc
醪	lvy
鸦	yay
粟	syx
丈	vga
熘	lqh
眯	moo
曜	yxo
窖	jbb
襦	rip
庇	bug
宸	igb
碴	isu
胞	bco
番	pjp
庾	yng
汆	crr
醺	xyy
鹭	lyz
麂	jpg
腓	feo
蒹	jmc
瑗	yew
槐	hlm
植	vom
蜕	tci
烛	vih
藩	fjc
雏	iid
驶	upm
尬	gly
貘	miv
蕃	boc
羲	xiy
肆	sua
怛	dsx
勘	kjq
际	jue
聪	cse
薯	uoc
旬	xub
娑	sod
爨	cep
厦	uli
玦	jyw
撼	hhf
勋	xyk
婉	wln
飒	sll
椿	iym
谏	jny
诳	kay
麝	uwg
煌	hah
绦	tcs
拇	mof
悼	dxx
迦	jxz
皙	xim
铱	yij
俶	iyr
濠	hvd
邨	cyt
龅	bcv
䁖	lzo
镚	bfj
饸	hru
饹	leu
淦	ghd
噙	qnk
淮	hld
笺	jmv
昼	vmi
荀	xuc
厢	xli
俑	yfr
晦	hco
酪	lxy
呓	yuk
谙	any
垃	lat
踅	xyf
荚	jcc
腭	ewo
屿	yne
厍	uwi
铸	vyj
臧	zhw
镯	vpj
桐	tdm
狈	bqq
赊	uek
佯	yjr
邝	kkg
铉	xej
赘	vcf
茹	ric
诫	joy
嵩	sse
翰	hhu
弁	bns
檄	xom
祯	vfp
镬	hij
珈	jxw
菀	wlc
喳	iak
娆	rvn
腙	zso
谝	pxy
馃	gqu
驭	ycm
彻	iwi
擎	qlc
髅	lxg
溯	syd
乓	phq
坊	fjt
娲	wan
纶	lus
谬	mpy
殆	dsd
疵	cib
睾	gcp
粲	chl
缶	fcw
廿	nnc
乂	yup
囿	ymk
嘹	lmk
鹳	gec
螃	pji
跐	ciz
惘	wkx
檬	mhm
泮	phd
硐	dau
箧	qov
铠	kgj
诏	vxy
魁	kbg
构	gmm
褐	hwp
诊	vhy
究	jqb
菱	llc
镂	lmj
椽	itm
捺	nlf
歹	dga
慷	khx
碜	ihu
缦	mhs
陇	lfe
癞	lsb
铅	ykj
羸	lew
沱	tpd
镉	grj
嫚	mhn
懿	yuu
仂	lwr
蛟	jni
铳	iaj
溃	kcd
督	duu
鸢	yry
麟	lng
秧	yhh
凋	dnd
撇	ppf
沓	tlu
晤	wyo
蜗	woi
淋	lvd
讳	hcy
沤	oy
钰	ycj
创	ilr
惶	hax
俅	qwr
懈	xox
艏	ucv
醅	pwy
栊	ldm
戕	qlp
缤	bbs
醛	qty
馒	mku
葆	bbc
烨	ywh
鲛	jna
陨	yie
偃	ylr
熔	rdh
炽	iuh
叱	iuk
骏	jtm
劣	lou
嬉	xin
迭	dqz
谒	ywy
氯	lcq
厘	loi
惰	dix
燔	fkh
猥	wrq
疹	vhb
驷	sum
麒	qog
诘	jqy
锑	tij
茵	ybc
磅	pju
侉	kvr
苡	ypc
蕴	ytc
琢	vpw
蹩	bqd
缨	yks
络	lis
鳗	mka
氐	dpu
妒	dyn
恍	hsx
罕	hlb
镗	tjj
娣	dun
倘	tkr
涕	tud
褂	gzp
倔	jrr
砺	luu
侩	kjr
笏	hyv
砷	ufu
胍	gxo
旻	mno
炯	jfh
奘	zgp
僦	jpr
醨	loy
隈	wwe
埗	byt
珺	jtw
琇	xpw
蟀	uji
酰	xmy
鹾	cpl
窍	qbb
嫡	don
梆	bhm
锹	qnj
愧	kcx
砚	yhu
嗵	tsk
鹫	jpw
庶	uyg
奎	kbd
石	dha
纺	fks
辜	guu
铍	poj
钕	nnj
绚	xes
铵	azj
锎	kdj
圩	wet
蚂	mdi
嫫	mpn
棹	vxm
蚴	ymi
咥	xuk
埤	put
崂	lve
琨	kyw
羌	qly
莽	mkc
爵	jyp
鳍	qoa
骇	hsm
鞑	dsg
骸	hfg
阀	fsm
哽	gjk
狭	xcq
绰	iis
篡	cev
唾	tik
槌	ibm
僻	pur
噼	pik
煜	ych
鳃	sda
镭	lej
靥	ywi
诞	dhy
怠	dss
戗	qlr
徵	vpi
耙	psl
刹	ilx
氘	dcq
濑	lsd
萼	ewc
哙	kjk
喟	kck
阪	ble
馥	fyh
缳	hts
衢	qbi
峪	yce
犇	bfn
皴	cys
瞰	kho
镓	jxj
冼	xxd
戋	jma
晡	buo
祎	yip
羟	qsy
谠	dky
髎	lmg
髓	sn
烬	jvh
纤	xms
丞	ihl
缉	jis
芜	wic
偿	ijr
夔	kbb
埙	xyt
鸮	xnk
讽	fjy
濡	rid
悄	qnx
渭	wqd
祟	sci
箬	riv
悚	sfx
蜃	udi
懦	nix
钯	bdj
鲔	wra
跖	voz
亢	kgw
桦	hzm
戢	jok
尴	gjy
獭	tdq
琐	sqw
铯	swj
鸯	yhy
姒	sun
惦	dnx
怄	oyx
橡	xkm
殳	uuj
眭	svo
玑	jiw
玘	qpw
藜	loc
邋	laz
垞	ist
昉	fko
燊	ufh
癿	bqb
瞋	ifo
胩	kdo
脞	cq
骺	hxg
蜥	xii
驯	xtm
剿	jzv
膛	tjo
疆	jlg
蝠	fii
绽	vhs
匕	bpp
燎	lmh
藻	zbc
楔	xpm
膀	bko
呻	ufk
弘	hdg
璨	chw
漕	cvd
顽	wke
昝	zlw
奠	dnb
魍	wkg
耧	lxl
辔	pqs
霹	piy
嚏	tuk
眩	xeo
荷	hwc
扽	ddf
乩	jil
杈	iam
鸵	tpn
扦	qmf
氰	qlq
酚	ffy
荠	juc
叨	dck
鳎	tda
褙	bqp
龈	ynv
琏	lxw
芗	xlc
匣	xck
鞘	qbg
衷	vsw
敞	ikx
桀	jqx
饲	suu
筏	fsv
颔	hhr
酬	ixy
峙	vue
贸	mxp
豉	ipa
舫	fkv
蹂	rxz
骰	txg
蘅	hhc
鳕	xua
鹜	wys
圾	jit
氩	ylq
胫	jjo
纂	zyv
蠹	dya
祭	vsp
泗	sud
绉	vms
噤	jvk
邈	mzz
髦	mva
忑	twx
惆	ixx
浐	ild
窿	ldb
龋	qnv
矫	jmu
囱	csp
泚	cpd
痈	ysb
钊	vcj
阆	lgm
黉	hdx
浔	xud
湫	qqd
缐	xns
釐	xiw
锻	dej
旨	vpb
绸	ixs
斟	vfq
冕	mxk
沼	vbd
钨	wuj
岐	qoe
帷	wej
烁	uih
芦	lic
鳝	uha
垄	lfl
韭	jef
堰	yht
绷	bjs
翩	pmh
赃	zhk
裾	jvp
匈	xsb
崛	jye
钿	dnj
忝	txt
扪	mgf
沂	yod
迥	jfz
魑	iig
堠	hmt
玠	jow
诟	gmy
涓	jrd
巷	hgc
莘	ufc
睦	myo
遑	haz
箜	ksv
醴	lpy
鞣	rxg
鲽	dqa
丕	pib
壸	kiu
涞	lfd
烝	vgl
诎	qvy
邂	xoz
刿	gce
喹	kbk
悃	kix
氾	fkd
澌	sid
烀	huh
瑀	ynw
蠊	lzi
鳉	jla
眸	mxo
墟	xvt
邬	wuw
愕	ewx
盔	kvu
饷	xsu
戎	rdg
轲	kei
蝗	hai
犸	mdq
庐	lig
朽	xem
幔	mhj
铛	dhj
悖	bqx
狡	jzq
睫	jqo
阐	ilm
斫	vpu
泌	mud
诰	gxy
讥	jiy
渎	did
猗	yiq
搡	skf
虺	hnw
誊	thj
牲	ugn
胰	yoo
锃	zfj
锟	kyj
眦	zuo
骷	kug
霭	apy
鲈	lia
冗	rf
峻	jte
稼	jzh
褪	ttp
吭	hjk
嫒	aun
胳	geo
螂	lji
湍	tr
绥	sbs
胛	jvo
蜘	vii
亳	bpw
曷	hro
狲	syq
酢	ziy
苔	tdc
埒	lot
屃	xuu
岜	bae
斓	lkw
柰	nsm
殂	cid
珩	hhw
祉	vpp
苒	rlc
颧	qtc
鹧	vwg
坭	not
尜	gsx
惋	wlx
糇	hxm
肫	vyo
菰	guc
蕞	zcc
蠓	mji
谖	xry
馇	iau
淬	ccd
戮	lyx
鬃	zsa
骤	vmm
讶	yly
竭	jql
帛	bpb
沧	chd
篷	phv
殃	yhd
沛	pqd
嗣	suk
担	dhf
瞿	qbo
湛	vhd
楷	kgm
乒	pkq
惭	ckx
洼	wad
矾	fku
缪	mbs
弛	iog
赁	lvr
蹶	jyz
黜	iyh
皋	gcb
丧	shu
恸	tax
钏	iej
菘	ssc
恚	hct
氖	ngq
糊	hum
簸	bqv
旌	jkf
抔	pxf
蝙	bmi
堡	pyr
铟	ybj
隧	sce
鲧	gia
忏	ihx
杞	qpm
淖	nxd
漉	lyd
赅	gdk
骋	ijm
貉	hrv
椭	tqm
绌	iys
俳	pfr
喾	kyx
徊	hli
撺	crf
攉	hof
璁	csw
砼	tdu
蔸	dzc
锗	vtj
鲷	dna
咉	yhk
哌	psk
埭	dst
庠	xag
忞	mnw
潽	pud
焓	hkh
瑙	nbw
篼	dzv
簏	lyv
綮	qjh
荻	doc
诒	yoy
谮	zdy
锇	erj
揖	yif
踪	zsz
鲲	kya
裳	uhx
虻	mhi
涎	xzd
碓	dcu
锭	djj
缎	des
辖	xci
蝰	kbi
涤	dod
宦	heb
磬	qju
钺	yrj
衡	hhi
遂	sbz
嫔	pnn
窠	keb
囔	nhk
诬	wuy
珽	taw
蛄	gui
鹄	hin
徘	pfi
缟	gbs
驮	dim
忖	cix
氚	irq
柩	jpm
篦	buv
韶	uvl
鹊	qrc
烷	wkh
诹	zzy
匐	fib
崭	vle
飕	szj
刖	yro
婳	hzn
脘	wlo
纪	jps
瘩	dab
岷	mne
庖	pvg
杌	wym
酹	lqy
钍	toj
朴	pmm
刳	kud
纾	uus
跆	tfz
钭	dcj
荑	toc
俣	ynr
姮	hhn
榄	llm
槭	qum
琚	jvw
痉	jjb
蔟	cyc
蝤	qwi
裎	ihp
镛	ysj
鹑	iuw
咀	znk
坼	iwt
夼	ksd
慝	twk
玎	dkw
痤	cpb
瘙	sx
蒐	szc
蓓	bqc
褓	bbp
逅	hmz
镆	mij
镱	yuj
阡	qme
鲩	hea
谪	vry
祀	sup
蚯	qqi
篆	vev
髯	rka
俸	ffr
儇	xrr
绍	uxs
舷	xzv
睑	jxo
穹	qdb
旋	xef
攘	rkf
赭	vtt
亍	iya
憩	quq
鸩	vdd
妨	fjn
倌	grr
儆	jar
夙	syj
僰	bpa
醮	jby
罴	pos
蹴	cyz
壤	rkt
曌	vxo
腑	foo
缄	jms
缭	lms
桡	rvm
曛	xyo
柠	nlm
痢	lub
祆	xmp
谄	ily
咤	vlk
垓	gdt
埘	uot
氛	ffq
璠	fkw
桴	fim
稗	bsh
艚	cvv
篁	hav
踊	yfz
髁	keg
鲢	lza
橛	jym
砵	bou
绻	qys
茱	vuc
萘	nsc
讵	jcy
髭	zia
鬏	jqa
麸	fuf
圮	ppt
婀	een
岢	kte
惚	hux
狍	pvq
甾	zdv
竦	sfl
缞	cvs
蟆	msi
豌	wja
鄱	ppp
镥	loj
陂	poe
鲳	iha
糁	ufm
凼	dgu
劢	msw
媄	mrn
嫱	qan
孛	bqu
崚	lhe
捃	jtf
淝	fed
炣	kth
焜	kyh
珅	ufw
珒	jbw
琬	wlw
睐	lso
筘	kmv
艿	ngc
苄	bnc
茏	ldc
蚪	dci
铒	eyj
馇	vau
龠	yrr
衙	ysi
肃	syv
纛	dxf
酋	qwb
觑	qch
晁	ivo
脍	kjo
偎	wwr
胁	xqo
炬	jch
箐	qjv
镫	dfj
獠	lmq
蠕	rii
庑	wog
袂	mqp
铆	mbj
黥	qlh
啬	swu
蹈	dbz
亵	xow
胥	xvv
垆	lit
薨	hsc
锢	gyj
锲	qoj
嵴	joe
忤	wox
燚	yuh
籴	dor
顷	qab
鬟	hta
洄	hbd
魉	lsg
佞	njr
宙	vmb
泅	qwd
狒	fqq
蝴	hii
躏	lvz
迄	quz
彀	gmu
瑭	tjw
噩	eww
榫	sim
氲	yyq
鳅	qqa
叆	aue
耦	ool
琮	cdw
祚	zip
萃	ccc
遐	xcz
馔	veu
氡	dsq
猬	wqq
猱	nvq
糅	rxm
胪	lio
襄	xlw
畜	iyw
傣	dgr
崤	xme
庋	gng
彖	te
氙	xmq
珥	eyw
腌	aao
圹	kkt
懔	lmx
滓	zpd
窈	ybb
胱	glo
荇	xjc
莼	iuc
蜓	tli
衲	nlp
黻	fiy
匙	uio
卬	ajp
呙	gok
圪	get
埯	azt
埼	qot
崁	khe
弢	tcg
懊	aix
樯	qam
汩	god
煳	hih
珐	flw
痱	fqb
瘳	izb
肼	jao
腘	gpo
蛔	hbi
诔	lry
铑	lbj
颡	sky
髌	bvg
鲑	gva
䶮	yll
兢	jku
刬	ihj
圬	wut
圳	vdt
墒	uht
夥	hqg
姗	ujn
娉	pkn
宬	ihb
嵘	rde
嶝	dfe
怙	hyx
慵	ysx
扃	jsh
摽	bbf
昳	dqo
椪	pfm
汶	wdd
溲	szd
濉	svd
烜	xyh
煋	xkh
瓿	byl
皛	xzb
簕	lwv
缱	qxs
耋	dql
耔	zpl
肟	wio
脬	pco
芎	xsc
苤	pwc
莛	tlc
葎	lcc
蛩	qdg
蟮	uhi
郴	ifm
镮	htj
隹	vvr
靺	mig
鞨	hrg
驸	fym
鲼	fda
鹈	tob
桉	anm
勐	mjz
陛	bue
噘	jtk
诅	zoy
谕	ycy
嵬	wee
牍	dip
掾	yef
褥	ryp
姹	iln
吝	lvw
胄	vmy
锊	lrj
僚	lmr
恙	ygy
罹	los
豕	upa
踵	vfz
豢	hej
橇	qnm
餮	tod
鼾	hjz
牯	gon
猡	lpq
赈	vdk
予	ybs
亘	gda
狺	ynq
侦	vfr
奡	aia
彝	yov
疟	nrb
艉	wrv
薮	scc
藐	mzc
闳	hdm
隳	hve
匏	pvd
梧	wim
篱	lov
蹽	lnz
堑	qni
竽	ybv
擂	lef
峭	qbe
獬	xoq
竺	viv
诽	fry
抟	ttf
肮	ah
腴	ybo
麾	hvg
臊	sxo
穰	rjh
蓍	uic
怏	ygx
惇	dyx
瞩	voo
缯	zgs
辘	lyi
骥	jum
绷	bfs
弋	yua
怦	pgx
柘	vwm
犒	kxn
觐	jvn
郦	lul
麈	vog
戬	jxy
盎	ag
籁	lsv
罘	fis
诨	hty
贮	vyk
辊	gii
轧	vsi
蔓	whc
嗉	syk
峁	mbe
樗	ium
瞌	keo
矼	ghu
绲	gis
缗	mns
镞	zij
鳔	bba
黾	mmk
鼐	nsn
模	mim
宿	xeb
宿	xpb
埴	vot
尥	lby
岙	aiy
崾	yxe
煊	xrh
琤	igw
琵	pow
璀	cn
矍	jyo
竣	jtl
缃	xls
缥	pns
舸	gtv
钬	hqj
膻	ujo
杻	icm
杻	nem
叨	dvk
叵	pqk
塄	lht
姤	gmn
孓	jyv
尨	mju
怍	zix
懋	mxm
懑	mdd
拤	qcf
杲	gbo
枹	bcm
榔	ljm
槁	gbm
璋	vhw
瘁	ccb
绨	tus
膑	bvo
芑	qpc
茛	gdc
萄	tvc
蔌	syc
蝽	iyi
褡	dap
觏	gma
诿	wry
谇	scy
谧	muy
辏	cmi
锘	nij
馄	huu
驺	zzm
伽	gar
㸆	kxh
丏	mxa
侏	vur
侹	tar
吣	qvk
哃	tdk
唢	sqk
啴	ilk
啶	djk
嗾	sck
嘌	pbk
囷	qyk
垯	dat
垸	yet
埌	lgt
墈	kht
墼	jii
妊	rdn
妯	vxn
娌	lpn
峣	yve
崀	lge
嵝	lce
嶒	che
巯	qwv
徛	jui
忸	nex
慥	zxx
戽	hyh
揿	qvf
晫	vpo
杷	psm
栟	bfm
梃	tam
梃	tjm
橥	vuq
氕	ppq
氤	ybq
渼	mrd
湓	pgd
炘	xbh
烃	tkh
煺	tch
爝	jyh
猃	xxq
猕	moq
甦	sug
畤	vut
畲	uer
疔	dkb
瘰	lqb
矻	kuu
硗	qnu
禤	xrp
穑	swh
窊	wab
窕	tzb
笆	bav
笊	vxv
翙	hce
翮	hra
翾	xrs
耑	dre
耩	jsl
脎	slo
腧	uyo
舻	liv
荮	vmc
萜	tpc
葑	fgc
蒉	kcc
蛸	xni
蜾	gqi
衄	ncx
诂	goy
贶	kkk
跞	luz
迮	zrz
遄	itz
邳	pip
鄞	ynn
酞	tsy
锶	sij
霈	pqy
靸	sdg
馓	slu
驲	rum
鲂	fja
鲅	bla
黪	clh
狩	umq
戍	uyw
漭	mkd
蒯	kac
牒	dqp
蟠	pki
佃	dnr
郫	pop
遏	ewz
擘	biu
湟	had
煅	deh
睃	soo
璜	haw
徭	yvi
蓁	vfc
猊	noq
倜	tur
殡	bvd
伥	ihr
桅	wem
悸	jux
邕	ysv
蔼	apc
螳	tji
蚣	gsi
佚	yur
徇	xti
馗	kbj
撄	ykf
袒	tlp
鳜	gca
儡	lrr
宕	dgb
旖	ypf
牦	mvn
獐	vhq
襕	lkp
橐	tpa
绶	ums
鼍	tpk
侗	dar
抨	pgf
晌	uko
疽	jvb
逵	kbz
嚅	rik
梏	gym
猝	cyq
桠	yam
迳	jjz
钇	ypj
饧	xlu
鬻	ycg
纤	qns
琢	zpw
紊	whw
蔗	vwc
趺	fuz
铧	hcj
舢	ujv
苴	jvc
铩	uaj
鳀	toa
蚌	bfi
匆	csb
埽	sxt
妩	won
忪	ssx
楪	dqm
殚	djd
汹	xsd
貅	xqv
镧	lkj
饴	you
骖	cjm
鳡	gla
燎	lzh
偾	fdr
堙	ybt
孺	riz
睥	puo
窣	sub
筵	ykv
芨	jic
蜩	tmi
铫	yvj
峨	ere
徉	yji
炔	qth
烽	fgh
瑁	mxw
箪	djv
绔	kys
薤	xoc
蚋	rci
鄄	jex
酡	tpy
钐	uhj
妫	gvn
揶	yrf
楯	uim
淆	xmd
潺	ikd
燮	xoh
璩	qbw
糌	zjm
繇	yxp
羧	soy
翛	xnr
聒	goe
臃	yso
蕤	rbc
褫	ipp
讴	ouy
谌	igy
赉	lsl
鄜	fug
醢	hgy
锆	gxj
阱	jae
隍	hae
雹	bvy
颙	ydy
飏	yjj
鹂	lol
黼	foy
纶	grs
柞	zim
玢	ffw
镏	lwj
佣	yar
澄	dfd
糜	meg
仃	dkr
仳	ppr
咡	eek
圯	yot
垠	ynt
垡	fsr
妁	uin
娩	mxn
崮	gye
帱	ixj
怩	nox
愆	qmi
搦	nif
曩	nko
柢	dpm
檩	lmm
滦	ltd
牂	zhp
畴	ixt
畹	wlt
砑	ylu
砝	fdu
砭	bmu
础	iou
笾	bmv
筢	psv
篝	gzv
纰	pis
绱	ugs
缵	zys
菟	tyc
蠲	jrb
诋	dpy
诮	qby
跂	qoz
轫	rdi
钷	pqj
铙	nvj
锪	hoj
鞧	qqg
鞴	bqg
韫	ytw
馘	gpb
朴	pim
综	zfs
戛	gaa
嫚	mjn
碌	lpu
伽	qqr
仉	vkr
仫	myr
侔	mxr
俜	pkr
偬	zfr
卣	ycl
叚	xcv
噍	jbk
圌	ibk
坌	bdb
坬	wat
垕	hmp
垟	yjt
垱	dgt
垲	kgt
垾	hht
埆	qrt
埝	nnt
堐	yst
堽	ght
塝	bgt
夐	xad
妘	yun
妣	bpn
娓	wrn
孀	uln
尪	why
屼	wye
屾	ufe
峘	hte
嵋	mee
帼	gpj
忉	dcx
忾	ksx
怊	icx
恂	xux
悱	frx
惙	iix
憬	jax
戤	gsn
扂	dnh
捽	zpf
掮	qzf
搛	jmf
摈	bvf
暹	xmz
杩	mlm
栲	kbm
檞	jwm
洫	xcd
洸	gld
涔	cgd
溻	tad
溽	ryd
漴	idd
漼	cnd
烔	tdh
烺	lkh
熇	hwh
牁	kep
牿	gyn
玕	gjw
琔	dnw
瑱	tnw
璈	apw
璪	zbw
瘃	vib
睽	kbo
矧	uhu
砟	vdu
磉	sku
磴	dfu
稂	ljh
窎	dbb
窭	jcb
竑	hdl
筅	xxv
筌	qtv
筦	gyv
箢	yrv
篌	hxv
绁	xos
绖	dqs
绠	gjs
绹	tvs
缂	kws
缌	sis
缔	dus
缙	jvs
缛	rys
翃	hdu
耏	ete
耵	dke
臜	zao
舴	zrv
舾	xiv
艟	isv
芠	wgc
茌	ioc
荏	rhc
莞	gyc
蒎	psc
蕗	lyc
蘩	fkc
虒	sip
蝻	nli
螋	szi
螬	cvi
蟫	yni
衒	xei
袷	qxp
裉	kdp
褟	tap
襜	ijp
襻	php
诙	hvy
趯	tut
跣	xxz
跬	kn
踦	ypz
躐	loz
躔	ikz
遨	apz
鄹	zze
酤	guy
酩	may
酴	tiy
酾	uiy
醭	biy
钔	mgj
锒	ljj
锿	aij
镤	pij
阒	qcm
陞	uge
鞲	gzg
饹	geu
鲘	hma
鲙	kja
鲦	tma
鲭	qka
鲹	ufa
鹌	and
麑	nog
黇	tmc
婠	wjn
傀	knr
晷	gno
魈	xng
倮	lqr
狞	nlq
橼	ytm
魃	bsg
恫	dax
傩	npr
纥	hrs
劾	hrw
陉	xle
姽	gnn
佝	gzr
苌	ijc
亸	dqw
隗	wre
鲵	noa
悢	lkx
狰	vgq
钽	tlj
伉	kgr
鞘	ucg
蝮	fyi
廓	kig
鼹	ylj
廙	yug
蝼	lxi
蹑	noz
辚	lni
镔	bbj
琥	how
骈	pzm
旒	lwf
瑚	hiw
禳	rjp
鲇	nza
鳟	zya
恹	yjx
胙	zio
辎	zii
锷	ewj
毐	apu
浚	jtd
髹	xqa
覃	tkx
恻	cwx
缑	gzs
孢	bcz
翱	apb
崆	kse
粜	tbi
跄	qkz
酝	yty
阃	kim
囹	llk
掇	dof
砧	vfu
谩	mhy
跻	jiz
鋈	wyd
鬲	gra
叇	dse
吩	ffk
媪	aqn
峤	jbe
旄	mvf
纻	vys
鏖	apg
殷	yjp
嘧	muk
埚	got
泞	njd
狻	srq
藁	gbc
螫	uut
褛	lnp
赂	lyk
赧	nlt
隰	xoe
骠	pbm
亶	dlw
侈	ipr
勍	qlw
墁	mht
甗	ylh
砫	vyu
籀	vmv
纡	yvs
胼	pzo
舄	xuj
衅	xvx
衽	rdp
袈	jxl
逡	qyz
铄	uij
铋	buj
锞	kwj
镋	tkj
陲	ibe
鲱	fwa
拶	zlf
岵	hye
牝	pvn
盍	hrt
缫	scs
罨	yls
荭	hdc
蝓	ybi
踉	lkz
踌	ixz
逶	wwz
铼	lfj
阋	xum
骼	grg
鲮	lla
鳊	bma
鳙	ysa
葚	udc
仞	rdr
佻	tnr
匦	gnk
嚭	ppu
媸	iin
嫪	lxn
嶙	lne
慆	tcx
擐	hef
柙	xcm
栝	gxm
歃	ulq
焞	tyh
犴	abq
玃	jyq
珣	xuw
疳	gjb
祧	tnp
秭	zph
稔	rhh
罅	xzf
翂	ffx
翥	vyl
耜	sul
胲	hgo
芘	bpc
蓊	wjc
蓐	ryc
蕹	wfc
蝣	yxi
袆	hvp
襁	qsp
讣	fyy
踣	bpz
蹯	fkz
躇	iiz
锨	xmj
鞯	jmg
颛	vre
鲊	vda
黠	xch
鼙	pou
迫	pgz
伺	cur
啜	ijk
绰	ics
莨	lgc
络	lxs
坷	ktt
苫	uhc
锔	jbj
膀	pjo
啁	vck
啁	vzk
儋	djr
勰	xql
哢	lak
哿	gtl
唪	fjk
啕	tvk
噀	xtk
坻	dpt
垧	ukt
墀	iot
媲	pun
崿	ewe
嵯	cpe
嶷	yoe
帑	tkn
帨	ucj
廛	ikg
忮	vux
惴	vcx
旆	pqf
椀	wlm
椸	yom
汭	rcd
泂	jfd
泔	gjd
泖	mbd
烠	hbh
熜	csh
燋	jnh
犷	gsq
玿	uvw
珙	gfw
琀	hkw
瓞	dqg
畛	vht
瘛	iub
砜	fgu
硿	kau
祜	hyp
秕	bph
笤	tmv
筶	gxv
籼	xmm
罟	gos
耇	gcl
耠	hol
聍	nle
聩	kce
肪	fjo
芴	wyc
莶	xmc
萑	htc
蓂	muc
虢	gpp
蛴	qoi
蟪	hci
裒	pxw
裢	lzp
裣	lxp
裥	jxp
褊	bxp
詟	vrl
诐	buy
谆	vyy
谵	vjy
跚	ujz
踬	vuz
蹁	pzz
遘	gmz
钫	fhj
阗	tzm
骒	kwm
髃	ybg
鬈	qta
鳇	haa
黟	yih
什	ugr
脏	zgo
撒	saf
蛤	gri
场	ijt
稍	uxh
挣	vgf
唉	aik
露	lyy
塞	ssb
塞	swb
晕	yto
阿	eee
扒	psf
炮	pvh
炮	bch
省	xau
埋	mkt
晃	hso
咽	yjk
臭	xpz
合	gtr
尽	jmi
曲	qvl
占	vjl
答	dav
观	gey
参	cfs
色	ugd
劲	jjv
读	dmy
圈	jek
片	pmp
降	xae
累	lrt
几	jip
哇	wak
胖	pko
绿	lys
爪	vbp
拉	lsf
们	mgr
朝	vcu
强	qsg
少	uxx
冲	iad
难	nhy
无	mpa
跑	pvz
车	jva
更	gga
便	pzr
哦	oik
打	dsf
把	blf
说	ucy
了	lzv
和	hph
都	dul
着	vcy
着	vvy
的	dib
的	dob
觉	jbx
谁	uby
桧	hcm
簸	biv
犍	qzn
瘩	dsb
芾	fqc
烊	ygh
趄	jvt
钐	ujj
镡	ikj
坷	ket
骀	dsm
鹘	gog
颏	krw
貉	hvv
蹊	qiz
荑	yoc
莨	lac
㑇	vmr
㕮	fok
㘎	hlk
㛚	tfn
㛹	pzn
㟃	sie
㠓	mhe
㤘	vmx
㥄	llx
㧐	sff
㫰	lgo
㬊	hyo
㬚	iwo
㭎	ghm
㶲	yah
㻬	tuw
䃅	diu
䌹	jfs
䎃	rlr
䏝	vro
䏡	uuo
䐃	jto
䓛	qvc
䗖	dui
䗛	xqi
䜣	xby
䝙	iuv
䦃	voj
䴓	uia
䴗	jbo
䴘	tip
上	ukl
亟	qul
伭	xzr
估	gyr
体	tir
佖	bur
佤	wdr
佴	nsr
佸	hpr
侂	tor
侥	yvr
侴	icr
俟	qor
俫	lfr
倕	ibr
倞	jjr
倥	kfr
倧	zsr
倴	bdr
倻	yer
偓	wir
偡	vhr
偰	xor
傃	syr
傉	nyr
傺	iur
僇	lyr
儴	rjr
划	hzg
刷	uzu
刺	cia
刽	gcr
剅	lxa
剕	fqf
剟	doy
劐	hoc
勾	gmb
匼	kek
单	ikb
南	nau
叉	isy
可	kwd
吁	yvk
同	tak
吐	tyk
吗	mdk
吵	ick
和	hoh
咪	mpk
咯	gek
哦	erk
哪	nak
哪	nrk
哼	hgk
啊	ask
啊	adk
啊	alk
喋	vsk
喷	pdk
嗯	ehk
嗯	ejk
嘚	dwk
囊	nha
圫	tot
圲	qmt
坋	fdt
坜	lut
坫	dnt
坰	jst
坽	llt
垍	jut
垏	lct
垭	yat
垴	nbt
垺	fit
垿	xct
埇	yft
埏	ujt
埪	kst
堌	gyt
堎	lft
堧	rtt
堨	ewt
堼	hft
堾	iyt
塆	wjt
塥	grt
墘	qzt
墦	fkt
妭	bsn
姈	lln
姶	ewn
娀	ssn
娠	ufn
婍	qpn
婘	qtn
婤	vzn
婫	kyn
婻	nhn
媆	ryn
媓	han
媛	yen
嫘	len
嫜	vhn
嫦	ijn
嫽	lmn
嬥	tzn
孅	xmn
宄	gnb
寁	zlb
尺	itu
尾	ypu
岖	qve
岞	zie
岿	kve
峂	tde
峃	xyx
峛	loe
峧	jne
峿	wie
崡	hke
嵁	kje
嵖	ise
嶟	zye
嶦	uhe
嶲	xie
巉	ike
差	ciy
帱	dxj
并	bkb
庤	vug
庱	ijg
廆	wrg
弆	jnt
弨	icg
弸	phg
徜	iji
忭	bnx
忺	xmx
怫	fix
恔	jzx
恧	nce
恶	ety
悈	jox
悛	qrx
悝	kvx
悰	cdx
惎	juq
愃	xrx
愎	bux
愐	mxx
慭	yvl
戌	qvw
戣	kbv
戭	ylb
扆	yph
抃	bnf
抢	qlf
抹	mif
拧	njf
挡	dgf
挲	sad
捎	uxf
掊	pcf
揳	xpf
搁	grf
搌	vlf
搒	phf
摛	iif
摩	mag
摴	iuf
擞	smf
斠	jba
斶	iyj
旴	xvo
旵	ilo
旿	woo
昃	zwo
昄	blo
昒	huo
昣	vho
昺	bao
晊	vuo
晐	gdo
晱	ulo
暅	gfo
暶	xto
暾	tyo
朏	fro
朓	tzo
杉	uam
杧	mjm
枘	rcm
枸	gzm
柖	uvm
柚	yxm
柽	igm
栐	yfm
桄	gkm
梾	lfm
梿	lzm
棓	bqm
棤	cim
椅	yim
椆	ixm
椹	udm
榅	wfm
榇	idm
榧	frm
欸	eis
欸	eus
汫	jad
沌	ved
泙	pld
洧	wrd
洭	kld
浈	vfd
浭	ggd
涄	pkd
淙	cdd
渟	tld
溞	scd
溹	sqd
滃	wgd
滆	grd
滏	fod
漷	hqd
潸	ujd
澽	jcd
瀑	bxd
瀼	rjd
瀼	rgd
炅	gco
炌	ksh
炟	dsh
烶	tah
焆	jrh
焌	jth
焌	qvh
煃	knh
煓	trh
煴	yyh
熥	tgh
燹	xxu
爚	yrh
爟	geh
牚	ifx
牟	mys
牥	fhn
犋	jcn
犨	izr
犴	hjq
狃	neq
狉	piq
狴	buq
猁	luq
猄	jkq
猞	ueq
猯	trq
猺	yvq
獍	jjq
獯	xyq
玒	hdw
玞	fuw
玤	bgw
玭	pnw
玶	plw
玼	cpw
珇	zow
珖	glw
珦	xkw
珷	wow
琄	xew
琈	fiw
琟	wew
瑅	tow
瑑	vew
瑔	qtw
瑖	dew
瑳	cow
璒	dgw
璬	jzw
璲	scw
璺	wdp
瓀	ryw
瓘	gew
瓦	wla
畎	qyt
畯	jtt
疁	lwt
疢	idb
疭	zab
疰	vyb
疸	dlb
痃	xtb
痄	vlb
痼	gyb
瘅	dhb
瘌	llb
瘭	bnb
癗	lrb
盉	hrh
盦	anr
眵	iio
睄	uxo
瞵	lno
矸	gju
砄	jyu
砆	fuu
砉	hxf
砗	ieu
砘	dtu
硁	kgu
硇	nvu
硍	ynu
硔	gfu
硖	xcu
硚	qmu
碡	vxu
碥	bxu
碹	xeu
磙	giu
磻	pku
礓	jlu
礞	mhu
礵	ulu
祃	mlp
祊	bgp
祋	dcp
祏	uop
祾	llp
禊	xup
禒	xxp
禘	dup
秘	buh
秸	jph
稃	fuh
稌	tih
稑	lyh
稹	vhh
穙	pih
笯	niv
笸	pqv
笼	lfv
筇	qdv
筤	ljv
筻	ggv
箖	lnv
箨	tiv
篑	kcv
篚	frv
篪	iov
簉	zxv
簖	dev
簝	lmv
簠	fov
簰	pfv
粘	nzm
纩	kks
纼	vds
经	jjs
缉	qis
缩	sys
缪	mps
缬	xqs
羓	bay
羰	thy
翯	hwx
耖	ixl
耥	thl
耰	yzl
耱	mil
肷	qxo
胂	udo
胈	bso
胠	qvo
胣	ipo
脟	loo
脶	lpo
脿	bzo
腠	cmo
腨	ueo
膏	gxw
膙	jso
膦	lvo
臑	nxo
舥	pav
艨	mhv
节	jqc
芄	wkc
芏	dyc
芤	kzc
芯	xvc
苉	ppc
苠	mnc
苧	nlc
茈	zpc
茋	dpc
茝	igc
茳	jlc
茽	vac
荖	lbc
荙	dsc
荛	rvc
荨	qzc
荽	svc
莝	cic
莴	woc
莿	cuc
菝	bsc
菹	zuc
萏	dhc
萣	djc
萳	nkc
萹	bmc
葖	tuc
葜	qxc
葰	sqc
葸	xpc
葺	quc
蒇	ilc
蒈	kgc
蒡	bgc
蓏	lqc
蔀	byc
蔈	pbc
薁	aic
薄	bic
薸	pmc
薿	npc
蘘	rjc
虷	gji
虷	hki
虸	zpi
虹	jki
虼	gwi
蚄	fhi
蚆	bai
蚲	pli
蛑	mxi
蛞	kii
蛱	jci
蛲	nvi
蛸	uci
蜎	yri
蜐	jqi
蜚	fwf
蜣	qli
蜿	wji
螵	pni
蟛	phi
衃	pwx
衎	khi
衩	ilp
袗	vhp
裰	dop
裼	tup
觇	ijl
觌	dou
觟	hzd
訄	qwj
訇	hsb
訚	ynm
讧	hay
讻	xsy
诖	gzy
豁	hib
貆	htv
赕	dlk
赪	igt
趑	zit
趱	zlt
趵	bxz
踒	woz
蹅	idz
蹐	joz
蹒	pkz
轳	lii
轷	hui
辀	vzi
辌	lai
辒	wfi
过	goz
逖	tuz
逭	hez
邗	hkg
邡	fhf
邿	uit
郎	lgd
郓	ytb
郾	ylk
鄗	hxw
鄠	hyy
酂	zhn
酊	day
酏	ypy
酦	poy
钢	ggj
铷	rij
铹	lvj
锫	pej
镄	fqj
镅	mej
镎	nsj
镩	crj
阽	dne
隃	uye
隩	aie
雱	phy
靰	wyg
靽	bhg
靿	yxg
鞅	yhg
鞅	ygg
鞒	qmg
鞔	mkg
鞡	lag
鞮	dig
韂	ihg
韪	wro
顸	hjg
颃	hjw
颥	riy
饪	rdu
饮	yvu
馌	ywu
驵	zkm
骎	qbm
骕	sym
骨	gul
髢	doa
髽	vxa
鬒	vha
魆	xvg
魋	tbg
鱽	dca
鱾	jpa
鲋	fya
鲏	poa
鲐	tfa
鲕	eta
鲗	zea
鲪	jya
鲬	yfa
鲰	zza
鲴	gya
鲾	bia
鲿	ija
鳁	wfa
鳂	wwa
鳑	pja
鳛	xoa
鳣	vja
鸹	gxq
鸼	vzv
鹙	qqh
鹨	lpx
鹩	lma
鹯	vjw
麀	yzg
麇	jyg
麇	qug
黩	dih
鼒	zic
鼱	jkj
齇	vaz
鿍	ggt
鿏	msj
𠳐	bhk
𡎚	pxt
𣗋	dkm
𥔲	ewu
𥕢	cvu
𥖨	zxu
𦈡	xvs
𦝼	lxo
𨐈	gli
𨙸	qou
𨟠	qro
𨱏	daj
𨱔	zyj
𨺙	nue
𩽾	ana
𩾌	kha
𪣻	lxt
𪤗	lbt
𪨶	uee
𪩘	yle
𫄸	xys
𫍯	xzy
𫐐	noi
𫐓	rxi
𫑡	mhk
𫓧	fuj
𫓯	jij
𫓶	xrj
𫔶	nom
𫖮	ype
𫖯	foe
𫖳	yyy
𫗧	syu
𫗴	vju
𫘨	tom
𫚖	cpv
𫞩	mgw
𫟅	las
𫟹	hdj
𫟼	dsj
𫠆	knu
𫢸	dhr
𫭟	out
𫭼	lvt
𫰛	xln
𫵷	lue
𫶇	dqe
𫷷	xbg
𫸩	kzg
𬇹	gpd
𬉼	ooh
𬊈	xuh
𬊤	ilh
𬍡	dgd
𬒗	lku
𬘘	dls
𬘩	tks
𬘭	ifs
𬙊	mis
𬜯	lsc
𬞟	pnc
𬣞	voy
𬣳	hhy
𬬭	luj
𬬸	uyj
𬬹	ugj
𬬻	lij
𬭁	moj
𬭚	iuj
𬭤	hxj
𬭩	wgj
𬭯	pwj
𬭶	hwj
𬭼	scj
𬮿	gse
𬯀	jie
𬯎	tbe
𬳶	jsm
𬴂	fwm
𬴃	hom
𬶮	xpa
𬸣	xmb
〇	ytv
〇	xkv
㕶	ez
㕶	ej
㛚	yfn
㜨	nf
㞎	pau
㞗	qwu
