的	d
我	w
是	u
了	l
你	n
在	z
和	h
都	dz
不	b
有	y
就	j
也	yt
好	hb
个	g
人	r
说	uo
用	ya
他	t
这	v
来	lf
要	yx
去	q
会	hc
看	k
中	vs
想	x
没	m
啊	a
那	nl
吧	ba
给	gr
能	nh
对	dc
上	ug
到	dx
多	do
吗	ma
里	lp
被	bq
做	zi
又	ym
过	gi
让	rg
还	hf
她	ta
打	dd
把	bd
而	e
着	ve
大	dl
从	c
它	tab
写	xw
再	zs
字	zu
得	de
搞	gb
狗	gc
猫	mc
一	yi
真	vf
下	xz
但	dh
叫	jb
很	hh
比	bp
呢	ne
最	zc
更	gf
地	du
地	det
等	dj
吃	i
像	xk
后	hm
时	uoo
只	vp
点	dxl
先	xm
话	hz
与	yn
快	kj
玩	wk
当	dhx
已	yp
问	wd
完	wkb
以	ypv
将	jl
您	nn
找	vb
爱	au
太	ts
谁	ue
才	cf
年	nz
新	xb
跟	gfz
别	bqk
学	xy
哇	wa
按	ab
哎	ai
前	qz
睡	uc
加	jx
所	s
为	we
为	wqd
可	kt
出	iu
该	gd
向	xkp
却	qr
哦	o
小	xzl
天	tm
高	gcw
买	mg
呀	yak
刚	gh
事	uu
好	hxn
坏	hj
发	f
全	qt
开	kd
万	wh
之	vi
心	xbd
帮	bh
回	hbk
得	dri
牛	nw
家	jxb
长	ij
月	yr
卖	ms
岁	sc
成	ih
唉	auk
跑	p
走	zct
早	zb
连	lz
滴	di
越	yrt
无	wi
阿	aa
送	sa
分	ff
黑	hw
额	er
妈	man
换	he
们	mf
难	nk
同	td
祝	vy
恩	en
干	gha
算	se
路	ly
并	bj
呗	bw
少	ub
猜	cd
放	fg
擦	ca
转	vyi
错	ci
脸	lx
贴	tp
陪	pe
带	ds
笑	xbv
敢	gl
谱	po
拿	ns
二	ee
煮	vo
鸡	ji
或	hi
书	uuv
每	mr
画	hza
坐	zir
咯	kdk
掉	db
讲	js
梦	mfm
冷	lj
花	hx
于	yb
手	ucp
咋	zd
哟	yo
爆	bx
站	vh
变	bn
看	kju
哥	ge
版	bl
水	un
起	qp
图	ti
弄	na
住	vyr
啦	la
够	gm
咩	mp
累	lq
倒	dxr
肉	rm
毛	mv
神	ugp
请	qa
拉	laf
肿	vfo
听	tk
内	nq
噢	oo
唱	ig
骂	ml
装	vl
三	sj
蛮	mk
腿	tn
正	vfa
瘦	um
卤	lo
俺	az
老	lb
俩	lv
抱	bxf
忙	mj
超	ic
疼	th
胖	pg
喔	wo
车	ie
某	mcg
第	duv
教	jn
生	ugpf
中	val
进	jv
假	jvr
差	il
忘	wg
热	rw
选	xyz
啥	us
微	ww
求	qw
若	ri
些	xp
久	je
苦	ko
米	mpd
约	yts
飞	fw
吓	xzk
亲	qb
照	vx
赢	yl
饿	ew
读	diy
秒	mz
信	xv
另	ljk
儿	et
靠	kx
聊	lm
远	yy
懂	df
羯	jq
低	dir
呆	ddk
晒	uso
追	vv
见	jnk
跳	tb
挂	gz
哪	nd
鸟	nzw
呃	ewk
挺	taf
贵	gcv
元	yte
摩	mpg
疯	fgb
张	vhg
萌	mh
头	tx
活	hp
行	xl
哒	da
次	cu
本	bha
骗	pn
店	dn
考	kb
歌	gea
喂	wq
强	qag
死	sp
收	uz
贱	jnkj
噗	pu
恨	hd
撸	lu
喵	mn
亮	lk
弱	rig
破	pi
哼	hg
拍	pd
躺	tku
抢	qs
吐	to
日	ru
谈	tky
饭	fh
帅	uj
离	low
号	hxk
闹	nx
办	bhl
还	htz
养	yk
红	hds
猪	vu
刷	ux
呐	nlk
姐	jw
洗	xpd
种	va
喝	hek
菜	cs
如	rin
赞	zh
丢	dq
捏	np
非	fwl
粉	fhm
怕	pl
坑	kg
网	wkk
总	zf
曾	ch
爹	dp
蛋	dhv
型	xlk
咱	zk
屎	up
纸	vps
杀	ua
自	zup
白	bf
急	jo
催	cv
吖	aak
改	gg
特	tw
包	bc
愿	ye
妹	mq
唔	wik
受	ump
抓	vxf
钱	qzj
者	vt
喷	pf
鱼	ybd
瞎	xx
此	cp
乱	le
滚	gid
呦	yz
晚	wl
留	lw
晕	yyo
风	fgj
抽	iz
块	kjt
怪	gj
度	dy
戳	io
往	wki
便	bnr
楼	lxm
党	dk
咬	ybk
吹	iv
练	ln
删	ujc
条	tmw
耶	yre
丫	yab
系	xu
君	jy
丑	icv
件	jnr
近	jvz
两	ls
雨	yna
力	luv
面	mna
球	qww
重	id
火	hq
爬	ps
脚	jz
管	gy
偶	oor
行	hjii
痛	taby
黄	ha
嘴	zn
戴	dsu
情	ql
各	gw
门	mgd
卡	kdu
倒	dbr
跪	gcz
道	dxz
病	bjb
边	bm
搜	sz
短	dyu
混	ht
呵	hekk
指	vpf
翻	fj
词	co
招	vc
尿	nb
摸	mo
嘤	ykk
撒	sd
毁	hn
顶	dad
马	md
喊	hl
由	yxl
悲	bwf
组	zo
帖	twj
则	zr
爪	vvp
配	pq
乃	ng
斤	jbp
秀	xph
伤	uh
喽	lzk
蓝	lkc
及	jop
谢	xo
报	bxfy
因	ybkd
泡	px
未	wqa
款	ky
定	djb
深	uf
渣	vad
粗	cum
咔	ka
爸	blb
输	uui
床	ia
碗	wlu
外	ws
宅	vfb
纯	ius
熊	xd
汗	hhd
搭	daf
药	yxc
使	upr
感	glx
宫	gs
双	ul
演	yld
木	my
粑	bam
班	bjw
赚	vek
货	hir
亿	yu
拼	pb
嗨	hdk
其	qo
名	mlx
类	lqm
棒	bg
王	wj
骑	qom
片	pnp
金	jbr
茶	is
处	iy
砸	zsu
查	ism
光	glxw
气	qu
枪	qlm
句	jc
扔	rgf
试	uuy
嫁	jzn
且	qwl
切	qoq
醒	xa
惹	rt
停	tl
树	uy
爽	usd
台	tf
口	kc
半	bhd
鞋	xq
雪	xuy
任	rd
摔	uk
接	jp
操	cc
娶	qn
入	ry
提	tof
狠	hhq
背	bwl
挖	waf
烂	lh
级	jos
间	jm
乖	gk
达	dsz
云	yue
冲	isd
团	tt
瓶	plb
踢	tiz
主	vod
硬	yj
魔	mpgg
嘞	lwk
女	nnv
动	dae
剪	jxbd
线	xn
叔	uuu
念	nnr
表	bz
挑	tnf
致	vua
槽	cvm
满	mld
甩	uak
油	yxd
皆	jpb
捡	jxf
省	uju
八	bap
皮	pov
子	zp
酒	jed
救	jpq
穷	qd
亦	yuw
忍	rh
妞	nqn
反	fl
呜	wu
部	by
借	jor
插	iaf
街	jpi
烦	fk
关	grb
草	cb
诗	ui
直	vou
踩	cg
嘿	hwk
课	kw
臭	im
城	iht
票	pbx
剩	ufq
趣	qc
握	wif
李	lpm
嘛	mak
撞	vk
汤	thd
刀	dcv
挤	jpf
替	tu
夜	yw
至	vuat
扯	it
懒	ll
房	fjh
腰	yc
香	xlh
安	an
奔	bfd
穿	ir
凭	plr
咦	yok
杯	bwm
泪	lqd
慢	mhx
虐	nr
逛	gkz
碎	scu
既	ju
痘	dm
题	too
舔	txq
即	jog
凉	lad
准	vid
占	vhl
屁	puu
记	juy
胸	xs
摆	bgf
国	gp
蛇	ur
派	psd
称	igh
拖	tofy
盘	pk
控	kaf
血	xwp
咧	lwkd
忒	tv
味	wqk
交	jnw
四	su
投	txf
偷	tz
涨	vkd
躲	dqu
推	tvf
抹	mqf
副	fy
式	uuyg
搬	bjf
咪	mi
尽	jvi
堵	dot
藏	cj
山	ujl
虎	ho
乐	lwp
左	zq
吵	ib
岂	qpe
欠	qnd
传	itr
笨	bdv
寄	jub
麽	mpgm
修	xqr
烧	uch
眼	ylo
机	jim
相	xlm
套	txd
撑	igf
蝎	xpi
落	li
绿	lc
折	vr
甜	tzq
糖	tj
奥	aip
鬼	gn
份	fd
烤	kbh
命	mjr
补	bo
象	xkd
节	jpc
惨	cl
熟	uxw
瞧	qm
群	quy
海	hgd
墙	qat
作	zirv
鸭	yaj
样	yg
圆	ytk
嫌	xzn
逗	dmz
身	ufp
旧	jpl
断	dem
歪	wdb
戏	xuyg
段	dep
罗	lps
窝	wob
盖	gsy
羊	yjb
闲	xzm
美	mry
夹	jca
觉	jyx
炒	ibh
仍	rhr
莫	mic
排	pff
五	woa
傻	ud
篇	pm
性	xj
租	zuh
几	jpp
周	vz
桥	qmm
区	qv
队	dce
碰	pfu
蹭	cfz
哈	hak
拆	idf
卷	jyj
哭	ku
场	ik
吻	whk
男	nkt
应	ykg
哄	hfk
签	qmv
法	fdd
色	sw
需	xvy
流	lwd
杨	yjm
逼	bi
娃	wsn
劝	qe
圈	qrk
集	jorm
语	yny
涂	tid
平	pla
期	qi
暖	ny
座	zig
缺	qtf
矮	ap
空	ks
软	ryi
憋	bpd
肥	fe
退	tc
扑	puf
耍	uv
牌	pfp
烟	yjh
狼	ljq
减	jxd
抄	icf
理	lpw
劈	piu
印	yv
望	wgw
陈	ige
郑	vfbe
整	vj
郭	go
蹲	dyz
恋	lnw
兔	ty
娘	nan
知	viu
驴	lbm
辣	lll
偏	pmr
噶	gsk
据	jcf
数	uym
清	qk
游	yxdz
粮	lam
归	gv
灰	hv
姓	xjn
绝	jys
么	me
欲	ycb
豆	dma
剧	jcu
待	dsi
待	ddi
那	nav
犯	fhq
师	uil
位	wqr
捉	vof
扣	km
较	jbi
齐	qow
灯	dg
明	mlo
酸	sr
帝	duw
值	vor
论	lt
季	juh
土	tou
右	ymu
啃	kh
熬	apf
揍	zm
赶	glt
银	ynj
合	hr
细	xus
厚	hmi
西	xi
南	nku
朝	ivu
狂	kaq
随	sb
瞅	ico
界	jot
盯	dko
趁	idt
淡	dhd
轻	qki
岛	dbp
嗷	apk
拔	bs
猛	mjq
扒	baf
宝	bb
脱	tooe
方	fhd
刮	gx
费	fq
遍	bnz
抠	kz
霜	uly
零	lly
星	xko
夸	kxd
邮	yxy
睇	duo
汪	whd
取	qne
菇	gu
易	yuo
蒸	vg
愁	ix
症	vfbv
化	hzr
足	zik
佛	fp
揉	rx
六	lpwb
码	mdu
龙	ld
糗	qem
馋	iku
刘	lww
服	fi
蟹	xod
牙	ys
富	fyb
吾	wiw
冰	bk
七	qia
常	ijx
底	dpg
仅	jmr
习	xov
粘	vjm
奖	jsd
妆	vld
爷	yrb
吼	hck
弯	wjw
炖	dt
嫩	ndn
文	wgwx
基	jiq
经	jk
坨	tpt
射	uw
单	djbl
薄	bv
隔	gre
史	upl
伞	sl
搓	cof
跌	dpz
雾	wy
必	bu
呸	pw
捧	pj
似	sur
困	ktk
掰	bdu
令	ljr
怎	zhv
刺	cua
答	dsv
冒	mx
凶	xsx
船	itv
酱	jkd
趴	pa
闪	ulm
昂	aj
紧	jml
贼	ze
电	dnl
声	ugu
具	jcq
压	yai
雷	ley
湿	uid
钻	zrj
登	dgv
啪	pak
咋	zrkv
百	bga
终	vss
哆	dok
酷	kyy
波	bod
林	lnm
治	vud
醉	zcy
唯	wek
弹	tkg
砍	kl
原	yti
咳	kr
猿	ytq
秤	if
害	hs
甚	udq
锅	goj
官	grbk
遭	zcz
赌	doko
怒	nyn
飘	pnx
炸	vlh
胡	hiu
村	cy
仔	zpr
解	jwd
订	djy
卧	wii
播	bof
捂	wof
伐	fs
量	ladl
量	lkdl
割	geb
淘	tvd
埋	mft
塞	sdb
略	lr
淫	ynd
宽	krb
透	tmz
凑	cm
劲	jvv
重	vap
届	jou
倍	bqr
胃	wqt
嬛	xr
举	jnx
灭	moa
残	ck
封	fgt
属	uou
脑	nbo
粥	vzg
福	fip
扫	sbf
韩	hk
废	fqg
升	ugpc
煎	jmb
征	vgi
捞	lcf
罚	fss
慌	hlx
价	jzr
今	jbrv
叠	dqy
饼	bau
勒	lwg
母	mov
存	cuu
杜	dym
胜	ufo
毒	dif
虽	sv
妖	ycn
叼	dnk
负	fyd
根	gfm
春	iyf
虾	xxi
迷	moz
啰	lok
寸	ct
体	tpr
供	gsr
抛	pc
烫	tg
拽	vjf
防	fje
炮	pxh
冻	dadd
编	bms
侠	xc
勿	wyb
共	ga
纹	wgs
闻	wgm
北	br
挡	dkf
守	ucb
拌	bhf
甄	vfx
牵	qmd
发	flv
克	kwu
摄	uwf
布	byu
降	jke
怂	sf
笔	bpv
奶	ngn
曰	ytka
霾	mfy
颗	ke
九	jep
泥	no
於	ybf
教	jblw
瑟	sww
遮	vez
澡	zbd
痒	ykb
锁	sq
吸	xik
敷	fu
德	dr
踹	ijz
介	jorl
吊	dbk
舞	wop
含	hkr
浓	ndd
料	lbmu
蹦	bfz
嘎	gak
潮	ivd
长	vkp
现	xnw
壳	kru
调	tmy
调	dby
罪	zcs
证	vfy
亏	kv
剃	tub
摇	yvf
肾	udl
素	sy
填	tzt
精	jkm
沾	vjd
盒	hrr
闷	mdm
犬	qy
通	tsz
铁	twju
洞	dadk
架	jzl
腻	nu
公	gsb
露	lmy
著	vyc
晃	hko
潘	pjd
铺	puj
砖	vru
孔	kf
乳	ro
食	uor
垫	dnf
建	jnz
什	uoru
键	jnj
捅	tff
饱	bbu
欧	ou
伪	wr
兽	umb
盼	ph
滑	hcd
运	ytz
绕	rxs
缠	iks
戒	jogc
散	sh
散	slcw
拜	bsu
嘘	xvk
枰	plm
赵	vxt
屏	plu
脏	zho
页	ywa
范	fhc
逃	tvz
馆	gyu
结	jqs
领	lar
巨	jck
处	iow
言	ykw
梗	gjm
攒	zl
翘	qba
挠	nv
溜	lqdt
市	uuw
伴	bhr
分	fdb
剑	jnrd
初	iup
利	luh
啧	zrk
针	vfj
掐	qx
啵	bok
博	bpu
否	fc
巧	qzg
虚	xvh
造	zx
寻	xue
蠢	ii
托	tofq
朵	dqj
逆	nuz
骚	scm
层	chu
测	cw
何	hrrk
磨	mpgu
局	jbu
剁	dij
缘	ytsu
般	bjv
代	dsr
诺	ni
均	jyt
叶	ywk
肌	jio
东	dsa
宠	ifb
端	drl
税	uche
首	ucbz
容	rdb
斯	si
物	wyn
录	lye
丽	lua
盐	ykt
吴	wikt
败	bsk
稍	ucho
咸	xzx
摘	vd
矣	yps
众	var
惊	jkx
竟	jj
敲	qnw
嗲	dv
干	gja
漏	lmd
湖	hid
沉	igd
截	jqu
朱	vup
付	fyr
醋	cyy
撕	sif
获	hic
朕	vdo
冥	mlb
轮	lui
丝	siv
河	hrd
炫	xe
塔	tdt
袁	ytt
喜	xpu
魂	hu
挣	vff
赔	pek
耳	ey
碧	buw
撤	iw
贪	tjr
扛	kjf
镇	vdj
肺	fqo
祸	hip
果	gq
怀	hlxb
嚯	hik
刑	xlkd
拱	gff
顺	ut
器	quk
秋	qq
孙	syz
巴	bas
捐	jr
屋	wuu
沪	hy
猴	hxq
龟	gvd
夏	xza
耐	nse
转	vei
仨	sar
争	vgd
肯	khv
歇	xpo
板	blm
案	abb
极	jom
扭	nef
观	gry
卸	xop
兼	jmbn
设	uwy
趟	tgt
攻	gsg
抖	dcf
除	iie
静	jjf
旁	pjw
稳	whh
董	dfc
逢	fhz
驾	jzlm
浅	qxd
环	htw
申	ufl
拒	jcfj
遇	ycz
绑	bks
乘	ihq
缩	so
泰	tsf
紫	zpv
认	rdy
串	iel
痣	vub
沙	uad
友	ycu
尼	nou
战	vhlg
臀	tuu
员	ytkr
丁	dka
股	goo
步	byv
档	dgm
嘻	xikk
鼻	boz
叻	lwkl
识	uoy
颇	povr
限	xne
幅	fij
响	xsk
旅	lnf
跨	kzz
崔	cve
意	yul
侬	ndr
哩	lik
糕	gcm
威	wwx
麻	msg
赛	ss
瓜	gxp
拧	naf
室	uub
愣	lfx
显	xxo
尊	zy
寒	hkb
广	gsd
率	lcw
品	pmk
休	xqrm
凹	ao
维	wes
裤	kyp
蒙	mhc
搂	lzf
苏	suc
斜	xqru
免	mxd
居	jvu
餐	cjl
膏	gcwo
染	rl
轰	hsi
唐	tjg
幂	mu
婚	hyn
摊	tjf
瑕	xcw
皂	zxb
桶	tfm
立	luw
客	kwb
枕	vhm
状	vkdq
闯	ismm
坟	fgtw
扶	fif
故	gyuw
千	qmp
尾	wru
震	vdy
粽	za
叹	thk
古	gou
灵	lle
堆	dvt
恶	ewy
损	sifr
呼	huk
琴	qnwv
虫	idv
展	vlu
善	uhy
芙	fic
抗	kgf
狮	uiq
科	keh
松	ssm
徐	xbi
充	isw
乡	xlv
嗒	dak
弄	law
拎	lbf
须	xvp
衫	ujp
尖	jmx
森	sfm
扎	vaf
膜	mpo
晴	qlo
婊	bzn
衣	yiw
棋	qomb
迟	ioz
酥	suy
章	vhlu
产	ill
僧	sg
竖	uyl
横	hhm
兄	xske
聚	jce
娇	jnn
十	uoa
石	uoak
宋	sab
尚	ugx
依	yir
瞄	mm
旺	wgo
妙	mb
膘	bno
甘	gjn
啾	jqk
田	tzk
噜	luk
距	jcz
悬	xt
己	jpv
青	qkf
郎	ljd
糟	zcm
雅	yd
惯	gex
唷	yoko
噻	sdk
麦	msf
侃	klr
钓	dbj
罢	bls
京	jkw
丹	djp
添	tmd
曲	qnl
嚼	jmk
扇	uhh
芯	xbc
赖	lsu
许	xny
音	ybl
葱	csc
丸	wkp
搁	gef
娜	nln
揪	jqf
榜	bkm
遛	lpz
宰	zg
俩	lsr
赏	ukx
谷	gob
曝	bxo
赐	cuk
黏	nzh
腹	fyo
桌	vol
蜜	mub
消	xnd
勺	uvb
辞	coq
江	jld
兵	bkq
裙	qup
蝶	dqi
饮	ymur
蔡	cscx
侧	cwr
告	gxn
寺	sut
仙	xmr
赴	fyt
甲	jvl
角	jzd
钗	idj
薛	xtc
止	vpl
港	gkd
磕	keu
曹	cva
崽	zge
巾	jbl
坎	klt
评	ply
窗	ilb
勾	gzb
罐	geff
艾	auc
咖	kak
斗	dmd
凡	fkj
继	jus
刻	kww
保	bbr
厄	ewi
蕾	lrc
抬	tffk
驻	vym
弟	dub
喘	iyk
壮	vkdu
喇	ldk
皱	vm
扎	zaf
唰	uxk
附	fye
格	grm
失	uip
暗	abo
野	ytl
橙	ihm
裸	lqp
桑	shy
蘸	vhc
嘉	jxu
沟	gzd
民	mnv
厂	ika
袋	dsry
疤	bab
拨	bofd
靴	xtg
涅	nod
园	ytke
弃	quw
汁	vidu
梨	loh
列	lod
灌	ged
净	jjd
温	wf
批	pif
互	hya
罩	vxs
尔	eyd
帐	vgj
柜	gcmj
圣	ufy
馅	xnu
挫	cif
粪	fdm
曼	mho
肝	gjo
梁	ladm
然	rk
仇	ixr
披	pify
邪	xqy
支	viuy
扁	bxh
翔	xay
肩	jmh
液	ywd
掏	tcf
末	mia
杠	ggm
院	yee
姜	jly
谨	jmy
瓦	wda
扮	bhfd
焦	jnrh
湾	wjd
堂	tjx
湘	xld
智	vuu
钟	vsj
辆	lki
莎	uac
联	lze
瞪	dfo
祭	jup
项	xkg
壶	hiuy
奇	qod
枚	mem
兮	xib
颜	yki
薇	wwc
术	uymd
镜	jjj
拐	gaf
兜	dzb
俄	err
围	wekw
优	yzr
贺	hwl
景	ja
余	ybr
剥	bce
崩	bge
工	gsa
盗	dxd
吞	tyt
窄	vgb
军	jyb
陆	lyej
携	xqf
痴	iib
影	yao
煲	bcr
当	dgx
舌	urq
衰	ukw
骨	gol
铅	qmj
划	hcg
裹	gqw
礼	lpp
饶	rv
顿	dtt
鼠	uoj
砂	uau
盆	pgb
恕	uyn
搅	jzf
专	vra
拦	lkf
浪	lg
卯	mbp
菊	jbc
沈	uhd
判	phb
引	ymg
复	fyp
制	vupd
漂	pnd
彩	cgp
族	zif
稿	gbh
漫	mhd
摁	eb
绛	jks
伊	yiry
核	hrm
郝	hbt
挨	aif
挨	aof
脉	mso
扇	ujh
妮	nin
标	bnm
创	ikr
鹅	erw
哔	buk
颤	ihw
乔	qmy
睁	vgo
梳	uum
思	sit
舒	uur
凸	tul
框	kk
移	yoh
泼	pod
邓	dfy
俗	sir
陷	xnej
恰	qzx
碟	dqum
患	hei
鲜	xma
阴	ybe
帽	mxj
磅	bgu
柳	lem
斩	vli
忌	juj
鲍	bxa
侯	hxr
熏	xyp
彭	phu
册	cwp
邀	yczw
晾	lko
掌	vkx
弦	xzg
玉	ycw
楞	lhm
业	ywl
汇	hcdk
社	uwp
骆	lim
塌	tat
暴	bxou
吨	dyk
坡	pot
雕	dnkf
懵	mjx
蒜	sec
财	cfk
赠	zfk
持	iof
涮	ued
怨	yex
墨	mih
注	vyd
庙	mbg
斑	bjww
靓	lkfe
吉	jouk
呲	cik
券	qej
玻	bow
迎	ylz
霍	hiy
筋	jbv
嗑	kwk
视	uup
洒	sdd
乜	mpv
译	yuy
夫	fua
柴	ifv
铲	ilj
蒋	jsc
悟	wyx
兰	lkb
茬	isc
漆	qid
恤	xcx
华	hcr
垮	kvt
孤	guz
箭	jnv
屯	tua
削	xnx
叉	iay
普	pob
英	ykc
志	vuux
州	vzd
禁	jvm
商	uhw
拣	jxfd
厅	tki
载	zsui
詹	vjdk
私	sih
腚	djo
浇	jnd
户	hyd
独	diq
脆	cco
瞒	mko
蒂	duc
壹	yiu
徒	tii
欸	eo
胎	tdo
简	jxv
世	uua
佬	lbr
锤	ibj
亚	yla
蛆	qvi
嘚	dek
捶	ibf
唇	iui
宁	nlb
增	zgt
禅	ikp
仿	fkr
铊	taj
县	xnq
忧	yzx
权	qtm
葬	zgc
龚	gsl
羞	xqyi
劫	jqt
童	tdl
希	xix
蹬	dgz
癖	pp
尤	yxyd
职	voe
粒	lum
瘫	tjb
渡	dyd
绣	xps
尝	ijxs
欺	qiq
毕	bub
敌	doq
梅	memm
差	iayg
实	uob
腐	fo
形	xlkp
杂	zsj
藕	ooc
仗	vgr
逮	dszn
糊	him
讯	xty
墓	myc
萱	xrc
浮	fid
哉	zdu
源	ytd
度	dpgy
织	vis
籽	zpm
岗	gke
腔	qlog
蒙	mgc
喃	nkk
备	bqw
扬	yjf
雄	xdu
牢	lvb
眠	mzo
萨	slc
撮	cofy
耶	yeee
迈	msz
焖	mdh
漂	pbd
续	xcs
严	yky
奏	zmf
沃	wid
系	jupx
呈	ihk
箱	xlvo
押	yaf
种	vfh
堡	bbrt
冯	fhdm
购	gmk
倩	qnr
功	gsgl
憨	hjv
愈	ycr
脖	bpo
嫖	pmn
川	irp
鹿	lyg
嗦	sok
窜	ce
撅	jt
樱	ykm
邦	bhfe
皇	hab
镐	gbj
忆	yux
挽	wlf
讨	tby
栽	zdum
庆	qj
胶	jno
卡	qvub
敬	jjc
润	rtd
永	yf
咒	vmk
棍	gt
袭	xol
井	jaa
俊	jtr
嘭	pgk
噎	yek
陶	tve
厝	cii
痰	tkb
嗅	xpk
乌	wup
甭	bhb
险	xxe
俾	bpr
邱	qqq
钢	ghj
坤	kyt
碳	thu
采	cgpm
贝	bqkr
鼓	gouy
孟	mfz
伸	ufr
蚝	hvi
缓	hys
咽	yh
纵	zas
卒	ziw
吱	vik
裂	lody
钙	gsj
翅	iuu
纪	jusj
耗	hxl
棵	kem
雀	qru
彼	bpi
挪	npf
始	upn
皿	mml
钉	dkj
冬	dsw
洋	yjd
苗	mmc
盛	ufi
袜	wlp
茧	jxc
纳	nls
啤	pok
妥	tq
暂	zhi
盲	mjw
误	wyy
菌	jyc
浴	ycd
孽	noc
枉	wkm
勇	yfs
峰	fge
父	fybx
汉	hhdy
嚷	rkk
晏	yho
研	yku
库	kyg
榛	vfm
噔	dgk
叽	jik
陌	mie
吒	vak
闭	bum
护	hyf
贾	jvx
捎	ucf
俞	ybrd
垵	ant
抵	dpf
莲	lzc
肚	dyo
冤	yrbd
臣	igk
椒	jnm
獒	apfq
葛	grc
仓	chr
朗	lkd
义	yud
尸	uiv
唠	lxk
唠	lvk
辛	xbl
轴	vxi
胆	dlo
煞	uld
枣	zba
途	tizh
稀	xih
晨	igo
仁	rgr
熄	xihx
庄	vlg
撩	lmf
秃	tuh
乙	ypvv
嗔	ifk
临	lnl
灸	jej
婶	uhn
鲁	loa
宴	yhb
币	bup
速	syzu
佳	jxr
索	squ
咕	guk
姬	jin
返	flz
禾	hrp
链	lnj
誓	uuf
执	vofw
眯	mio
瓷	cod
绘	hcs
密	mube
恃	uux
吕	lnk
仲	varv
探	thf
番	fjp
哀	aiw
铝	lnjk
乎	hup
蛙	wai
氪	kwq
置	vus
埃	ait
芊	qmc
掀	xmf
裆	dhp
镁	mrj
兑	dcb
卢	lil
阔	ki
谜	moy
暮	myco
洲	vzdv
差	idyg
昏	hyu
谓	wqy
承	ihv
忠	vsv
潜	qzd
瞟	pz
驼	tpm
欢	hry
悔	hnx
巫	wug
诚	ihy
崴	wge
毙	bubb
呛	qlk
呛	qkk
涩	swd
曾	zgb
轶	yui
递	duz
烙	lxh
棉	mzm
句	gzbk
霸	bly
缝	fhs
缝	ffs
鹰	ykgn
嘀	dokk
切	qpq
祛	qvp
舟	vzp
鞭	bmg
瘾	ymb
黎	lohu
亭	tlw
荼	tic
阉	yjmd
呕	ook
雇	gyh
顾	gyi
舍	utr
镶	xlj
巷	xkc
质	vupr
背	bql
剂	juw
渴	ktd
昨	zpo
间	jnmo
帖	toj
叮	dkk
姚	yvn
御	yci
蛤	hsik
谎	hsy
乍	vlp
阳	yje
荤	hyc
亲	qjl
忽	huw
账	vgk
剥	boe
舍	uwr
枝	vim
捷	jqfr
桃	tvm
揭	jpfv
勤	qnn
荡	dgc
嗝	grk
畔	pht
薪	xbcj
喳	vakd
嘟	duk
奉	fff
孝	xblz
售	umr
挑	tzf
桩	vlm
犊	din
徕	lfi
拳	qtj
溅	jndj
泯	mmd
泡	pcd
铜	tdj
助	vyq
盾	dtp
措	cifo
焉	yjv
悦	yrx
夺	dpd
伦	lur
瑞	rc
诸	vuy
萧	xnc
宜	yob
跶	daz
健	jnrz
拾	uof
珠	vuw
凤	ffj
圭	gvt
揽	llf
池	iod
弓	gsv
诛	vuyv
钩	gzj
境	jjt
谦	qmyn
莪	erc
阅	yrm
匿	nuk
渤	bpdl
隆	lde
审	uhb
妾	qol
渝	ybdd
硅	gvu
咻	xqk
叭	bak
触	iyd
缸	ghf
喏	nik
坊	fht
谭	tkyu
嚓	cak
颠	dmu
窦	dmb
莱	lfc
旗	qof
孩	hfz
嗡	wgk
裁	cfu
哑	ydk
计	juyu
亡	wjwv
淌	tkd
吆	yck
硕	uiu
危	wwd
颈	jav
倔	jyr
荣	rdc
嗳	apky
泉	qtb
淹	yjdd
钵	boj
卵	lyp
谣	yvy
恒	hhx
债	vsr
肠	ijo
嚎	hvk
拟	npfr
拴	urf
垂	ibp
妃	fwn
伏	fir
撬	qbf
恐	kfg
媛	ytn
菲	fwc
矗	iyu
靡	mpgf
搏	bpf
晓	xzo
抡	lyf
睿	rcl
腌	yjo
颁	bjbr
程	ihh
撇	pwf
筒	tfv
扳	bjfy
淋	lnd
鸣	mlk
搽	isf
娟	jrn
彪	bnh
揣	iafe
拷	kbf
目	myk
恁	ndrx
眨	vdof
兹	zib
囤	dtk
囤	tuk
脾	poo
绳	uhs
蒽	enc
姆	mon
洁	jqd
涌	yfd
妻	qian
踏	tlz
迁	qmz
翼	yuxb
秦	qnf
姨	yon
藏	zgci
称	idhx
柯	kemk
序	xcg
束	uya
异	yus
康	khg
嗓	sk
篮	lkv
觅	mup
镑	bgj
汀	tkdd
营	ylc
掺	ijf
螨	mli
俏	qbr
珊	ujw
傍	bgr
贫	pnb
芭	bac
司	sivk
崖	yse
嘣	bgk
传	ver
叁	sjs
豹	bxv
哗	hcku
哗	hxku
献	xnuq
辨	bnl
兆	vxe
瘪	bwb
枯	kum
芮	rcc
舰	jnve
蜡	lli
涛	tcd
犹	yxq
誉	ycx
僵	jlr
阵	vde
辫	bnlu
府	fog
吡	bpk
坛	tkt
煨	wwh
幸	xjt
栋	dam
刨	pv
刨	bxb
瑛	ykwy
赫	hwt
努	non
袄	aq
氏	uupv
椅	ypm
痨	lvbl
玛	mdw
吽	hsk
晋	jvy
氧	ykq
矬	cpu
瘟	wfb
武	woav
作	zor
俱	jcr
卫	wqe
捣	dbf
蜀	uos
柚	ymm
坠	vce
辱	roi
轩	xri
吟	ynk
渐	jndj
廖	lbg
肖	xnxo
竹	vip
柔	rxsm
奴	niny
棕	zsm
祖	zop
咚	dsk
洪	hdd
泛	fhdf
斋	vdw
浑	hud
眉	mev
奔	bdd
卿	qkp
穴	xyb
佑	ymr
燥	zxh
尘	igx
校	xbm
迪	doz
扎	vsf
雌	cov
馊	szu
姿	zid
胯	kzo
栏	lkm
确	qruy
席	xog
擤	xaf
沿	ykd
嗖	szk
遂	scz
燕	yhn
逾	ybz
兴	xjx
训	xtyi
咿	yik
焗	jbh
卷	jejv
默	mihq
奸	jmn
炕	kgh
摞	lif
应	yjg
避	buz
贰	eey
缁	zis
冠	grbc
冠	gebc
汝	rod
厌	yhi
颓	tbh
殿	dnu
掂	dmf
呱	gxk
馍	mpu
绮	qps
期	jiqo
哨	uxko
宣	xrb
隐	yme
荒	hlc
累	let
驱	qvm
殇	uhdp
掖	ywf
豪	hvw
淇	qodb
魏	wqh
糙	ccm
妍	ykn
砰	pgu
砌	quu
瑜	ybw
飙	bnq
畅	igu
瘸	qyb
翁	wgb
预	ycs
刹	uax
空	kab
腮	sdo
蛹	yfi
宇	ynb
唬	hok
袅	nzp
施	uif
糯	nim
辩	bnlu
参	cjs
嫂	sbn
阮	rye
艘	szv
癣	xyby
拥	ysf
扩	kif
倾	qkr
叨	tck
嬴	ylw
挥	hvf
豁	hob
啷	lhk
楚	iom
莉	luc
遁	dtz
厮	sii
潭	tkdu
滩	tjd
辽	lmz
貂	dnv
唤	hekd
例	lurd
歼	jmd
泄	xodu
玄	xtw
宥	ymbo
耙	bll
噌	cgk
脂	vio
醇	iuy
刁	dnva
积	jih
捋	lof
幺	ycv
卦	gzt
纱	uas
隋	sbe
蚊	wgi
鳖	bpda
痕	hgb
齁	hzz
数	uom
颂	sabr
玮	wrw
霉	mey
杆	gjmg
杆	glm
珂	kew
炝	qkh
栓	urm
苯	bhc
裱	bzp
厨	iii
筐	klv
寂	juby
寨	vsb
铰	jzj
岭	lae
享	xsw
濯	vpd
璐	lyw
瓣	bhlu
籍	jov
囊	nj
映	yjoy
伯	bprb
符	fiv
煤	meh
蔫	nm
幼	ymy
势	uufl
呷	xxk
怡	yox
辈	bqf
斌	bbw
蛊	goi
激	jid
佟	tdr
奕	yuwd
韵	ytld
胀	vgoi
衬	idp
酿	nky
歉	qnb
访	fky
覆	fyx
突	tubq
埸	yut
弗	fivl
士	uuua
仪	yor
浩	hxd
谋	mxy
谤	bgy
簋	gnv
尿	svu
惜	xixo
掩	ylf
孕	ytnz
遵	zyz
辟	buu
妇	fyn
杏	xjm
啖	dhk
棱	lhmw
耸	sfr
碑	bwu
杵	iomw
农	nddn
坪	plt
贬	bxk
皎	jzb
珞	liw
嗜	uuk
蝉	iki
姑	gun
钦	qbj
耽	dje
堪	kjtv
帘	lzb
碘	dxu
捆	kifm
恼	nbx
筛	udv
倚	ypr
喀	kakk
棚	phm
蚺	rki
缇	tos
町	dkt
笛	dov
绞	jzs
缴	jzsw
扰	rb
态	tst
医	yiku
苑	yec
傲	air
尺	ip
茨	coc
磡	khu
劳	lvc
笼	ldv
撂	lbfk
穆	myh
巢	ivv
寝	qmb
涠	wed
吓	hwkx
蕉	jnc
闰	rtm
粤	yrp
跋	bsz
刊	kjg
葵	kbc
沐	myd
帕	plj
佐	zqr
讹	ery
坚	jmlt
岸	abe
绷	bgs
荷	hrc
症	vgbv
堕	die
凯	kge
笋	sivy
黛	dsrh
亨	hgw
攀	pjm
棣	dum
矫	jzu
绒	rds
虏	lohl
鹏	pho
熙	xikh
咏	yfk
幽	yze
愚	yby
碍	auu
虹	hdi
妓	jun
洛	lid
彦	yhip
焕	heh
岩	yke
警	jac
琳	lnwm
啄	vpk
癌	aob
悌	tux
霆	tly
祇	qop
拘	jvf
碾	nxu
脓	ndo
膈	gro
闫	ykms
叉	idy
碇	dju
匪	fr
津	jbd
落	llc
葡	pic
腾	tho
杖	vgm
绊	bhs
拈	nmf
溏	tjdk
蹄	toz
膝	xio
灾	zdb
浣	hed
惧	jcx
硌	gwu
嘬	zok
谗	iky
弧	hig
饺	jzux
晶	jko
璇	xtwr
掷	vuf
卜	bol
铬	gwj
羹	ggy
幻	hey
郡	jty
孬	nc
奈	nsd
窃	qob
宿	syb
哏	ggk
嘈	cvk
饬	iuul
稠	ixh
癫	dmbr
擀	glf
杰	jqm
拄	vofv
舱	chv
馕	nju
辰	igi
茎	jkc
肘	vco
攥	zef
吠	fqk
傅	fyrc
箍	guv
尻	kcu
导	dbs
谴	qxy
惟	wex
钻	zej
梵	fhmf
验	yhm
芳	fhcf
粿	gqm
犟	jkg
玫	mew
婆	ppd
钛	tsj
壁	buut
弹	dhg
捯	dvf
鳄	ewa
弩	nong
区	oukx
溶	rdd
息	xiz
慎	udx
叙	xcr
锥	vvj
卟	bokb
贷	dsrr
滇	dmdb
浸	jvd
昆	kyo
撵	nxf
琦	qowk
逝	uuz
陀	tpe
疣	yxb
渊	yrd
察	isb
屈	qvu
泽	zrd
炸	vsh
嗬	hekk
溺	nud
艳	yhf
仔	zgr
翠	ccx
啐	cck
谂	uhyx
嘶	sik
种	idh
锋	fgjf
良	ladg
栖	qim
柄	bamb
肛	gho
闵	mmm
皖	wlb
洇	ybdd
抻	iff
咣	glk
徽	hviw
媚	mqn
慕	mycx
坞	wyt
腥	xkou
估	gur
掘	jyf
逑	qwz
痔	vubc
诉	syy
逐	viz
臂	buuo
剽	pnxd
哲	vrf
烩	hch
鲨	uada
萎	wrc
曦	xiod
炎	ykh
允	yis
袖	xpp
娥	ern
俯	for
瘤	lwb
律	lci
聂	noe
芽	ysc
羽	ynx
钞	icj
赤	iut
勒	lwgl
似	uurr
毯	tlm
禹	ynp
咂	zak
宏	hdb
瀑	py
廋	szg
喧	xrk
仰	ykr
丰	fga
暨	jug
剖	pzl
黍	uoh
鸿	hddn
盈	yln
螈	ytix
胗	vfop
苍	chc
蔻	kmc
禄	lypu
仕	uuru
夕	xip
鑫	xbj
尹	ymv
熨	ytu
吭	kgk
苔	tfc
湉	tzd
薜	buc
铛	igj
锯	jcj
叩	kmk
螺	lpi
蓉	rdck
藤	thc
褪	tcp
榨	vlmv
滋	zidy
宗	zsb
锦	jmj
竞	jjl
戾	luhq
浙	vw
啫	vtk
澳	aid
勃	bpul
哺	bokf
韦	wea
炜	wrh
藓	xxc
邹	zz
鲸	jka
媒	men
囡	njk
曝	pyo
匀	yub
溪	xid
杭	hjm
鳓	lwa
朴	pom
屙	eeu
遗	yoz
楹	ylm
衩	idpi
伙	hqr
魅	mqg
倪	nor
嚄	hoky
纠	jqsl
艋	mjv
幕	mycj
捻	nxfx
殴	ouk
磐	pkv
屑	xou
益	yubm
瘀	yvb
规	gvf
聋	ldl
燃	rkh
狐	hiq
寰	htb
论	luy
瓢	pmx
脐	qoo
茜	xic
镕	rdj
盏	vlj
於	yvfd
庵	ang
候	hmr
鸠	jqj
狷	jeq
炆	wgh
宾	bbb
赋	fyk
抹	maf
伽	jxrk
姝	uun
宵	xnb
邢	xlke
灶	zxht
煸	bmh
岔	ilbe
呔	ddkt
肱	gso
蚶	hji
皓	hxb
历	luil
蟒	mki
瘆	udb
逸	yuz
鼬	ymj
锺	vsjv
涧	jndo
礁	jnu
俚	lpr
孰	uiw
嘎	gskg
壳	qbu
落	lxc
薰	xyc
延	ykz
翟	dox
阁	grmk
喉	hxku
倦	jer
戚	qiw
氢	qkq
烘	hsh
模	mpm
诵	say
喆	vruk
渍	zud
锉	cij
浆	jldu
决	jyd
闷	mfmx
嵌	qner
塑	sybt
娅	ylny
噫	yikx
跃	yrz
敝	bud
霏	fwy
匹	ppk
韬	tcw
艺	yuc
柱	vymv
檫	ismx
貌	mxv
政	vfv
匙	ioo
担	djf
铺	pyj
淑	uud
硪	wiu
暇	xco
釉	ymp
酌	vpy
炅	jf
蓬	phc
痧	uab
巳	suv
帧	vfjr
逄	pjz
丧	sgu
柏	bgm
汞	gfg
舅	jpj
滥	lhd
蘼	moc
寿	umf
昕	xbo
函	hkl
航	hjvj
啰	lokx
儒	rir
庭	tlg
鄣	vhle
鄂	ewke
秆	glh
轿	jbil
廊	ljg
鲤	lpa
怜	lzx
浦	podf
汰	tsd
坦	tlt
攒	ctf
齿	ipv
幢	vkj
笃	dovm
玖	jew
肋	lqo
炉	lih
翘	qma
嗄	ulk
伢	ysr
笫	zpvp
谍	dqym
樊	fkm
窥	kvb
溜	lpd
屡	lnu
啼	tok
锌	xbju
泵	bfu
陡	dcer
墩	dyt
固	gyk
径	jji
酶	meym
娴	xznm
箸	vyv
缀	vcs
耻	ipe
斧	fob
吮	uik
绾	wls
雁	yhif
喻	yckd
淤	yvd
掴	gkf
赣	ghl
唧	jike
腊	llo
蒲	picf
嘁	qik
屠	tiu
驮	tpmd
瓮	wfbw
浊	vpdi
慧	hcf
辉	hvx
偈	jur
荐	jncz
鸥	oukn
萋	qic
违	wez
蟑	vhi
埵	dqt
竿	gjv
纲	ghs
击	jia
陋	lme
寐	mqb
挈	qofu
帖	tpj
午	wopg
蚤	zbi
钝	dtj
耄	mxl
疏	uuvv
珍	vfw
怔	vfxv
灿	chh
婵	ikn
垢	gmt
耒	lrf
仑	lurb
胚	pwo
琪	qowb
昙	tko
贤	xzlr
资	zidr
咀	jnkq
聘	pve
肽	tso
坍	tjt
琛	ifw
促	cyr
饵	eyu
敛	lxr
叛	phby
圃	pokf
暑	uooo
伍	wor
盅	vsvm
嗤	iik
迩	eyz
恢	hvxh
缰	jls
沫	mid
秾	ndh
频	pnv
唆	sokw
砣	tpu
枭	xnp
窑	yvbf
舀	ybp
惠	hca
寮	lmb
莓	mec
朋	phoo
锡	xij
览	llle
狸	loq
钳	qzjg
熵	uhhk
咝	siks
塘	tjtk
遥	yvz
议	yuyy
铢	vuj
睬	cgo
孑	jqv
涉	uwd
统	tfs
诈	vly
阻	zoe
堇	jmna
蹿	cr
悍	hhxg
牧	myn
髂	qzgk
乾	qzu
卅	sla
莺	ykcn
蛀	vyiv
锕	aaj
剐	gvk
桂	gcmt
痂	jxbk
盟	mhom
祢	mop
妄	wgwn
焐	wyh
涯	ysd
央	yhl
糍	com
壕	hvt
幌	hsj
猎	loqo
烹	pgw
琼	qdw
丘	qqp
煽	ujhx
释	uupl
醍	toy
樽	zym
菖	ihc
崇	ide
戆	vkl
轨	gni
技	juf
脊	jpd
鉴	jnl
铃	llj
凝	nld
委	wrhn
泻	xody
疑	yobr
悠	yzrx
驳	bpm
捕	boff
凳	dfv
蠃	lqw
敏	mmp
蕊	rn
挞	tlf
阎	ykmj
垚	yvt
荫	yvc
铞	dbjj
瑾	jmw
泾	jkdg
哐	klk
炼	lnh
榴	lwm
融	rda
婷	tln
鱿	yxa
弊	budc
昌	iho
舵	div
癸	gnvt
桔	jqmk
锰	mjj
缅	mxs
鼯	wij
灞	bld
菲	frc
槛	klm
俪	lurl
讷	nwy
佩	pqr
姘	pbn
骟	uhm
泫	xed
裔	yuwk
冢	vfbn
卓	vplu
查	vam
谔	ewyk
抿	mmf
玥	yrw
黯	abh
唵	azk
簿	byvc
狄	doqh
枫	fgm
棘	joa
烈	lodh
橹	lom
碌	lyu
乜	nov
嗫	nok
务	wyw
旋	xtf
孵	ful
晗	hkok
匠	jkk
濂	lzd
泷	ldd
箩	lpv
萝	lpc
昇	ugo
搋	ikf
鼎	dao
检	jxm
哩	likl
泠	lld
龄	llv
寞	mib
甯	njb
启	qph
锐	rcj
台	tds
销	xnj
骁	xnm
驿	yum
胤	yvp
泳	yfdy
躁	zxz
窘	jfb
描	mmft
濮	pid
糁	slm
率	ujwu
酮	tdy
吁	ycky
尧	yva
绗	hjs
筷	kjv
搂	lcfn
漂	pzd
赎	uikd
朔	uib
娼	ihn
狙	jvq
溢	yudm
择	zrf
闸	vsm
唛	msk
浜	bhdb
澹	dhdk
谛	duy
诡	gny
橘	jbm
挎	kzf
笠	luvl
凌	lldw
陕	ule
拂	fiff
铭	mlj
硼	phuo
祥	xap
馨	xbu
埂	gjt
茅	mvc
亩	mow
沏	qidd
毅	yuly
爰	ytp
褶	vtp
综	zss
丙	baa
枷	jxmk
冏	jfk
剌	llu
霖	lny
瞥	ppdo
企	qpr
壬	rgq
饰	uuuj
灏	hxdr
澜	lkdj
咛	nlkd
逊	xtz
彧	yca
蛛	vui
岗	ghe
厕	cwi
阶	jpe
矛	mvs
楠	nkm
昵	nuo
疲	poby
擒	qnfd
龌	wiv
巡	xuz
迅	xtzu
滢	yldy
臻	vfah
澄	ihd
碉	dnuk
蛾	eri
旱	hho
婕	jqn
垒	lrs
淼	mzu
纽	nes
侵	qbry
膳	uho
嫣	yjn
援	ytf
璧	buuy
倡	igr
矿	kku
袍	pvp
邵	uxd
渗	udd
鲞	xsj
效	xbw
畜	xcwt
炙	vuph
怵	iyx
蹉	coz
典	dxlb
巅	dme
跺	diz
碱	jxuk
棠	tjxm
佗	tprb
鳌	apfa
褒	bcw
摧	cvf
鹤	hwd
嚼	jyk
宓	mubb
哞	mzk
锈	xpj
渔	ybda
捌	bafd
策	cwv
繁	fkp
疾	job
矜	jbs
寇	kmb
缕	lns
糜	mog
悯	mmx
闽	mmmi
娜	npn
炳	bah
磁	cou
苷	gjc
戈	gead
钾	jvj
骄	jnml
黔	qzh
怯	qox
惕	tuxw
豚	tuo
腺	xno
趾	vpz
钚	byj
蚕	ckt
搀	ijfd
喋	dqk
饥	jiu
娄	lxmn
钠	nlj
廷	tlzr
揸	vafd
蛰	vrfi
梓	zpmu
睹	doo
贩	fhk
芬	ffc
蜂	fgi
亥	hsw
嗟	jpk
鳞	lna
腩	nlo
滕	thou
剔	tio
雯	wgy
蓄	xcc
夷	yoa
庸	ysg
酉	ycxa
芋	ycc
株	vum
呤	ljks
澈	iwd
汾	fgd
绫	lls
拢	lff
葩	pac
坯	pit
仆	pir
梯	tim
伟	wrr
堤	dit
寡	gvb
浒	hod
莰	klc
邻	lnr
哂	uhk
霞	xcy
霰	xnyw
偕	xqrb
欣	xbjr
疮	ilbv
旦	dho
斗	dcd
鸽	ger
苟	gcc
惑	higx
跤	jnzx
犁	lohn
掳	lofl
蜷	qti
旭	xcj
炊	ivh
恭	gsc
猾	hcq
馁	nru
裘	qwq
韧	rdw
寅	ynbb
筑	vyvf
斥	iupd
肤	fuo
绢	jes
镌	jrj
恪	kwx
诓	kly
缈	mzs
湜	uod
慰	wqu
愉	ybx
炷	vyh
姊	zpn
猹	isq
趸	diw
焊	hhh
衿	jbpv
洺	mldk
哝	ndk
裴	pef
芃	phcf
璞	piw
蔷	qac
沁	qvd
蚀	uoui
莳	uuc
箫	xnv
狱	ycq
责	zrfr
瞻	vjo
芝	vic
谶	idyj
妲	dsn
盖	gty
阙	qrm
瓤	rj
搔	scf
署	uoso
梭	som
瞳	tdol
庹	tqg
瑶	yvw
裕	ycp
凿	zv
暧	auo
瑷	auw
锝	drj
璟	jaw
睛	jkoo
廉	lzg
昧	mqo
钼	myj
畏	wqtn
颖	yabr
芸	yucs
仄	zw
召	vxd
粢	zidm
鬓	bva
沸	fqd
葭	jxcy
鹃	jrk
岚	lke
萁	qoc
檀	tkm
蚁	ypi
漪	yid
簪	zj
伲	norb
彬	bbm
泊	bpdb
稻	dxh
掼	gefr
姣	jnnx
槿	jmm
揩	kdf
糠	khm
涝	lxd
瞭	lbo
痞	ppb
冉	rll
莎	soc
跎	tpz
兀	wya
薏	yucx
焯	ich
钣	blj
耕	ggl
苛	kec
磷	lnul
玲	llw
跷	qnz
穗	sch
腆	txo
硝	xnuo
诱	ymyn
筠	yuv
鞍	angn
昶	ikyo
缚	fys
渺	mzd
刃	rddd
擅	uhf
腕	who
贯	gev
冀	jul
监	jmlm
陆	lpe
惬	qoxj
汐	xidx
爻	yvx
蜇	vef
卑	bwp
锄	iij
抚	fof
钴	gojk
辑	joi
芥	joc
铐	kxj
芈	mpl
耨	nml
悭	qmx
狨	rdq
慑	uwx
淞	ssd
羡	xnyr
昭	vcok
祗	vipd
渚	vodo
敖	apfw
拗	aifl
拗	npfl
枞	csm
呋	fuk
革	grn
夯	hhdl
佶	jork
珑	ldw
契	quf
膻	dhod
杉	ujm
涡	wod
倭	worn
熹	xiu
鳐	yvaf
刈	yuxd
岳	yrq
肇	vxh
酯	vpyo
坝	blt
乏	fsp
艮	gde
贡	gag
秽	hchx
况	kkd
厉	luiw
牟	mxsn
培	pet
柒	qidm
禽	qnrd
奢	uedo
苕	uvc
衔	xzi
椰	yem
域	yct
樾	yrmv
匾	bxkc
镖	bnj
储	ior
帆	fjj
核	himr
甪	lypy
滤	lcd
秘	muh
姥	lbn
萍	plc
迫	piz
泣	qud
戊	wyad
郁	ycue
盹	dio
斐	frf
蒿	hcc
髻	jua
窟	kub
匡	klkw
胧	ldo
茗	mlc
齉	ngz
霓	noy
茑	nzc
劁	qnrd
渠	qbd
述	uyz
隼	siru
痿	wrb
诌	vzy
氨	anq
禀	baw
丛	cdr
沣	fgdf
横	hfm
剋	kwud
恳	khgx
磊	lru
锣	lpj
蜱	poi
祺	qopb
适	uuzk
艇	tav
玹	xtwy
耀	yxx
淳	iud
踮	dxzk
否	ppbk
概	gsm
耿	gje
瑰	gvw
闺	gvm
蕙	hccx
伶	llr
钮	nej
蹼	poz
遣	qxz
虱	uivi
瞬	uto
庥	xqg
昱	yco
噪	zxk
拙	vofi
欸	eps
欸	aps
酣	hjy
薅	hccc
踝	hlz
矶	jiuj
藉	joco
靓	jjfe
琅	ljw
蔓	mhcy
耪	pkl
锵	qlj
恬	tzx
拓	tif
蔚	wqc
硒	xiux
漾	ygd
予	yns
嘱	vok
嗞	ziky
靶	bdg
磋	coug
敦	dyw
涐	erd
焚	fgmh
尕	gdn
圜	htk
戟	jpu
济	jud
禁	jbmx
鞠	jvg
篓	lcv
虑	lch
琶	psw
庞	pjg
乞	qpp
茄	qqc
囚	qwk
茸	rdce
讪	uhye
矢	upp
舜	utp
炭	the
悉	xipx
削	xtx
役	yuiy
婴	ykkn
昀	yuod
稚	vuh
逞	ijzw
愤	fdx
肓	hlw
栾	ltw
臊	sco
眺	tbo
翕	xir
峡	xce
戌	xvw
轧	yli
抑	yuf
蝇	ylid
毓	ycpv
载	zgu
滞	vudj
坂	blty
禅	uhp
橱	iim
龊	iiv
祠	cop
辅	foi
洹	htd
恺	kgx
硫	lwu
芒	mjc
宁	njbd
铊	tpjb
杳	ybm
辙	vri
贞	vfl
鄙	bpke
豳	bbe
材	cfm
翀	isx
氮	dhq
镀	dyj
獾	hrq
亟	jol
闾	lbmk
侣	lnrk
昴	mbo
楸	qqm
示	uue
凇	ssds
详	xayy
憎	zgx
枳	vpm
尢	whu
卞	bnd
怖	byx
岑	cge
嘲	ivk
簇	cyv
珰	dhw
氟	fiq
涵	hkd
栗	lux
赦	uwt
犀	xiun
鼋	yted
甑	zfb
振	vdf
钡	bqj
蔽	bucw
驰	iomy
撮	zqf
铎	dpj
柑	gjmg
冈	ghk
棺	grmk
铪	haj
诀	jyy
髋	krg
唳	lukq
镰	lzj
绺	les
祕	mupb
侨	qmr
茕	qdc
纬	wrs
污	wud
鲜	xxa
夭	ycpd
莹	ylcy
雍	ysw
育	ycwo
员	ytkr
赟	yyw
铡	vsjd
灼	vph
畀	but
豺	ifvc
掣	iwp
慈	cob
沌	dtd
甫	foa
衮	giw
践	jnzj
厥	jyi
陵	llew
麓	lym
沦	lud
骡	lpmx
弥	mogx
衾	qbry
笙	ugv
侍	uurc
授	umfy
彤	tdd
剜	wjb
匝	zakj
栅	vlmc
筝	vgv
遢	taz
婢	bun
铂	bpj
掸	dlf
扼	ewf
绯	fws
鲎	hmx
旷	kko
擂	lqf
圙	lrk
殁	midy
攮	nkf
咆	pvk
膨	phop
佘	urr
叟	scp
榻	tlmx
蹚	thz
鹀	wig
协	xqu
岫	xpe
暄	xro
虞	ybh
彘	vuv
芷	vpc
佰	bgrb
滨	bbd
跛	bqz
玚	yjw
筹	ixv
蹙	cyw
啡	fwk
旮	gaj
庚	ggg
沽	gud
卉	hcu
箕	jiv
圐	kuk
谅	lky
茂	mxc
摹	mpc
疱	pxb
梢	ucm
柿	uumj
漱	uyd
啸	xbk
兴	xkx
祐	ympk
觜	ziv
唑	zikt
胺	abon
舛	iyxl
扉	fwh
羔	gcy
琯	gyw
诃	heyk
嫉	jon
霁	juyl
婧	jjn
掠	lrfx
绵	mzsj
镊	noj
佺	qtr
嗽	sm
忻	xbx
铀	yxj
吱	ziky
褚	iop
獴	mjqu
蚌	bgi
焙	bqh
钉	djj
糊	hym
迹	juz
柬	jxa
粱	ladm
啰	lpk
勉	mxdl
仟	qmrq
雀	qzuf
扫	sxf
绅	ufs
盛	ihi
纨	wks
媳	xon
蚬	xxie
巽	xts
栈	vhmj
障	vge
址	vpt
椎	vvm
孖	ziz
脯	pio
逮	dgzn
岱	dsre
葛	gtc
躬	gsu
贾	gox
氦	hsq
昊	hxo
桓	htm
茴	hbc
汲	jod
菌	jtc
履	lnuw
乸	ndy
祈	qopj
芡	qnc
嚷	rhk
榕	rdm
舐	uuq
蓑	socy
逍	xnz
猩	xkq
絮	xcn
瑄	xrw
循	xui
颐	yokr
侑	ymro
寓	ycby
郅	vuae
苞	bcc
堡	bor
侪	ifr
怼	dcy
祼	gep
毫	hvwm
凰	hajw
晖	hvo
岬	jve
滘	jbdk
靖	jjlo
堃	kyf
醪	lvy
锂	lpjl
撩	lnfx
锚	mvj
湄	med
呶	nvk
埔	potf
蕖	qbc
趋	qvt
挟	xqfj
殉	xtd
腋	ywo
嗌	yuk
嗌	aukm
妤	ybn
愠	ytx
轴	vmi
胞	bco
庇	bug
碴	isu
蟾	ikik
宸	igb
汆	crr
番	pjp
腓	feo
喙	hcku
麂	jpg
屐	jiuy
赍	jiur
蒹	jmc
窖	jbb
疗	lmbl
翎	llrx
熘	lqh
鹭	lyz
眯	moo
苹	plcp
愀	qzxh
襦	rip
粟	syx
饕	tckl
醺	xyy
鸦	yay
檐	ykmk
曜	yxo
殷	ybpy
庾	yng
瑗	yew
丈	vga
侄	vort
艾	yucx
痹	bubl
雏	iid
啜	iiky
聪	cse
爨	cep
怛	dsx
藩	fjc
蕃	boc
尬	gly
槐	hlm
际	jue
玦	jyw
勘	kjq
璃	lowd
貘	miv
驽	ninm
毗	potb
厦	uli
驶	upm
薯	uoc
肆	sua
娑	sod
蜕	tci
毋	wiva
昔	xico
羲	xiy
旬	xub
茚	yvce
植	vom
烛	vih
龅	bcv
镚	bfj
镲	idjx
俶	iyr
椿	iym
邨	cyt
悼	dxx
奋	fddt
罡	ghsv
饹	leu
撼	hhf
濠	hvd
饸	hru
煌	hah
迦	jxz
谏	jny
蕨	jycr
诳	kay
烙	lihk
䁖	lzo
茫	mjcw
拇	mof
飒	sll
麝	uwg
绦	tcs
婉	wln
鹟	wgbn
皙	xim
霄	xnyo
勋	xyk
曳	ywlp
铱	yij
洞	tddk
谙	any
椴	demy
腭	ewo
淦	ghd
淮	hld
晦	hco
荚	jcc
笺	jmv
垃	lat
酪	lxy
氓	mjwm
暝	mlob
凄	qidn
虔	qzhw
噙	qnk
厍	uwi
析	ximj
飨	xsxl
厢	xli
踅	xyf
荀	xuc
呓	yukv
俑	yfr
屿	yne
札	vsmv
昼	vmid
狈	bqq
弁	bns
馃	gqu
憾	hhxx
翰	hhu
泓	hdds
镬	hij
颊	jcjr
珈	jxw
诫	joy
掬	jvfm
邝	kkg
励	luil
谝	pxy
娆	rvn
茹	ric
赊	uek
嵩	sse
蹋	tlzx
桐	tdm
菀	wlc
渥	widt
檄	xom
铉	xej
佯	yjr
盂	ybym
臧	zhw
喳	iak
瘴	vgbu
祯	vfp
铸	vyj
赘	vcf
骓	vvmf
镯	vpj
咨	zidk
腙	zso
濒	bbdr
摒	bjfk
粲	chl
彻	iwi
埕	ihtw
疵	cib
跐	ciz
殆	dsd
硐	dau
坊	fjt
缶	fcw
绀	ghsg
郜	gxne
睾	gcp
鹳	gec
僭	jnro
啉	lnkm
嘹	lmk
髅	lxg
纶	lus
檬	mhm
谬	mpy
牡	mont
廿	nnc
泮	phd
螃	pji
乓	phq
箧	qov
擎	qlc
拭	uufg
殊	uudv
溯	syd
娲	wan
惘	wkx
禧	xppk
叶	xqku
乂	yup
囿	ymk
驭	ycm
鸳	yrxn
嗳	auky
坳	aitl
碜	ihu
椽	itm
毳	ccmm
歹	dga
镉	grj
构	gmm
褐	hwp
究	jqb
铠	kgj
慷	khx
魁	kbg
癞	lsb
阑	lkmj
仂	lwr
羸	lew
菱	llcw
陇	lfe
镂	lmj
嫚	mhn
缦	mhs
靡	mogf
捺	nlf
彷	pjif
铅	ykj
蛳	siij
沱	tpd
懿	yuu
姻	ybnd
迂	yvzy
诏	vxy
诊	vhy
铮	vgjl
葆	bbc
缤	bbs
偲	cdrx
铳	iaj
舂	isfj
创	ilr
凋	dnd
督	duu
惶	hax
讳	hcy
笳	jxvk
笕	jxve
蛟	jni
驹	jvmk
颏	kewr
溃	kcd
喱	lokl
涟	lzdz
麟	lng
淋	lvd
栊	ldm
馒	mku
沤	oy
醅	pwy
撇	ppf
祁	qope
戕	qlp
樵	qmmh
俅	qwr
醛	qty
艏	ucv
沓	tlu
蜗	woi
晤	wyo
懈	xox
魇	ylig
旸	yjop
秧	yhh
烨	ywh
钰	ycj
鸢	yry
哕	yukx
哕	hckx
撰	vefb
磅	pju
叱	iuk
炽	iuh
哧	iikd
迭	dqz
惰	dix
燔	fkh
嗐	hskk
艰	jmyg
犍	jmnz
桨	jsdm
鲛	jna
诘	jqy
襟	jbpx
钜	jcjj
骏	jtm
侉	kvr
厘	loi
劣	lou
聆	lles
琉	lwwv
氯	lcq
玟	wgww
颞	noer
颦	pnvu
麒	qog
熔	rdh
轼	uuig
驷	sum
锑	tij
猥	wrq
奚	xipd
嬉	xin
偃	ylr
鄢	yjve
谒	ywy
苡	ypc
茵	ybc
娱	ybnt
陨	yie
疹	vhb
桢	vfmr
蹩	bqd
埗	byt
鹾	cpl
娣	dun
氐	dpu
妒	dyn
阜	fypu
褂	gzp
胍	gxo
罕	hlb
笏	hyv
涣	hedd
恍	hsx
疖	jpbe
荆	jkcd
炯	jfh
僦	jpr
倔	jrr
珺	jtw
侩	kjr
括	kifk
醨	loy
沥	ludl
砺	luu
络	lis
鳗	mka
朦	mhou
旻	mno
茉	micm
募	mycl
砷	ufu
蟀	uji
倘	tkr
涕	tud
隈	wwe
唏	xikj
酰	xmy
校	jbmx
榭	xomc
歆	xblr
琇	xpw
晔	ywou
翊	yulx
缨	yks
佣	ysry
蕴	ytc
奘	zgp
琢	vpw
龇	zivb
镗	tjj
铵	azj
梆	bhm
敕	iuuw
嫡	don
菂	ducu
幡	fjjt
纺	fks
巩	gfgf
辜	guu
呱	gukg
鹫	jpw
锎	kdj
奎	kbd
愧	kcx
琨	kyw
崂	lve
鬣	loav
蚂	mdi
嫫	mpn
钕	nnj
埤	put
铍	poj
骞	qmbm
窍	qbb
锹	qnj
偌	rirk
石	dha
庶	uyg
嗵	tsk
圩	wet
宪	xnbe
潇	xnds
谐	xqyb
绪	xcso
绚	xes
砚	yhu
湮	yjdt
肴	yvxo
罂	ykkf
蚴	ymi
瘐	ynby
棹	vxm
踏	tazo
咥	xuk
耙	psl
阪	ble
犇	bfn
迸	bfzk
弼	bugg
俵	bbry
秉	bapn
晡	buo
槎	ismg
刹	ilx
憧	isxl
槌	ibm
绰	iis
篡	cev
皴	cys
鞑	dsg
怠	dss
诞	dhy
谠	dky
筜	dhve
氘	dcq
萼	ewc
阀	fsm
芣	ficb
馥	fyh
哽	gjk
骸	hfg
骇	hsm
捍	hhfg
阖	hrmm
缳	hts
咴	hvkh
镓	jxj
枧	jxme
蹇	jxbr
戋	jma
爵	jyp
隽	jern
瞰	kho
哙	kjk
喟	kck
濑	lsd
镭	lej
髎	lmg
凛	lmdx
鸰	llrn
娈	ltwn
鸾	ltwn
捋	lnfc
莽	mkc
镍	nojm
爿	pkvp
僻	pur
噼	pik
鳍	qoa
羟	qsy
羌	qly
戗	qlr
衢	qbi
鳃	sda
疝	uhbe
曙	uooo
唾	tik
罔	wkkw
窸	xibx
狭	xcq
冼	xxd
溴	xpdq
靥	ywi
祎	yip
峪	yce
煜	ych
筼	yuvr
辄	vriv
诤	vfyl
徵	vpi
钯	bdj
赑	bukr
采	csp
垞	ist
偿	ijr
瞋	ifo
丞	ihl
辍	iiiy
脞	cq
惦	dnx
胴	daok
昉	fko
讽	fjy
尴	gjy
眭	svo
纮	hdss
骺	hxg
桦	hzm
戢	jok
玑	jiw
缉	jis
烬	jvh
胩	kdo
阚	khmw
亢	kgw
眶	kkow
夔	kbb
邋	laz
藜	loc
蓼	lzcp
嬷	mpnm
蘑	mpcu
懦	nix
怄	oyx
澎	phdp
莆	picf
玘	qpw
悄	qnx
袪	qvps
濡	rid
箬	riv
铯	swj
芍	uvcu
蜃	udi
燊	ufh
殳	uuj
姒	sun
悚	sfx
祟	sci
髓	sn
琐	sqw
獭	tdq
渭	wqdo
鲔	wra
芜	wic
晞	xioj
纤	xms
橡	xkm
鸮	xnk
煦	xcoh
询	xuyo
埙	xyt
鸯	yhy
冶	ytdk
毡	vjmk
彰	vhlp
跖	voz
癿	bqb
膀	bko
褙	bqp
咇	bukb
匕	bpp
辟	puuu
扁	pmh
璨	chw
漕	cvd
杈	iam
彳	iupr
仇	qwrj
揣	ikfe
扽	ddf
奠	dnb
颚	ewkr
酚	ffy
蝠	fii
釜	foba
莞	wlce
颌	hrrr
弘	hdg
藿	hicf
乩	jil
伎	jury
荠	juc
俭	jxra
疆	jlg
剿	jzv
喈	jpkb
靳	jvgj
颈	gjvr
噱	xyku
匮	kckr
栎	luml
琏	lxw
燎	lmh
骝	lwmt
耧	lxl
缪	mxsp
蘖	nocm
辔	pqs
霹	piy
歧	qovy
扦	qmf
氰	qlq
呻	ufk
晟	ihoi
俟	suru
鳎	tda
膛	tjo
叨	dck
嚏	tukr
鸵	tpn
顽	wke
魍	wkg
蜥	xii
醯	xiym
芗	xlc
楔	xpm
眩	xeo
驯	xtm
谚	yhyp
龈	ynv
瀛	yldf
舆	ybpb
隅	ybey
豫	ycsn
昝	zlw
藻	zbc
绽	vhs
秩	vuhu
潴	vudo
荷	hwc
卜	bold
浐	ild
敞	ikx
豉	ipa
惆	ixx
酬	ixy
雠	ixrf
泚	cpd
囱	cspw
蠹	dya
踱	dpzy
筏	fsv
舫	fkv
钆	gsjv
丐	gsav
觚	gudg
颔	hhr
蘅	hhc
黉	hdx
珲	huwi
圾	jit
祭	vsp
矫	jmu
桀	jqx
噤	jvk
胫	jjo
蝲	llid
阆	lgm
吏	luan
釐	xiw
璘	lnwl
窿	ldb
椤	lpmx
髦	mva
贸	mxp
邈	mzz
脲	nbou
湃	psdf
鞘	qbg
湫	qqd
龋	qnv
诠	qtyw
蹂	rxz
潵	sddw
弑	uuxg
墅	uylt
抒	uufl
泗	sud
饲	suu
忑	twx
骰	txg
鹜	wys
烯	xihj
匣	xck
缐	xns
漩	xtdr
鳕	xua
浔	xud
氩	ylq
焰	yhhj
琰	ylwh
奄	yldd
荧	ylch
痈	ysb
攸	yzrw
榆	ybmd
辗	vlin
钊	vcj
挚	vufu
肢	vioy
峙	vue
衷	vsw
绉	vms
纂	zyv
绷	bjs
舶	bpvb
蛏	igit
魑	iig
绸	ixs
粹	ccmu
玳	dswy
骶	dpgd
钿	dnj
鲽	dqa
锻	dej
俘	firz
孚	fipz
诟	gmy
刿	gce
壑	hwlt
堠	hmt
葫	hico
瓠	hydg
烀	huh
遑	haz
戛	jcag
鳉	jla
玠	jow
菁	jkco
迥	jfz
韭	jef
蒟	jnck
裾	jvp
涓	jrd
崛	jye
箜	ksv
喹	kbk
壸	kiu
悃	kix
涞	lfd
俐	lurd
醴	lpy
蠊	lzi
蔺	lvcf
垄	lfl
芦	lic
颅	lilr
扪	mgf
冕	mxk
睦	myo
丕	pib
翩	pmhx
岐	qoe
碛	quur
讫	quyq
鸲	qbbn
诎	qvy
痊	qtbw
阕	qrmt
鞣	rxg
蒻	ricd
鳝	uha
莘	ufc
澍	uydc
烁	uih
澌	sid
稣	suah
螣	thoi
忝	txt
仝	tdrg
僮	tdrl
柝	timi
帷	wej
钨	wuj
隙	xuex
晰	xioj
巷	hgc
械	xomc
邂	xoz
匈	xsb
欻	xvhr
堰	yht
沂	yod
贻	yokk
挹	yufb
邑	yukb
瑀	ynw
赃	zhk
沼	vbd
斟	vfq
箴	vfvk
烝	vgl
旨	vpb
纣	vmsc
镦	dyjw
氾	fkd
嫒	aun
霭	apy
岜	bae
悖	bqx
锛	bfjc
毖	bubb
亳	bpw
馇	iau
阐	ilm
殂	cid
疍	dhvd
铛	dhj
靛	dnfr
渎	did
愕	ewx
尜	gsx
诰	gxy
胳	geo
毂	gouy
菰	guc
吭	hjk
曷	hro
珩	hhw
糇	hxm
唿	hukx
蝗	hai
诲	hcym
虺	hnw
睢	svof
蓟	jucd
讥	jiy
稽	jiho
稼	jzh
胛	jvo
狡	jzq
郊	jnwe
睫	jqo
蚧	joil
疚	jpbj
眷	jejo
峻	jte
龛	kjrl
轲	kei
骷	kug
盔	kvu
锟	kyj
斓	lkw
螂	lji
骊	loml
埒	lot
庐	lig
鲈	lia
犸	mdq
幔	mhj
蠓	mji
泌	mud
秣	mihm
眸	mxo
柰	nsm
馕	nkuy
坭	not
瓯	oukw
珀	piwb
芩	qncv
颧	qtc
苒	rlc
戎	rdg
冗	rf
搡	skf
汕	uhde
杓	bnmu
牲	ugn
枢	uumx
绥	sbs
狲	syq
苔	tdc
誊	thj
湍	tr
褪	ttp
惋	wlx
宛	wlbv
巍	wweg
邬	wuw
屃	xuu
饷	xsu
朽	xem
勖	xckl
墟	xvt
渲	xedg
谖	xry
胰	yoo
猗	yiq
莜	yxcw
垣	yttg
沅	ytde
锃	zfj
樟	vhmu
鹧	vwg
祉	vpp
蜘	vii
肫	vyo
斫	vpu
眦	zuo
蕞	zcc
酢	ziy
鹡	jodn
螯	apfi
堡	pyr
襞	buuy
蝙	bmi
骉	bnmm
帛	bpb
膊	bpoc
簸	bqv
惭	ckx
沧	chd
忏	ihx
怅	igxi
骋	ijm
弛	iog
绌	iys
黜	iyh
揣	ijfe
钏	iej
璁	csw
撺	crf
淬	ccd
埭	dst
绐	dssk
担	dhf
荻	doc
翟	vfxf
簟	dnvu
甸	dnbt
鲷	dna
篼	dzv
蔸	dzc
阇	dumo
垛	dqtm
锇	erj
矾	fku
苻	ficc
赅	gdk
皋	gcb
鲧	gia
焓	hkh
郃	hrre
貉	hrv
糊	hum
徊	hli
奂	hedd
恚	hct
攉	hof
畸	jitk
铗	jcjj
鹣	jmbn
徼	jbiw
竭	jql
旌	jkf
咎	jpwk
矩	jnuj
苣	jccj
蹶	jyz
楷	kgm
蝌	keiu
喾	kyx
栳	lbmb
潦	lmdx
呖	lukl
赁	lvr
咙	ldkl
瘘	lmbn
戮	lyx
漉	lyd
簏	lyv
泺	lidl
汨	mudo
忞	mnw
漠	midd
缪	mbs
氖	ngq
瑙	nbw
淖	nxd
啮	nokk
俳	pfr
哌	psk
沛	pqd
篷	phv
乒	pkq
抔	pxf
潽	pud
杞	qpm
茜	qncx
綮	qjh
瞿	qbo
荃	qtcw
纫	rdsr
丧	shu
觞	uhdp
噬	uukr
蔬	uucv
嗣	suk
伺	surk
崧	sses
菘	ssc
隧	sce
骀	tfmk
砼	tdu
恸	tax
椭	tqm
洼	wad
淅	xidj
岘	xnee
庠	xag
囟	xvpx
洵	xudo
讶	yly
衍	ylii
殃	yhd
浥	yudb
翳	yukx
蜴	yuiw
谊	yuyq
诒	yoy
铟	ybj
萤	ylci
萦	ylcx
聿	ycvl
耘	yuls
谮	zdy
湛	vhd
锗	vtj
雉	vuuf
骤	vmm
鬃	zsa
咉	yhk
媞	uunr
柏	bpmb
褓	bbp
蓓	bqc
篦	buv
蓖	bucb
髀	bugu
裳	uhx
坼	iwt
裎	ihp
螭	iiid
楮	iomo
氚	irq
鹑	iuw
蔟	cyc
忖	cix
痤	cpb
耷	dade
瘩	dab
焘	tcfh
涤	dod
邸	dpde
锭	djjr
玎	dkw
酊	dkyd
铥	dqjs
钭	dcj
肚	doot
缎	des
碓	dcu
哚	dqkm
咄	doki
匐	fib
茯	ficq
辐	fiit
溉	gsdv
缟	gbs
蛄	gui
氿	jedj
姮	hhn
衡	hhi
逅	hmz
鹄	hin
婳	hzn
宦	heb
鲩	hea
荟	hccs
绩	jusr
羁	jism
纪	jps
菅	jmck
茭	jncx
疥	jobl
痉	jjb
柩	jpm
倨	jcrk
莒	jnck
琚	jvw
雎	jvqf
咀	znk
慨	kgxv
窠	keb
垦	khgt
刳	kud
夼	ksd
蝰	kbi
鲲	kya
榄	llm
酹	lqy
蛎	luiw
蠡	lpvi
寥	lmbp
蒌	lxcn
潞	lydk
虻	mhi
瞢	mhco
岷	mne
珉	mnwm
溟	mldb
镆	mij
囔	nhk
辇	nxfi
徘	pfi
庖	pvg
貔	povb
嫔	pnn
匍	pibf
朴	pmm
蕲	qocj
汽	qudq
欹	qidr
槭	qum
蹊	xizd
钤	qzjv
阡	qme
慬	qnxa
磬	qju
罄	qjuf
蝤	qwi
鹊	qrc
瘙	sx
赡	uhkk
韶	uvl
潲	uxdo
纾	uus
蒐	szc
飕	szj
跆	tfz
忐	tlux
慝	twk
珽	taw
钍	tojt
驮	dim
烷	wkh
脘	wlo
杌	wym
诬	wuy
潟	xudh
徙	xpir
辖	xci
涎	xzd
铣	xpje
枵	xnmv
惺	xkxu
嬿	yhnh
焱	yhhh
峄	yuel
诣	yuyo
镱	yuj
揖	yif
荑	toc
霪	ynyr
颍	yabr
甬	yfsy
镛	ysj
阈	ycma
俣	ynr
湲	ytdy
刖	yro
钺	yrj
錾	zhij
崭	vle
晢	vrfo
轸	vhip
拯	vjfa
摭	vofh
卮	vipv
踪	zsz
诹	zzy
遂	sbz
稗	bsh
邶	bqle
孛	bqu
陂	poe
苄	bnc
飑	bnjs
僰	bpa
钹	bpjd
砵	bou
艚	cvv
谄	ily
鲳	iha
蚩	iivi
亍	iya
蹴	cyz
缞	cvs
凼	dgu
砥	dpud
蚪	dci
婀	een
铒	eyj
璠	fkw
钒	fkjf
妨	fjn
淝	fed
忿	fdbx
氛	ffq
俸	ffr
酆	fgee
桴	fim
腑	foo
麸	fuf
垓	gdt
觥	gsdw
倌	grr
毌	geva
菡	hhck
菏	hrck
斛	hidu
惚	hux
篁	hav
蕺	joca
浃	jxdj
睑	jxo
缄	jms
槛	jnmm
醮	jby
珒	jbw
儆	jar
臼	jppa
鬏	jqa
讵	jcy
踞	jczk
橛	jym
珏	jywy
捃	jtf
岢	kte
炣	kth
髁	keg
铿	kgjt
筘	kmv
揆	kbft
焜	kyh
睐	lso
痢	lub
奁	lzdx
鲢	lza
缭	lms
冽	lodd
捩	lofq
洌	lodd
羚	llys
苓	llcs
崚	lhe
茏	ldc
泷	uldl
泸	lidu
镥	loj
蟆	msi
劢	msw
牤	mhnw
媄	mrn
醚	moyz
麋	mogm
沔	mxdm
蓦	micm
萘	nsc
艿	ngc
睨	nuoe
旎	npfb
柠	nlm
狍	pvq
罴	pos
圮	ppt
鄱	ppp
魄	pibg
亓	qoel
骐	qomb
憩	quq
洽	qzdk
慊	qnxn
慊	qoxn
荨	xucc
嫱	qan
穹	qdb
蚯	qqi
铨	qtjw
绻	qys
髯	rka
壤	rkt
攘	rkf
桡	rvm
糁	ufm
绍	uxs
珅	ufw
埘	uot
谥	uuym
祀	sup
竦	sfl
夙	syj
邰	tfse
倓	tkrh
铤	tajz
疃	tytl
饨	tuut
琬	wlw
豌	wja
沩	wedw
玺	xpdy
歙	uwrr
舷	xzv
祆	xmp
筱	xzvw
嚣	xnkk
吁	xvky
楦	xemg
儇	xrr
旋	xef
谑	xrya
曛	xyo
岈	ysey
琊	yswe
赝	yhir
酽	yhyy
邺	ywye
弈	yuwc
潩	yudb
缢	yusm
臆	yuox
荫	ybco
郢	yake
璎	ykwn
踊	yfz
壅	yswt
欤	ybyr
鹬	ycsn
芫	ytce
龠	yrr
甾	zdv
择	vffl
咤	vlk
旃	vjfd
曌	vxo
谪	vry
赭	vtt
鸩	vdd
缜	vhsb
溱	qndh
峥	vgel
窒	vubt
蛭	vuit
栀	vimv
茱	vuc
篆	vev
擢	vpff
叕	vpyy
髭	zia
馇	vau
骜	aifm
靬	qzgg
腌	aao
叆	aue
隘	auem
埯	azt
懊	aix
鲃	baab
荜	bucu
濞	budl
摽	bbf
髌	bvg
箔	bpvb
鲌	bpab
泊	podb
埠	bytu
瓿	byl
汊	ildi
刬	ihj
晁	ivo
郴	ifm
宬	ihb
澂	ihdw
匙	uio
瘳	izb
梼	tvmc
莼	iuc
琮	cdw
萃	ccc
傣	dgr
纛	dxf
蹈	dbz
嶝	dfe
镫	dfj
戥	djog
籴	dor
耋	dql
昳	dqo
氡	dsq
椟	dimd
噩	eww
鹗	ewkn
珥	eyw
珐	flw
狒	fqq
翡	frfx
痱	fqb
鲼	fda
凫	fipj
黻	fiy
驸	fym
冮	ghdg
圪	get
疙	gebq
鲠	gjag
赓	gggr
彀	gmu
锢	gyj
汩	god
胱	glo
庋	gng
鲑	gva
腘	gpo
嗥	hvku
鞨	hrg
鸻	hhin
薨	hsc
煳	hih
蝴	hii
怙	hyx
镮	htj
鬟	hta
痪	hebd
徨	haiw
洄	hbd
蛔	hbi
贿	hcko
夥	hqg
鲫	juae
踺	jnzz
酵	jbyz
肼	jao
兢	jku
扃	jsh
厩	jpiv
阄	jqmv
炬	jch
飓	jcjb
枸	jnmk
谲	jyyk
钧	jyjd
崁	khe
疴	kebk
脍	kjo
浍	hcds
圹	kkt
铑	lbj
簕	lwv
诔	lry
莅	lucl
魉	lsg
獠	lmq
躏	lvz
懔	lmx
蛉	llis
垆	lit
胪	lio
葎	lcc
孪	ltwz
峦	ltwe
蟊	mvsi
铆	mbj
袂	mqp
宓	fibb
眇	mzou
篾	movu
蔑	mocu
靺	mig
衲	nlp
猱	nvq
佞	njr
耦	ool
滂	phdf
脬	pco
椪	pfm
蚍	poib
譬	puuk
淠	pudl
苤	pwc
鲆	plap
娉	pkn
哱	bokz
埼	qot
迄	quz
耆	qolo
缱	qxs
樯	qam
荞	qmcl
锲	qoj
郄	qoxe
黥	qlh
顷	qab
蜻	qkio
箐	qjv
蛩	qdg
泅	qwd
酋	qwb
鳅	qqa
觑	qch
傕	jyrf
嵘	rde
糅	rxm
蠕	rii
颡	sky
啬	swu
霎	ulyn
蟮	uhi
姗	ujn
墒	uht
莳	uocc
秫	uihu
沭	uydu
槊	uibm
溲	szd
涑	sydu
肃	syv
燧	schz
濉	svd
榫	sim
闼	tlmz
覃	qnxu
瑭	tjw
傥	tkre
嘡	thkt
弢	tcg
铽	twjx
鹈	tob
屉	tuuu
莛	tlc
蜓	tli
彖	te
呙	gok
妧	ytne
猬	wqq
偎	wwr
尉	wquc
汶	wdd
肟	wio
侮	worm
庑	wog
忤	wox
圬	wut
郤	xube
浠	xidj
粞	ximx
遐	xcz
氙	xmq
襄	xlw
骧	xlmy
崤	xme
皛	xzb
绡	xnso
胁	xqo
亵	xow
荇	xjc
煋	xkh
芎	xsc
酗	xcyk
胥	xvv
畜	iyw
烜	xyh
鲟	xuac
蕈	xtcu
衙	ysi
滟	yhdb
餍	yhil
䶮	yll
卬	ajp
烊	yjhy
窈	ybb
怿	yuxl
熠	yuh
燚	yuhh
媖	ykny
鹦	ykkn
慵	ysx
牖	ycpf
铕	ycjo
黝	ychl
嵛	ybed
玙	ybwy
萸	ybcy
谀	ybyy
堉	ycto
圉	ynkg
禺	ybld
嫄	ytnx
钥	yrjo
恽	ytxi
殒	yidr
氲	yyq
哳	vakj
楂	vamd
嶂	vgeu
圳	vdt
禛	vfpb
陟	vuep
宙	vmb
帚	vcej
伫	vyra
馔	veu
隹	vvr
茁	vpci
恣	zudx
滓	zpd
耔	zpl
淄	zidt
兹	coby
俎	zorq
祚	zip
訾	zpvk
嵴	joe
镝	dijk
奓	vadx
皑	aobj
桉	anm
盎	ag
肮	ah
奡	aia
岙	aiy
鲅	bla
笆	bav
枹	bcm
栟	bfm
甏	bfuw
绷	bfs
滗	budm
箅	buvl
陛	bue
昪	bnoc
鳔	bba
膑	bvo
伯	bgrb
逋	buzf
黪	clh
伧	chrv
嶒	che
姹	iln
孱	ikuz
鬯	igxb
猖	ihqo
琤	igw
茺	isce
樗	ium
遄	itz
怆	ikxv
幢	iajl
蝽	iyi
踔	iozu
苁	cscr
枞	zsmr
辏	cmi
徂	ciiq
瘁	ccb
璀	cn
褡	dap
淀	dndr
啶	djk
疔	dkb
牍	dip
耑	dre
惇	dyx
礅	dyuw
垩	ewyt
苊	ewcv
洱	eyde
鲂	fja
诽	fry
棻	ffcm
纷	ffsd
葑	fgc
罘	fis
矼	ghu
杲	gbo
槁	gbm
舸	gtv
袼	gepk
亘	gda
茛	gdc
唝	hfkr
觏	gma
姤	gmn
牯	gon
诂	goy
鹘	hign
绲	gis
辊	gii
蜾	gqi
咍	hdkk
瀚	hhdx
鼾	hjz
沆	hgdj
翮	hra
桁	hhmi
闳	hdm
槲	himu
戽	hyh
豢	hej
圜	ytky
彗	hcfe
翙	hce
翚	hvxi
麾	hvg
隳	hve
馄	huu
溷	htdu
诨	hty
钬	hqj
濩	hidy
岌	joej
楫	jome
殛	joda
徛	jui
洎	judz
芰	jucy
骥	jum
墼	jii
嵇	jihe
笄	jivk
济	jpdl
泇	jxdk
戬	jxy
謇	jxbk
湔	jmdd
耩	jsl
侥	jzrw
褯	jopj
芥	gscl
藉	joco
觐	jvn
遽	jczu
沮	jndq
孓	jyv
抉	jyfg
攫	jyfy
爝	jyh
矍	jyo
噘	jtk
竣	jtl
锴	kgjb
墈	kht
㸆	kxh
犒	kxn
瞌	keo
矻	kuu
贶	kkk
蒉	kcc
籁	lsv
漤	lldn
榔	ljm
埌	lgt
罍	letf
擂	lef
塄	lht
棱	lgmw
篱	lov
缡	los
罹	losf
蓠	locd
枥	luml
砾	luul
隶	luvn
娌	lpn
跞	luz
郦	lul
僚	lmr
尥	lby
蹽	lnz
吝	lvw
鎏	lwdj
尨	mju
嵝	lce
舻	liv
渌	lydu
辘	lyi
偻	lnrn
挛	ltwu
锊	lrj
猡	lpq
逻	lpzx
荦	licn
瘰	lqb
蔓	whc
邙	mjwe
懋	mxm
峁	mbe
渼	mrd
懑	mdd
勐	mjz
蜢	mjim
猕	moq
谧	muy
敉	mpmw
丏	mxa
藐	mzc
缗	mns
黾	mmk
谟	mpyd
瘼	mibd
模	mim
苜	myco
鼐	nsn
忸	nex
杻	nem
杻	icm
衄	ncx
疟	nrb
锘	nij
杷	psm
匏	pvd
霈	pqy
湓	pgd
怦	pgx
枇	pomb
琵	pow
伾	pirp
邳	pip
骠	bnmx
缥	pns
氕	ppq
叵	pqk
菩	pick
溥	podc
崎	qoek
碶	quud
屺	qpej
棨	qphm
芑	qpc
佥	qmra
钎	qmjq
堑	qni
谯	qmyh
峭	qbe
橇	qnm
硗	qnu
伽	gar
芹	qncj
吣	qvk
揿	qvf
檠	qlcm
巯	qwv
璆	qwwp
遒	qwzy
囷	qyk
穰	rjh
妊	rdn
驲	rum
瑢	rdwk
褥	ryp
脎	slo
靸	sdg
馓	slu
臊	sxo
穑	swh
裟	uady
膻	ujo
畲	uer
鲥	uoac
鼫	uoju
豕	upa
蓍	uic
塾	uiwt
腧	uyo
菽	uucy
闩	urma
兕	suae
笥	suvk
锶	sij
嗾	sck
薮	scc
嗉	syk
蔌	syc
谡	syyw
甦	sug
宿	xeb
宿	xpb
谇	scy
邃	sczu
唢	sqk
酞	tsy
啴	ilk
搪	tjfk
萄	tvc
縢	thox
绨	tus
沺	tzdt
殄	txdp
窕	tzb
餮	tod
萜	tpc
侹	tar
烃	tkh
梃	tam
梃	tjm
哃	tdk
曈	tdol
潼	tddl
抟	ttf
煺	tch
鲀	tuat
拓	tlfu
窊	wab
嵬	wee
帏	wejw
潍	wedf
艉	wrv
苇	wrcw
诿	wry
涡	godn
梧	wim
蜈	wiit
寤	wybk
鹉	woan
屣	xpur
穸	xibx
谿	xipk
猃	xxq
缃	xls
葙	xlco
哓	xnkw
虓	xnjj
蛸	xni
獬	xoq
伈	xmrx
脩	xqro
诩	xnyx
煊	xrh
禤	xrp
翾	xrs
蚜	ysiy
轧	vsi
怏	ygx
恙	ygy
泱	yhdy
峣	yve
彝	yov
弋	yua
羿	yuxc
狺	ynq
鄞	ynn
愔	ybxo
氤	ybq
瘿	yabn
膺	ykgo
猷	yxbq
竽	ybv
腴	ybo
谕	ycy
予	ybs
塬	yttx
掾	yef
垸	yet
狁	yiqe
慥	zxx
迮	zrz
缯	zgs
栅	ujmc
璋	vhw
笊	vxv
蜇	vrfi
柘	vwm
赈	vdk
侦	vfr
埴	vot
桎	vumt
豸	vupp
轾	vuit
稙	vihq
畤	vut
踵	vfz
舯	vsvv
妯	vxn
胄	vmy
荮	vmc
柷	vyme
贮	vyk
瞩	voo
麈	vog
侏	vur
橥	vuq
竺	viv
啭	vekv
晫	vpo
孜	zizw
驺	zzm
镞	zij
诅	zoy
怍	zix
叨	dvk
拤	qcf
炘	xbh
蜚	frfi
嘌	pbk
镪	qlji
垯	dat
崀	lge
硊	hcuv
崾	yxe
砹	auux
蔼	apc
锿	aij
鹌	and
璈	apw
聱	apfe
遨	apz
鏊	aifj
攽	bjbw
癍	bjbw
塝	bgt
蚌	bfi
雹	bvy
鸨	bbbn
碚	bquk
鞴	bqg
庳	bugu
坌	bdb
畚	bhst
荸	bocz
嬖	buun
苾	bucb
妣	bpn
舭	bpvb
贲	bfur
睥	puo
砭	bmu
笾	bmv
摈	bvf
殡	bvd
玢	ffw
菠	bocy
擘	biu
醭	biy
骖	cjm
螬	cvi
涔	cgd
𥻗	ismd
侘	ilrq
诧	ilyq
潺	ikd
躔	ikz
羼	ihuy
襜	ijp
伥	ihr
阊	ihmo
怊	icx
忱	igxv
谌	igy
棽	ifmv
棽	ufmv
惩	ihix
酲	ihyw
澄	dfd
漦	iowu
茌	ioc
褫	ipp
笞	iivk
艟	isv
漴	idd
畴	ixt
帱	ixj
滁	iidh
憷	iyxr
搐	iyft
础	iou
圌	ibk
惙	iix
匆	csb
猝	cyq
漼	cnd
溚	dsdk
轪	dsid
迨	dszk
殚	djd
眈	djov
箪	djv
澹	tkdk
垱	dgt
宕	dgb
忉	dcx
磴	dfu
玓	duwu
缔	dus
诋	dpy
柢	dpm
扂	dnh
琔	dnw
癜	dnby
佃	dnr
窎	dbb
铫	yvj
堞	dqtm
牒	dqp
绖	dqs
蹀	dqzm
楪	dqm
仃	dkr
耵	dke
胨	daod
垌	datk
侗	dar
煅	deh
蹾	dyzw
峨	ere
轭	ewiv
遏	ewz
咡	eek
耏	ete
垡	fsr
砝	fdu
蘩	fkc
畈	fhty
繁	pppx
枋	fhmf
悱	frx
芾	ficl
偾	fdr
烽	fgh
涪	fidk
祓	fipd
绋	fisf
蚨	fiif
蜉	fiiz
咐	fykc
赙	fykc
拊	fofc
黼	foy
趺	fuz
鄜	fug
脯	foof
戤	gsn
澉	gld
鳡	gla
玕	gjw
酐	gjyg
堽	ght
锆	gxj
篙	gcvk
饹	geu
绠	gjs
蚣	gsi
岣	gcek
篝	gzv
鞲	gzg
崮	gye
梏	gym
牿	gyn
榖	gouy
瀔	gody
酤	guy
坬	gztg
夬	gjvn
筦	gyv
莞	gyc
洸	gldw
妫	gvn
珪	gvwt
皈	gvby
桧	gcms
鳜	gca
帼	gpj
馘	gpb
聒	goe
蝈	goiy
醢	hgy
垾	hht
扞	hhfg
撖	hhfw
暵	hhon
淏	hxdt
涸	hrdk
龢	hrrh
熇	hwh
竑	hdl
翃	hdu
篌	hxv
垕	hmp
鲘	hma
醐	hiyo
鹕	hiun
浒	xndw
铧	hcj
峘	hte
漶	hedx
湟	had
璜	haw
癀	habb
簧	havb
锽	hajw
隍	hae
诙	hvy
阍	hymo
笈	jovj
悸	jux
穄	juhx
觊	juee
剞	jidd
芨	jic
荠	qocl
觭	jidk
郏	jcje
跏	jxzk
袷	qxp
毽	jnmz
腱	jnoz
翦	jxbx
谫	jxyd
搛	jmf
缣	jmsn
鲣	jmat
糨	jkmi
噍	jbk
漖	jbdw
藠	jbcb
檞	jwm
湝	jpdb
拮	jqfk
颉	xqur
妗	jvnv
祲	jvpy
缙	jvs
荩	jvc
馑	jmua
迳	jjz
憬	jax
阱	jae
岠	jcej
窭	jcb
醵	jcyu
榉	jnml
龃	jnvq
娵	jvny
疽	jvb
苴	jvcq
枸	gcmk
岨	jveq
鄄	jex
蠲	jrb
垲	kgt
闿	kgmj
忾	ksx
钪	kgjj
栲	kbm
缂	kws
牁	kep
裉	kdp
绔	kys
姱	kxnk
郐	kjre
鲙	kja
蒯	kac
睽	kbo
逵	kbz
馗	kbj
愦	kcxr
馈	kcur
跬	kn
裈	kypi
鹍	kyon
旯	lsoj
镴	lljv
赉	lsl
褴	lkp
襕	lkpj
谰	lkyj
镧	lkj
缆	llse
稂	ljh
锒	ljj
塱	lkdt
烺	lkh
泐	lwdl
檑	lemt
儡	lrr
礌	leut
嫠	lown
鹂	lol
黧	lohh
苈	lucl
荔	lucl
詈	lusk
雳	luyl
澧	lpda
疠	lubw
楝	lnmj
墚	latm
椋	lamx
燎	lzh
钌	lzjl
漻	lmdp
趔	lotd
躐	loz
粼	lnmv
遴	lnzl
檩	lmm
棂	llmh
舲	llvs
酃	llye
浏	lwdd
镏	lwj
锍	lejv
眬	ldol
琭	lywu
蕗	lyc
榈	lbmk
碌	lpu
滦	ltd
囵	lukb
纶	grs
雒	liwf
杩	mlm
荬	mgcd
鬘	mkay
镘	mhjy
漭	mkd
牦	mvn
瑁	mxw
嵋	mee
楣	memo
鹛	mevn
浼	mrdv
钔	mgj
醾	moym
糜	meg
娩	mxn
腼	mxom
愍	mmmx
湣	mmdo
瞑	mlob
酩	may
侔	mxr
仫	myr
𧿹	mozm
蝻	nli
曩	nko
铙	nvj
怩	nox
猊	noq
铌	nojb
麑	nog
埝	nnt
陧	noet
搦	nif
讴	ouy
筢	psv
蒎	psc
槃	pkvm
蟠	pki
襻	php
抨	pgf
郫	pop
砒	piub
仳	ppr
纰	pis
殍	pzdz
俜	pkr
钷	pqj
钋	pojb
镤	pij
镨	pojo
埔	bytf
朴	pim
芪	qocu
锜	qojk
跂	qoz
踦	ypz
圻	qotj
掮	qzf
岍	qmek
愆	qmi
搴	qmbu
杄	qmmq
汧	qmdk
锖	qljo
戗	qkrg
憔	qmxh
诮	qby
悄	qzxo
伽	qqr
檎	qnmd
庼	qagr
圊	qkko
鲭	qka
邛	qdge
犰	qwqj
虬	qwiv
赇	qwkq
萩	qqch
鞧	qqg
灈	qbdf
璩	qbw
蘧	qbcz
蠼	qbiy
鼩	qbjk
阒	qcm
蛐	qviq
躯	qvux
筌	qtv
辁	qtiw
炔	qth
埆	qrt
轫	rdi
荏	rhc
嚅	rik
嬬	rine
孺	riz
溽	ryd
缛	rys
蕤	rbc
蚋	rci
磉	sku
埽	sxt
铩	uaj
舢	ujv
钐	uhj
绱	ugs
晌	uko
劭	uxdl
艄	ucvo
矧	uhu
屾	ufe
甡	ufuu
诜	ufye
鲹	ufa
甥	ugul
陞	uge
筮	uuvr
贳	uuur
铈	uujj
酾	uiy
狩	umq
绶	ums
戍	uyw
孀	uln
楯	uim
妁	uin
搠	uifo
蒴	uico
涘	sudu
缌	sis
虒	sip
讼	says
忪	ssx
螋	szi
锼	szjy
擞	scfw
愫	syxx
簌	syvr
窣	sub
荪	sycx
飧	syxl
睃	soo
羧	soy
挲	sodu
溻	tad
褟	tap
趿	tazj
沓	dsuo
炱	tfsh
薹	tfct
袒	tlp
螳	tji
鄌	tjge
镗	thjt
绹	tvs
滔	tcdj
鳀	toa
倜	tur
趯	tut
黇	tmc
瑱	tnw
蜩	tmi
鲦	tma
鲖	tdak
橦	tdml
烔	tdh
酴	tiy
堍	tytd
菟	tyc
橐	tpa
酡	tpy
鼍	tpk
柁	tpmb
畖	wat
畹	wlt
涴	yrdv
箢	yrv
辋	wkiw
尪	why
桅	wem
煟	wqho
娓	wrn
硙	wquj
圩	xvty
芠	wgc
刎	whw
紊	whwx
郚	wiwe
婺	wysn
屼	wye
痦	wybk
骛	wysm
妩	won
怃	woxw
觋	xoge
绤	xusk
饩	xuuq
俙	xirj
樨	ximn
牺	xinx
舾	xiv
郗	xixe
鼷	xijd
恓	xixx
傒	xird
暿	xiok
狎	xcqj
痫	xzbm
苋	xnce
狝	xxqx
筅	xxv
跣	xxz
暹	xmz
纤	qns
洨	xmd
淆	xmdo
哮	xbkz
猇	xnqj
翛	xnr
敩	xbxw
撷	xqfr
渫	xodm
燮	xoh
绁	xos
薤	xoc
絜	jqfx
饧	xlu
骍	xkmu
汹	xsd
夐	xad
貅	xqv
馐	xqui
洫	xcd
衒	xei
恂	xux
徇	xti
汛	xtdu
郇	xube
堐	yst
砑	ylu
迓	ylzy
桠	yam
筵	ykv
谳	yhyq
俨	ylry
弇	ylrc
沇	ylde
胭	yjod
剡	uhhd
歅	ybxr
垟	yjt
徉	yji
飏	yjj
羕	ygyy
徭	yvi
珧	yvwd
繇	yxp
揶	yrf
圯	yot
饴	you
屹	yueq
悒	yuxb
瘗	yubt
翌	yuxl
旖	ypf
舣	ypvy
钇	ypj
洢	yidy
佚	yur
垠	ynt
蚓	ymiy
喑	ybko
堙	ybt
蟫	yni
窨	yvbo
撄	ykf
颙	ydy
臃	yso
邕	ysv
佣	yar
莸	yxcy
卣	ycl
羑	ycyj
嵎	ybey
舁	ybjc
觎	ybre
蜮	ycia
遹	yczk
鬻	ycg
圄	ynkk
辕	ytiy
薳	wrcz
瀹	yrdc
妘	yun
鋆	yutj
韫	ytw
缊	ytsm
臜	zao
瓒	zhwr
糌	zjm
牂	zhp
璪	zbw
舴	zrv
罾	zgso
砟	vdu
仉	vkr
漳	vhdu
獐	vhq
召	uxdk
蔗	vwc
瑧	vfwh
蓁	vfc
钲	vgjv
絷	vofx
帙	vuju
帜	vujb
梽	vumx
贽	vufr
沚	vpdv
柊	vsmd
瘃	vib
舳	vivy
躅	vizi
洙	vudv
挝	wofz
缒	vcsz
倬	voru
涿	vodn
琢	zpw
孳	zibz
赀	zivr
偬	zfr
综	zfs
鄹	zze
陬	zzey
缵	zys
躜	zrzr
捽	zpf
柞	zim
玡	yswy
戛	gaa
涫	gedk
嫚	mjn
坬	watg
叚	xcv
陴	poeu
锪	hoj
禔	vipr
漴	uldx
藦	mpcu
啊	aakk
啊	as
啊	ad
啊	al
阿	eee
捱	aoft
毐	apu
唉	aik
嗳	aiky
荌	abc
垵	aztn
揞	azf
𩽾	ana
盦	anr
廒	apg
翱	apb
鏖	apgj
骜	apfm
垇	aita
媪	aqn
嶅	apfe
嶅	aife
熬	aofh
拗	aqf
凹	wal
奥	ycpd
隩	aie
隩	yced
妭	bsn
胈	bso
菝	bsc
魃	bsg
朳	bamb
羓	bay
蚆	bai
把	blf
吧	bakb
鲃	blab
罢	bass
罢	poss
㞎	bdub
㞎	fiu
㞎	psu
钯	psj
扒	psf
捭	bgfu
柏	bim
靽	bhg
昄	blo
粄	blmy
𨭉	bjwj
瘢	bjby
般	bov
般	pkvy
湴	bhdy
湴	pkd
拌	phf
玤	bgw
蒡	bgc
𠳐	bhk
榜	bgmf
膀	pjo
搒	bgff
搒	phff
棓	bgmk
棓	pcm
棓	bqm
棓	bwmk
孢	bcz
趵	bxz
趵	bozu
薄	bpc
薄	bic
枹	fims
暴	pyou
惫	bqwx
琲	bqwf
糒	bqmy
鐾	bquj
鞁	bqgy
鹎	bwpn
呗	bskr
北	bqlb
庳	bwg
庳	pog
孛	bpuz
被	pipy
椑	bwmu
椑	pomu
陂	bwe
陂	poey
倴	bdr
栟	bkmk
坋	bdt
坋	fdt
揼	bff
琫	bjwl
祊	bgp
祊	fhp
佖	bur
坒	bubt
愎	bux
狴	buq
珌	buwb
皕	bubb
筚	buvu
萆	bucu
觱	buxy
诐	buy
跸	buzu
邲	bube
铋	buj
馝	buh
沘	bpdb
秕	bph
屄	biub
鲾	bia
臂	bwuo
贲	buur
芘	bucb
芘	poc
裨	bupu
裨	popu
濞	pudl
睥	buou
𨚕	bnse
忭	bnx
抃	bnf
汴	bndb
碥	bxu
褊	bxp
萹	bmc
鳊	bma
便	pzr
儦	bnrh
幖	bnjx
瀌	bndh
熛	bnhx
猋	bnqq
瘭	bnb
脿	bnoy
蔈	bncx
镳	bnjh
髟	bna
摽	bnfx
藨	bnch
藨	pcc
别	bokd
瘪	bpbb
傧	bbrb
邠	bbbe
镔	bbj
槟	bbmb
槟	bkmb
玢	bbwd
抦	bafb
昺	bao
邴	babe
仌	bkr
蛃	bki
并	bkb
欂	bpmc
浡	bpdz
礴	bpuc
袯	bppd
踣	bpz
镈	bpjc
馞	bphz
鹁	bpun
檗	bium
嶓	boet
癶	bovn
饽	bouz
鲌	blab
擘	bduu
伯	blr
勃	bqul
簸	biv
桲	bpmz
桲	pomz
蔀	byc
簿	bpvc
不	fca
嚓	iakx
啋	cgkm
偲	sirx
䅟	clhp
参	ufsp
参	cfs
参	sjsp
喰	cjk
喰	sykl
喰	qikl
鸧	chrn
伧	ifrv
𥕢	cvu
肏	cx
恻	cwx
侧	zwr
侧	vdr
噌	igko
嵖	ise
衩	ilp
蹅	idz
锸	iajj
碴	iaud
杈	ilmi
叉	isy
差	ciy
虿	iswi
拆	caf
瘥	isbg
瘥	cpbg
茝	igc
茝	vpcl
巉	ike
廛	ikg
澶	ikdd
瀍	ikdt
镵	ikj
韂	ihg
冁	ilbn
旵	ilo
蒇	ilc
骣	ilmz
觇	ijl
辿	ijze
孱	chuz
儳	ikrd
儳	ihrd
刬	iljd
掺	xmfp
掺	chf
掺	ulf
梴	ijmz
梴	ykmz
颤	vhwr
嫦	ijn
徜	iji
苌	ijc
鲿	ija
氅	ikxm
厂	anap
厂	hha
场	ijt
倡	ihro
裳	ijxy
惝	ikxk
惝	tkx
玚	igwp
耖	ixl
弨	icg
吵	ick
嘲	vck
㬚	iwo
唓	iek
砗	ieu
車	iea
車	jva
车	jval
煁	ighv
莀	igcn
榇	idm
疢	idb
龀	idvb
梣	igm
梣	cgm
谌	udy
塍	ihot
枨	ihmi
珵	ihww
珹	ihwi
铖	ihji
庱	ijg
柽	igmt
瞠	igot
赪	igt
偁	igrr
偁	idr
称	ifh
裎	ijpw
牚	igxy
牚	ifx
憕	ihxa
憕	dfx
憕	vfxa
㨃	ihf
㨃	dnfz
乘	ufqn
墀	iot
篪	iov
踟	iozk
傺	iur
啻	iuwk
瘛	iub
侈	ipr
胣	ipo
媸	iin
摛	iif
瓻	iixw
眵	iio
鸱	iidn
黐	iih
尺	itu
㳘	isde
忡	isxv
摏	isfj
珫	iswe
冲	iad
埫	ift
埫	ukt
漴	vkdx
俦	ixrc
踌	ixz
犨	izr
䌷	izs
䌷	ixsy
帱	dxj
裯	ixp
裯	dcp
梼	ixm
梼	dxm
臭	xpz
椆	ixmk
椆	vmmk
椆	dnm
刍	iide
蜍	iiih
蹰	iiz
躇	iizo
斶	iyj
濋	iodr
䢺	iuie
摴	iuf
㤘	iyxe
㤘	cyx
㤘	vmx
俶	tury
揣	ttfe
揣	vvf
巛	irv
圌	itk
堾	iyt
堾	iyto
噇	iakl
倕	ibr
棰	ibmi
陲	ibe
瑃	iywo
䏝	iuo
䏝	vyov
淳	vydz
逴	iozu
绰	ics
啜	ijk
惙	icxy
鹚	cobn
佽	cur
莿	cuc
刺	cia
玼	ciw
玼	cpw
跐	cpz
悰	cdx
淙	cdd
骢	csmx
从	zar
熜	csh
熜	zfh
腠	cmo
麤	cug
蹴	jqz
镩	crj
悴	ccxu
榱	cvmy
漼	cvdf
啐	qiku
缞	svs
缞	uks
膥	cym
嵯	cpe
莝	cic
瑳	cow
酂	cpn
酂	zhn
𫟼	dsj
垯	dstz
炟	dsh
笪	dsvd
荙	dsc
跶	dszz
靼	dsgd
瘩	dsb
答	dav
打	dsf
大	dsun
大	tsu
溚	tddk
叇	dse
垈	dsrt
甙	dsy
呔	tgk
憺	dhxk
萏	dhc
赕	dlk
妉	djn
聃	djer
郸	djbe
惮	dhxl
惮	dsxl
疸	dlb
疸	dabd
瘅	dhb
瘅	djbl
亶	dlw
亶	dhwd
儋	djr
儋	dhr
担	dlfd
掸	uhfl
单	uhbl
单	ikb
砀	dgup
菪	dgcu
挡	dgf
祷	dbpc
舠	dcvd
鱽	dca
焘	dxfh
嘚	dw
得	dric
的	dob
的	dubu
璒	dgw
觌	dou
镝	doj
髢	doa
𤧛	duwj
䗖	dui
俤	dur
碲	duuj
禘	dup
踶	duzr
啲	dik
羝	diyd
鞮	dig
坻	dpt
坻	iotd
柢	iomd
棣	dsm
棣	tum
底	deg
氐	diu
杕	dumd
杕	dimd
媂	dunj
媂	ton
遆	duzj
遆	tozj
弟	tubp
弟	tbb
蹢	dozk
蹢	vozk
坫	dnt
玷	dnwk
磹	dnuu
佃	tzr
钿	tzj
甸	tzbt
甸	ufb
阽	dne
阽	ykek
屌	dzu
汈	dndd
铫	dbjd
铫	tmj
䏲	dqop
垤	dqtt
瓞	dqg
哋	doky
哋	duky
咥	dqkt
咥	xikt
楪	ywm
昳	yuou
喋	vsk
萣	djc
酊	day
丁	vgal
恫	dax
岽	dsed
鸫	dsdn
垌	tdtk
侗	tdrk
侗	tfr
唞	dxk
都	dul
髑	digi
黩	dih
芏	dyc
厾	duvs
毒	dsfm
渎	dmdd
读	dmy
阇	urmo
塅	dety
瑖	dew
簖	dev
耑	vre
祋	dcpy
镦	dvj
兑	rcb
兑	yrbe
砘	dtu
蹲	cuz
顿	ditr
敦	dcw
沌	ved
饳	diui
亸	dqw
㙍	doty
剟	doy
掇	dof
裰	dop
垛	ditm
堕	hvet
喥	dpk
喥	vlky
𥔲	ewu
崿	ewe
锷	ewj
堨	ewt
堨	aut
堨	ywt
恶	wyyx
恶	ety
恶	wuyx
姶	ewn
姶	ylnk
阏	ewm
阏	yjmd
蛾	ypiw
欸	ei
欸	eu
诶	eiy
诶	eoy
诶	ep
诶	euy
诶	xiyu
奀	enb
陑	etee
鲕	eta
鸸	eten
耏	nsep
佴	eer
佴	nsr
墦	fkt
蹯	fkz
氾	fhdv
噃	fjk
噃	bokt
蕃	fjct
蕃	fkct
肪	fjo
牥	fhn
邡	fhf
钫	fhj
蚄	fhi
蚄	bgif
枋	bjm
房	pjh
剕	fqf
镄	fqj
棐	frfm
榧	frm
篚	frv
蜚	fwf
鲱	fwa
痱	feb
斐	fwfw
芾	fqc
朏	fro
朏	kuo
妃	pqn
𣸣	fgdr
棼	fgmd
豮	fgu
鼢	fgjd
瀵	fddb
瞓	fdo
吩	ffk
翂	ffx
份	bbrd
赗	ffko
唪	fjkl
凨	fgjs
凬	fgjo
堼	fgtt
崶	fgec
沨	fgdx
砜	fgux
风	fjjx
浲	fhdf
浲	hddf
冯	pld
佛	firf
佛	burf
佛	bprf
幞	fijn
怫	fix
绂	fisd
艴	fifb
茀	ficf
菔	ficy
袱	fipq
郛	fipe
韨	fiw
㳇	fydx
蝮	fyi
讣	fyy
鲋	fya
滏	fod
簠	fov
玞	fuw
砆	fuu
稃	fuh
跗	fuzc
拂	buf
服	fyoy
洑	fidq
洑	fydq
琈	fiwz
琈	fuwz
父	fobx
夫	fia
榑	fimc
榑	fymc
榑	bpmc
䓛	foc
䓛	goc
䓛	qvc
呒	fok
副	pua
莩	ficz
莩	pzc
脯	poof
㕮	fokx
㕮	tbk
嘎	gdkg
晐	gdo
荄	gdcr
陔	gder
盖	hrym
㽏	ghdg
骭	ghg
橄	glmw
坩	gjtg
泔	gjd
疳	gjb
矸	gju
旰	ghog
旰	hhog
筻	ggv
㭎	ghm
杠	ghmg
钢	ggj
港	jsds
矼	qlu
矼	kau
戆	gglx
筶	gxv
藁	gbc
槔	gcmu
膏	gxw
镐	hxj
皋	hvb
塥	grt
槅	grml
滆	grd
骼	grg
虼	gwi
嗰	gtk
个	gtr
各	gtw
搁	grf
胳	grok
蛤	gri
革	jonl
哿	gtl
哿	jxl
镉	luj
鬲	gra
鬲	lual
疙	yubq
给	jpsk
哏	hhk
浭	ggd
畊	ggt
鹒	gggn
更	gga
珙	gfw
䢼	gsce
共	gscb
供	garb
唝	gakr
唝	gfk
蚣	vsis
媾	gmnr
遘	gmz
雊	gmb
玽	gcwk
笱	gcvk
耇	gcl
缑	gzs
姤	dynk
勾	gmbs
芶	gzc
芶	gccs
佝	gzr
佝	kmr
堌	gyt
痼	gyb
鲴	gya
𦙶	gook
瞽	gouo
罟	gos
羖	goyy
臌	gooy
馉	gouo
巭	gug
蓇	guco
轱	guik
鸪	guun
骨	gul
估	gyr
鹘	gog
嘏	gouy
嘏	jvuy
汩	ycdo
谷	ycbk
啩	gzk
诖	gzy
鸹	gxq
呱	gvkg
栝	gxm
栝	txm
栝	kim
爟	geh
瓘	gew
盥	gepm
鳤	gyak
涫	grdk
蒄	grcc
鳏	grad
观	gey
莞	grce
毌	wjv
広	gsgs
犷	gsq
垙	gltw
珖	glw
广	andi
桄	glmw
桄	gkm
刽	gcr
攰	gcu
筀	gcvt
匦	gnk
姽	gnn
宄	gnb
晷	gno
邽	gvte
鬶	gvfl
桧	hcm
氿	gnd
柜	jnmj
鳜	jya
龟	jydv
龟	qqdv
眭	gco
廆	gvg
廆	wrg
廆	hcgg
嶲	gve
嶲	xie
嶲	jee
鲑	xqa
磙	giu
棍	htmb
掴	gpf
虢	gpp
椁	gqmz
菓	gqc
埚	got
崞	goez
过	goz
过	gozc
哈	hdkk
哈	hlk
铪	kej
胲	hgo
嗨	hwkm
崡	hke
嵅	hkek
浛	hkdk
琀	hkw
虷	hki
邗	hkg
邯	hkge
蔊	hhcg
顸	hjg
犴	hjq
犴	abq
汗	hkdg
㘎	hlkw
㘎	hhkw
颃	hjw
夯	bddl
行	hhii
行	hgi
侴	hxrd
恏	hxnx
皞	hxbu
鄗	hxw
颢	hxor
嚆	hckk
号	hvkv
劾	hrw
姀	hrn
盉	hrh
盍	hrt
阂	hrmr
鹖	hron
龁	hrvq
垎	hwtk
翯	hwx
呵	aakk
呵	kek
颌	grrr
合	gtrk
纥	hrs
纥	ges
貉	hvv
貉	mivk
何	her
何	hwr
和	hwhk
和	hph
和	hihk
和	hihk
喝	hwkv
喝	ywkv
熇	xnh
嘿	mik
桁	hjmi
亨	pgwl
𫟹	hdj
玒	hdw
硔	hdub
荭	hdc
谼	hdbb
蕻	hac
讧	hay
訇	hsb
红	gss
哄	hskb
哄	hakb
瘊	hxbu
郈	hmpe
犼	hcqv
吽	hckn
吽	oukn
侯	hmru
囫	hikw
猢	hiqo
瑚	hiw
縠	hiuy
觳	hiuy
冱	hydh
嫭	hynh
嫮	hynk
岵	hye
扈	hyhb
昈	hyo
祜	hyp
鄠	hyy
鳠	hyay
鹱	hyny
琥	how
昒	huo
淴	hudx
滹	hudh
轷	hui
鹄	gonn
鹄	hwn
隺	hidf
隺	hwdf
唬	xzkj
骅	hcmu
嬅	hznl
化	hxrb
华	hzru
华	hxru
划	hzg
划	hkgd
划	gig
划	gqg
觟	hzd
觟	xodt
坏	pwt
坏	pitb
坏	petb
澴	htdy
荁	htc
萑	htcf
锾	htjy
鹮	htsn
擐	hef
逭	hez
㬊	hyoy
貆	htv
貆	hrvg
嬛	htn
嬛	qdn
喤	hakw
媓	han
瑝	haww
磺	hau
艎	havw
蟥	haib
鳇	haa
㿠	hkbw
滉	hkdw
潢	hadb
潢	gldb
晃	hso
橞	hcmx
蟪	hci
袆	hvp
豗	hvwu
隳	diex
烠	hbh
烠	hnh
虺	hvwi
会	kjrs
睢	hvof
珲	hvwi
混	hudb
婫	htnb
婫	kyn
惛	hyxo
惛	mdx
荤	xyci
佸	hpr
㸌	hihf
彟	hie
蠖	hiiy
锪	hijx
劐	hoc
耠	hol
喐	hike
喐	gpk
喐	xcke
濩	hydy
豁	hib
豁	hcb
漷	hqd
漷	hide
漷	kid
嚄	hiky
嚄	oq
伋	jorj
堲	jogt
姞	jonk
瘠	jobo
蒺	jocu
蹐	joz
垍	jut
惎	juq
漈	judx
瀱	judd
稷	juhw
罽	jusd
跽	juzx
鲚	jual
嵴	jpeo
掎	jpfk
虮	jpij
鱾	jpa
枅	jimk
犄	jink
畿	jiyt
跻	jiz
鹡	jidn
齑	jiwl
几	jip
耤	jolo
耤	jolo
偈	jqr
亟	qul
䓫	juck
䓫	qock
伎	qor
觭	qodk
稽	qpho
缉	qis
恝	jcfx
蛱	jci
叚	jvvy
斝	jvku
槚	jvmr
袈	jxly
假	jzry
夹	jxan
夹	gaan
家	jxbu
家	jpbu
价	jorl
价	jprl
袷	jcp
袷	jqp
瘕	jvby
瘕	xcb
瘕	xxb
楗	jnmz
牮	jnrn
饯	jnuj
硷	jxua
裥	jxp
趼	jxzk
锏	jxjo
瑊	jmwk
靬	jmg
鞯	jmgz
鳒	jman
渐	jmdj
溅	jmdj
鞬	jng
鞬	jmgz
篯	jxvj
篯	jmvj
监	jnlm
暕	jxoj
暕	lkoj
囝	jxk
囝	njkz
犍	qzn
见	xnke
弶	jkgx
洚	jkdl
膙	jso
礓	jlu
茳	jlc
豇	jlag
将	jkdc
浆	jkdu
疆	qaga
降	xae
嘦	jbkn
斠	jba
皭	jbbc
佼	jzrx
敫	jzbw
璬	jzw
皦	jzbw
䴔	jnwn
僬	jnrh
峧	jne
鹪	jnrn
剿	icvd
徼	jzi
筊	jzvx
筊	jbvx
脚	jyoe
角	jydy
嚼	jbkc
峤	jbe
峤	qmel
蕉	qmch
燋	jnh
燋	qmh
燋	jyhh
燋	vphh
艽	jncj
艽	qwc
姣	xmn
侥	yvr
缴	vpsw
㛃	jqfn
劼	jqul
岊	jqbe
蜐	jqi
讦	jqyg
鲒	jqak
骱	jogl
毑	jwmy
秸	jph
诘	joyk
拮	jcfk
结	jpsk
节	jqc
解	jodn
解	xodn
桔	jbmk
悈	jox
悈	kwxc
揭	qufv
颉	jqur
颉	jcur
碣	jquv
碣	yluv
墐	jvt
殣	jvda
浕	jvdd
溍	jvdo
瑨	jvwo
赆	jvkd
卺	jmlv
堇	jbn
琎	jbwz
尽	jmi
仅	jvry
劲	jjv
廑	jmga
廑	qng
矜	qnsv
矜	grsv
瀞	jjdl
獍	jjq
竫	jjll
丼	jaad
刭	javd
汫	jad
澋	jadx
璥	jaww
䴖	jkfn
猄	jkq
粳	jkmg
腈	jkoo
麖	jkgx
鼱	jkj
净	igdl
景	yaox
䌹	jfs
䐃	jfo
囧	jfkv
泂	jfd
颎	jfbr
坰	jst
炅	gcoh
㠇	jpey
桕	jpmj
赳	jqtl
䴗	jbo
屦	jcun
澽	jcd
犋	jcn
秬	jchj
弆	jnt
筥	jnvk
踽	jnzy
崌	jvek
椐	jvmk
泃	jvdk
砠	jvuq
腒	jvok
锔	jvjk
鞫	jvgk
苴	iscq
拘	gzf
据	jvfk
沮	jcdq
岨	jneq
苣	qncj
桊	jejm
罥	jeso
锩	jyjv
焆	jrh
焆	ywho
㵐	jydr
劂	jyid
桷	jymy
獗	jyq
玃	jyqy
砄	jyu
觖	jydg
镢	jyjr
觉	jbx
蹶	juzr
撅	jyfr
噱	jyku
晙	jto
畯	jtt
葰	jtcw
皲	jyby
莙	jyck
鲪	jyak
隽	jtrn
麇	jyg
麇	qug
浚	jtd
浚	xtdw
佧	kdr
咔	kdkb
咖	gakk
炌	ksh
剀	kged
蒈	kgc
嘅	kgkv
嘅	gtkv
楷	jpmb
忾	xuxq
衎	khi
冚	klb
戡	kjqg
嵁	kje
嵁	vhe
伉	kgr
𡐓	khtn
𩾌	kha
扛	ghfg
闶	kgmj
闶	khmj
洘	kbdv
洘	kxdv
溘	kwd
锞	kwj
骒	kwm
稞	kehg
蚵	keik
咳	hdkr
苛	hec
可	kwdk
嗑	kekm
坷	ket
坷	ktt
匼	kekk
匼	qzk
剋	kwud
硍	kdug
硍	xnug
硍	giug
硍	ymug
硁	kgu
埪	kst
崆	kse
硿	ksu
倥	ksr
倥	kfr
空	kfb
眍	kzox
芤	kzc
堀	kut
姱	hynk
挎	kuf
夸	kzd
狯	kjqs
㧟	kafk
浍	kjd
纩	kks
洭	kld
戣	kbv
暌	kbot
櫆	kbmu
骙	kbmt
篑	kcv
聩	kce
𫠆	knu
煃	knh
岿	kve
匮	gck
傀	knr
傀	gvr
溃	hcdr
蒉	kjc
悝	kvx
悝	lpx
阃	kimm
崑	kye
醌	kyyb
髡	kyaw
廓	kig
蛞	kii
括	gxf
鞡	lag
瘌	llb
菈	lac
剌	lsud
啦	lak
拉	lsf
腊	xioo
蜡	vlio
俫	lfr
崃	lfel
梾	lfm
铼	lfj
癞	llbr
徕	lsi
婪	lkmn
躝	lkz
罱	llsg
啉	lkk
桹	ljml
蒗	lgc
㫰	lkol
㮾	lkdm
崀	lkel
朤	lkoo
蓢	lkco
筤	ljv
筤	lgv
郎	lgd
莨	lgcl
莨	lacl
铹	lvj
嫪	lxn
耢	lxll
咾	lbk
荖	lbc
潦	lbd
潦	lxdx
玏	lwwl
砳	lwuu
了	lzv
乐	yrpd
乐	yxpd
乐	lxp
嫘	len
缧	lesx
癗	lrb
藟	lrct
嘞	lek
肋	leo
礌	lrut
累	lrt
堎	lft
棱	llmw
㰀	lomu
嚟	loku
漓	lodd
鲡	loal
傈	lurm
凓	ludm
坜	lut
朸	luml
浰	ludd
溧	ludm
猁	luq
珕	luwl
疬	lubl
篥	luvm
粝	lumw
蜊	luid
轹	luil
峛	lped
浬	lpdl
逦	lpzl
鳢	lpaa
砬	luul
砬	lau
砬	lsul
疠	lsbw
丽	load
哩	lpkl
跞	liz
釐	lowl
釐	xpwl
栎	yrml
郦	vole
裢	lzp
殓	lnda
潋	lndw
瑓	lnwj
蔹	lxcw
裣	lxpa
梿	lzm
梿	lxmz
磏	lzu
磏	qmu
𫟅	las
俍	larl
辌	lai
悢	lkx
倞	lkr
倞	jjr
凉	lkdx
踉	lazl
踉	lkzl
嫽	lmn
敹	lml
橑	lmmx
簝	lmv
鹩	lma
镣	lbjx
憭	lzxx
憭	lmxx
瞭	lzox
钌	lbjl
漻	lwdp
蓼	lycp
䴕	lodn
脟	loo
裂	lwdy
咧	lpkd
咧	lqk
咧	lpkd
冧	lnb
嶙	lne
潾	lndl
瞵	lno
粦	lnml
翷	lnmx
辚	lni
膦	lvo
廪	lmgx
箖	lnv
箖	lmvm
〇	llvv
㥄	llx
呤	llk
囹	llks
坽	llt
姈	lln
昤	llos
柃	llms
澪	llds
瓴	llrw
祾	llp
鲮	lla
崚	llew
岭	lles
令	llrs
令	lars
旒	lwf
瑠	lwwt
瑬	lwdy
疁	lwt
镠	lwjp
飗	lwjt
鹠	lwpn
鹨	lpxn
珋	lewe
罶	lest
馏	lput
馏	lwut
六	lywb
咯	lokk
咯	likk
咯	gek
昽	ldol
漋	lddu
癃	ldbu
砻	ldlu
哢	lakc
垅	lftl
笼	lfv
尨	ldu
尨	mhu
尨	pjud
剅	lxa
溇	lxdn
蝼	lxi
喽	lxkn
露	lyy
栌	limu
轳	lii
鸬	liln
僇	lyr
勠	lyxl
稑	lyh
箓	lyvu
菉	lycu
赂	lyk
辂	lyik
逯	lyzu
氇	lomo
澛	lodo
垏	lct
梠	lnmk
稆	lnhk
膂	lnfo
褛	lnp
偻	lxrn
绿	lys
脔	ltwr
銮	ltwj
抡	luf
攞	lpf
脶	lpo
倮	lqr
蓏	lqc
硌	liu
络	lxs
泺	podl
漯	lidx
漯	tld
呣	mxkm
唛	mlkw
祃	mlp
嘛	mskm
杩	mdmm
吗	mskm
吗	mdk
蚂	mai
蚂	mlim
蟆	mii
埋	mkt
脉	mioy
谩	mky
墁	mht
颟	mjcr
瞒	mgo
鞔	mkg
鞔	mdg
厖	mjid
杧	mjm
牻	mjnd
硭	mjuw
蟒	mjic
楙	mvm
茆	mvce
蝥	mvsi
眊	mxom
瞀	mxso
袤	mxwy
鄚	mxce
冇	mbu
泖	mbd
旄	mvf
旄	mxf
芼	mvcm
芼	mxcm
猫	mvq
冒	miko
么	mpp
么	map
么	ycps
槑	mek
瑂	mewo
郿	meve
镅	mej
躾	mru
没	midy
𫞩	mgw
们	mgr
㠓	mhe
幪	mhju
濛	mhdu
獴	mhq
甍	mhcw
礞	mhuu
艨	mhv
鹲	mhcn
擝	mgfm
氓	mhw
瞢	mjco
蒙	mjcn
縻	mogx
嘧	muk
弭	mpge
洣	mpdm
渳	mpde
脒	mpom
泌	budb
祕	bupb
秘	buhb
沵	mpdx
沵	ludx
谜	mqy
弥	mpgx
偭	mxrm
勔	mxml
愐	mxx
湎	mxdm
眄	mxom
渑	mxdd
渑	uhdd
鹋	mmcn
杪	mzmu
搣	mofh
慜	mnp
碈	mnu
苠	mnc
鳘	mmpa
湣	hydo
黾	mxkd
黾	mjk
玟	mnww
忞	mmw
忞	whwx
蓂	mlcb
螟	mlib
尛	mpx
耱	mil
藦	micu
貊	mivb
摩	mag
麽	megm
麽	magm
磨	migu
抹	mif
莫	mycd
蛑	mxi
踎	mxz
鍪	mxsj
缪	mps
缪	mys
缪	lzs
牟	mysn
毪	mimn
莯	mycm
姥	monb
嗱	nsk
镎	nsj
肭	nlon
雫	ndyx
那	ndv
那	nqv
那	nwv
那	npv
呐	nwk
哪	nrk
哪	nak
哪	nrke
𦰡	nlc
𦰡	npc
迺	ngzx
婻	nhn
萳	nlcg
赧	nlt
南	nau
难	nhy
难	npy
囊	nha
峱	nvqe
硇	nvu
蛲	nvi
臑	nxo
垴	nbt
嫐	nbn
淖	iidu
淖	vodu
呢	nokb
内	nll
恁	nnrx
能	nss
嗯	eg
𫠜	nove
鲵	noa
𨺙	nue
氼	nuu
薿	npcr
妳	npnx
妳	ngnx
泥	nudb
婗	none
婗	npne
伲	npr
伲	nur
溺	nbd
鲇	nza
鲶	nzax
唸	nnk
惗	nnx
撚	nxfh
捻	npfx
粘	nzm
嬢	nany
孃	nany
嬲	nzt
鸟	dzw
苶	nqc
嵲	noem
糵	nocm
臬	noz
蹑	nozy
菍	nocx
菍	rhcx
狞	nlq
聍	nle
泞	njd
甯	nlby
拧	nlfd
拧	njf
宁	vyb
狃	neq
妞	hxni
孥	ninz
笯	niv
傉	nyr
砮	nonu
胬	nonr
恧	nce
朒	nco
朒	gdor
女	rov
疟	yxba
傩	nprf
喏	rtk
哦	oi
哦	erk
喔	ookt
𠙶	oolk
沤	oud
呕	oukx
呕	oyk
潖	psdb
舥	pav
簰	pfv
派	pad
排	pgff
丬	pkdl
蹒	pkz
袢	phpb
柈	pkm
柈	bhmb
磻	pku
磻	bout
鳑	pja
膖	phoz
雱	phy
旁	bgwf
彷	fki
胖	pko
胖	phob
炮	pvh
炮	bch
麃	pvgh
麃	bng
跑	pvz
锫	pej
帔	pqjy
旆	pqf
珮	pqw
衃	pwx
喷	pdk
弸	phg
蟛	phi
彭	bhu
堋	phto
堋	bft
泙	pgdp
泙	pldp
鲏	poa
鼙	pou
䴙	puun
媲	pun
澼	pudu
甓	puuw
嚭	ppu
苉	ppc
狉	piq
陴	pie
吡	ppkb
淠	pqdl
埤	potu
铍	pijy
仳	por
劈	ppud
纰	posb
纰	bps
潎	pudw
潎	ppdw
㛹	pzn
楩	pzm
胼	pzo
蹁	pzz
骈	pzmk
𡎚	pxt
犏	pmnc
片	pmp
薸	pmc
嘌	pnk
螵	pni
骠	pbm
嫖	pnnx
票	pnxx
缥	pzs
玭	pnw
牝	pvn
榀	pmmk
频	bbv
呯	plk
帡	pljk
洴	pldk
玶	plw
荓	plck
蚲	pli
涄	pkdv
砯	pkuu
屏	bauk
淜	pldo
淜	phdo
苹	pgc
皤	ppbt
粕	pimb
笸	pqv
哱	pikz
哱	bakz
酦	poy
酦	fa
迫	pgz
魄	tib
魄	bpbg
裒	pxw
垺	pxtz
垺	fit
掊	pcf
掊	pxfk
墣	pitn
穙	pih
蒱	picf
酺	piyf
氆	pomo
瀑	bxd
朴	pomb
仆	purb
愭	qoxo
畦	qott
碁	qoqu
綦	qoqx
蛴	qoi
蜞	qoib
颀	qojr
鲯	qoab
汔	qudq
炁	qua
磜	quux
葺	quc
呇	qpu
婍	qpn
桤	qimj
郪	qiae
其	jiqb
奇	jidk
齐	juwl
齐	ziwl
齐	vdwl
岂	kgej
跂	qpz
妻	quan
砌	qou
契	qofd
契	xof
槭	swm
耆	uul
栖	ximx
蹊	qiz
踦	qizk
圻	yntj
𨙸	qoue
𨙸	viue
拤	qvfb
葜	qxc
墘	qzt
伣	qnre
椠	qnim
蒨	qnco
肷	qxo
圲	qmt
褰	qmby
鹐	qmdn
乾	gjuq
浅	jmdj
嵌	kher
荨	qzc
堑	zhit
堑	jnit
襁	qsp
镪	qsj
蜣	qli
玱	qlw
玱	chwv
蔃	qaci
蔃	jkci
跄	qlz
跄	qkz
抢	qlf
抢	igfv
强	qsg
强	jkgi
硚	qmul
鞒	qmg
缲	qnsm
缲	scs
鞘	ucg
睄	qmo
睄	uxo
睄	xnoo
俏	xbr
癿	qqb
茄	jxck
趄	qotq
趄	jvtq
且	jvla
郄	xuxe
嗪	qnkh
螓	qnih
锓	qmjy
嵚	qber
骎	qbm
慬	jvxa
慬	jmxa
勍	qlwl
暒	qlou
碃	qjuo
靘	qjf
苘	qack
郬	qkfe
箐	jkv
綮	qphx
鲭	vgao
䓖	qdcl
筇	qdv
跫	qdgr
銎	qdgj
㞗	qwu
訄	qwj
鼽	qwzj
鹙	qqh
湫	jzdh
蝤	yxi
佢	qbrj
劬	qbbl
欋	qbmf
氍	qbom
癯	qbbf
磲	qbum
㭕	qvms
坥	qvtq
岖	qve
胠	qvo
麹	qvfm
黢	qvh
趣	cyty
趋	cyte
渠	jcdm
瞿	jco
焌	qvhw
焌	jth
竘	qnlk
竘	kcl
觑	qvhe
曲	qvl
朐	qbok
朐	xcok
朐	iiok
瑔	qtw
鬈	qta
鳈	qtau
畎	qyt
悛	qrx
婘	qtn
婘	jen
棬	qrmv
棬	jem
圈	jek
圈	jrkv
券	xejd
悫	qrux
棤	qrmo
榷	qrmf
炔	gch
傕	qrr
埆	jyty
𨟠	qro
𨟠	jyoe
𨟠	qroe
雀	qnuf
阙	qtmr
碏	qruo
碏	xiuo
逡	qyz
䎃	rlr
珃	rlw
禳	rjp
蘘	rjc
瀼	rjd
瀼	nkd
儴	rjr
儴	xlr
荛	rvc
桡	nvm
娆	rbn
忈	rge
仞	rdr
纴	rdsr
衽	rdp
讱	rdyr
饪	rdu
稔	rhh
任	rgrr
礽	rhp
蝾	rdim
薷	rice
铷	rij
颥	riy
洳	rydk
蓐	ryc
堧	rtt
朊	ryo
瓀	ryw
媆	ryn
媆	ndnd
枘	rcm
汭	rcd
挼	rp
叒	riyy
爇	rich
鄀	rice
婼	rink
婼	iink
若	rtc
撒	saf
洒	xpdx
嗮	sgk
嘥	sdkr
塞	ssb
塞	swb
鳃	xpa
毵	sjsm
潵	shd
溞	scd
缫	scsg
埽	sbt
骚	sbm
璱	swwb
洓	swdn
洓	qudn
洓	zudn
色	ugd
閪	sem
閪	ximx
㴔	swdx
㴔	yudx
唼	ulkn
歃	ulq
嗄	ask
沙	uldu
煞	uadh
厦	xziw
墡	uhtk
嬗	uhnd
缮	uhsk
鄯	uhye
晱	ulo
搧	ujf
潸	ujd
羴	ujy
芟	ujcy
跚	ujz
杉	uam
姗	uhnc
苫	ujck
苫	uhc
钐	ujj
彡	ujpp
彡	xxp
掞	uhfh
掞	yhfh
掞	ylfh
恦	ugxk
垧	uktk
上	ukl
玿	uvw
筲	ucvo
杓	uvm
梢	sxm
柖	uvmk
柖	uxm
少	uxx
捎	uxf
稍	uxh
滠	uwdy
猞	ueq
奓	uedx
奓	ipd
奓	vldx
摄	nof
射	ywu
射	yuuc
蛇	yoi
畬	uert
畬	ybrt
胂	udo
瞫	uhou
侁	ufre
娠	ufn
沈	igdv
葚	udc
葚	rdcv
甚	ugq
莘	xbcu
嵊	ufen
琞	ufoy
眚	ujuo
湦	ugdu
焺	ugh
晟	ufoi
省	xau
実	uobn
炻	uohu
祏	uop
䏡	uuo
奭	uudb
昰	uuov
栻	uumg
襫	uupb
䴓	uia
浉	uidj
邿	uit
鲺	uiai
鸤	uiun
酾	udyl
拾	uwfk
什	ugr
食	surl
食	yurl
螫	uut
螫	vet
识	vuyb
氏	vipv
倏	uurq
婌	uuny
摅	uufx
毹	uurm
琡	uuwy
鄃	uure
陎	uuev
熟	uiwh
数	uimw
术	uimd
术	vimd
澍	vydc
属	vouy
刷	uzu
衰	cvw
腨	ueo
灀	ukd
礵	ulu
骦	ulmo
鹴	ulyn
帨	ucj
谁	uby
楯	dtm
铄	uij
硕	uour
说	ucy
说	yrye
亖	sue
汜	suds
耜	sul
㟃	sie
凘	sidj
楒	simx
飔	sijx
鸶	sisn
伺	curk
俟	qoru
思	sdt
𪨊	sdu
㧐	sff
娀	ssn
忪	vsx
瞍	scoy
擞	smf
傃	syr
僳	syrm
玊	syw
觫	sydu
蹜	syzb
骕	sym
鹔	sys
苏	sycb
狻	srq
𫟦	sciz
旞	scfz
璲	scw
穟	schz
襚	scpz
荽	svc
隋	dieo
孙	xtzx
溹	sidx
嗍	soko
桫	somu
惢	sqx
惢	rnx
挲	uadu
缩	sysb
遢	tlzx
阘	tlmx
鞳	tlgk
祂	tapy
嗒	tlk
她	jwn
鲐	tfa
榃	tkmt
郯	tkhe
锬	tkj
璮	tlwd
菼	tlch
钽	tlj
怹	tjrx
啴	tjk
啴	tokl
惔	tkxh
惔	dhxh
覃	tkxu
倓	thr
䣘	tjxe
樘	tjmt
螗	tjik
耥	tkl
镋	tkje
劏	thx
羰	thy
倘	ijrk
淌	ikdk
帑	tkn
帑	ninj
汤	uhdp
趟	tht
铴	tgj
铴	thjp
啕	tvk
洮	tvdd
鼗	tvey
慆	tcx
陶	yvef
忒	twy
忒	twyx
䲢	thoa
熥	tgh
熥	tsh
媞	tonr
瑅	tow
薙	tuc
逖	tuz
䴘	tip
提	difr
提	dpfr
绨	tosp
醍	tpyr
体	tir
趯	yrtf
禔	top
禔	vppr
擿	tifz
擿	vufz
擿	vdfz
畋	tztw
畑	tzh
阗	tzm
掭	tnfx
晪	txob
淟	txdb
觍	txqe
兲	tmwb
瑱	tzw
瑱	vdwb
填	vdtb
笤	tmv
迢	tmzk
髫	tmak
龆	tmvk
粜	tbi
嬥	tzn
朓	tzo
佻	tnr
祧	tnp
调	vzyk
苕	tmck
跳	tvzd
条	tnwm
窕	yvbd
䗴	tliz
葶	tlcd
圢	tatd
烶	tah
颋	tarr
铤	djjz
町	tatd
渟	tldd
渟	tkdd
桯	tkmw
桯	ylmw
𦒍	tdlx
𫍣	tdyk
峂	tde
茼	tdck
㛚	tfn
橦	iaml
峒	tdek
峒	daek
烔	dah
同	tak
穜	tdhl
穜	vfhl
僮	vkrl
头	tzdd
㻬	tiw
腯	tioo
葖	tucq
梌	timh
梌	ismh
稌	tih
稌	uohh
菟	ticd
吐	tyk
煓	trh
猯	trq
猯	teq
魋	tbg
氽	tiru
暾	tyo
焞	tyh
坉	tutt
坉	dttt
屯	vya
忳	tuxt
忳	vyx
忳	dtx
箨	tiv
萚	ticl
侂	tor
柁	dimb
拓	vofu
腽	wlom
佤	wdr
瓦	wla
哇	wak
搲	wafg
搲	wdf
搲	wlfg
喎	wdk
呙	wdkn
呙	hrk
呙	wqkn
呙	wakn
呙	gvkn
崴	wwen
芄	wkc
卍	whv
椀	wlm
塆	wjt
蜿	wji
万	miap
婠	wjn
婠	wlnk
涴	wld
涴	widv
妧	whn
宛	yrbv
箢	wlv
菀	ytcv
菀	yccv
王	wga
亡	wiwv
𣲗	wedw
峗	weev
洈	wedv
闱	wemw
螱	wqui
霨	wqyc
鳚	wqac
洧	wrd
韪	wro
溦	wwdw
烓	wwht
葳	wwcn
逶	wwz
鳂	wwa
硊	wruv
硊	gcuv
隗	wre
隗	kbe
亹	wrwq
亹	mgwq
㧑	wef
㧑	wrf
碨	wrun
碨	wqun
委	wwhn
硙	weu
硙	aou
硙	gsuj
尾	ypu
琟	wew
琟	ycwf
尉	ycuc
蔚	yccc
阌	wgmy
揾	wdfm
璺	wdp
辒	wfi
鳁	wfa
汶	mgdw
纹	wds
榅	wfm
榅	ytm
蕹	wfc
蓊	wjc
滃	wjdx
滃	wgd
偓	wir
幄	wijt
莴	woc
踒	woz
斡	wiuu
斡	gyuu
倭	wwrn
峿	wie
浯	widk
珸	wiwk
鋈	wyd
阢	wyee
靰	wyg
𣲘	wodw
仵	worw
牾	wonk
珷	wow
迕	wozw
洿	wudk
芴	wyc
芴	huc
无	mpa
旿	wyow
旿	woo
唔	wyk
吾	ycwk
铻	wijk
铻	ynjk
𠅤	xowx
喺	xok
嶍	xoe
隰	xoeh
鳛	xoa
係	xur
卌	xual
禊	xup
舄	xuj
阋	xum
憙	xpux
枲	xpsm
葸	xpc
蓰	xpcr
僖	xirk
嚱	xikg
巇	xieg
熻	xihx
爔	xihd
睎	xioj
矽	xiux
肸	xiou
菥	xicj
螅	xiix
蟋	xiix
觿	xidk
豨	xiuj
酅	xiee
饻	xiuy
娭	xinu
娭	ain
戏	huy
盻	xuo
盻	plo
恓	qix
恓	xcxx
歙	xirr
裼	xipw
裼	tup
傒	xurd
暿	xpok
洗	xxde
䜣	xiyj
䜣	xby
䜣	ynyj
柙	xcm
硖	xcu
翈	xcjx
黠	xch
罅	xzf
呷	gakj
虾	haix
挦	xzfc
鹇	xzmn
㬎	xxoh
崄	xxea
燹	xxu
禒	xxpu
忺	xmx
籼	xmm
跹	xmzz
锨	xmj
咁	xzkg
咁	gjkg
莶	xmc
莶	lxca
孅	xmnj
孅	qmn
盷	xzod
盷	tzod
铣	xxj
伭	xzr
伭	xtr
县	xtq
珦	xkw
瓖	xlwy
相	xkmo
详	yjy
咲	xbkt
涍	xbdz
婋	xnn
蟏	xnis
魈	xng
嚣	apkk
恔	xbxx
恔	jzx
蛸	uci
肖	xbxo
敩	xyx
㙦	xqrt
勰	xql
缬	xqs
𤫉	xowy
偰	xor
廨	xogn
榍	xomo
澥	xodn
瀣	xodj
薢	xocn
躞	xozy
揳	xpf
嚡	xqkt
嚡	hfkt
挟	jxfj
絜	xqfx
些	sive
血	xrpm
邪	ysy
邪	yrye
邪	ybye
邪	xbye
泄	yudu
枔	xnmv
炘	xvhj
衅	xvx
妡	xbn
杺	xbmx
信	ufrk
镡	xnju
镡	tkju
镡	ikju
芯	xvc
硎	xlud
钘	xljk
铏	xljd
陉	xle
倖	xjr
婞	xjng
悻	xjxg
瑆	xkwu
荥	xlcu
荥	ykcu
诇	xayk
讻	xsy
夐	xedw
珛	xpwo
滫	xedo
髹	xqam
鸺	xqrn
休	xnrm
冔	xbky
垿	xct
婿	xcno
昫	xcok
溆	xcdy
蓿	xccb
栩	xnmx
珝	xnwx
糈	xnmo
醑	xnyo
媭	xvpn
盱	xvo
谞	xvyo
顼	xvwr
魆	xvg
欻	ixhr
许	hoy
砉	xvf
砉	hxf
嘘	uiky
旴	xcoy
旴	xvoy
湑	xndo
湑	xvd
𫠊	xtmy
暶	xto
痃	xtb
昡	xeoy
琄	xew
碹	xeu
愃	xrx
揎	xrf
昍	xroo
晅	xrog
翧	xrbx
暅	xyog
暅	gfo
玹	xzw
咺	xykg
咺	xrkg
峃	xyxe
茓	xycb
峋	xueo
栒	xumo
珣	xuw
噀	xtk
獯	xyq
郇	htbe
熏	xtp
睚	ysot
揠	ylfn
玡	ylwy
蕥	ydc
垭	yat
吖	yaky
猰	ylqd
猰	jcqd
猰	qoqd
哑	yaky
呀	yaky
压	ylid
轧	gsiv
啱	ykku
琂	ykwk
虤	ykhj
蜒	ykiz
唁	yhkk
墕	yhth
烻	yhhz
觃	yhkz
兖	ylwe
厣	ylij
戭	ylb
扊	ylh
甗	ylhw
罨	yls
蝘	ylin
郾	ylk
黡	ylih
鼹	ylj
崦	yjed
恹	yjx
漹	yjdh
埏	yktz
埏	ujt
剡	ylhd
夵	yldx
夵	tcdx
研	yhuk
燕	yjnh
棪	ylmh
棪	yhmh
奄	yjdd
渰	yjdc
渰	yldc
咽	yjk
咽	ywkd
歅	yjxr
湮	ybdt
炀	yjhp
疡	yjbp
蛘	yjiy
钖	yjjp
咉	ykky
仰	ajr
卬	ykp
羊	xab
烊	ygh
鞅	yhg
鞅	ygg
媱	yvnf
滧	yvdw
猺	yvq
轺	yvik
靿	yxg
鹞	yxpn
崾	yben
窅	ybbo
要	ycxn
繇	yvpx
繇	vmp
铘	yrje
馌	ywum
嘢	ytkl
埜	ytmt
倻	yer
吔	yeky
掖	yefn
匜	yoky
宧	yobl
嶷	yoe
扅	yohx
椸	yom
痍	yoby
簃	yovx
㑊	yurd
佾	yuro
劓	yuzd
勚	yuul
嫕	yunx
廙	yug
晹	yuow
杙	yumy
枍	yumv
殪	yuda
疫	yuby
癔	yubx
绎	yusl
肄	yuby
螠	yuim
裛	yuwy
镒	yujm
鹝	yuan
鹢	yubn
扆	yph
酏	ypy
嫛	yikn
繄	yikx
黟	yih
眙	yook
眙	iuok
佁	yprk
佁	iurk
诒	dsyk
佚	dqr
仡	yurq
仡	gerq
疑	npb
荑	yoc
遗	wqz
迤	ypzy
迤	yozy
椅	yim
猗	ypq
嚚	ynkk
夤	ynxb
崟	ynej
烎	ynkh
訚	ynm
䲟	yvae
慭	yvl
溵	ybdy
禋	ybpt
骃	ybmd
珢	ynwg
珢	kdw
龂	ynvj
龂	khvj
龈	khvg
吲	ymky
吲	uhky
蟫	xuiu
窨	xybo
殷	yjp
殷	ympy
隐	yvex
溁	yldm
潆	yldx
茔	ylct
蓥	ylcj
媵	yjon
桜	ykmn
锳	ykjy
哟	yoku
㶲	yah
埇	yft
恿	yfsx
栐	yfm
鲬	yfa
墉	ystl
鄘	ysge
饔	yswl
鳙	ysa
涌	isdy
澭	ysdf
澭	yfdf
喁	ydky
喁	ybky
尢	yxu
蚰	yxiy
蝣	yxiz
鲉	yxay
莠	yccn
耰	yzl
麀	yzg
槱	ycmh
槱	ibmh
浟	yzd
浟	dodw
柚	yxm
有	ymuo
揄	ybfd
狳	ybqh
窬	ybbd
臾	ybpn
艅	ybvh
蝓	ybi
褕	ybpd
邘	ybye
雩	ybyk
髃	ybg
㳚	ycdu
妪	ycnx
棫	ycma
淯	ycdo
滪	ycdr
潏	ycdk
燏	ychk
燠	ychd
蓣	yccr
薁	yccd
饫	ycuy
鹆	ycbn
㺄	ynqd
伛	ynrx
敔	ynww
窳	ynbg
鄅	ynye
龉	ynvk
纡	yvs
込	yvzr
悆	ycrx
悆	uurx
愉	tzxd
於	wuf
矞	ycsk
矞	xcsk
矞	jysk
隃	ybed
隃	yved
隃	uye
育	yow
语	ycyk
雨	ycad
禺	ycld
禺	oold
俞	ycrd
俞	uyr
与	ycaa
与	yba
圫	yctq
圫	vyt
円	ytka
橼	ytmu
羱	yty
眢	yrxo
蜎	yri
垸	htt
薳	yyc
芫	ykce
媛	yen
远	yez
员	yukr
爚	yrh
籥	yrvc
妜	yrn
妜	jyn
钥	yxjo
约	ycsu
沄	yuds
涢	yudr
纭	yuss
郧	yuke
郓	ytb
酝	ytys
筠	jyvd
蕰	ytcm
蕰	wfcm
韫	wfw
馧	yyh
馧	wih
熨	ycuh
晕	yto
煴	yyhm
煴	yihm
缊	yys
缊	wfs
拶	zafx
拶	zlf
咋	vakv
甾	zivt
寁	zlb
趱	zlt
咱	zsk
咱	zdk
脏	zgo
驵	zkm
臧	zgw
臧	cjw
奘	vspd
𥖨	zxu
唣	zxkq
簉	zxv
帻	zrjr
沢	zrdi
箦	zrvr
赜	zrkr
昃	zwo
泽	uudl
责	vsfr
鲗	zea
矰	zguo
鄫	zgbe
缯	zfso
霅	vsy
溠	vldg
痄	vlb
蚱	vliv
䃎	vdux
拃	vdfv
鲝	vdya
挓	vafq
齇	vaz
楂	ismd
栅	uimc
栅	cwm
吒	vlkq
鲊	vda
鲊	vla
劄	vav
劄	vsvd
瘵	vsbx
砦	vsvu
偡	vhr
搌	vlf
飐	vljk
栴	vjmd
谵	vjy
鹯	vjw
崭	ikej
辗	nxi
嶦	vje
嶦	uhe
鳣	vja
鳣	uhad
占	vjl
僝	vhrz
僝	verz
僝	ikrz
幛	vgju
嫜	vhn
暲	vho
涨	vgdi
旐	vxfd
朝	vcu
炤	vxhk
炤	vch
爪	vbp
棹	vomu
磔	vrum
詟	vrl
䗪	vwgi
啫	uuko
折	vefj
折	urfj
嗻	vekh
嗻	vwk
嗻	vykh
嗻	vekh
这	vq
着	vpyo
着	vvy
着	vcy
纼	vds
昣	vhop
畛	vht
稹	vhh
袗	vhp
鬒	vha
浈	vfd
砧	vfu
葴	vfck
溱	vfdh
椹	vfmv
椹	udm
揕	vdfv
揕	vffv
怔	vgx
狰	vgq
掟	vjfr
掟	djfr
挣	vgf
正	vgav
钲	vfjv
踯	voze
庤	vug
忮	vux
晊	vuo
栉	vume
滍	vudi
觯	vudl
跱	vuz
踬	vuzr
铚	vujt
锧	vujr
骘	vuem
鸷	vufn
凪	vpjv
咫	vpib
扺	vpfu
茋	vpcd
轵	vpib
黹	vpyd
𦭜	vicb
榰	vimo
泜	vidd
胝	viod
痓	vubt
痓	iubt
畤	ixtc
畤	uutc
疐	vuur
疐	duur
祇	vppu
枝	qomy
殖	vodq
殖	uidq
峙	uuec
徵	vgiw
知	vuuk
织	vusb
只	vikb
茽	vac
螽	vswi
碡	vxu
㑇	vmr
籀	vmv
酎	vmyc
赒	vzk
辀	vzi
鸼	vzv
婤	vzn
婤	izn
粥	ycgg
啁	vzkk
啁	vckk
啁	tbkk
蠋	viii
杼	vyml
疰	vybv
纻	vys
翥	vyl
苎	vyca
槠	vumo
邾	vuve
助	iiq
褚	vop
竺	dove
苧	vycd
苧	nlcd
朱	uipw
筑	vivf
砫	vyu
砫	vouv
著	vpco
著	vec
髽	vxa
挝	vxfz
跩	vazy
拽	vkf
拽	ywfy
僎	verb
瑑	vew
颛	vrer
转	vai
惴	vcx
椎	ibmf
隹	cvr
隹	wer
追	dvz
窀	vybt
衠	vyii
谆	vyy
肫	iuot
椓	vpmn
浞	vpdr
禚	vpph
诼	vpyn
棁	vome
焯	voh
汋	vpdu
汋	qrd
叕	ypyy
叕	luyy
叕	jyyy
濯	vxdf
秭	zph
虸	zpi
姕	zivn
嵫	zie
訾	zivk
趑	zit
辎	zii
鄑	ziye
锱	zijt
镃	zijy
鲻	ziat
鼒	zic
茈	zpc
茈	cocb
粢	codm
呲	zikb
孖	maz
仔	zirz
觜	znv
疭	zab
倧	zsr
鬷	zsaw
纵	zfsr
鲰	zza
菹	zuc
卒	cywu
崒	zieu
崒	cce
珇	zow
珇	jcw
槜	zcmn
僔	zirc
撙	zifc
噂	zyk
嶟	zye
鳟	zya
咗	zokg
岞	ziev
胙	zio
阼	ziev
嘬	ijky
酢	cyyv
笮	zpvv
笮	zrvv
怍	vlx
柞	vlmv
叉	ilyd
戌	qvw
吁	yvk
芦	loch
饮	yvu
和	hoh
的	dib
经	jjs
虹	jki
咪	mpk
拜	bfuf
俱	jvrb
通	tazy
蔓	mkcy
膀	phof
艮	ghen
呃	eekv
豸	vspp
䏝	vro
𬉼	ooh
骀	dsmk
荥	ylcu
枸	gzm
眄	mnom
䥽	pojd
蛄	goik
挲	sad
锔	jbj
颏	krw
蜊	loid
谩	mhy
耥	thl
蓿	xvcb
镏	lpjt
蕻	hdcb
䦃	voj
氇	lumo
蠡	lovi
𬣙	xvyy
圫	tot
𬇕	whdw
𬣞	voy
𬘓	xusi
𫭟	out
𫭟	qvtx
𫭢	litb
㧑	hvfw
芘	bpcb
𫇭	wrcw
𫐄	yriw
𫵷	lue
呇	mduk
𬇙	bqdr
𬣡	jnyj
𫸩	kzg
𫘜	wgmw
𬘘	dls
𫘝	jymn
茋	dpc
𬨂	qoiu
𬀩	wrow
𬀪	xnoe
岨	qveq
𬬩	yujy
𬣳	hhy
𬩽	xuee
𬮿	gse
𬯀	jie
𫰛	xln
𬳵	pimp
𬳶	jsm
𬍛	luwl
鿍	ggtl
𬜬	mhck
𪾢	xnoe
虷	gji
峛	loe
𪨰	qveq
𫓧	fuj
𬬮	ikji
𬬱	jbjj
𬬭	lujb
侴	icr
㳚	xcdu
𬘡	ybsd
𬳽	ufme
𬘩	tks
𫄧	yksz
𪟝	jufl
𬍤	xuwc
𫭼	lvt
𬜯	lsc
𬂩	jxmj
𨐈	gli
𬌗	hryk
晅	xyog
冔	xnky
𫑡	mhk
𪨶	uee
𬬸	uyj
𬬻	lij
𬬹	ugj
𬬿	vcjk
𬭁	moj
𫢸	dhrl
𫗧	syu
烻	ujhz
𬊈	xuh
浰	lndd
浟	yxdw
𬒈	qrxu
𬳿	timh
𫄨	iisj
𬘫	htse
䂮	lrfu
琎	jvwz
埫	tktk
𫮃	uhtl
䓬	vpcu
䓨	ykcf
梣	qnmv
硔	gfu
鿎	dsuz
鿎	tduz
硍	ynu
㫰	lgo
𬱖	doyr
蛃	baib
𬟽	dsid
𫓯	jij
䝙	iuv
䏲	tiop
𬇹	gpd
𬍡	dgd
𬤇	ybyt
𫍯	xzy
𬤊	uuyr
𫍲	xzyy
艴	bpfb
𬯎	tbe
婌	uiny
𬘬	qnso
𬘭	ifs
𬴂	fwm
𫘦	tvmf
𬘯	visz
𫘧	lymu
琡	iywy
堼	hft
㙘	yctn
𪣻	lxt
萳	nkc
葰	sqc
棤	cim
𬃊	vumr
𬷕	bofn
𫐐	noi
𬹼	xovl
𫶇	dqe
𫖮	ype
鿏	msj
𬭊	dyjt
𨱇	qwjq
𫓶	xrj
𬭎	hdjs
𫖯	foe
脿	bzo
䐃	jtoh
𬱟	wrdr
𫛭	kaqn
𫷷	xbg
𬮱	ybmt
𬊤	ilh
㴔	jodx
湑	xcdo
𬴃	hom
𫘨	tom
蓂	muc
楙	mxmm
𬪩	ndyn
𬒔	gjuo
碈	hyuo
䃅	diul
硿	kaug
𬨎	yxiy
𫐓	rxi
𫫇	ewkx
𫓹	jijb
𬭚	iuj
𬭛	bojy
𬕂	lfvr
𬶋	jvak
𬶍	tpab
𦝼	lxo
𦝼	lbon
𫔶	nom
溹	sqd
滧	xbdw
𫌀	jipr
𫖳	yyy
𫘪	ytmx
𫘬	xomd
墕	yjth
𪤗	lbt
蔈	pbc
蔊	hlcg
𣗋	dkm
𬸘	ylkn
䃎	vlux
𬒗	lku
𫚖	cpv
𨱏	daj
𬭤	hxju
𫚕	uiaj
𬶐	vxav
𬶏	weav
𬸚	yrqn
𬤝	hcyx
𬙂	ylsb
㻬	tuw
薁	aic
霅	vlyk
噂	zikc
𬭩	wgj
𩾃	mxav
𬸣	xmb
𫍽	xryy
𬴊	lnml
𬞟	pnc
𬺈	ypvk
䗛	xqi
𪩘	yle
𬭬	hcje
𨱑	hajb
𬭯	pwj
𫗴	vju
𬸦	vpfn
𫄷	yusx
𤩽	htwq
磹	tkuu
𬭳	xpjk
𬭶	hwj
𫔍	fkjt
𬭸	lnjl
𨱔	zyj
𬭼	scj
𫔎	jyjk
𬸪	fkpn
䲠	iyao
𬶟	llad
𬶠	lnaj
𬶨	juga
𦈡	xvs
𫄸	xys
𬟁	yucn
䎖	zgbx
𬙊	mis
𬶭	juax
彟	ytey
𬶮	xpak
瀼	rgd
𬙋	xlsy
𬺓	iovr
𫚭	loav
