的	debu
我	wqga
是	uuoz
了	leal
你	nprx
在	zsut
和	hrhk
都	dzle
不	byab
有	ycuo
就	jpwy
也	ytvv
好	hbnz
个	gwrl
人	rgpn
说	uoyx
用	yakf
他	tary
这	vwzw
来	lfam
要	yxxn
去	qcts
会	hcry
看	khuo
中	vskl
想	xsmx
没	medu
啊	aakk
那	nlve
吧	bakb
给	grsk
能	nhsb
对	dcyc
上	ugba
到	dxgd
多	doxx
吗	makm
里	lptt
被	bqpp
做	zirw
又	ymvn
过	gizc
让	rgyu
还	hfzb
她	tany
打	ddfd
把	bdfb
而	etal
着	veyo
大	dlar
从	cdrr
它	tabb
写	xwby
再	zsar
字	zubz
得	derc
搞	gbfk
狗	gcqj
猫	mcqt
一	yiaa
真	vfub
下	xzab
但	dhrd
叫	jbkj
很	hhrg
比	bpbb
呢	nekb
最	zcoy
更	gfan
地	duty
地	dety
等	djvc
吃	iikv
像	xkru
后	hmik
时	uooc
只	vpkb
点	dxvh
先	xmne
话	hzyu
与	ynva
快	kjxg
玩	wkwy
当	dhxe
已	ypkv
问	wdmk
完	wkby
以	yplr
将	jllc
您	nnrx
找	vbfg
爱	auvy
太	tsdd
谁	ueyv
才	cfup
年	nzpf
新	xblj
跟	gfzg
别	bqkd
学	xyxz
哇	wakt
按	abfn
哎	aikx
前	qzbd
睡	ucot
加	jxlk
所	sqhj
为	weld
为	wqld
可	ktdk
出	iuuu
该	gdyr
向	xkpk
却	qrqe
哦	opkw
小	xzlb
天	tmad
高	gcwk
买	mgad
呀	yaky
刚	ghkd
事	uugy
好	hxnz
坏	hjtb
发	fafy
全	qtrw
开	kdac
万	whav
之	vidn
心	xbdd
帮	bhfj
回	hbkk
得	drrc
牛	nwpu
家	jxbu
长	ijpn
月	yrke
卖	msud
岁	scux
成	ihwv
唉	auku
跑	pbzb
走	zctz
早	zbou
连	lzzi
滴	didg
越	yrtl
无	wiay
阿	aaek
送	sazt
分	ffbd
黑	hwlh
额	erby
妈	manm
换	hefd
们	mfrm
难	nkyv
同	tdkk
祝	vypx
恩	enyx
干	ghau
算	sevc
路	lyzk
并	bjbk
呗	bwkb
少	ubxp
猜	cdqo
放	fgfw
擦	cafu
转	vyiv
错	cijo
脸	lxoq
贴	tpbv
陪	peek
带	dscj
笑	xbvy
敢	glew
谱	poyo
拿	nsru
二	eeaa
煮	volh
鸡	jiyn
或	higa
书	uuvd
每	mrpm
画	hzat
坐	zitr
咯	kdkk
掉	dbfu
讲	jsyj
梦	mfmx
冷	ljds
花	hxcb
于	ybau
手	ucpy
咋	zdkv
哟	yoku
爆	bxhu
站	vhlv
变	bnwy
看	kjuo
哥	gekk
版	blpy
水	unln
起	qptj
图	tikd
弄	nawc
住	vyrv
啦	lakl
够	gmjx
咩	mpky
累	lqtx
倒	dxrd
肉	rmnr
毛	mvpv
神	ugpu
请	qayo
拉	lafl
肿	vfov
听	tkkj
内	nqkr
噢	ookd
唱	igko
骂	mlkm
装	vlly
三	sjae
蛮	mkwi
腿	tnog
正	vfav
瘦	umby
卤	lobx
俺	azrd
老	lblb
俩	lvrl
抱	bxfb
忙	mjxw
超	ictk
疼	thbd
胖	pgob
喔	wokt
车	ieau
某	mcgm
第	duvd
教	jnlw
生	ugpf
中	vakl
进	jvzj
假	jvry
差	ilyg
忘	wgwx
热	rwfh
选	xyze
啥	uskg
微	wwrj
求	qwud
若	rick
些	xpve
久	jedn
苦	kocg
米	mpbm
约	ytsu
飞	fwvd
吓	xzkx
亲	qblm
照	vxoh
赢	ylwb
饿	ewuw
读	diyd
秒	mzhu
信	xvrk
另	ljkl
儿	etpv
靠	kxnf
聊	lmee
远	yyzy
懂	dfxv
羯	jqyr
低	diru
呆	ddkm
晒	usox
追	vvzl
见	jnke
跳	tbzv
挂	gzft
哪	ndke
鸟	nzna
呃	ewkv
挺	taft
贵	gcvb
元	ytaw
摩	mpgu
疯	fgbf
张	vhgi
萌	mhco
头	txdd
活	hpdu
行	xlrd
哒	dakd
次	cudq
本	bhma
骗	pnmc
店	dngv
考	kblk
歌	gekq
喂	wqky
强	qagi
死	spdb
收	uzjw
贱	jnbj
噗	pukf
恨	hdxg
撸	lufo
喵	mnkt
亮	lkwj
弱	rigg
破	piup
哼	hgkl
拍	pdfb
躺	tkuk
抢	qsfv
吐	tokt
日	ruka
谈	tkyh
饭	fhuy
帅	ujlj
离	lown
号	hxkk
闹	nxmj
办	bhld
还	htzb
养	ykbl
红	hdsg
猪	vuqo
刷	uxud
呐	nlkn
姐	jwnq
洗	xpde
种	vahv
喝	hekr
菜	cscc
如	rink
赞	zhnb
丢	dqpq
捏	npft
非	fwls
粉	fhmf
怕	plxb
坑	kgtj
网	wkkx
总	zfbx
曾	chbo
爹	dpfx
蛋	dhzi
型	xlkt
咱	zkkz
屎	upum
纸	vpsu
杀	uaxm
自	zupo
白	bfpo
急	jodx
催	cvrv
吖	aaky
改	ggjw
特	twnc
包	bcbs
愿	yeix
妹	mqnw
唔	wikk
受	umvy
抓	vxfv
钱	qzjj
者	vtlo
喷	pfkb
鱼	ybda
瞎	xxok
此	cpvb
乱	leuv
滚	gidg
呦	yzkl
晚	wloe
留	lwpt
晕	yyoi
风	fgjx
抽	izfy
块	kjtg
怪	gjxt
度	dygy
戳	ioxg
往	wkrv
便	bnrg
楼	lxmn
党	dkxx
咬	ybkf
吹	ivkq
练	lnsd
删	ujcd
条	tmwm
耶	yree
丫	yabl
系	xupx
君	jyyk
丑	icvt
件	jnrn
近	jvzj
两	lsar
雨	ynad
力	luvp
面	mnao
球	qwwq
重	idql
火	hqbr
爬	psvb
脚	jzoe
管	gyvl
偶	oord
行	hjrd
痛	taby
黄	hacb
嘴	znky
戴	dsgg
情	qlxo
各	gwwk
门	mgdv
卡	kdub
倒	dbrd
跪	gczv
道	dxzz
病	bjbn
边	bmzl
搜	szfy
短	dyub
混	htdb
呵	hekk
指	vpfo
翻	fjcx
词	coyk
招	vcfk
尿	nbuu
摸	mofd
嘤	ykkn
撒	sdfw
毁	hnju
顶	dady
马	mdva
喊	hlkk
由	yxlt
悲	bwfx
组	zosq
帖	twjv
则	zrbd
爪	vvin
配	pqyj
乃	ngvp
斤	jbil
秀	xphn
伤	uhrl
喽	lzkn
蓝	lkcm
及	jopn
谢	xoyc
报	bxfy
因	ybkd
泡	pxdb
未	wqam
款	kytq
定	djbz
深	ufdm
渣	vadd
粗	cumq
咔	kakb
爸	blfb
输	uuid
床	iagm
碗	wluv
外	wsxb
宅	vfbq
纯	iust
熊	xdsh
汗	hhdg
搭	dafk
药	yxcu
使	uprl
感	glwx
宫	gsbk
双	ulyy
演	yldb
木	myur
粑	bamb
班	bjwl
赚	vebj
货	hirb
亿	yurv
拼	pbfk
嗨	hdkm
其	qocb
名	mlxk
类	lqmd
棒	bgmf
王	wjat
骑	qomk
片	pnpv
金	jbrb
茶	iscm
处	iywb
砸	zsuj
查	ismd
光	glxe
气	qupv
枪	qlmv
句	jcbk
扔	rgfn
试	uuyg
嫁	jznu
且	qwoa
切	qoqd
醒	xayu
惹	rtcx
停	tlrd
树	uymc
爽	usdx
台	tfsk
口	kcla
半	bhbf
鞋	xqgt
雪	xuye
任	rdrt
摔	ukfu
接	jpfn
操	ccfm
娶	qnen
入	rypn
提	tofz
狠	hhqg
背	bwbo
挖	wafv
烂	lhhl
级	josj
间	jmmo
乖	gkqb
达	dszd
云	yuas
冲	isdv
团	ttkc
瓶	plbw
踢	tizw
主	vowt
硬	yjug
魔	mpgg
嘞	lwkl
女	nnva
动	dayl
剪	jxbd
线	xnsj
叔	uuuy
念	nnrx
表	bzfy
挑	tnfv
致	vugw
槽	cvmo
满	mldl
甩	uayv
油	yxdy
皆	jpbb
捡	jxfq
省	ujuo
八	bapn
皮	popy
子	zpla
酒	jedy
救	jpqw
穷	qdbl
亦	yuwb
忍	rhrx
妞	nqni
反	fliy
呜	wukw
部	byle
借	joro
插	iafj
街	jprt
烦	fkhy
关	grbt
草	cbcu
诗	uiyc
直	vouq
踩	cgzc
嘿	hwkh
课	kwyg
臭	imzq
城	ihti
票	pbxu
剩	ufqd
趣	qcty
握	wift
李	lpmz
嘛	makm
撞	vkfl
汤	thdp
刀	dcvp
挤	jpfq
替	tufo
夜	ywww
至	vugt
扯	itfv
懒	llxb
房	fjhf
腰	ycon
香	xlho
安	anbn
奔	bfdc
穿	irby
凭	plrj
咦	yoky
杯	bwmb
泪	lqdo
慢	mhxy
虐	nrhe
逛	gkzw
碎	scuu
既	jugw
痘	dmbb
题	tooy
舔	txux
即	joge
凉	ladx
准	vidv
占	vhbk
屁	puub
记	juyj
胸	xsox
摆	bgfq
国	gpky
蛇	urib
派	psdy
称	ighx
拖	tofy
盘	pkvm
控	kafg
血	xwpm
咧	lwkd
忒	tvyx
味	wqkw
交	jnwf
四	suke
投	txfu
偷	tzrd
涨	vkdi
躲	dqum
推	tvfv
抹	mqfw
副	fyad
式	uuyg
搬	bjfu
咪	mikm
尽	jvid
堵	doto
藏	cjci
山	ujkl
虎	hohj
乐	lwpx
左	zqug
吵	ibku
岂	qpuj
欠	qndr
传	itrv
笨	bdvb
寄	jubk
麽	mpgm
修	xqrp
烧	uchw
眼	ylog
机	jimj
相	xlmo
套	txds
撑	igfu
蝎	xpir
落	lick
绿	lcsu
折	vrfj
甜	tzug
糖	tjmk
奥	aipd
鬼	gnps
份	fdrf
烤	kbhk
命	mjre
补	bopb
象	xkdu
节	jpce
惨	clxp
熟	uxwh
瞧	qmoh
群	quyy
海	hgdm
墙	qatk
作	zirv
鸭	yajn
样	ygmy
圆	ytkb
嫌	xznj
逗	dmzb
身	ufzc
旧	jplo
断	devj
歪	wdbv
戏	xuyg
段	depu
罗	lpsx
窝	wobn
盖	gsym
羊	yjbf
闲	xzmm
美	mryd
夹	jcar
觉	jyxj
炒	ibhu
仍	rhrn
莫	micd
排	pfff
五	woaw
傻	udrw
篇	pmvc
性	xjxu
租	zuhq
几	jppv
周	vzkk
桥	qmml
区	qvkx
队	dcer
碰	pfuy
蹭	cfzo
哈	hakk
拆	idfi
卷	jyjv
哭	kukq
场	iktp
吻	whkw
男	nktl
应	ykga
哄	hfkg
签	qmvq
法	fddq
色	swdb
需	xvye
流	lwdi
杨	yjmp
逼	bizt
娃	wsnt
劝	qeyl
圈	qrkv
集	jorm
语	ynyk
涂	tidm
平	plau
期	qico
暖	nyoy
座	zigr
缺	qtfg
矮	apun
空	ksbg
软	ryiq
憋	bpxx
肥	feob
退	tczg
扑	pufb
耍	uven
牌	pfpu
烟	yjhy
狼	ljql
减	jxdk
抄	icfu
理	lpwl
劈	piud
印	yvpe
望	wgww
陈	iged
郑	vfbe
整	vjuv
郭	gowe
蹲	dyzc
恋	lnwx
兔	tydd
娘	nanl
知	viuk
驴	lbmh
辣	llxu
偏	pmrc
噶	gskr
据	jcfg
数	uymw
清	qkdo
游	yxdz
粮	laml
归	gvle
灰	hvuh
姓	xjnu
绝	jysb
么	meps
欲	ycgq
豆	dmab
剧	jcud
待	dsrc
待	ddrc
那	nave
犯	fhqv
师	uilj
位	wqrl
捉	vofz
扣	kmfk
较	jbif
齐	qowl
灯	dghd
明	mloo
酸	sryw
帝	duwj
值	vorq
论	ltyl
季	juhz
土	toua
右	ymuk
啃	khko
熬	apfh
揍	zmft
赶	gltg
银	ynjg
合	hrrk
细	xust
厚	hmiz
西	xiak
南	nkug
朝	ivuo
狂	kaqw
随	sbeo
瞅	icoh
界	jotj
盯	dkod
趁	idtp
淡	dhdh
轻	qkij
岛	dbnu
嗷	apkw
拔	bsff
猛	mjqm
扒	bafb
宝	bbby
脱	toox
方	fhwv
刮	gxud
费	fqfb
遍	bnzc
抠	kzfq
霜	ulyo
零	llys
星	xkou
夸	kxdk
邮	yxye
睇	duod
汪	whdw
取	qney
菇	gucg
易	yuow
蒸	vgch
愁	ixhx
症	vfbv
化	hzrb
足	zikz
佛	fprf
揉	rxfm
六	lpwb
码	mdum
龙	ldyp
糗	qemq
馋	ikud
刘	lwwd
服	fioy
蟹	xodi
牙	ysgp
富	fybt
吾	wiwk
冰	bkdu
七	qiav
常	ijxj
底	dpgu
仅	jmry
习	xovd
粘	vjmv
奖	jsld
妆	vlln
爷	yrfe
吼	hckv
弯	wjwg
炖	dtht
嫩	ndnw
文	wgwx
基	jict
经	jksj
坨	tptb
射	uwuc
单	djbu
薄	bvcc
隔	greg
史	upkn
伞	slru
搓	cofg
跌	dpzf
雾	wyyl
必	buxp
呸	pwkp
捧	pjff
似	surr
困	ktkm
掰	bduu
令	ljrs
怎	zhvx
刺	cuud
答	dsvk
冒	mxoo
凶	xskx
船	itvk
酱	jkly
趴	pazb
闪	ulmr
昂	ajoe
紧	jmlx
贼	zebu
电	dnyv
声	ugtu
具	jcqb
压	yaid
雷	leyt
湿	uidy
钻	zrjv
登	dgbb
啪	pakb
咋	zrkv
百	bgab
终	vssd
哆	dokx
酷	kyyk
波	bodp
林	lnmm
治	vudk
醉	zcyu
唯	wekv
弹	tkgu
砍	kluq
原	ytix
咳	krkr
猿	ytqy
秤	ifhp
害	hsbk
甚	udcb
锅	gojn
官	grbl
遭	zczo
赌	dobo
怒	nynx
飘	pnxf
炸	vlhv
胡	higo
村	cymc
仔	zprz
解	jwdn
订	djyd
卧	wiib
播	boft
捂	wofk
伐	fsrg
量	laol
量	lkol
割	gebd
淘	tvdf
埋	mftl
塞	sdbt
略	lrtk
淫	yndt
宽	krbj
透	tmzn
凑	cmdt
劲	jvjl
重	vaql
届	jouy
倍	bqrk
胃	wqto
嬛	xrny
举	jnxf
灭	moah
残	ckdj
封	fgtc
属	uouy
脑	nbox
粥	vzgm
福	fipt
扫	sbfe
韩	hkuw
废	fqgf
升	ugpc
煎	jmbh
征	vgrv
捞	lcfl
罚	fssd
慌	hlxi
价	jzrj
今	jbrv
叠	dqyq
饼	bauk
勒	lwgl
母	momd
存	cuuz
杜	dymt
胜	ufou
毒	difm
虽	svki
妖	ycny
叼	dnkd
负	fydb
根	gfmg
春	iyio
虾	xxix
迷	mozm
啰	lokx
寸	ctud
体	tprb
供	gsrg
抛	pcfl
烫	tgdh
拽	vjfy
防	fjef
炮	pxhb
冻	dadd
编	bmsc
侠	xcrj
勿	wybp
共	gacb
纹	wgsw
闻	wgme
北	brlb
挡	dkfe
守	ucbc
拌	bhfb
甄	vfxw
牵	qmdn
发	flfy
克	kwux
摄	uwfy
布	byuj
降	jkef
怂	sfrx
笔	bpvm
奶	ngnn
曰	ytka
霾	mfyl
颗	kegy
九	jepv
泥	nodb
於	ybfd
教	jblw
瑟	swwb
遮	vezh
澡	zbdm
痒	ykby
锁	sqjb
吸	xikj
敷	fufw
德	drrx
踹	ijze
介	jorl
吊	dbkj
舞	wopf
含	hkrk
浓	nddy
料	lbmd
蹦	bfzo
嘎	gakg
潮	ivdo
长	vkpn
现	xnwj
壳	krtj
调	tmyk
调	dbyk
罪	zcsf
证	vfyv
亏	kvak
剃	tubd
摇	yvff
肾	udlo
素	syfx
填	tztb
精	jkmo
沾	vjdv
盒	hrrm
闷	mdmx
犬	qydd
通	tszy
铁	twjf
洞	dadk
架	jzlm
腻	nuob
公	gsbs
露	lmyk
著	vyco
晃	hkoe
潘	pjdt
铺	pujf
砖	vruv
孔	kfzv
乳	rovv
食	uorg
垫	dnft
建	jnzy
什	uoru
键	jnjy
捅	tffy
饱	bbub
欧	ouqq
伪	wrrw
兽	umbk
盼	phof
滑	hcdo
运	ytzy
绕	rxsw
缠	iksl
戒	jogc
散	shcw
散	slcw
拜	bsuf
嘘	xvky
枰	plmp
赵	vxtx
屏	pluk
脏	zhot
页	ywab
范	fhcv
逃	tvzv
馆	gyul
结	jqsk
领	lary
巨	jckk
处	iowb
言	ykwk
梗	gjmg
攒	zlfb
翘	qbyx
挠	nvfw
溜	lqdt
市	uuwj
伴	bhrb
分	fdbd
剑	jnqd
初	iupd
利	luhd
啧	zrkb
针	vfju
掐	qxfj
啵	bokp
博	bpuc
否	fcbk
巧	qzgk
虚	xvhy
造	zxzk
寻	xuec
蠢	iiii
托	tofq
朵	dqjm
逆	nuzn
骚	scmi
层	chuy
测	cwdd
何	hrrk
磨	mpgu
局	jbuk
剁	dijd
缘	ytsu
般	bjvu
代	dsry
诺	niyk
均	jyty
叶	ywku
肌	jioj
东	dsax
宠	ifbl
端	drle
税	uchx
首	ucbz
容	rdbg
斯	sicj
物	wynw
录	lyeu
丽	luad
盐	yktm
吴	wikt
败	bsbw
稍	ucho
咸	xzwk
摘	vdfg
矣	ypsu
众	varr
惊	jkxx
竟	jjle
敲	qnwy
嗲	dvkx
干	gjau
漏	lmdy
湖	hido
沉	igdj
截	jqgv
朱	vupw
付	fyrc
醋	cyyo
撕	sifj
获	hicq
朕	vdot
冥	mlbl
轮	luil
丝	sisa
河	hrdk
炫	xehx
塔	tdtk
袁	ytty
喜	xptk
魂	huyg
挣	vffy
赔	pebk
耳	eyol
碧	buwu
撤	iwfw
贪	tjrb
扛	kjfg
镇	vdjb
肺	fqou
祸	hipn
果	gqtm
怀	hlxb
嚯	hikv
刑	xlkd
拱	gffg
顺	utiy
器	qukk
秋	qqhh
孙	syzx
巴	basl
捐	jrfo
屋	wuut
沪	hydh
猴	hxqu
龟	gvdd
夏	xzbw
耐	nsec
转	veiv
仨	sars
争	vgdy
肯	khvo
歇	xpoq
板	blmy
案	abbm
极	jomj
扭	nefi
观	gryj
卸	xove
兼	jmbb
设	uwyu
趟	tgtk
攻	gsgw
抖	dcfd
除	iiem
静	jjfy
旁	pjwf
稳	whhx
董	dfcv
逢	fhzf
驾	jzlm
浅	qxdj
环	htwb
申	uftl
拒	jcfj
遇	yczd
绑	bkse
乘	ihqr
缩	sosb
泰	tsiu
紫	zpvx
认	rdyr
串	iekl
痣	vubx
沙	uadu
友	ycuy
尼	noub
战	vhvg
臀	tuuo
员	ytkb
丁	dkal
股	goou
步	byvu
档	dgme
嘻	xikk
鼻	bozw
叻	lwkl
识	uoyv
颇	popy
限	xneg
幅	fijt
响	xskk
旅	lnfy
跨	kzzk
崔	cvuv
意	yulx
侬	ndry
哩	likl
糕	gcmh
威	wwwn
麻	msgm
赛	ssbb
瓜	gxin
拧	nafd
室	uubt
愣	lfxf
显	xxoy
尊	zybc
寒	hkbd
广	gsdi
率	lcwu
品	pmkk
休	xqrm
凹	aola
维	wesv
裤	kypi
蒙	mhcu
搂	lzfn
苏	sucb
斜	xqrd
免	mxde
居	jvug
餐	cjdg
膏	gcwo
染	rldm
轰	hsiy
唐	tjgk
幂	mubj
婚	hyno
摊	tjfv
瑕	xcwy
皂	zxbq
桶	tfmy
立	luwb
客	kwbk
枕	vhme
状	vklq
闯	ismm
坟	fgtw
扶	fiff
故	gygw
千	qmpu
尾	wrum
震	vdyi
粽	zamu
叹	thky
古	gouk
灵	lleh
堆	dvtv
恶	ewyx
损	sifb
呼	hukh
琴	qnwv
虫	idvd
展	vluy
善	uhyk
芙	ficf
抗	kgfj
狮	uiqj
科	kehd
松	ssmg
徐	xbrm
充	iswy
乡	xlvp
嗒	dakk
弄	lawc
拎	lbfs
须	xvpy
衫	ujpp
尖	jmxd
森	sfmm
扎	vafv
膜	mpod
晴	qloo
婊	bzny
衣	yiwy
棋	qomb
迟	iozi
酥	suyh
章	vhlu
产	ilwi
僧	sgro
竖	uyll
横	hhmh
兄	xske
聚	jceu
娇	jnnl
十	uoal
石	uoak
宋	sabm
尚	ugxk
依	yiry
瞄	mmot
旺	wgow
妙	mbnu
膘	bnou
甘	gjca
啾	jqkh
田	tzku
噜	luko
距	jczj
悬	xtqx
己	jpkv
青	qkfo
郎	ljle
糟	zcmo
雅	ydyv
惯	gexb
唷	yoko
噻	sdkt
麦	msfw
侃	klri
钓	dbju
罢	blsq
京	jkwx
丹	djkd
添	tmdx
曲	qnkc
嚼	jmkc
扇	uhhx
芯	xbcx
赖	lsub
许	xnyu
音	yblo
葱	cscx
丸	wkld
搁	gefk
娜	nlne
揪	jqfh
榜	bkmf
遛	lpzt
宰	zgbx
俩	lsrl
赏	ukxb
谷	gobk
曝	bxou
赐	cubw
黏	nzhv
腹	fyow
桌	vobm
蜜	mubi
消	xndo
勺	uvbd
辞	coux
江	jldg
兵	bkqb
裙	qupk
蝶	dqim
饮	ymuq
蔡	cscu
侧	cwrd
告	gxnk
寺	sutc
仙	xmru
赴	fytb
甲	jvtl
角	jzdy
钗	idji
薛	xtcx
止	vplb
港	gkds
磕	keum
曹	cvco
崽	zgux
巾	jbkl
坎	kltq
评	plyp
窗	ilbw
勾	gzbs
罐	gefv
艾	aucx
咖	kakk
斗	dmud
凡	fkjd
继	jusm
刻	kwwd
保	bbrm
厄	ewiv
蕾	lrct
抬	tffk
驻	vymv
弟	dubd
喘	iyke
壮	vklt
喇	ldkd
皱	vmdp
扎	zafv
唰	uxkd
附	fyec
格	grmk
失	uipf
暗	aboo
野	ytly
橙	ihmb
裸	lqpg
桑	shym
蘸	vhch
嘉	jxtk
沟	gzdg
民	mnvv
厂	ikap
袋	dsry
疤	babb
拨	boff
靴	xtgb
涅	nodt
园	ytky
弃	quwc
汁	vidu
梨	lohm
列	lodd
灌	gedv
净	jjdy
温	wfdm
批	pifb
互	hyah
罩	vxsu
尔	eydx
帐	vgji
柜	gcmj
圣	ufyt
馅	xnuj
挫	cifr
粪	fdmg
曼	mhoy
肝	gjog
梁	ladm
然	rkxh
仇	ixrj
披	pifp
邪	xqye
支	viuy
扁	bxhc
翔	xayx
肩	jmho
液	ywdw
掏	tcff
末	miam
杠	ggmg
院	yeey
姜	jlyn
谨	jmyw
瓦	wdad
扮	bhff
焦	jnrh
湾	wjdg
堂	tjxt
湘	xldo
智	vuuo
钟	vsjv
辆	lkil
莎	uacu
联	lzet
瞪	dfob
祭	juxu
项	xkgy
壶	hity
奇	qodk
枚	memw
兮	xibk
颜	ykwy
薇	wwcj
术	uymd
镜	jjje
拐	gafl
兜	dzpe
俄	errw
围	wekw
优	yzry
贺	hwlb
景	jaox
余	ybrm
剥	bced
崩	bguo
工	gsaa
盗	dxdm
吞	tytk
窄	vgbv
军	jybi
陆	lyej
携	xqfn
痴	iibk
影	yaop
煲	bcrh
当	dgxe
舌	urqk
衰	ukyv
骨	gogo
铅	qmjk
划	hcgd
裹	gqyg
礼	lppv
饶	rvuw
顿	dtty
鼠	uojv
砂	uauu
盆	pgfm
恕	uynx
搅	jzfj
专	vrts
拦	lkfl
浪	lgdl
卯	mbpe
菊	jbcm
沈	uhde
判	phbd
引	ymgl
复	fypw
制	vund
漂	pndu
彩	cgcp
族	zifu
稿	gbhk
漫	mhdy
摁	ebfx
绛	jksf
伊	yiry
核	hrmr
郝	hbie
挨	aifu
挨	aofu
脉	msoy
扇	ujhx
妮	ninb
标	bnmu
创	ikrd
鹅	erwn
哔	buku
颤	ihwy
乔	qmyl
睁	vgoy
梳	uumi
思	sitx
舒	uury
凸	tula
框	kkmw
移	yohx
泼	podf
邓	dfye
俗	sirg
陷	xnej
恰	qzxk
碟	dqum
患	heix
鲜	xmyy
阴	ybeo
帽	mxjo
磅	bguf
柳	leme
斩	vlij
忌	jujx
鲍	bxyb
侯	hxru
熏	xyqh
彭	phtp
册	cwka
邀	yczw
晾	lkox
掌	vkxu
弦	xzgx
玉	ycwd
楞	lhmf
业	ywla
汇	hcdk
社	uwpt
骆	limk
塌	tatx
暴	bxou
吨	dykt
坡	potp
雕	dnkv
懵	mjxo
蒜	secu
财	cfbc
赠	zfbo
持	iofc
涮	uedd
怨	yexx
墨	milt
注	vydv
庙	mbgy
斑	bjww
靓	lkfj
吉	jotk
呲	cikb
券	qejd
玻	bowp
迎	ylze
霍	hiyv
筋	jbvl
嗑	kwkm
视	uupj
洒	sddx
乜	mpvv
译	yuyf
夫	fuer
柴	ifvm
铲	ilji
蒋	jscc
悟	wyxk
兰	lkbs
茬	isct
漆	qidu
恤	xcxm
华	hcru
垮	kvtk
孤	guzg
箭	jnvd
屯	tuav
削	xnxd
叉	iayd
普	pobo
英	ykcy
志	vutx
州	vzdl
禁	jvmu
商	uhwk
拣	jxfd
厅	tkid
载	zsgi
詹	vjdk
私	sihs
腚	djoz
浇	jndw
户	hydu
独	diqi
脆	ccov
瞒	mkol
蒂	ducj
壹	yitb
徒	tirz
欸	eosq
胎	tdok
简	jxvo
世	uucv
佬	lbrl
锤	ibjt
亚	ylay
蛆	qviq
嘚	dekc
捶	ibft
唇	iuik
宁	nlbd
增	zgto
禅	ikpu
仿	fkrf
铊	tajb
县	xnqs
忧	yzxy
权	qtmy
葬	zgcc
龚	gslg
羞	xqyi
劫	jqql
童	tdll
希	xixj
蹬	dgzb
癖	ppbx
尤	yxyd
职	voev
粒	luml
瘫	tjbv
渡	dydy
绣	xpsn
尝	ijxy
欺	qicq
毕	bubu
敌	douw
梅	memm
差	iayg
实	uobd
腐	fogr
形	xlkp
杂	zsjm
藕	oocd
仗	vgrv
逮	dszl
糊	himo
讯	xtyu
墓	myct
萱	xrcd
浮	fidz
哉	zdgk
源	ytdx
度	dpgy
织	visv
籽	zpmz
岗	gkux
腔	qlog
蒙	mgcu
喃	nkkg
备	bqwt
扬	yjfp
雄	xduv
牢	lvbn
眠	mzom
萨	slci
撮	cofy
耶	yeee
迈	mszw
焖	mdhx
漂	pbdu
续	xcsd
严	ykai
奏	zmit
沃	widy
系	jupx
呈	ihkw
箱	xlvo
押	yafj
种	vfhv
堡	bbrt
冯	fhdm
购	gmbg
倩	qnro
功	gsgl
憨	hjex
愈	ycrx
脖	bpoz
嫖	pmnu
川	irpl
鹿	lygb
嗦	sokx
窜	cebi
撅	jtfq
樱	ykmn
邦	bhfe
皇	habw
镐	gbjk
忆	yuxv
挽	wlfe
讨	tbyc
栽	zdgm
庆	qjgd
胶	jnof
卡	qvub
敬	jjcw
润	rtdw
永	yfdu
咒	vmkj
棍	gtmb
袭	xoly
井	jaca
俊	jtrw
嘭	pgkp
噎	yekb
陶	tvef
厝	ciio
痰	tkbh
嗅	xpkq
乌	wupa
甭	bhby
险	xxeq
俾	bpru
邱	qqqe
钢	ghjx
坤	kytu
碳	thuh
采	cgvm
贝	bqkr
鼓	gotv
孟	mfzm
伸	ufru
蚝	hvim
缓	hysy
咽	yhky
纵	zasr
卒	ziwu
吱	vikv
裂	lody
钙	gsjg
翅	iuvx
纪	jusj
耗	hxlm
棵	kemg
雀	qrxv
彼	bprp
挪	npfe
始	upnk
皿	mmka
钉	dkjd
冬	dswd
洋	yjdy
苗	mmct
盛	ufim
袜	wlpw
茧	jxci
纳	nlsn
啤	poku
妥	tqvn
暂	zhio
盲	mjwo
误	wyyt
菌	jych
浴	ycdg
孽	nocz
枉	wkmw
勇	yfsl
峰	fguf
父	fybx
汉	hhdy
嚷	rkkx
晏	yhon
研	ykuk
库	kygi
榛	vfmh
噔	dgkb
叽	jikj
陌	mieb
吒	vakq
闭	bumc
护	hyfh
贾	jvxb
捎	ucfo
俞	ybrd
垵	antn
抵	dpfu
莲	lzci
肚	dyot
冤	yrbt
臣	igkl
椒	jnmy
獒	apfq
葛	grcr
仓	chrv
朗	lklo
义	yudx
尸	uivp
唠	lxkl
唠	lvkl
辛	xblu
轴	vxiy
胆	dlod
煞	uldh
枣	zbud
途	tizm
稀	xihj
晨	igoi
仁	rgre
熄	xihx
庄	vlgt
撩	lmfx
秃	tuhj
乙	ypvv
嗔	ifkb
临	lnlk
灸	jejh
婶	uhnu
鲁	loyo
宴	yhbn
币	bupj
速	syzu
佳	jxrt
索	squx
咕	gukg
姬	jini
返	flzy
禾	hrpm
链	lnji
誓	uufk
执	vofw
眯	miom
瓷	codw
绘	hcsy
密	mubu
恃	uuxc
吕	lnkk
仲	varv
探	thfm
番	fjct
哀	aiyk
铝	lnjk
乎	hupl
蛙	wait
氪	kwqx
置	vusq
埃	aitu
芊	qmcq
掀	xmfq
裆	dhpe
镁	mrjd
兑	dcbx
卢	libu
阔	kimu
谜	moym
暮	myco
洲	vzdv
差	idyg
昏	hyuo
谓	wqyo
承	ihln
忠	vsvx
潜	qzdo
瞟	pzou
驼	tpmb
欢	hryq
悔	hnxm
巫	wugr
诚	ihyi
崴	wgun
毙	bubb
呛	qlkv
呛	qkkv
涩	swdv
曾	zgbo
轶	yuif
递	duzd
烙	lxhk
棉	mzmj
句	gzbk
霸	blyo
缝	fhsf
缝	ffsf
鹰	ykgn
嘀	dokg
切	qpqd
祛	qvpq
舟	vzpd
鞭	bmgg
瘾	ymbx
黎	lohu
亭	tlwd
荼	ticm
阉	yjmd
呕	ookq
雇	gyhv
顾	gyiy
舍	utrg
镶	xljx
巷	xkgs
质	vuib
背	bqbo
剂	juqd
渴	ktdr
昨	zpov
间	jnmo
帖	tojv
叮	dkkd
姚	yvnv
御	ycre
蛤	hsik
谎	hsyi
乍	vlpe
阳	yjeo
荤	hyci
亲	qjlm
忽	huwx
账	vgbi
剥	boed
舍	uwrg
枝	vimv
捷	jqfz
桃	tvmv
揭	jpfr
勤	qncl
荡	dgcp
嗝	grkg
畔	phtb
薪	xbcj
喳	vakd
嘟	duke
奉	ffif
孝	xblz
售	umrk
挑	tzfv
桩	vlmt
犊	dind
徕	lfrl
拳	qtju
溅	jndj
泯	mmdm
泡	pcdb
铜	tdjk
助	vyql
盾	dtio
措	cifo
焉	yjvh
悦	yrxx
夺	dpdc
伦	lurl
瑞	rcwe
诸	vuyo
萧	xncb
宜	yobq
跶	dazd
健	jnry
拾	uofk
珠	vuww
凤	ffjy
圭	gvtt
揽	llfj
池	iody
弓	gsvv
诛	vuyw
钩	gzjg
境	jjte
谦	qmyj
莪	ercw
阅	yrmx
匿	nukk
渤	bpdl
隆	ldeu
审	uhbu
妾	qoln
渝	ybdd
硅	gvut
咻	xqkm
叭	bakb
触	iydi
缸	ghfg
喏	nikk
坊	fhtf
谭	tkyu
嚓	caku
颠	dmuy
窦	dmbd
莱	lfcl
旗	qofb
孩	hfzr
嗡	wgkx
裁	cfgy
哑	ydky
计	juyu
亡	wjwv
淌	tkdk
吆	ycky
硕	uiuy
危	wwdv
颈	jajy
倔	jyri
荣	rdcm
嗳	apky
泉	qtbu
淹	yjdd
钵	bojb
卵	lypd
谣	yvyf
恒	hhxd
债	vsrb
肠	ijop
嚎	hvku
拟	npfr
拴	urfw
垂	ibqt
妃	fwnj
伏	firq
撬	qbfm
恐	kfgx
媛	ytny
菲	fwcf
矗	iyuq
靡	mpgf
搏	bpfc
晓	xzow
抡	lyfl
睿	rcbo
腌	yjod
颁	bjfy
程	ihhw
撇	pwfw
筒	tfvk
扳	bjfy
淋	lndm
鸣	mlkn
搽	isfm
娟	jrno
彪	bnhp
揣	iafe
拷	kbfk
目	myke
恁	ndrx
眨	vdof
兹	ziby
囤	dtkt
囤	tukt
脾	poou
绳	uhsd
蒽	encx
姆	monm
洁	jqdk
涌	yfdy
妻	qiun
踏	tlzo
迁	qmzq
翼	yuxg
秦	qnih
姨	yony
藏	zgci
称	idhx
柯	kemk
序	xcgy
束	uygr
异	yujc
康	khgl
嗓	skkm
篮	lkvm
觅	muvj
镑	bgjf
汀	tkdd
营	ylck
掺	ijfp
螨	mlil
俏	qbro
珊	ujwc
傍	bgrf
贫	pnfb
芭	bacb
司	sivk
崖	ysut
嘣	bgko
传	verv
叁	sjss
豹	bxvu
哗	hcku
哗	hxku
献	xnuq
辨	bnxl
兆	vxed
瘪	bwbl
枯	kumg
芮	rccn
舰	jnvj
蜡	llio
涛	tcdc
犹	yxqy
誉	ycxk
僵	jlrj
阵	vdei
辫	bnxs
府	fogc
吡	bpkb
坛	tkty
煨	wwhy
幸	xjtg
栋	damd
刨	pvbd
刨	bxbd
瑛	ykwy
赫	hwii
努	nonl
袄	aqpy
氏	uupv
椅	ypmk
痨	lvbl
玛	mdwm
吽	hskn
晋	jvyo
氧	ykqy
矬	cpur
瘟	wfbm
武	wogv
作	zorv
俱	jcrb
卫	wqea
捣	dbfu
蜀	uosi
柚	ymmy
坠	vcet
辱	roic
轩	xrig
吟	ynkv
渐	jndj
廖	lbgp
肖	xnxo
竹	vigg
柔	rxmm
奴	niny
棕	zsmu
祖	zopq
咚	dskd
洪	hddg
泛	fhdf
斋	vdwe
浑	hudi
眉	meuo
奔	bddc
卿	qkpg
穴	xybb
佑	ymrk
燥	zxhm
尘	igxt
校	xbmf
迪	dozy
扎	vsfv
雌	covv
馊	szuy
姿	zidn
胯	kzok
栏	lkml
确	qruy
席	xogj
擤	xafw
沿	ykdk
嗖	szky
遂	sczu
燕	yhch
逾	ybzd
兴	xjxb
训	xtyi
咿	yiky
焗	jbhk
卷	jejv
默	milq
奸	jmng
炕	kghj
摞	lifx
应	yjga
避	buzx
贰	eeyb
缁	zist
冠	grbc
冠	gebc
汝	rodn
厌	yhiq
颓	tbhy
殿	dnuu
掂	dmfv
呱	gxkg
馍	mpud
绮	qpsk
期	jico
哨	uxko
宣	xrbd
隐	ymex
荒	hlci
累	letx
驱	qvmq
殇	uhdp
掖	ywfw
豪	hvwu
淇	qodb
魏	wqhg
糙	ccmk
妍	yknk
砰	pgup
砌	quud
瑜	ybwd
飙	bnqf
畅	igup
瘸	qybr
翁	wggx
预	ycyy
刹	uaxd
空	kabg
腮	sdox
蛹	yfiy
宇	ynby
唬	hokj
袅	nzny
施	uify
糯	nime
辩	bnxy
参	cjsp
嫂	sbny
阮	ryey
艘	szvy
癣	xyby
拥	ysfy
扩	kifg
倾	qkry
叨	tckd
嬴	ylwn
挥	hvfi
豁	hobg
啷	lhke
楚	iomz
莉	lucd
遁	dtzo
厮	siij
潭	tkdu
滩	tjdv
辽	lmzl
貂	dnvk
唤	hekd
例	lurd
歼	jmdq
泄	xodu
玄	xtwy
宥	ymbo
耙	bllb
噌	cgko
脂	vioo
醇	iuyz
刁	dnva
积	jihv
捋	lofc
幺	ycvs
卦	gztb
纱	uasu
隋	sbeo
蚊	wgiw
鳖	bpxy
痕	hgbg
齁	hzzj
数	uomw
颂	sagy
玮	wrww
霉	meym
杆	gjmg
杆	glmg
珂	kewk
炝	qkhv
栓	urmw
苯	bhcb
裱	bzpy
厨	iiic
筐	klvw
寂	juby
寨	vsbm
铰	jzjf
岭	laus
享	xswz
濯	vpdv
璐	lywk
瓣	bhxg
籍	jovo
囊	njgy
映	yjoy
伯	bprb
符	fivc
煤	mehm
蔫	nmch
幼	ymyl
势	uufl
呷	xxkj
怡	yoxk
辈	bqfi
斌	bbwv
蛊	goim
激	jidw
佟	tdrd
奕	yuwd
韵	ytly
胀	vgoi
衬	idpc
酿	nkyl
歉	qnjq
访	fkyf
覆	fyxw
突	tubq
埸	yutw
弗	figl
士	uuua
仪	yory
浩	hxdk
谋	mxym
谤	bgyf
簋	gnvm
尿	svuu
惜	xixo
掩	ylfd
孕	ytnz
遵	zyzc
辟	buux
妇	fyne
杏	xjmk
啖	dhkh
棱	lhmw
耸	sfre
碑	bwuu
杵	iomu
农	ndby
坪	pltp
贬	bxbf
皎	jzbf
珞	liwk
嗜	uuko
蝉	ikiu
姑	gung
钦	qbjq
耽	djee
堪	kjtb
帘	lzbj
碘	dxub
捆	kifm
恼	nbxx
筛	udvj
倚	yprk
喀	kakk
棚	phmo
蚺	rkir
缇	tosz
町	dktd
笛	dovy
绞	jzsf
缴	jzsw
扰	rbfy
态	tstx
医	yiku
苑	yecv
傲	airw
尺	ipun
茨	cocq
磡	khul
劳	lvcl
笼	ldvl
撂	lbfk
穆	myhp
巢	ivvg
寝	qmby
涠	wedw
吓	hwkx
蕉	jnch
闰	rtmw
粤	yrpk
跋	bszf
刊	kjgd
葵	kbct
沐	mydm
帕	pljb
佐	zqrg
讹	eryb
坚	jmlt
岸	abug
绷	bgso
荷	hrck
症	vgbv
堕	diet
凯	kguj
笋	sivy
黛	dsrh
亨	hgwl
攀	pjmu
棣	duml
矫	jzul
绒	rdsu
虏	lohl
鹏	phon
熙	xiih
咏	yfky
幽	yzuy
愚	ybtx
碍	auuc
虹	hdig
妓	junv
洛	lidk
彦	yhwp
焕	hehd
岩	ykuu
警	jack
琳	lnwm
啄	vpku
癌	aobu
悌	tuxd
霆	tlyt
祇	qopu
拘	jvfj
碾	nxuy
脓	ndoy
膈	grog
闫	ykms
叉	idyd
碇	djuz
匪	frkf
津	jbdy
落	llck
葡	picf
腾	thom
杖	vgmv
绊	bhsb
拈	nmfv
溏	tjdk
蹄	tozj
膝	xiou
灾	zdbh
浣	hedy
惧	jcxb
硌	gwuk
嘬	zoky
谗	ikyd
弧	higg
饺	jzuf
晶	jkoo
璇	xtwz
掷	vufe
卜	bold
铬	gwjk
羹	ggyd
幻	heyv
郡	jtye
孬	ncbz
奈	nsdu
窃	qobd
宿	sybb
哏	ggkg
嘈	cvko
饬	iuul
稠	ixhk
癫	dmby
擀	glfg
杰	jqmh
拄	vofv
舱	chvv
馕	njuy
辰	igiy
茎	jkcj
肘	vcoc
攥	zefx
吠	fqkq
傅	fyrc
箍	guvj
尻	kcuj
导	dbsc
谴	qxyl
惟	wexv
钻	zejv
梵	fhmf
验	yhmq
芳	fhcf
粿	gqmg
犟	jkgn
玫	meww
婆	ppdn
钛	tsjt
壁	buut
弹	dhgu
捯	dvfd
鳄	ewyk
弩	nong
区	oukx
溶	rddg
息	xizx
慎	udxb
叙	xcry
锥	vvjv
卟	bokb
贷	dsrb
滇	dmdb
浸	jvdy
昆	kyob
撵	nxfi
琦	qowk
逝	uuzj
陀	tpeb
疣	yxby
渊	yrdl
察	isbu
屈	qvui
泽	zrdf
炸	vshv
嗬	hekk
溺	nudg
艳	yhfb
仔	zgrz
翠	ccxu
啐	ccku
谂	uhyx
嘶	sikj
种	idhv
锋	fgjf
良	ladg
栖	qimx
柄	bamn
肛	ghog
闵	mmmw
皖	wlby
洇	ybdy
抻	iffu
咣	glke
徽	hvrx
媚	mqno
慕	mycx
坞	wytw
腥	xkou
估	gurg
掘	jyfi
逑	qwzq
痔	vubc
诉	syyi
逐	vizu
臂	buuo
剽	pnxd
哲	vrfk
烩	hchy
鲨	uady
萎	wrcn
曦	xiok
炎	ykhh
允	yise
袖	xppy
娥	ernw
俯	forc
瘤	lwbt
律	lcry
聂	noey
芽	yscy
羽	ynxx
钞	icju
赤	iutb
勒	lwgl
似	uurr
毯	tlmh
禹	ynpd
咂	zakj
宏	hdbs
瀑	pydu
廋	szgy
喧	xrkd
仰	ykre
丰	fgsl
暨	jugd
剖	pzld
黍	uohu
鸿	hddn
盈	ylnm
螈	ytix
胗	vfop
苍	chcv
蔻	kmcy
禄	lypu
仕	uurt
夕	xipd
鑫	xbjj
尹	ymep
熨	ytuh
吭	kgkj
苔	tfck
湉	tzdu
薜	bucx
铛	igje
锯	jcjg
叩	kmke
螺	lpix
蓉	rdcg
藤	thcu
褪	tcpg
榨	vlmv
滋	zidy
宗	zsbu
锦	jmjj
竞	jjlx
戾	luhq
浙	vwdj
啫	vtko
澳	aidd
勃	bpul
哺	bokf
韦	wefv
炜	wrhw
藓	xxcy
邹	zzde
鲸	jkyx
媒	menm
囡	njkn
曝	pyou
匀	yubd
溪	xidd
杭	hjmj
鳓	lwyl
朴	pomb
屙	eeuk
遗	yozb
楹	ylmm
衩	idpi
伙	hqrh
魅	mqgw
倪	nore
嚄	hoky
纠	jqsj
艋	mjvm
幕	mycj
捻	nxfx
殴	ouqu
磐	pkvu
屑	xouo
益	yubm
瘀	yvbd
规	gvfj
聋	ldle
燃	rkhh
狐	hiqg
寰	htby
论	luyl
瓢	pmxg
脐	qooq
茜	xicx
镕	rdjg
盏	vljm
於	yvfd
庵	angd
候	hmru
鸠	jqjn
狷	jeqo
炆	wghw
宾	bbbb
赋	fybv
抹	mafw
伽	jxrk
姝	uunw
宵	xnbo
邢	xlke
灶	zxht
煸	bmhc
岔	ilfu
呔	ddkt
肱	gsos
蚶	hjig
皓	hxbk
历	luil
蟒	mkic
瘆	udbp
逸	yuzt
鼬	ymjy
锺	vsjv
涧	jndo
礁	jnuh
俚	lprl
孰	uiww
嘎	gskg
壳	qbtj
落	lxck
薰	xych
延	ykzv
翟	doxv
阁	grmk
喉	hxku
倦	jerv
戚	qiwx
氢	qkqj
烘	hshg
模	mpmd
诵	sayy
喆	vrtk
渍	zudb
锉	cijr
浆	jllu
决	jydg
闷	mfmx
嵌	qnuq
塑	synt
娅	ylny
噫	yikx
跃	yrzy
敝	buxw
霏	fwyf
匹	ppke
韬	tcwj
艺	yucv
柱	vymv
檫	ismu
貌	mxve
政	vfvw
匙	ioob
担	djfd
铺	pyjf
淑	uudy
硪	wiuw
暇	xcoy
釉	ymcy
酌	vpyu
炅	jfoh
蓬	phcf
痧	uabu
巳	sukv
帧	vfjb
逄	pjzf
丧	sgty
柏	bgmb
汞	gfgu
舅	jpjl
滥	lhdm
蘼	mocf
寿	umfc
昕	xboj
函	hkku
航	hjvj
啰	lokx
儒	rire
庭	tlgt
鄣	vhle
鄂	ewke
秆	glhg
轿	jbil
廊	ljge
鲤	lpyl
怜	lzxs
浦	podf
汰	tsdt
坦	tltd
攒	ctfb
齿	ipvr
幢	vkjl
笃	dovm
玖	jewj
肋	lqol
炉	lihh
翘	qmyx
嗄	ulkw
伢	ysry
笫	zpvd
谍	dqym
樊	fkmd
窥	kvbj
溜	lpdt
屡	lnun
啼	tokj
锌	xbjx
泵	bfuu
陡	dcez
墩	dytw
固	gykg
径	jjrj
酶	meym
娴	xznm
箸	vyvo
缀	vcsy
耻	ipev
斧	fofj
吮	uiky
绾	wlsl
雁	yhiv
喻	yckd
淤	yvdd
掴	gkfy
赣	ghlb
唧	jike
腊	lloo
蒲	picf
嘁	qikx
屠	tiuo
驮	tpmd
瓮	wfgw
浊	vpdi
慧	hcfx
辉	hvxi
偈	jurr
荐	jncz
鸥	ouqn
萋	qicn
违	wezw
蟑	vhiu
埵	dqtt
竿	gjvg
纲	ghsx
击	jifk
陋	lmen
寐	mqbw
挈	qofu
帖	tpjv
午	wopu
蚤	zbii
钝	dtjt
耄	mxlm
疏	uuvi
珍	vfwp
怔	vfxv
灿	chhu
婵	iknu
垢	gmtk
耒	lrfr
仑	lurb
胚	pwop
琪	qowb
昙	tkoy
贤	xzlb
资	zidb
咀	jnkq
聘	pvek
肽	tsot
坍	tjtd
琛	ifwm
促	cyrz
饵	eyue
敛	lxqw
叛	phby
圃	pokf
暑	uooo
伍	worw
盅	vsvm
嗤	iiki
迩	eyzx
恢	hvxh
缰	jlsj
沫	midw
秾	ndhy
频	pnvy
唆	sokw
砣	tpub
枭	xnnm
窑	yvbf
舀	ybvj
惠	hcix
寮	lmbx
莓	mecm
朋	phoo
锡	xijw
览	lllj
狸	loql
钳	qzjg
熵	uhhk
咝	siks
塘	tjtk
遥	yvzf
议	yuyy
铢	vujw
睬	cgoc
孑	jqla
涉	uwdu
统	tfsy
诈	vlyv
阻	zoeq
堇	jmcw
蹿	crzi
悍	hhxg
牧	mynw
髂	qzgk
乾	qzuv
卅	slai
莺	ykcn
蛀	vyiv
锕	aajk
剐	gvkd
桂	gcmt
痂	jxbk
盟	mhom
祢	mopx
妄	wgwn
焐	wyhk
涯	ysdt
央	yhkr
糍	comy
壕	hvtu
幌	hsje
猎	loqo
烹	pgwh
琼	qdwx
丘	qqja
煽	ujhx
释	uucf
醍	toyz
樽	zymc
菖	ihco
崇	iduu
戆	vklx
轨	gnij
技	jufv
脊	jpro
鉴	jnlj
铃	lljs
凝	nldz
委	wrhn
泻	xody
疑	yobz
悠	yzrx
驳	bpmx
捕	boff
凳	dfbj
蠃	lqwi
敏	mmpw
蕊	rncx
挞	tlfd
阎	ykmj
垚	yvtt
荫	yvco
铞	dbjj
瑾	jmww
泾	jkdj
哐	klkw
炼	lnhd
榴	lwmt
融	rdgi
婷	tlnd
鱿	yxyy
弊	buxc
昌	ihoo
舵	divb
癸	gnbt
桔	jqmk
锰	mjjm
缅	mxsm
鼯	wijk
灞	bldo
菲	frcf
槛	klmm
俪	lurd
讷	nwyn
佩	pqrj
姘	pbnk
骟	uhmx
泫	xedx
裔	yuyk
冢	vfbu
卓	vpbu
查	vamd
谔	ewyk
抿	mmfm
玥	yrwo
黯	ablo
唵	azkd
簿	byvc
狄	doqh
枫	fgmf
棘	jouu
烈	lodh
橹	lomo
碌	lyuu
乜	novv
嗫	noky
务	wywl
旋	xtfz
孵	fulz
晗	hkok
匠	jkkj
濂	lzdj
泷	lddl
箩	lpvx
萝	lpcx
昇	ugoc
搋	ikfj
鼎	dapo
检	jxmq
哩	likl
泠	llds
龄	llvs
寞	mibd
甯	njby
启	qphk
锐	rcjx
台	tdsk
销	xnjo
骁	xnmw
驿	yumf
胤	yveo
泳	yfdy
躁	zxzm
窘	jfbk
描	mmft
濮	pidf
糁	slmp
率	ujwu
酮	tdyk
吁	ycky
尧	yvyw
绗	hjsd
筷	kjvg
搂	lcfn
漂	pzdu
赎	uibd
朔	uino
娼	ihno
狙	jvqq
溢	yudm
择	zrff
闸	vsmj
唛	mskw
浜	bhdb
澹	dhdk
谛	duyj
诡	gnyv
橘	jbmk
挎	kzfk
笠	luvl
凌	lldw
陕	ulej
拂	fiff
铭	mljk
硼	phuo
祥	xapy
馨	xbto
埂	gjtg
茅	mvcm
亩	mowt
沏	qidd
毅	yulu
爰	ytvy
褶	vtpb
综	zssu
丙	baan
枷	jxmk
冏	jfkk
剌	llud
霖	lnym
瞥	ppxo
企	qprv
壬	rgpt
饰	uuuj
灏	hxdy
澜	lkdj
咛	nlkd
逊	xtzx
彧	ycga
蛛	vuiw
岗	ghux
厕	cwid
阶	jpej
矛	mvyp
楠	nkmg
昵	nuob
疲	pobp
擒	qnfn
龌	wivt
巡	xuzv
迅	xtzu
滢	yldy
臻	vfgh
澄	ihdb
碉	dnuk
蛾	eriw
旱	hhog
婕	jqnz
垒	lrst
淼	mzuu
纽	nesi
侵	qbry
膳	uhok
嫣	yjnh
援	ytfy
璧	buuy
倡	igro
矿	kkug
袍	pvpb
邵	uxde
渗	uddp
鲞	xsjy
效	xbww
畜	xcxt
炙	vuxh
怵	iyxu
蹉	cozg
典	dxqb
巅	dmuy
跺	dizm
碱	jxuk
棠	tjxm
佗	tprb
鳌	apfy
褒	bcym
摧	cvfv
鹤	hwbn
嚼	jykc
宓	mubb
哞	mzkn
锈	xpjn
渔	ybdy
捌	bafd
策	cwvu
繁	fkpx
疾	jobu
矜	jbmv
寇	kmby
缕	lnsn
糜	mogm
悯	mmxw
闽	mmmi
娜	npne
炳	bahn
磁	couy
苷	gjcg
戈	geyp
钾	jvjj
骄	jnml
黔	qzlv
怯	qoxq
惕	tuxw
豚	tuou
腺	xnou
趾	vpzv
钚	byjb
蚕	ckti
搀	ijfd
喋	dqkm
饥	jiuj
娄	lxmn
钠	nljn
廷	tlzt
揸	vafd
蛰	vrfi
梓	zpmx
睹	dooo
贩	fhby
芬	ffcf
蜂	fgif
亥	hswr
嗟	jpkg
鳞	lnyf
腩	nlog
滕	thou
剔	tiod
雯	wgyw
蓄	xcct
夷	yoar
庸	ysgo
酉	ycxa
芋	yccy
株	vumw
呤	ljks
澈	iwdw
汾	fgdf
绫	llsw
拢	lffl
葩	pacb
坯	pitp
仆	pirb
梯	timd
伟	wrrw
堤	ditz
寡	gvbf
浒	hodu
莰	klcq
邻	lnre
哂	uhkx
霞	xcyy
霰	xnyw
偕	xqrb
欣	xbjq
疮	ilbv
旦	dhoa
斗	dcud
鸽	gern
苟	gccj
惑	higx
跤	jnzf
犁	lohn
掳	lofl
蜷	qtiv
旭	xcjo
炊	ivhq
恭	gsgx
猾	hcqo
馁	nrun
裘	qwqy
韧	rdwr
寅	ynbb
筑	vyvf
斥	iujd
肤	fuof
绢	jeso
镌	jrjn
恪	kwxk
诓	klyw
缈	mzsu
湜	uodz
慰	wqux
愉	ybxd
炷	vyhv
姊	zpnd
猹	isqd
趸	diwz
焊	hhhg
衿	jbpv
洺	mldk
哝	ndky
裴	pefy
芃	phcf
璞	piwf
蔷	qack
沁	qvdx
蚀	uoui
莳	uucc
箫	xnvb
狱	ycqq
责	zrfb
瞻	vjok
芝	vicv
谶	idyj
妲	dsnd
盖	gtym
阙	qrmq
瓤	rjxg
搔	scfi
署	uoso
梭	somw
瞳	tdol
庹	tqgi
瑶	yvwf
裕	ycpg
凿	zvkg
暧	auoy
瑷	auwy
锝	drjc
璟	jawx
睛	jkoo
廉	lzgj
昧	mqow
钼	myjo
畏	wqty
颖	yaby
芸	yucy
仄	zwir
召	vxdk
粢	zidm
鬓	bveb
沸	fqdf
葭	jxcy
鹃	jrkn
岚	lkuf
萁	qocb
檀	tkmd
蚁	ypiy
漪	yidk
簪	zjvo
伲	norb
彬	bbmp
泊	bpdb
稻	dxhj
掼	gefb
姣	jnnf
槿	jmmw
揩	kdfb
糠	khml
涝	lxdl
瞭	lbox
痞	ppbk
冉	rlkt
莎	socu
跎	tpzb
兀	wyae
薏	yucx
焯	ichu
钣	bljy
耕	gglj
苛	keck
磷	lnuf
玲	llws
跷	qnzw
穗	schx
腆	txob
硝	xnuo
诱	ymyn
筠	yuvy
鞍	angn
昶	ikyo
缚	fysc
渺	mzdu
刃	rddd
擅	uhfd
腕	whov
贯	gemb
冀	jubg
监	jmlm
陆	lpej
惬	qoxj
汐	xidx
爻	yvxx
蜇	vefi
卑	bwpu
锄	iijl
抚	fofw
钴	gojg
辑	joie
芥	jocj
铐	kxjk
芈	mpcf
耨	nmlc
悭	qmxt
狨	rdqu
慑	uwxy
淞	ssdg
羡	xnyq
昭	vcok
祗	vipu
渚	vodo
敖	apfw
拗	aifl
拗	npfl
枞	csmr
呋	fukf
革	grcu
夯	hhdl
佶	jork
珑	ldwl
契	qufd
膻	dhod
杉	ujmp
涡	wodn
倭	worn
熹	xith
鳐	yvyf
刈	yuxd
岳	yrqu
肇	vxhy
酯	vpyo
坝	bltb
乏	fspv
艮	gdoy
贡	gagb
秽	hchx
况	kkdx
厉	luiw
牟	mxsn
培	petk
柒	qidm
禽	qnrn
奢	uedo
苕	uvck
衔	xzrj
椰	yeme
域	ycta
樾	yrml
匾	bxkc
镖	bnju
储	ioro
帆	fjjf
核	himr
甪	lypy
滤	lcdx
秘	muhb
姥	lbnl
萍	plcp
迫	pizb
泣	qudl
戊	wygp
郁	ycue
盹	diot
斐	frfw
蒿	hcck
髻	juek
窟	kubi
匡	klkw
胧	ldol
茗	mlck
齉	ngzy
霓	noye
茑	nzcn
劁	qnrd
渠	qbdm
述	uyzu
隼	siru
痿	wrbn
诌	vzye
氨	anqn
禀	bawu
丛	cdra
沣	fgdf
横	hfmh
剋	kwud
恳	khgx
磊	lruu
锣	lpjx
蜱	poiu
祺	qopb
适	uuzu
艇	tavt
玹	xtwx
耀	yxxv
淳	iudz
踮	dxzv
否	ppbk
概	gsmw
耿	gjeh
瑰	gvwg
闺	gvmt
蕙	hccx
伶	llrs
钮	neji
蹼	pozf
遣	qxzl
虱	uivi
瞬	utof
庥	xqgm
昱	ycol
噪	zxkm
拙	vofi
欸	epsq
欸	apsq
酣	hjyg
薅	hccc
踝	hlzg
矶	jiuj
藉	joco
靓	jjfj
琅	ljwl
蔓	mhcy
耪	pklf
锵	qljc
恬	tzxu
拓	tifu
蔚	wqcc
硒	xiux
漾	ygdy
予	ynsl
嘱	voky
嗞	ziky
靶	bdgb
磋	coug
敦	dyww
涐	erdw
焚	fgmh
尕	gdnx
圜	htky
戟	jpug
济	judq
禁	jbmu
鞠	jvgm
篓	lcvn
虑	lchx
琶	pswb
庞	pjgl
乞	qppv
茄	qqck
囚	qwkr
茸	rdce
讪	uhyu
矢	uppd
舜	utvf
炭	thuh
悉	xicx
削	xtxd
役	yuru
婴	ykbn
昀	yuoy
稚	vuhv
逞	ijzw
愤	fdxb
肓	hlwo
栾	ltwm
臊	scom
眺	tbov
翕	xirx
峡	xcuj
戌	xvwa
轧	yliv
抑	yufe
蝇	ylid
毓	ycpi
载	zggi
滞	vudj
坂	blty
禅	uhpu
橱	iimc
龊	iivz
祠	copk
辅	foif
洹	htdd
恺	kgxj
硫	lwui
芒	mjcw
宁	njbd
铊	tpjb
杳	ybmo
辙	vriw
贞	vfbb
鄙	bpke
豳	bbuu
材	cfmc
翀	isxv
氮	dhqh
镀	dyjy
獾	hrqv
亟	jola
闾	lbmk
侣	lnrk
昴	mboe
楸	qqmh
示	uuex
凇	ssdg
详	xayy
憎	zgxo
枳	vpmv
尢	whuv
卞	bnwb
怖	byxj
岑	cguv
嘲	ivko
簇	cyvu
珰	dhwe
氟	fiqf
涵	hkdu
栗	luxm
赦	uwiw
犀	xiun
鼋	ytyd
甑	zfbw
振	vdfi
钡	bqjb
蔽	bucw
驰	iomy
撮	zqfy
铎	dpjf
柑	gjmg
冈	ghkx
棺	grml
铪	hajk
诀	jyyg
髋	krgj
唳	lukq
镰	lzjj
绺	lesk
祕	mupb
侨	qmrl
茕	qdcu
纬	wrsw
污	wudk
鲜	xxyy
夭	ycpd
莹	ylcy
雍	yswv
育	ycwo
员	ytkb
赟	yywb
铡	vsjd
灼	vphu
畀	butw
豺	ifvc
掣	iwnu
慈	cobx
沌	dtdt
甫	fouy
衮	giyg
践	jnzj
厥	jyiq
陵	llew
麓	lyml
沦	ludl
骡	lpmx
弥	mogx
衾	qbry
笙	ugvu
侍	uurc
授	umfy
彤	tddp
剜	wjbd
匝	zakj
栅	vlmc
筝	vgvy
遢	tazx
婢	bunu
铂	bpjb
掸	dlfu
扼	ewfv
绯	fwsf
鲎	hmxy
旷	kkog
擂	lqft
圙	lrkm
殁	midu
攮	nkfy
咆	pvkb
膨	phop
佘	urru
叟	scjy
榻	tlmx
蹚	thzt
鹀	wign
协	xqub
岫	xpuy
暄	xrod
虞	ybht
彘	vuhb
芷	vpcv
佰	bgrb
滨	bbdb
跛	bqzp
玚	yjwp
筹	ixvc
蹙	cywz
啡	fwkf
旮	gajo
庚	gggr
沽	gudg
卉	hcuc
箕	jivb
圐	kukf
谅	lkyx
茂	mxcw
摹	mpcu
疱	pxbb
梢	ucmo
柿	uumj
漱	uydq
啸	xbkb
兴	xkxb
祐	ympk
觜	zivy
唑	zikr
胺	abon
舛	iyxf
扉	fwhf
羔	gcyh
琯	gywl
诃	heyk
嫉	jonu
霁	juyq
婧	jjno
掠	lrfx
绵	mzsj
镊	nojy
佺	qtrw
嗽	smkq
忻	xbxj
铀	yxjy
吱	zikv
褚	iopo
獴	mjqu
蚌	bgif
焙	bqhk
钉	djjd
糊	hymo
迹	juzb
柬	jxur
粱	ladm
啰	lpkx
勉	mxdl
仟	qmrq
雀	qzxv
扫	sxfe
绅	ufsu
盛	ihim
纨	wksw
媳	xonx
蚬	xxij
巽	xtsg
栈	vhmj
障	vgeu
址	vptv
椎	vvmv
孖	zizz
脯	piof
逮	dgzl
岱	dsru
葛	gtcr
躬	gsug
贾	goxb
氦	hsqr
昊	hxot
桓	htmd
茴	hbck
汲	jodj
菌	jtch
履	lnuw
乸	ndym
祈	qopj
芡	qncq
嚷	rhkx
榕	rdmg
舐	uuuu
蓑	socv
逍	xnzo
猩	xkqu
絮	xcnx
瑄	xrwd
循	xuro
颐	yoiy
侑	ymro
寓	ycbd
郅	vuge
苞	bccb
堡	bort
侪	ifrq
怼	dcyx
祼	gepg
毫	hvwm
凰	hajw
晖	hvoi
岬	jvuj
滘	jbdk
靖	jjlo
堃	kyft
醪	lvyp
锂	lpjl
撩	lnfx
锚	mvjt
湄	medo
呶	nvky
埔	potf
蕖	qbcm
趋	qvte
挟	xqfj
殉	xtdo
腋	ywow
嗌	yukm
嗌	aukm
妤	ybny
愠	ytxm
轴	vmiy
胞	bcob
庇	bugb
碴	isud
蟾	ikik
宸	igbi
汆	crru
番	pjct
腓	feof
喙	hcku
麂	jplj
屐	jiuv
赍	jiub
蒹	jmcj
窖	jbbk
疗	lmbl
翎	llrx
熘	lqht
鹭	lyzn
眯	moom
苹	plcp
愀	qzxh
襦	ripe
粟	syxm
饕	tckg
醺	xyyh
鸦	yayn
檐	ykmk
曜	yxov
殷	ybpu
庾	yngr
瑗	yewy
丈	vgan
侄	vort
艾	yucx
痹	bubw
雏	iidv
啜	iiky
聪	csex
爨	cejh
怛	dsxd
藩	fjct
蕃	boct
尬	glyj
槐	hlmg
际	jueu
玦	jywg
勘	kjcl
璃	lown
貘	mivd
驽	ninm
毗	potb
厦	uliw
驶	upmu
薯	uoco
肆	suey
娑	sodn
蜕	tcix
毋	wimp
昔	xico
羲	xiyk
旬	xubo
茚	yvce
植	vomq
烛	vihi
龅	bcvb
镚	bfjo
镲	idju
俶	iyry
椿	iymo
邨	cyte
悼	dxxu
奋	fddt
罡	ghsv
饹	leuk
撼	hhfx
濠	hvdu
饸	hruk
煌	hahw
迦	jxzk
谏	jnyj
蕨	jycq
诳	kayw
烙	lihk
䁖	lzon
茫	mjcw
拇	mofm
飒	sllf
麝	uwlc
绦	tcsm
婉	wlnv
鹟	wggn
皙	ximb
霄	xnyo
勋	xykl
曳	ywyp
铱	yijy
洞	tddk
谙	anyo
椴	demu
腭	ewok
淦	ghdj
淮	hldv
晦	hcom
荚	jccj
笺	jmvj
垃	latl
酪	lxyk
氓	mjwm
暝	mlol
凄	qidn
虔	qzhw
噙	qnkn
厍	uwii
析	ximj
飨	xsxg
厢	xlio
踅	xyfz
荀	xuco
呓	yukv
俑	yfry
屿	ynuy
札	vsmv
昼	vmid
狈	bqqb
弁	bnsc
馃	gqug
憾	hhxx
翰	hhux
泓	hdds
镬	hijy
颊	jcjy
珈	jxwk
诫	joyc
掬	jvfm
邝	kkge
励	luil
谝	pxyc
娆	rvnw
茹	rick
赊	uebu
嵩	ssuk
蹋	tlzx
桐	tdmk
菀	wlcv
渥	widt
檄	xomw
铉	xejx
佯	yjry
盂	ybym
臧	zhvi
喳	iakd
瘴	vgbu
祯	vfpb
铸	vyjc
赘	vcfb
骓	vvmv
镯	vpji
咨	zidk
腙	zsou
濒	bbdy
摒	bjfk
粲	chdm
彻	iwrd
埕	ihtw
疵	cibb
跐	cizb
殆	dsdk
硐	dauk
坊	fjtf
缶	fcpk
绀	ghsg
郜	gxne
睾	gcpg
鹳	gecn
僭	jnro
啉	lnkm
嘹	lmkx
髅	lxgn
纶	lusl
檬	mhmu
谬	mpyp
牡	mont
廿	nnca
泮	phdb
螃	pjif
乓	phqd
箧	qovj
擎	qlcu
拭	uufg
殊	uudw
溯	sydo
娲	wann
惘	wkxw
禧	xppk
叶	xqku
乂	yupn
囿	ymko
驭	ycmy
鸳	yrxn
嗳	auky
坳	aitl
碜	ihup
椽	itmu
毳	ccmm
歹	dgax
镉	grjg
构	gmmg
褐	hwpr
究	jqbj
铠	kgjj
慷	khxl
魁	kbgd
癞	lsbb
阑	lkmj
仂	lwrl
羸	lewy
菱	llcw
陇	lfel
镂	lmjn
嫚	mhny
缦	mhsy
靡	mogf
捺	nlfu
彷	pjrf
铅	ykjk
蛳	siij
沱	tpdb
懿	yutx
姻	ybny
迂	yvzy
诏	vxyk
诊	vhyp
铮	vgjy
葆	bbcm
缤	bbsb
偲	cdrx
铳	iajy
舂	isij
创	ilrd
凋	dndk
督	duuo
惶	haxw
讳	hcyw
笳	jxvk
笕	jxvj
蛟	jnif
驹	jvmj
颏	kewy
溃	kcdb
喱	lokl
涟	lzdi
麟	lnlf
淋	lvdm
栊	ldml
馒	mkuy
沤	oydq
醅	pwyk
撇	ppfw
祁	qope
戕	qlpg
樵	qmmh
俅	qwrq
醛	qtyw
艏	ucvz
沓	tluo
蜗	woin
晤	wyok
懈	xoxn
魇	ylig
旸	yjop
秧	yhhy
烨	ywhu
钰	ycjy
鸢	yryn
哕	yukx
哕	hckx
撰	vefg
磅	pjuf
叱	iukb
炽	iuhv
哧	iiki
迭	dqzf
惰	dixo
燔	fkht
嗐	hskk
艰	jmyg
犍	jmny
桨	jslm
鲛	jnyf
诘	jqyk
襟	jbpu
钜	jcjj
骏	jtmw
侉	kvrk
厘	loil
劣	loul
聆	lles
琉	lwwi
氯	lcqu
玟	wgww
颞	noey
颦	pnvu
麒	qolb
熔	rdhg
轼	uuig
驷	sums
锑	tijd
猥	wrqy
奚	xivd
嬉	xink
偃	ylrn
鄢	yjve
谒	ywyr
苡	ypcr
茵	ybcy
娱	ybnt
陨	yieb
疹	vhbp
桢	vfmb
蹩	bqxz
埗	bytu
鹾	cpbg
娣	dund
氐	dpud
妒	dynh
阜	fylu
褂	gzpb
胍	gxog
罕	hlbg
笏	hyvw
涣	hedd
恍	hsxe
疖	jpbe
荆	jkcd
炯	jfhk
僦	jpry
倔	jrri
珺	jtwk
侩	kjry
括	kifu
醨	loyn
沥	ludl
砺	luuw
络	lisk
鳗	mkyy
朦	mhou
旻	mnow
茉	micw
募	mycl
砷	ufuu
蟀	ujiu
倘	tkrk
涕	tudd
隈	wwey
唏	xikj
酰	xmye
校	jbmf
榭	xomc
歆	xblq
琇	xpwn
晔	ywou
翊	yulx
缨	yksn
佣	ysry
蕴	ytcm
奘	zgpd
琢	vpwu
龇	zivb
镗	tjjt
铵	azjn
梆	bhme
敕	iuuw
嫡	dong
菂	ducu
幡	fjjt
纺	fksf
巩	gfgf
辜	gugx
呱	gukg
鹫	jpwn
锎	kdjk
奎	kbdt
愧	kcxg
琨	kywb
崂	lvul
鬣	loev
蚂	mdim
嫫	mpnd
钕	nnjn
埤	putu
铍	pojp
骞	qmbm
窍	qbbk
锹	qnjh
偌	rirk
石	dhak
庶	uygh
嗵	tsky
圩	wety
宪	xnbe
潇	xndb
谐	xqyb
绪	xcso
绚	xeso
砚	yhuj
湮	yjdt
肴	yvxo
罂	ykbf
蚴	ymil
瘐	ynbr
棹	vxmu
踏	tazo
咥	xukt
耙	pslb
阪	bley
犇	bfnn
迸	bfzk
弼	bugb
俵	bbry
秉	baqr
晡	buof
槎	ismg
刹	ilxd
憧	isxl
槌	ibml
绰	iisu
篡	cevs
皴	cyyp
鞑	dsgd
怠	dssx
诞	dhyv
谠	dkyx
筜	dhve
氘	dcql
萼	ewck
阀	fsmg
芣	ficb
馥	fyhw
哽	gjkg
骸	hfgr
骇	hsmr
捍	hhfg
阖	hrmm
缳	htsy
咴	hvkh
镓	jxju
枧	jxmj
蹇	jxbz
戋	jmga
爵	jyvc
隽	jern
瞰	khow
哙	kjky
喟	kcko
濑	lsdb
镭	lejt
髎	lmgp
凛	lmdu
鸰	llrn
娈	ltwn
鸾	ltwn
捋	lnfc
莽	mkcc
镍	nojm
爿	pkvl
僻	purx
噼	pikx
鳍	qoyo
羟	qsyj
羌	qlyv
戗	qlrg
衢	qbrv
鳃	sdyx
疝	uhbu
曙	uooo
唾	tikt
罔	wkkw
窸	xibx
狭	xcqj
冼	xxde
溴	xpdq
靥	ywim
祎	yipw
峪	ycug
煜	ychl
筼	yuvb
辄	vriv
诤	vfyy
徵	vprw
钯	bdjb
赑	bubb
采	csvm
垞	istq
偿	ijry
瞋	ifob
丞	ihla
辍	iiiy
脞	cqor
惦	dnxv
胴	daok
昉	fkof
讽	fjyf
尴	gjym
眭	svot
纮	hdss
骺	hxgk
桦	hzmu
戢	jokg
玑	jiwj
缉	jise
烬	jvhd
胩	kdob
阚	khmw
亢	kgwj
眶	kkow
夔	kbbw
邋	lazv
藜	locu
蓼	lzcp
嬷	mpnm
蘑	mpcu
懦	nixe
怄	oyxq
澎	phdp
莆	picf
玘	qpwj
悄	qnxo
袪	qvpq
濡	ride
箬	rivk
铯	swjb
芍	uvcu
蜃	udii
燊	ufhm
殳	uujy
姒	sunr
悚	sfxu
祟	sciu
髓	sngo
琐	sqwb
獭	tdqb
渭	wqdo
鲔	wryo
芜	wicw
晞	xioj
纤	xmsq
橡	xkmu
鸮	xnkn
煦	xcoh
询	xuyo
埙	xytb
鸯	yhyn
冶	ytdk
毡	vjmv
彰	vhlp
跖	vozu
癿	bqbv
膀	bkof
褙	bqpo
咇	bukb
匕	bppv
辟	puux
扁	pmhc
璨	chwm
漕	cvdo
杈	iami
彳	iupr
仇	qwrj
揣	ikfe
扽	ddft
奠	dnbd
颚	ewky
酚	ffyf
蝠	fiit
釜	fofb
莞	wlcy
颌	hrry
弘	hdgs
藿	hicv
乩	jivv
伎	jurv
荠	jucq
俭	jxrq
疆	jlgj
剿	jzvd
喈	jpkb
靳	jvgj
颈	gjjy
噱	xyku
匮	kckb
栎	luml
琏	lxwi
燎	lmhx
骝	lwmt
耧	lxln
缪	mxsp
蘖	nocm
辔	pqsk
霹	piyx
歧	qovv
扦	qmfq
氰	qlqo
呻	ufku
晟	ihoi
俟	suru
鳎	tdyx
膛	tjot
叨	dckd
嚏	tukz
鸵	tpnb
顽	wkyy
魍	wkgw
蜥	xiij
醯	xiym
芗	xlcx
楔	xpmd
眩	xeox
驯	xtmi
谚	yhyp
龈	ynvg
瀛	yldn
舆	ybjb
隅	ybed
豫	ycyu
昝	zlwo
藻	zbcm
绽	vhsz
秩	vuhf
潴	vudo
荷	hwck
卜	bold
浐	ildi
敞	ikxw
豉	ipdv
惆	ixxk
酬	ixyv
雠	ixry
泚	cpdb
囱	cspw
蠹	dygi
踱	dpzy
筏	fsvg
舫	fkvf
钆	gsjv
丐	gsav
觚	gudg
颔	hhry
蘅	hhcd
黉	hdxh
珲	huwi
圾	jitj
祭	vsxu
矫	jmul
桀	jqxm
噤	jvku
胫	jjoj
蝲	llid
阆	lgml
吏	lugn
釐	xiwl
璘	lnwf
窿	ldbu
椤	lpmx
髦	mvem
贸	mxpb
邈	mzze
脲	nbou
湃	psdf
鞘	qbgo
湫	qqdh
龋	qnvy
诠	qtyw
蹂	rxzm
潵	sddw
弑	uuxg
墅	uylt
抒	uufy
泗	suds
饲	suuk
忑	twxx
骰	txgu
鹜	wymn
烯	xihj
匣	xckj
缐	xnsu
漩	xtdz
鳕	xuye
浔	xudc
氩	ylqy
焰	yhhj
琰	ylwh
奄	yldd
荧	ylch
痈	ysby
攸	yzrw
榆	ybmd
辗	vliy
钊	vcjd
挚	vufu
肢	viov
峙	vuuc
衷	vsyv
绉	vmse
纂	zyvx
绷	bjso
舶	bpvb
蛏	igit
魑	iign
绸	ixsk
粹	ccmu
玳	dswy
骶	dpgu
钿	dnjt
鲽	dqym
锻	deju
俘	firz
孚	fivz
诟	gmyk
刿	gcud
壑	hwbt
堠	hmtu
葫	hico
瓠	hydg
烀	huhh
遑	hazw
戛	jcbg
鳉	jlyc
玠	jowj
菁	jkco
迥	jfzk
韭	jefa
蒟	jncj
裾	jvpg
涓	jrdo
崛	jyui
箜	ksvg
喹	kbkt
壸	kity
悃	kixm
涞	lfdl
俐	lurd
醴	lpyb
蠊	lzij
蔺	lvcv
垄	lflt
芦	lich
颅	liby
扪	mgfm
冕	mxoe
睦	myot
丕	piba
翩	pmhx
岐	qouv
碛	quub
讫	quyv
鸲	qbjn
诎	qvyi
痊	qtbw
阕	qrmt
鞣	rxgm
蒻	ricg
鳝	uhyk
莘	ufcx
澍	uydc
烁	uihl
澌	sidj
稣	suyh
螣	thoi
忝	txtx
仝	tdrg
僮	tdrl
柝	timi
帷	wejv
钨	wujw
隙	xueo
晰	xioj
巷	hggs
械	xomc
邂	xozn
匈	xsbx
欻	xvhq
堰	yhtn
沂	yodj
贻	yobk
挹	yufb
邑	yukb
瑀	ynwy
赃	zhbt
沼	vbdk
斟	vfcd
箴	vfvk
烝	vglh
旨	vpbo
纣	vmsc
镦	dyjw
氾	fkdv
嫒	auny
霭	apyr
岜	baub
悖	bqxz
锛	bfjc
毖	bubb
亳	bpwq
馇	iaud
阐	ilmu
殂	cidq
疍	dhzd
铛	dhje
靛	dnfz
渎	didd
愕	ewxk
尜	gsxx
诰	gxyk
胳	geok
毂	gotu
菰	gucg
吭	hjkj
曷	hror
珩	hhwd
糇	hxmu
唿	hukx
蝗	haiw
诲	hcym
虺	hnwi
睢	svov
蓟	jucd
讥	jiyj
稽	jiho
稼	jzhu
胛	jvoj
狡	jzqf
郊	jnwe
睫	jqoz
蚧	joij
疚	jpbj
眷	jejo
峻	jtuw
龛	kjrl
轲	keik
骷	kugg
盔	kvum
锟	kyjb
斓	lkwj
螂	ljie
骊	lomd
埒	lotc
庐	ligh
鲈	liyu
犸	mdqm
幔	mhjy
蠓	mjiu
泌	mudb
秣	mihw
眸	mxon
柰	nsmu
馕	nkuy
坭	notb
瓯	ouqw
珀	piwb
芩	qncv
颧	qtcy
苒	rlcr
戎	rdgu
冗	rfbj
搡	skfm
汕	uhdu
杓	bnmu
牲	ugnu
枢	uumq
绥	sbsn
狲	syqx
苔	tdck
誊	thjk
湍	trde
褪	ttpg
惋	wlxv
宛	wlbv
巍	wwug
邬	wuwe
屃	xuub
饷	xsuk
朽	xemk
勖	xcol
墟	xvty
渲	xedd
谖	xryy
胰	yooy
猗	yiqk
莜	yxcw
垣	yttd
沅	ytdy
锃	zfjw
樟	vhmu
鹧	vwgn
祉	vppv
蜘	viik
肫	vyot
斫	vpuj
眦	zuob
蕞	zccy
酢	ziyv
鹡	jorn
螯	apfi
堡	pyrt
襞	buuy
蝙	bmic
骉	bnmm
帛	bpbj
膊	bpoc
簸	bqvp
惭	ckxj
沧	chdv
忏	ihxq
怅	igxi
骋	ijmk
弛	iogy
绌	iysi
黜	iyli
揣	ijfe
钏	ieji
璁	cswx
撺	crfi
淬	ccdu
埭	dstl
绐	dssk
担	dhfd
荻	doch
翟	vfxv
簟	dnvu
甸	dnbt
鲷	dnyk
篼	dzve
蔸	dzce
阇	dumo
垛	dqtm
锇	erjw
矾	fkuf
苻	ficc
赅	gdbr
皋	gcbu
鲧	giyx
焓	hkhk
郃	hrre
貉	hrvk
糊	humo
徊	hlrk
奂	hedd
恚	hctx
攉	hofv
畸	jitk
铗	jcjj
鹣	jmjn
徼	jbrf
竭	jqlr
旌	jkfu
咎	jpwk
矩	jnuj
苣	jccj
蹶	jyzq
楷	kgmb
蝌	keid
喾	kyxk
栳	lbml
潦	lmdx
呖	lukl
赁	lvrb
咙	ldkl
瘘	lmbn
戮	lyxg
漉	lydl
簏	lyvl
泺	lidl
汨	mudo
忞	mnwx
漠	midd
缪	mbsp
氖	ngqn
瑙	nbwx
淖	nxdu
啮	nokr
俳	pfrf
哌	psky
沛	pqdu
篷	phvf
乒	pkqp
抔	pxfb
潽	pudo
杞	qpmj
茜	qncx
綮	qjhx
瞿	qbov
荃	qtcw
纫	rdsr
丧	shty
觞	uhdp
噬	uukr
蔬	uuci
嗣	sukk
伺	surk
崧	ssug
菘	sscg
隧	sceu
骀	tfmk
砼	tdug
恸	taxl
椭	tqmo
洼	wadt
淅	xidj
岘	xnuj
庠	xagy
囟	xvpx
洵	xudo
讶	ylyy
衍	ylrd
殃	yhdy
浥	yudb
翳	yukx
蜴	yuiw
谊	yuyq
诒	yoyk
铟	ybjy
萤	ylci
萦	ylcx
聿	ycyg
耘	yuly
谮	zdyo
湛	vhdb
锗	vtjo
雉	vuuv
骤	vmmu
鬃	zseu
咉	yhky
媞	uunz
柏	bpmb
褓	bbpm
蓓	bqck
篦	buvb
蓖	bucb
髀	bugu
裳	uhxy
坼	iwti
裎	ihpw
螭	iiin
楮	iomo
氚	irqi
鹑	iuwn
蔟	cycu
忖	cixc
痤	cpbr
耷	dade
瘩	dabk
焘	tcfh
涤	dodm
邸	dpue
锭	djjz
玎	dkwd
酊	dkyd
铥	dqjq
钭	dcjd
肚	doot
缎	desu
碓	dcuv
哚	dqkm
咄	doki
匐	fibt
茯	ficq
辐	fiit
溉	gsdw
缟	gbsk
蛄	guig
氿	jedj
姮	hhnd
衡	hhrd
逅	hmzk
鹄	hinn
婳	hznt
宦	hebi
鲩	heyy
荟	hccy
绩	jusb
羁	jism
纪	jpsj
菅	jmcl
茭	jncf
疥	jobj
痉	jjbj
柩	jpmj
倨	jcrg
莒	jnck
琚	jvwg
雎	jvqv
咀	znkq
慨	kgxw
窠	kebg
垦	khgt
刳	kudd
夼	ksdi
蝰	kbit
鲲	kyyb
榄	llmj
酹	lqyc
蛎	luiw
蠡	lphi
寥	lmbp
蒌	lxcn
潞	lydk
虻	mhiw
瞢	mhco
岷	mnum
珉	mnwm
溟	mldl
镆	mijd
囔	nhky
辇	nxfi
徘	pfrf
庖	pvgb
貔	povb
嫔	pnnb
匍	pibf
朴	pmmb
蕲	qocj
汽	qudq
欹	qidq
槭	qumx
蹊	xizd
钤	qzjv
阡	qmeq
慬	qnxw
磬	qjtu
罄	qjtf
蝤	qwiy
鹊	qrcn
瘙	sxbi
赡	uhbk
韶	uvlk
潲	uxdo
纾	uusy
蒐	szcg
飕	szfy
跆	tfzk
忐	tlux
慝	twkx
珽	tawt
钍	tojt
驮	dimd
烷	wkhy
脘	wloy
杌	wymw
诬	wuyr
潟	xudh
徙	xprz
辖	xcik
涎	xzdv
铣	xpje
枵	xnmk
惺	xkxu
嬿	yhnh
焱	yhhh
峄	yuuf
诣	yuyo
镱	yujx
揖	yife
荑	tocy
霪	ynyt
颍	yaby
甬	yfsy
镛	ysjo
阈	ycma
俣	ynrt
湲	ytdy
刖	yrod
钺	yrjl
錾	zhij
崭	vluj
晢	vrfo
轸	vhip
拯	vjfi
摭	vofh
卮	viiv
踪	zszu
诹	zzyy
遂	sbzu
稗	bshu
邶	bqbe
孛	bquz
陂	poep
苄	bncb
飑	bnfb
僰	bpur
钹	bpjf
砵	boub
艚	cvvo
谄	ilyj
鲳	ihyo
蚩	iici
亍	iyad
蹴	cyzy
缞	cvsv
凼	dgku
砥	dpuu
蚪	dcid
婀	eenk
铒	eyje
璠	fkwt
钒	fkjf
妨	fjnf
淝	fedb
忿	fdfx
氛	ffqf
俸	ffrf
酆	fgue
桴	fimz
腑	fooc
麸	fuff
垓	gdtr
觥	gsde
倌	grrl
毌	geml
菡	hhcu
菏	hrck
斛	hidd
惚	huxx
篁	havw
蕺	jocg
浃	jxdj
睑	jxoq
缄	jmsk
槛	jnmm
醮	jbyh
珒	jbwy
儆	jarw
臼	jppa
鬏	jqeh
讵	jcyj
踞	jczg
橛	jymq
珏	jywy
捃	jtfk
岢	ktuk
炣	kthk
髁	kegg
铿	kgjt
筘	kmvk
揆	kbft
焜	kyhb
睐	lsol
痢	lubd
奁	lzdq
鲢	lzyi
缭	lmsx
冽	lodd
捩	lofq
洌	lodd
羚	llys
苓	llcs
崚	lhuw
茏	ldcl
泷	uldl
泸	lidu
镥	lojo
蟆	msid
劢	mswl
牤	mhnw
媄	mrnd
醚	moym
麋	molm
沔	mxdg
蓦	micm
萘	nscu
艿	ngcn
睨	nuoe
旎	npfb
柠	nlmd
狍	pvqb
罴	posh
圮	pptj
鄱	ppce
魄	pibg
亓	qoaw
骐	qomb
憩	quux
洽	qzdk
慊	qnxj
慊	qoxj
荨	xucc
嫱	qank
穹	qdbg
蚯	qqiq
铨	qtjw
绻	qysv
髯	rker
壤	rktx
攘	rkfx
桡	rvmw
糁	ufmp
绍	uxsk
珅	ufwu
埘	uotc
谥	uuym
祀	sups
竦	sflu
夙	syjd
邰	tfse
倓	tkrh
铤	tajt
疃	tytl
饨	tuut
琬	wlwv
豌	wjdv
沩	wedw
玺	xpdy
歙	uwrq
舷	xzvx
祆	xmpt
筱	xzvw
嚣	xnkk
吁	xvky
楦	xemd
儇	xrry
旋	xefz
谑	xrye
曛	xyoh
岈	ysuy
琊	yswe
赝	yhib
酽	yhyy
邺	ywye
弈	yuwc
潩	yudg
缢	yusm
臆	yuox
荫	ybco
郢	yake
璎	ykwn
踊	yfzy
壅	yswt
欤	ybyq
鹬	ycmn
芫	ytcy
龠	yrrc
甾	zdvt
择	vfff
咤	vlkq
旃	vjfd
曌	vxog
谪	vryg
赭	vtio
鸩	vdbn
缜	vhsb
溱	qndh
峥	vguy
窒	vubt
蛭	vuit
栀	vimv
茱	vucw
篆	vevu
擢	vpfv
叕	vpyy
髭	zieb
馇	vaud
骜	aifm
靬	qzgg
腌	aaod
叆	auyy
隘	auem
埯	aztd
懊	aixd
鲃	bayb
荜	bucu
濞	budw
摽	bbfu
髌	bvgb
箔	bpvb
鲌	bpyb
泊	podb
埠	bytf
瓿	bylw
汊	ildi
刬	ihjd
晁	ivov
郴	ifme
宬	ihbi
澂	ihdw
匙	uiob
瘳	izbp
梼	tvmc
莼	iuct
琮	cdwu
萃	cccu
傣	dgru
纛	dxfx
蹈	dbzj
嶝	dfub
镫	dfjb
戥	djog
籴	dorm
耋	dqlt
昳	dqof
氡	dsqd
椟	dimd
噩	ewwk
鹗	ewkn
珥	eywe
珐	flwq
狒	fqqf
翡	frfx
痱	fqbf
鲼	fdyb
凫	finj
黻	fiyf
驸	fymc
冮	ghdg
圪	getv
疙	gebv
鲠	gjyg
赓	gggb
彀	gmtu
锢	gyjg
汩	godo
胱	gloe
庋	gngv
鲑	gvyt
腘	gpoy
嗥	hvku
鞨	hrgr
鸻	hhrn
薨	hscb
煳	hiho
蝴	hiio
怙	hyxg
镮	htjy
鬟	htey
痪	hebd
徨	harw
洄	hbdk
蛔	hbik
贿	hcbo
夥	hqgx
鲫	juye
踺	jnzy
酵	jbyz
肼	jaoj
兢	jkux
扃	jshk
厩	jpiw
阄	jqmd
炬	jchj
飓	jcfb
枸	jnmj
谲	jyyk
钧	jyjy
崁	khuq
疴	kebk
脍	kjoy
浍	hcdy
圹	kktg
铑	lbjl
簕	lwvl
诔	lryl
莅	lucl
魉	lsgl
獠	lmqx
躏	lvzv
懔	lmxu
蛉	llis
垆	litu
胪	liou
葎	lccy
孪	ltwz
峦	ltwu
蟊	mvmi
铆	mbje
袂	mqpg
宓	fibb
眇	mzou
篾	movd
蔑	mocd
靺	migw
衲	nlpn
猱	nvqm
佞	njrn
耦	oold
滂	phdf
脬	pcoz
椪	pfmy
蚍	poib
譬	puuk
淠	pudw
苤	pwcp
鲆	plyp
娉	pknk
哱	bokz
埼	qotk
迄	quzv
耆	qolo
缱	qxsl
樯	qamk
荞	qmcl
锲	qojd
郄	qoxe
黥	qllx
顷	qaby
蜻	qkio
箐	qjvo
蛩	qdgi
泅	qwdr
酋	qwby
鳅	qqyh
觑	qchj
傕	jyrv
嵘	rdum
糅	rxmm
蠕	riie
颡	skyy
啬	swtk
霎	ulyn
蟮	uhik
姗	ujnc
墒	uhtk
莳	uocc
秫	uihu
沭	uydu
槊	uinm
溲	szdy
涑	sydu
肃	syyb
燧	schu
濉	svdv
榫	simu
闼	tlmd
覃	qnxu
瑭	tjwk
傥	tkrx
嘡	thkt
弢	tcgy
铽	twjx
鹈	tobn
屉	tuuu
莛	tlct
蜓	tlit
彖	tehu
呙	gokn
妧	ytny
猬	wqqo
偎	wwry
尉	wquc
汶	wddw
肟	wiok
侮	worm
庑	wogw
忤	woxu
圬	wutk
郤	xuge
浠	xidj
粞	ximx
遐	xczy
氙	xmqu
襄	xlyf
骧	xlmx
崤	xmuo
皛	xzbb
绡	xnso
胁	xqob
亵	xoyw
荇	xjcd
煋	xkhu
芎	xscg
酗	xcyx
胥	xvzo
畜	iyxt
烜	xyhd
鲟	xuyc
蕈	xtcu
衙	ysrk
滟	yhdb
餍	yhig
䶮	yllt
卬	ajpe
烊	yjhy
窈	ybbl
怿	yuxf
熠	yuhb
燚	yuhh
媖	ykny
鹦	ykbn
慵	ysxo
牖	ycpf
铕	ycjo
黝	ycll
嵛	ybud
玙	ybwy
萸	ybcr
谀	ybyr
堉	ycto
圉	ynkg
禺	ybtd
嫄	ytnx
钥	yrjo
恽	ytxi
殒	yidb
氲	yyqm
哳	vakj
楂	vamd
嶂	vguu
圳	vdti
禛	vfpb
陟	vueu
宙	vmby
帚	vcej
伫	vyrv
馔	veug
隹	vvrv
茁	vpci
恣	zudx
滓	zpdx
耔	zplz
淄	zidt
兹	coby
俎	zorq
祚	zipv
訾	zpvk
嵴	jouo
镝	dijg
奓	vadx
皑	aobj
桉	anmn
盎	agym
肮	ahoj
奡	aibl
岙	aiyu
鲅	blyf
笆	bavb
枹	bcmb
栟	bfmk
甏	bftw
绷	bfso
滗	budm
箅	buvw
陛	buet
昪	bnoc
鳔	bbyu
膑	bvob
伯	bgrb
逋	buzf
黪	cllp
伧	chrv
嶒	chuo
姹	ilnq
孱	ikuz
鬯	igkb
猖	ihqo
琤	igwy
茺	iscy
樗	iumk
遄	itze
怆	ikxv
幢	iajl
蝽	iyio
踔	iozu
苁	cscr
枞	zsmr
辏	cmit
徂	cirq
瘁	ccbu
璀	cnwv
褡	dapk
淀	dndz
啶	djkz
疔	dkbd
牍	dipd
耑	drue
惇	dyxz
礅	dyuw
垩	ewyt
苊	ewcv
洱	eyde
鲂	fjyf
诽	fryf
棻	ffcm
纷	ffsf
葑	fgcc
罘	fisb
矼	ghug
杲	gbom
槁	gbmk
舸	gtvk
袼	gepk
亘	gdad
茛	gdcg
唝	hfkb
觏	gmfj
姤	gmnk
牯	gong
诂	goyg
鹘	hign
绲	gisb
辊	giib
蜾	gqig
咍	hdkk
瀚	hhdx
鼾	hjzg
沆	hgdj
翮	hrgx
桁	hhmd
闳	hdms
槲	himd
戽	hyhd
豢	heju
圜	ytky
彗	hcfe
翙	hcux
翚	hvxi
麾	hvgm
隳	hvex
馄	huub
溷	htdu
诨	htyi
钬	hqjh
濩	hidy
岌	jouj
楫	jome
殛	joda
徛	jurk
洎	judz
芰	jucv
骥	jumg
墼	jiit
嵇	jihu
笄	jivk
济	jpdq
泇	jxdk
戬	jxyg
謇	jxbk
湔	jmdd
耩	jslr
侥	jzrw
褯	jopj
芥	gscj
藉	joco
觐	jvcj
遽	jczu
沮	jndq
孓	jyln
抉	jyfg
攫	jyfy
爝	jyhc
矍	jyoy
噘	jtkq
竣	jtlw
锴	kgjb
墈	khtl
㸆	kxhf
犒	kxnk
瞌	keom
矻	kuuv
贶	kkbx
蒉	kccb
籁	lsvb
漤	lldn
榔	ljme
埌	lgtl
罍	letf
擂	left
塄	lhtf
棱	lgmw
篱	lovn
缡	losn
罹	losv
蓠	locn
枥	luml
砾	luul
隶	luyu
娌	lpnl
跞	luzl
郦	lule
僚	lmrx
尥	lbyu
蹽	lnzx
吝	lvwk
鎏	lwdj
尨	mjlp
嵝	lcun
舻	livu
渌	lydu
辘	lyil
偻	lnrn
挛	ltwu
锊	lrjc
猡	lpqx
逻	lpzx
荦	licn
瘰	lqbx
蔓	whcy
邙	mjwe
懋	mxmx
峁	mbue
渼	mrdd
懑	mddx
勐	mjzl
蜢	mjim
猕	moqx
谧	muym
敉	mpmw
丏	mxgl
藐	mzce
缗	mnso
黾	mmkd
谟	mpyd
瘼	mibd
模	mimd
苜	myco
鼐	nsno
忸	nexi
杻	nemi
杻	icmi
衄	ncpi
疟	nrbe
锘	nijk
杷	psmb
匏	pvdb
霈	pqyu
湓	pgdm
怦	pgxp
枇	pomb
琵	powb
伾	pirp
邳	pibe
骠	bnmu
缥	pnsu
氕	ppqp
叵	pqkk
菩	pick
溥	podc
崎	qouk
碶	quud
屺	qpuj
棨	qphm
芑	qpcj
佥	qmra
钎	qmjq
堑	qnit
谯	qmyh
峭	qbuo
橇	qnmm
硗	qnuw
伽	gark
芹	qncj
吣	qvkx
揿	qvfq
檠	qlcm
巯	qwji
璆	qwwp
遒	qwzy
囷	qykh
穰	rjhx
妊	rdnt
驲	rumo
瑢	rdwg
褥	rypc
脎	slom
靸	sdgj
馓	sluw
臊	sxom
穑	swhk
裟	uady
膻	ujod
畲	uert
鲥	uoyc
鼫	uoju
豕	upau
蓍	uico
塾	uiwt
腧	uyod
菽	uucy
闩	urma
兕	suae
笥	suvk
锶	sijx
嗾	scku
薮	sccw
嗉	sykx
蔌	sycq
谡	syyw
甦	sugu
宿	xebb
宿	xpbb
谇	scyu
邃	sczu
唢	sqkb
酞	tsyt
啴	ilku
搪	tjfk
萄	tvcf
縢	thox
绨	tusd
沺	tzdt
殄	txdp
窕	tzbv
餮	todg
萜	tpcv
侹	tart
烃	tkhj
梃	tamt
梃	tjmt
哃	tdkk
曈	tdol
潼	tddl
抟	ttfv
煺	tchg
鲀	tuyt
拓	tlfu
窊	wabg
嵬	weug
帏	wejw
潍	wedv
艉	wrvm
苇	wrcw
诿	wryn
涡	godn
梧	wimk
蜈	wiit
寤	wybk
鹉	wogn
屣	xpuz
穸	xibx
谿	xivg
猃	xxqq
缃	xlso
葙	xlco
哓	xnkw
虓	xnjj
蛸	xnio
獬	xoqn
伈	xmrx
脩	xqro
诩	xnyx
煊	xrhd
禤	xrpx
翾	xrsx
蚜	ysiy
轧	vsiv
怏	ygxy
恙	ygyx
泱	yhdy
峣	yvuw
彝	yohc
弋	yuyd
羿	yuxc
狺	ynqk
鄞	ynce
愔	ybxo
氤	ybqy
瘿	yabn
膺	ykgo
猷	yxbq
竽	ybvy
腴	ybor
谕	ycyd
予	ybsl
塬	yttx
掾	yefu
垸	yety
狁	yiqy
慥	zxxk
迮	zrzv
缯	zgso
栅	ujmc
璋	vhwu
笊	vxvv
蜇	vrfi
柘	vwmu
赈	vdbi
侦	vfrb
埴	votq
桎	vumt
豸	vupp
轾	vuit
稙	vihq
畤	vutc
踵	vfzv
舯	vsvv
妯	vxny
胄	vmyo
荮	vmcc
柷	vymx
贮	vybv
瞩	vooy
麈	volv
侏	vurw
橥	vuqm
竺	vive
啭	vekv
晫	vpou
孜	zizw
驺	zzme
镞	ziju
诅	zoyq
怍	zixv
叨	dvkd
拤	qcfb
炘	xbhj
蜚	frfi
嘌	pbku
镪	qlji
垯	datd
崀	lgul
硊	hcuv
崾	yxun
砹	auux
蔼	apcr
锿	aijk
鹌	andn
璈	apww
聱	apfe
遨	apzw
鏊	aifj
攽	bjfw
癍	bjbw
塝	bgtf
蚌	bfif
雹	bvyb
鸨	bbbn
碚	bquk
鞴	bqgy
庳	bugu
坌	bdft
畚	bhst
荸	bocz
嬖	buun
苾	bucb
妣	bpnb
舭	bpvb
贲	bfub
睥	puou
砭	bmuf
笾	bmvl
摈	bvfb
殡	bvdb
玢	ffwf
菠	bocp
擘	biuu
醭	biyf
骖	cjmp
螬	cvio
涔	cgdv
𥻗	ismd
侘	ilrq
诧	ilyq
潺	ikdz
躔	ikzt
羼	ihuy
襜	ijpk
伥	ihri
阊	ihmo
怊	icxk
忱	igxe
谌	igyb
棽	ifmv
棽	ufmv
惩	ihrx
酲	ihyw
澄	dfdb
漦	iowu
茌	ioct
褫	ippj
笞	iivk
艟	isvl
漴	iddu
畴	ixtc
帱	ixjc
滁	iidm
憷	iyxz
搐	iyft
础	ioui
圌	ibke
惙	iixy
匆	csbd
猝	cyqu
漼	cndv
溚	dsdk
轪	dsid
迨	dszk
殚	djdu
眈	djoe
箪	djvu
澹	tkdk
垱	dgte
宕	dgbu
忉	dcxd
磴	dfub
玓	duwu
缔	dusj
诋	dpyu
柢	dpmu
扂	dnhv
琔	dnwz
癜	dnbu
佃	dnrt
窎	dbbn
铫	yvjv
堞	dqtm
牒	dqpm
绖	dqst
蹀	dqzm
楪	dqmm
仃	dkrd
耵	dked
胨	daod
垌	datk
侗	dark
煅	dehu
蹾	dyzw
峨	eruw
轭	ewiv
遏	ewzr
咡	eeke
耏	etep
垡	fsrt
砝	fduq
蘩	fkcx
畈	fhty
繁	pppx
枋	fhmf
悱	frxf
芾	ficu
偾	fdrb
烽	fghf
涪	fidk
祓	fipf
绋	fisf
蚨	fiif
蜉	fiiz
咐	fykc
赙	fybc
拊	fofc
黼	foyf
趺	fuzf
鄜	fule
脯	foof
戤	gsng
澉	gldw
鳡	glyx
玕	gjwg
酐	gjyg
堽	ghtv
锆	gxjk
篙	gcvk
饹	geuk
绠	gjsg
蚣	gsig
岣	gcuj
篝	gzvr
鞲	gzgr
崮	gyug
梏	gymk
牿	gynk
榖	gotu
瀔	godu
酤	guyg
坬	gztg
夬	gjvr
筦	gyvy
莞	gycy
洸	glde
妫	gvnw
珪	gvwt
皈	gvby
桧	gcmy
鳜	gcyq
帼	gpjy
馘	gpba
聒	goeu
蝈	goiy
醢	hgym
垾	hhtg
扞	hhfg
撖	hhfw
暵	hhot
淏	hxdt
涸	hrdg
龢	hrrh
熇	hwhk
竑	hdls
翃	hdux
篌	hxvu
垕	hmit
鲘	hmyk
醐	hiyo
鹕	hign
浒	xndu
铧	hcju
峘	htud
漶	hedx
湟	hadw
璜	hawh
癀	habh
簧	havh
锽	hajw
隍	haew
诙	hvyh
阍	hymo
笈	jovj
悸	juxz
穄	juhu
觊	juuj
剞	jidd
芨	jicj
荠	qocq
觭	jidk
郏	jcje
跏	jxzk
袷	qxpk
毽	jnmy
腱	jnoy
翦	jxbx
谫	jxyd
搛	jmfj
缣	jmsj
鲣	jmyt
糨	jkmi
噍	jbkh
漖	jbdw
藠	jbcb
檞	jwmn
湝	jpdb
拮	jqfk
颉	xqty
妗	jvnv
祲	jvpy
缙	jvso
荩	jvcd
馑	jmuw
迳	jjzj
憬	jaxx
阱	jaej
岠	jcuj
窭	jcbn
醵	jcyu
榉	jnmf
龃	jnvq
娵	jvny
疽	jvbq
苴	jvcq
枸	gcmj
岨	jvuq
鄄	jexe
蠲	jrbi
垲	kgtj
闿	kgmj
忾	ksxq
钪	kgjj
栲	kbmk
缂	kwsg
牁	kepk
裉	kdpg
绔	kysk
姱	kxnk
郐	kjre
鲙	kjyy
蒯	kacd
睽	kbot
逵	kbzt
馗	kbjz
愦	kcxb
馈	kcub
跬	knzt
裈	kypi
鹍	kyon
旯	lsoj
镴	lljv
赉	lslb
褴	lkpm
襕	lkpj
谰	lkyj
镧	lkjj
缆	llsj
稂	ljhl
锒	ljjl
塱	lklt
烺	lkhl
泐	lwdl
檑	lemt
儡	lrrt
礌	leut
嫠	lown
鹂	loln
黧	lohh
苈	lucl
荔	lucl
詈	lusk
雳	luyl
澧	lpdb
疠	lubw
楝	lnmj
墚	latm
椋	lamx
燎	lzhx
钌	lzjl
漻	lmdp
趔	lotd
躐	lozv
粼	lnmv
遴	lnzf
檩	lmmu
棂	llmh
舲	llvs
酃	llye
浏	lwdd
镏	lwjt
锍	leji
眬	ldol
琭	lywu
蕗	lyck
榈	lbmk
碌	lpuu
滦	ltdm
囵	lukl
纶	grsl
雒	liwv
杩	mlmm
荬	mgcd
鬘	mkey
镘	mhjy
漭	mkdc
牦	mvnm
瑁	mxwo
嵋	meuo
楣	memo
鹛	meun
浼	mrde
钔	mgjm
醾	moym
糜	megm
娩	mxne
腼	mxom
愍	mmmx
湣	mmdo
瞑	mlol
酩	mayk
侔	mxrn
仫	myrm
𧿹	mozm
蝻	nlig
曩	nkox
铙	nvjw
怩	noxb
猊	noqe
铌	nojb
麑	nole
埝	nntx
陧	noet
搦	nifg
讴	ouyq
筢	psvb
蒎	pscy
槃	pkvm
蟠	pkit
襻	phpu
抨	pgfp
郫	pope
砒	piub
仳	pprb
纰	pisb
殍	pzdz
俜	pkrk
钷	pqjk
钋	pojb
镤	pijf
镨	pojo
埔	bytf
朴	pimb
芪	qocu
锜	qojk
跂	qozv
踦	ypzk
圻	qotj
掮	qzfo
岍	qmuk
愆	qmrx
搴	qmbu
杄	qmmq
汧	qmdk
锖	qljo
戗	qkrg
憔	qmxh
诮	qbyo
悄	qzxo
伽	qqrk
檎	qnmn
庼	qagy
圊	qkko
鲭	qkyo
邛	qdge
犰	qwqj
虬	qwiv
赇	qwbq
萩	qqch
鞧	qqgy
灈	qbdv
璩	qbwu
蘧	qbcu
蠼	qbiy
鼩	qbjj
阒	qcmq
蛐	qviq
躯	qvuq
筌	qtvw
辁	qtiw
炔	qthg
埆	qrty
轫	rdir
荏	rhct
嚅	rike
嬬	rine
孺	rize
溽	rydc
缛	rysc
蕤	rbcu
蚋	rcin
磉	skum
埽	sxtj
铩	uajm
舢	ujvu
钐	uhjp
绱	ugsk
晌	ukok
劭	uxdl
艄	ucvo
矧	uhul
屾	ufuu
甡	ufuu
诜	ufye
鲹	ufyp
甥	ugul
陞	uget
筮	uuvr
贳	uuub
铈	uujj
酾	uiyd
狩	umqc
绶	umsy
戍	uywd
孀	ulno
楯	uimo
妁	uinu
搠	uifo
蒴	uico
涘	sudu
缌	sisx
虒	siij
讼	sayg
忪	ssxg
螋	sziy
锼	szjy
擞	scfw
愫	syxx
簌	syvq
窣	subu
荪	sycx
飧	syxg
睃	soow
羧	soyw
挲	sodu
溻	tadx
褟	tapx
趿	tazj
沓	dsuo
炱	tfsh
薹	tfct
袒	tlpd
螳	tjit
鄌	tjge
镗	thjt
绹	tvsf
滔	tcdj
鳀	toyz
倜	turk
趯	tutv
黇	tmhv
瑱	tnwb
蜩	tmik
鲦	tmym
鲖	tdyk
橦	tdml
烔	tdhk
酴	tiym
堍	tytt
菟	tyct
橐	tpgm
酡	tpyb
鼍	tpkd
柁	tpmb
畖	watg
畹	wltv
涴	yrdv
箢	yrvv
辋	wkiw
尪	whyw
桅	wemv
煟	wqho
娓	wrnm
硙	wquj
圩	xvty
芠	wgcw
刎	whwd
紊	whwx
郚	wiwe
婺	wymn
屼	wyuw
痦	wybk
骛	wymm
妩	wonw
怃	woxw
觋	xogj
绤	xusg
饩	xuuq
俙	xirj
樨	ximn
牺	xinx
舾	xivx
郗	xixe
鼷	xijd
恓	xixx
傒	xird
暿	xiok
狎	xcqj
痫	xzbm
苋	xncj
狝	xxqx
筅	xxve
跣	xxze
暹	xmzv
纤	qnsq
洨	xmdf
淆	xmdo
哮	xbkz
猇	xnqj
翛	xnrx
敩	xbxw
撷	xqfy
渫	xodm
燮	xohy
绁	xosu
薤	xocj
絜	jqfx
饧	xlup
骍	xkmx
汹	xsdx
夐	xadw
貅	xqvm
馐	xqui
洫	xcdm
衒	xerx
恂	xuxo
徇	xtro
汛	xtdu
郇	xube
堐	ystt
砑	yluy
迓	ylzy
桠	yamy
筵	ykvv
谳	yhyq
俨	ylry
弇	ylrc
沇	yldy
胭	yjoy
剡	uhhd
歅	ybxq
垟	yjty
徉	yjry
飏	yjfp
羕	ygyy
徭	yvrf
珧	yvwv
繇	yxvx
揶	yrfe
圯	yots
饴	youk
屹	yuuv
悒	yuxb
瘗	yubt
翌	yuxl
旖	ypfk
舣	ypvy
钇	ypjv
洢	yidy
佚	yurf
垠	yntg
蚓	ymil
喑	ybko
堙	ybtt
蟫	yniu
窨	yvbo
撄	ykfn
颙	ydty
臃	ysov
邕	ysvb
佣	yary
莸	yxcy
卣	ycbk
羑	ycyj
嵎	ybud
舁	ybjc
觎	ybrj
蜮	ycia
遹	yczk
鬻	ycgg
圄	ynkk
辕	ytiy
薳	wrcy
瀹	yrdc
妘	yuny
鋆	yutj
韫	ytwm
缊	ytsm
臜	zaob
瓒	zhwb
糌	zjmo
牂	zhpy
璪	zbwm
舴	zrvv
罾	zgso
砟	vduv
仉	vkrj
漳	vhdu
獐	vhqu
召	uxdk
蔗	vwch
瑧	vfwh
蓁	vfch
钲	vgjv
絷	vofx
帙	vujf
帜	vujv
梽	vumx
贽	vufb
沚	vpdv
柊	vsmd
瘃	vibu
舳	vivy
躅	vizi
洙	vudw
挝	wofc
缒	vcsl
倬	voru
涿	vodu
琢	zpwu
孳	zibz
赀	zivb
偬	zfrx
综	zfsu
鄹	zzee
陬	zzey
缵	zysb
躜	zrzb
捽	zpfu
柞	zimv
玡	yswy
戛	gabg
涫	gedl
嫚	mjny
坬	watg
叚	xcuy
陴	poeu
锪	hojx
禔	vipz
漴	uldu
藦	mpcu
啊	aakk
啊	askk
啊	adkk
啊	alkk
阿	eeek
毐	aptm
唉	aiku
嗳	aiky
垵	aztn
𩽾	anyn
盦	anrm
廒	apgw
翱	apbx
鏖	aplj
骜	apfm
媪	aqnm
嶅	apfu
嶅	aifu
熬	aofh
拗	aqfl
艹	aqal
艹	cbal
凹	wala
奥	ycpd
隩	aied
隩	yced
妭	bsnf
胈	bsof
菝	bscf
魃	bsgf
朳	bamb
羓	bayb
蚆	baib
把	blfb
吧	bakb
鲃	blyb
罢	basq
罢	posq
钯	psjb
扒	psfb
捭	bgfu
柏	bimb
靽	bhgb
昄	bloy
𨭉	bjwj
瘢	bjbu
般	bovu
般	pkvu
湴	bhdy
湴	pkdy
拌	phfb
玤	bgwf
蒡	bgcf
𠳐	bhke
榜	bgmf
膀	pjof
搒	bgff
搒	phff
棓	bgmk
棓	pcmk
棓	bqmk
棓	bwmk
孢	bczb
趵	bxzu
趵	bozu
薄	bpcc
薄	bicc
枹	fimb
暴	pyou
惫	bqwx
琲	bqwf
糒	bqmy
鐾	bquj
鞁	bqgp
鹎	bwpn
呗	bskb
北	bqlb
庳	bwgu
庳	pogu
孛	bpuz
被	pipp
椑	bwmu
椑	pomu
陂	bwep
陂	poep
倴	bdrc
栟	bkmk
坋	bdtf
坋	fdtf
琫	bjwf
祊	bgpf
祊	fhpf
佖	burb
坒	bubt
愎	buxw
狴	buqt
珌	buwb
皕	bubb
筚	buvu
萆	bucu
觱	buwy
诐	buyp
跸	buzu
邲	bube
铋	bujb
馝	buhb
沘	bpdb
秕	bphb
屄	biub
鲾	biyt
臂	bwuo
贲	buub
芘	bucb
芘	pocb
裨	bupu
裨	popu
濞	pudw
睥	buou
𨚕	bnse
忭	bnxb
抃	bnfb
汴	bndb
碥	bxuc
褊	bxpc
萹	bmcc
鳊	bmyc
便	pzrg
儦	bnrh
幖	bnju
瀌	bndh
熛	bnhu
瘭	bnbu
脿	bnoy
蔈	bncu
镳	bnjh
摽	bnfu
藨	bnch
藨	pcch
别	bokd
瘪	bpbl
傧	bbrb
邠	bbfe
镔	bbjb
槟	bbmb
槟	bkmb
玢	bbwf
昺	baon
邴	babe
蛃	bkin
并	bkbk
欂	bpmc
浡	bpdz
礴	bpuc
袯	bppf
踣	bpzk
镈	bpjc
馞	bphz
鹁	bpun
檗	bium
嶓	bout
饽	bouz
鲌	blyb
擘	bduu
伯	blrb
勃	bqul
簸	bivp
桲	bpmz
桲	pomz
蔀	byce
簿	bpvc
不	fcab
嚓	iaku
偲	sirx
䅟	clhp
参	ufsp
参	cfsp
参	sjsp
鸧	chlh
伧	ifrv
𥕢	cvuo
肏	cxrr
恻	cwxd
侧	zwrd
侧	vdrd
噌	igko
嵖	isud
衩	ilpi
蹅	idzd
锸	iajj
碴	iaud
杈	ilmi
叉	isyd
差	ciyg
虿	iswi
拆	cafi
瘥	isbg
瘥	cpbg
茝	igci
茝	vpci
巉	ikut
廛	ikgt
澶	ikdd
瀍	ikdt
镵	ikjt
韂	ihgk
冁	ilby
旵	ilou
蒇	ilcb
骣	ilmz
觇	ijvj
辿	ijzu
孱	chuz
儳	ikrt
儳	ihrt
刬	iljd
掺	xmfp
掺	chfp
掺	ulfp
梴	ijmv
梴	ykmv
颤	vhwy
嫦	ijnj
徜	ijrk
苌	ijci
鲿	ijyy
氅	ikxm
厂	anap
厂	hhap
场	ijtp
倡	ihro
裳	ijxy
惝	ikxk
惝	tkxk
玚	igwp
耖	ixlu
弨	icgk
吵	icku
嘲	vcko
㬚	iwow
砗	ieui
屮	iwkl
屮	cbkl
車	ieuu
車	jvuu
车	jvau
煁	ighb
榇	idmm
疢	idbh
龀	idvb
梣	igmv
梣	cgmv
谌	udyb
塍	ihot
枨	ihmi
珵	ihww
珹	ihwi
铖	ihji
庱	ijgw
柽	igmt
瞠	igot
赪	igib
偁	igrr
偁	idrr
称	ifhx
裎	ijpw
牚	igxy
牚	ifxy
憕	ihxb
憕	dfxb
憕	vfxb
乘	ufqr
墀	iotn
篪	iovj
踟	iozk
傺	iuru
啻	iuwk
瘛	iubx
侈	iprx
胣	ipoy
媸	iini
摛	iifn
瓻	iixw
眵	iiox
鸱	iiun
尺	itun
㳘	isdy
忡	isxv
摏	isfj
珫	iswy
冲	iadv
埫	iftk
埫	uktk
漴	vkdu
俦	ixrc
踌	ixzc
犨	izrn
帱	dxjc
梼	ixmc
梼	dxmc
臭	xpzq
椆	ixmk
椆	vmmk
椆	dnmk
刍	iide
蜍	iiim
蹰	iizc
躇	iizo
斶	iyji
濋	iodz
䢺	iuie
摴	iufk
㤘	iyxe
㤘	cyxe
㤘	vmxe
俶	tury
揣	ttfe
揣	vvfe
圌	itke
堾	iyto
堾	iyto
噇	iakl
倕	ibrt
棰	ibmt
陲	ibet
瑃	iywo
䏝	iuov
䏝	vyov
淳	vydz
逴	iozu
绰	icsu
啜	ijky
惙	icxy
鹚	cobn
佽	curq
莿	cucd
刺	ciud
玼	ciwb
玼	cpwb
跐	cpzb
悰	cdxu
淙	cddu
骢	csmx
从	zarr
熜	cshx
熜	zfhx
腠	cmot
蹴	jqzy
镩	crji
悴	ccxu
榱	cvmv
漼	cvdv
啐	qiku
缞	svsv
缞	uksv
嵯	cpug
莝	cicr
瑳	cowg
酂	cpne
酂	zhne
𫟼	dsjd
垯	dstd
炟	dshd
笪	dsvd
荙	dscd
跶	dszd
靼	dsgd
瘩	dsbk
答	davk
打	dsfd
大	dsar
大	tsar
溚	tddk
叇	dsyl
垈	dsrt
呔	tgkt
憺	dhxk
萏	dhcj
赕	dlbh
聃	djer
郸	djbe
惮	dhxu
惮	dsxu
疸	dlbd
疸	dabd
瘅	dhbu
瘅	djbu
亶	dlwd
亶	dhwd
儋	djrk
儋	dhrk
担	dlfd
掸	uhfu
单	uhbu
单	ikbu
砀	dgup
菪	dgcu
挡	dgfe
祷	dbpc
舠	dcvd
鱽	dcyd
焘	dxfh
嘚	dwkc
得	drrc
的	dobu
的	dubu
璒	dgwb
觌	douj
镝	dojg
髢	doey
𤧛	duwj
䗖	duij
碲	duuj
禘	dupj
踶	duzz
羝	diyu
鞮	digz
坻	dptu
坻	iotu
柢	iomu
棣	dsml
棣	tuml
底	degu
氐	diud
杕	dumd
杕	dimd
媂	dunj
媂	tonj
遆	duzj
遆	tozj
弟	tubd
弟	tbbd
蹢	dozg
蹢	vozg
坫	dntv
玷	dnwv
磹	dnuu
佃	tzrt
钿	tzjt
甸	tzbt
甸	ufbt
阽	dnev
阽	ykev
屌	dzuj
汈	dndd
铫	dbjv
铫	tmjv
䏲	dqod
垤	dqtt
瓞	dqgf
咥	dqkt
咥	xikt
楪	ywmm
昳	yuof
喋	vskm
萣	djcz
酊	dayd
丁	vgal
恫	daxk
岽	dsud
鸫	dsdn
垌	tdtk
侗	tdrk
侗	tfrk
都	dule
髑	digi
黩	dild
芏	dyct
厾	duvq
毒	dsfm
渎	dmdd
读	dmyd
阇	urmo
塅	detu
瑖	dewu
簖	devj
耑	vrue
祋	dcpu
镦	dvjw
兑	rcbx
兑	yrbx
砘	dtut
蹲	cuzc
顿	dity
敦	dcww
沌	vedt
饳	diui
亸	dqwu
㙍	doty
剟	doyd
掇	dofy
裰	dopy
垛	ditm
堕	hvet
𥔲	ewuk
崿	ewuk
锷	ewjk
堨	ewtr
堨	autr
堨	ywtr
恶	wyyx
恶	etyx
恶	wuyx
姶	ewnk
姶	ylnk
阏	ewmd
阏	yjmd
蛾	ypiw
欸	eisq
欸	eusq
诶	eiyu
诶	eoyu
诶	epyu
诶	euyu
诶	xiyu
陑	etee
鲕	etye
鸸	eten
耏	nsep
佴	eere
佴	nsre
墦	fktt
蹯	fkzt
氾	fhdv
蕃	fjct
蕃	fkct
肪	fjof
牥	fhnf
邡	fhfe
钫	fhjf
蚄	fhif
蚄	bgif
枋	bjmf
房	pjhf
剕	fqfd
镄	fqjb
棐	frfm
榧	frmf
篚	frvf
蜚	fwfi
鲱	fwyf
痱	febf
斐	fwfw
芾	fqcu
朏	froi
朏	kuoi
妃	pqnj
𣸣	fgdb
棼	fgmf
豮	fgub
鼢	fgjf
瀵	fddg
吩	ffkf
翂	ffxf
份	bbrf
赗	ffbo
唪	fjkf
堼	fgtt
崶	fguc
沨	fgdf
砜	fguf
风	fjjx
浲	fhdf
浲	hddf
冯	pldm
佛	firf
佛	burf
佛	bprf
幞	fijf
怫	fixf
绂	fisf
艴	fifb
茀	ficf
菔	ficy
袱	fipq
郛	five
韨	fiwf
㳇	fydf
蝮	fyiw
讣	fyyb
鲋	fyyc
滏	fodb
簠	fovm
玞	fuwf
砆	fuuf
稃	fuhz
跗	fuzc
拂	buff
服	fyoy
洑	fidq
洑	fydq
琈	fiwz
琈	fuwz
父	fobx
夫	fier
榑	fimc
榑	fymc
榑	bpmc
䓛	foci
䓛	goci
䓛	qvci
呒	fokw
副	puad
莩	ficz
莩	pzcz
脯	poof
㕮	fokf
㕮	tbkf
嘎	gdkg
晐	gdor
荄	gdcr
陔	gder
盖	hrym
㽏	ghdg
橄	glmw
坩	gjtg
泔	gjdg
疳	gjbg
矸	gjug
旰	ghog
旰	hhog
筻	ggvg
㭎	ghmx
杠	ghmg
钢	ggjx
港	jsds
矼	qlug
矼	kaug
戆	gglx
筶	gxvk
藁	gbcm
槔	gcmu
膏	gxwo
镐	hxjk
皋	hvbu
塥	grtg
滆	grdg
骼	grgk
虼	gwiv
个	gtrl
各	gtwk
搁	grfk
胳	grok
蛤	grik
革	jocu
哿	gtlk
哿	jxlk
镉	lujg
鬲	gral
鬲	lual
疙	yubv
给	jpsk
哏	hhkg
浭	ggdg
鹒	gggn
更	ggan
珙	gfwg
䢼	gsge
共	gscb
供	garg
唝	gakb
唝	gfkb
蚣	vsig
媾	gmnr
遘	gmzr
雊	gmjv
笱	gcvj
耇	gclj
缑	gzsu
姤	dynk
勾	gmbs
佝	gzrj
佝	kmrj
堌	gytg
痼	gybg
鲴	gyyg
𦙶	goog
瞽	goto
罟	gosg
羖	goyu
臌	goov
馉	gouo
蓇	guco
轱	guig
鸪	gugn
骨	gugo
估	gyrg
鹘	gogn
嘏	gogy
嘏	jvgy
汩	ycdo
谷	ycbk
诖	gzyt
鸹	gxun
呱	gvkg
栝	gxmu
栝	txmu
栝	kimu
爟	gehv
瓘	gewv
盥	gejm
鳤	gyyl
涫	grdl
蒄	grcc
鳏	gryx
观	geyj
莞	grcy
毌	wjml
犷	gsqg
垙	glte
珖	glwe
广	andi
桄	glme
桄	gkme
刽	gcrd
筀	gcvt
匦	gnkj
姽	gnnv
宄	gnbj
晷	gnok
邽	gvte
鬶	gvfg
桧	hcmy
氿	gndj
柜	jnmj
鳜	jyyq
龟	jydd
龟	qqdd
眭	gcot
廆	gvgg
廆	wrgg
廆	hcgg
嶲	gvuk
嶲	xiuk
嶲	jeuk
鲑	xqyt
磙	giug
棍	htmb
掴	gpfy
虢	gpvj
椁	gqmz
埚	gotn
崞	gouz
过	gozc
过	gozc
哈	hdkk
哈	hlkk
铪	kejk
胲	hgor
嗨	hwkm
崡	hkuu
嵅	hkuk
浛	hkdk
琀	hkwk
虷	hkig
邗	hkge
邯	hkge
蔊	hhcg
顸	hjgy
犴	hjqg
犴	abqg
汗	hkdg
㘎	hlkw
㘎	hhkw
颃	hjwy
夯	bddl
行	hhrd
行	hgrd
侴	hxrd
皞	hxbu
鄗	hxwe
颢	hxoy
嚆	hckk
号	hvkk
劾	hrwl
盉	hrhm
盍	hrqm
阂	hrmr
鹖	hron
龁	hrvv
垎	hwtk
翯	hwxk
呵	aakk
呵	kekk
颌	grry
合	gtrk
纥	hrsv
纥	gesv
貉	hvvk
貉	mivk
何	herk
何	hwrk
和	hwhk
和	hphk
和	hihk
和	hihk
喝	hwkr
喝	ywkr
熇	xnhk
嘿	mikh
桁	hjmd
亨	pgwl
𫟹	hdjg
玒	hdwg
硔	hdug
荭	hdcg
谼	hdgg
蕻	hacg
讧	hayg
訇	hsbk
红	gssg
哄	hskg
哄	hakg
瘊	hxbu
郈	hmie
吽	hckn
吽	oukn
侯	hmru
囫	hikw
猢	hiqo
瑚	hiwo
縠	hitu
觳	hitu
冱	hydh
嫭	hynh
岵	hyug
扈	hyhb
昈	hyoh
祜	hypg
鄠	hyye
鳠	hyyy
鹱	hyny
琥	howj
昒	huow
淴	hudx
滹	hudh
轷	huih
鹄	gonn
鹄	hwnn
隺	hibv
隺	hwbv
唬	xzkj
骅	hcmu
化	hxrb
华	hzru
华	hxru
划	hzgd
划	hkgd
划	gigd
划	gqgd
觟	hzdt
觟	xodt
坏	pwtb
坏	pitb
坏	petb
澴	htdy
荁	htcd
萑	htcv
锾	htjy
鹮	htsn
擐	hefy
逭	hezl
㬊	hyoy
睆	hyoy
貆	htvd
貆	hrvd
嬛	htny
嬛	qdny
喤	hakw
媓	hanw
瑝	haww
磺	hauh
艎	havw
蟥	haih
鳇	hayw
㿠	hkbe
滉	hkde
潢	hadh
潢	gldh
晃	hsoe
橞	hcmx
蟪	hcix
袆	hvpw
隳	diex
芔	hccc
芔	hucc
烠	hbho
烠	hnho
虺	hvwi
会	kjry
睢	hvov
珲	hvwi
混	hudb
婫	htnb
婫	kynb
惛	hyxo
惛	mdxo
荤	xyci
佸	hpru
㸌	hihv
彟	hiey
蠖	hiiy
锪	hijx
劐	hocd
耠	holk
濩	hydy
豁	hibg
豁	hcbg
漷	hqde
漷	hide
漷	kide
嚄	hiky
嚄	oqky
伋	jorj
堲	jogt
姞	jonk
瘠	jobo
蒺	jocu
蹐	jozo
垍	jutz
惎	jucx
漈	judu
瀱	judd
稷	juhw
罽	jusd
跽	juzx
鲚	juyq
嵴	jpuo
掎	jpfk
虮	jpij
鱾	jpyj
枅	jimk
犄	jink
畿	jigt
跻	jizq
鹡	jirn
齑	jiqj
几	jipv
耤	jolo
耤	jolo
偈	jqrr
亟	qula
䓫	juck
䓫	qock
伎	qorv
觭	qodk
稽	qpho
缉	qise
恝	jcfx
蛱	jcij
叚	jvuy
斝	jvkd
槚	jvmb
袈	jxly
假	jzry
夹	jxar
夹	gaar
家	jxbu
家	jpbu
价	jorj
价	jprj
袷	jcpk
袷	jqpk
瘕	jvby
瘕	xcby
瘕	xxby
楗	jnmy
牮	jnrn
饯	jnuj
裥	jxpo
趼	jxzk
锏	jxjo
靬	jmgg
鞯	jmgz
鳒	jmyj
渐	jmdj
溅	jmdj
鞬	jngy
鞬	jmgy
篯	jxvj
篯	jmvj
监	jnlm
暕	jxoj
暕	lkoj
犍	qzny
见	xnke
弶	jkgx
洚	jkdf
膙	jsoi
礓	jluj
茳	jlcg
豇	jldg
将	jklc
浆	jklu
疆	qagj
降	xaef
斠	jbfd
皭	jbbc
佼	jzrf
敫	jzbw
璬	jzww
皦	jzbw
䴔	jnwn
僬	jnrh
峧	jnuf
鹪	jnrn
剿	icvd
徼	jzrf
脚	jyoe
角	jydy
嚼	jbkc
峤	jbul
峤	qmul
蕉	qmch
燋	jnhh
燋	qmhh
燋	jyhh
燋	vphh
艽	jncj
艽	qwcj
姣	xmnf
侥	yvrw
缴	vpsw
㛃	jqfn
劼	jqtl
岊	jqbu
蜐	jqil
讦	jqyg
鲒	jqyk
骱	jogj
秸	jphk
诘	joyk
拮	jcfk
结	jpsk
节	jqce
解	jodn
解	xodn
桔	jbmk
悈	joxc
悈	kwxc
揭	qufr
颉	jqty
颉	jcty
碣	jqur
碣	ylur
墐	jvtw
殣	jvdw
浕	jvdd
溍	jvdo
瑨	jvwo
赆	jvbd
卺	jmlv
堇	jbcw
琎	jbwj
尽	jmid
仅	jvry
劲	jjjl
廑	jmgw
廑	qngw
矜	qnmv
矜	grmv
獍	jjqe
竫	jjly
丼	jajd
刭	jajd
汫	jadj
璥	jaww
䴖	jkfn
猄	jkqx
粳	jkmg
腈	jkoo
麖	jklx
鼱	jkjo
净	igdy
景	yaox
䌹	jfsk
䐃	jfoh
囧	jfkk
泂	jfdk
颎	jfby
坰	jstk
炅	gcoh
㠇	jpuy
桕	jpmj
赳	jqtj
䴗	jbon
屦	jcun
澽	jcdu
犋	jcnb
秬	jchj
弆	jnqc
筥	jnvk
踽	jnzy
崌	jvug
椐	jvmg
泃	jvdj
砠	jvuq
腒	jvog
锔	jvjk
鞫	jvgk
苴	iscq
拘	gzfj
据	jvfg
沮	jcdq
岨	jnuq
苣	qncj
桊	jejm
锩	jyjv
焆	jrho
焆	ywho
㵐	jydq
劂	jyid
桷	jymy
獗	jyqq
玃	jyqy
砄	jyug
觖	jydg
镢	jyjq
觉	jbxj
蹶	juzq
撅	jyfq
噱	jyku
晙	jtow
畯	jttw
葰	jtcw
皲	jybp
莙	jyck
鲪	jyyk
隽	jtrn
麇	jylh
麇	qulh
浚	jtdw
浚	xtdw
咔	kdkb
咖	gakk
炌	kshj
剀	kgud
蒈	kgcb
楷	jpmb
忾	xuxq
衎	khrg
戡	kjcg
嵁	kjub
嵁	vhub
伉	kgrj
𡐓	khtl
𩾌	khyl
扛	ghfg
闶	kgmj
闶	khmj
洘	kbdk
洘	kxdk
溘	kwdm
锞	kwjg
骒	kwmg
稞	kehg
咳	hdkr
苛	heck
可	kwdk
嗑	kekm
坷	ketk
坷	kttk
匼	kekk
匼	qzkk
剋	kwud
硍	kdug
硍	xnug
硍	giug
硍	ymug
硁	kguj
埪	kstg
崆	ksug
硿	ksug
倥	ksrg
倥	kfrg
空	kfbg
眍	kzoq
芤	kzcv
姱	hynk
挎	kufk
夸	kzdk
狯	kjqy
㧟	kafk
浍	kjdy
纩	kksg
洭	kldw
戣	kbbg
暌	kbot
櫆	kbmd
骙	kbmt
篑	kcvb
聩	kceb
𫠆	knvy
煃	knht
岿	kvue
匮	gckb
傀	knrg
傀	gvrg
溃	hcdb
蒉	kjcb
悝	kvxl
悝	lpxl
阃	kimm
醌	kyyb
髡	kyew
廓	kige
蛞	kiiu
括	gxfu
鞡	lagl
瘌	llbd
菈	lacl
剌	lsud
啦	lakl
拉	lsfl
腊	xioo
蜡	vlio
俫	lfrl
崃	lful
梾	lfml
铼	lfjl
癞	llbb
徕	lsrl
婪	lkmn
罱	llsg
啉	lkkm
桹	ljml
蒗	lgcl
㫰	lkol
㮾	lklm
崀	lkul
蓢	lkco
筤	ljvl
筤	lgvl
郎	lgle
莨	lgcl
莨	lacl
铹	lvjl
嫪	lxnp
耢	lxll
荖	lbcl
潦	lbdx
潦	lxdx
了	lzal
乐	yrpx
乐	yxpx
乐	lxpx
嫘	lenx
缧	lesx
癗	lrbt
藟	lrct
嘞	lekl
肋	leol
礌	lrut
累	lrtx
堎	lftw
棱	llmw
㰀	lomu
漓	lodn
鲡	loyd
傈	lurm
凓	ludm
坜	lutl
朸	luml
浰	ludd
溧	ludm
猁	luqd
珕	luwl
疬	lubl
篥	luvm
粝	lumw
蜊	luid
轹	luil
峛	lpud
浬	lpdl
逦	lpzd
鳢	lpyb
砬	luul
砬	laul
砬	lsul
疠	lsbw
丽	load
哩	lpkl
跞	lizl
釐	lowl
釐	xpwl
栎	yrml
郦	vole
裢	lzpi
殓	lndq
潋	lndw
瑓	lnwj
蔹	lxcw
裣	lxpq
梿	lzmi
梿	lxmi
磏	lzuj
磏	qmuj
𫟅	lasx
俍	larl
辌	laix
悢	lkxl
倞	lkrx
倞	jjrx
凉	lkdx
踉	lazl
踉	lkzl
嫽	lmnx
橑	lmmx
簝	lmvx
鹩	lmdn
镣	lbjx
憭	lzxx
憭	lmxx
瞭	lzox
钌	lbjl
漻	lwdp
蓼	lycp
䴕	lodn
脟	looc
裂	lwdy
咧	lpkd
咧	lqkd
咧	lpkd
嶙	lnuf
潾	lndf
瞵	lnof
翷	lnmx
辚	lnif
膦	lvof
廪	lmgu
箖	lnvm
箖	lmvm
〇	llvv
㥄	llxw
呤	llks
囹	llks
坽	llts
姈	llns
昤	llos
柃	llms
澪	llds
瓴	llrw
祾	llpw
鲮	llyw
崚	lluw
岭	llus
令	llrs
令	lars
旒	lwfi
瑬	lwdy
疁	lwtp
镠	lwjp
飗	lwft
鹠	lwpn
鹨	lpxn
珋	lewe
罶	lest
馏	lput
馏	lwut
六	lywb
咯	lokk
咯	likk
咯	gekk
昽	ldol
漋	lddu
癃	ldbu
砻	ldlu
哢	lakc
笼	lfvl
尨	ldlp
尨	mhlp
尨	pjlp
剅	lxdd
溇	lxdn
蝼	lxin
喽	lxkn
露	lyyk
栌	limu
轳	liiu
鸬	libn
僇	lyrp
勠	lyxl
稑	lyht
箓	lyvu
菉	lycu
赂	lybk
辂	lyik
逯	lyzu
氇	lomo
澛	lodo
垏	lcty
梠	lnmk
稆	lnhk
膂	lnfo
褛	lnpn
偻	lxrn
绿	lysu
脔	ltwr
銮	ltwj
抡	lufl
脶	lpon
倮	lqrg
蓏	lqcg
硌	liuk
络	lxsk
泺	podl
漯	lidx
漯	tldx
唛	mlkw
祃	mlpm
嘛	mskm
杩	mdmm
吗	mskm
吗	mdkm
蚂	maim
蚂	mlim
蟆	miid
埋	mktl
脉	mioy
谩	mkyy
墁	mhty
颟	mjcy
瞒	mgol
鞔	mkge
鞔	mdge
厖	mjip
杧	mjmw
牻	mjnp
硭	mjuw
蟒	mjic
楙	mvmm
茆	mvce
蝥	mvmi
眊	mxom
瞀	mxmo
袤	mxym
鄚	mxce
冇	mbuk
泖	mbde
旄	mvfm
旄	mxfm
芼	mvcm
芼	mxcm
猫	mvqt
冒	mioo
么	mpps
么	maps
么	ycps
瑂	mewo
郿	meue
镅	mejo
没	midu
𫞩	mgwl
们	mgrm
㠓	mhuu
幪	mhju
濛	mhdu
獴	mhqu
甍	mhcw
礞	mhuu
艨	mhvu
鹲	mhcn
氓	mhwm
瞢	mjco
蒙	mjcu
縻	mogx
嘧	muku
弭	mpge
洣	mpdm
脒	mpom
泌	budb
祕	bupb
秘	buhb
谜	mqym
弥	mpgx
偭	mxrm
勔	mxml
愐	mxxm
湎	mxdm
眄	mxog
渑	mxdd
渑	uhdd
鹋	mmcn
杪	mzmu
碈	mnuo
苠	mncm
鳘	mmpy
湣	hydo
黾	mxkd
黾	mjkd
玟	mnww
忞	mmwx
忞	whwx
蓂	mlcl
螟	mlil
耱	milu
藦	micu
貊	mivb
摩	magu
麽	megm
麽	magm
磨	migu
抹	mifw
莫	mycd
蛑	mxin
鍪	mxmj
缪	mpsp
缪	mysp
缪	lzsp
牟	mysn
毪	mimn
姥	monl
镎	nsju
肭	nlon
那	ndve
那	nqve
那	nwve
那	npve
呐	nwkn
哪	nrke
哪	nake
哪	nrke
𦰡	nlce
𦰡	npce
迺	ngzx
婻	nhng
萳	nlcg
赧	nliy
南	naug
难	nhyv
难	npyv
囊	nhgy
峱	nvqu
硇	nvux
蛲	nviw
臑	nxoe
垴	nbtx
淖	iidu
淖	vodu
呢	nokb
内	nlkr
恁	nnrx
能	nssb
嗯	egkx
𫠜	nove
鲵	noye
𨺙	nuee
薿	npcz
泥	nudb
伲	nprb
伲	nurb
溺	nbdg
鲇	nzyv
鲶	nzyx
捻	npfx
粘	nzmv
嬢	nanf
鸟	dzna
嵲	noum
糵	nocm
臬	nozm
蹑	nozy
菍	nocx
菍	rhcx
狞	nlqd
聍	nled
泞	njdd
甯	nlby
拧	nlfd
拧	njfd
宁	vybd
狃	neqi
妞	hxni
孥	ninz
笯	nivy
傉	nyrc
砮	nonu
胬	nonr
恧	ncex
女	rova
疟	yxbe
傩	nprv
喏	rtkk
哦	oikw
哦	erkw
喔	ookt
𠙶	ookl
沤	oudq
呕	oukq
呕	oykq
潖	psdb
舥	pavb
簰	pfvu
派	pady
排	pgff
蹒	pkzl
袢	phpb
柈	pkmb
柈	bhmb
磻	pkut
磻	bout
鳑	pjyf
雱	phyf
旁	bgwf
彷	fkrf
胖	pkob
胖	phob
炮	pvhb
炮	bchb
跑	pvzb
锫	pejk
帔	pqjp
旆	pqfu
珮	pqwj
衃	pwpb
喷	pdkb
弸	phgo
蟛	phip
彭	bhtp
堋	phto
堋	bfto
泙	pgdp
泙	pldp
鲏	poyp
鼙	potu
䴙	puun
媲	punb
澼	pudx
甓	puuw
嚭	pptk
苉	ppcp
狉	piqp
陴	pieu
吡	ppkb
淠	pqdw
埤	potu
铍	pijp
仳	porb
劈	ppud
纰	posb
纰	bpsb
㛹	pzng
楩	pzmg
胼	pzok
蹁	pzzc
骈	pzmk
𡎚	pxtc
犏	pmnc
片	pmpv
薸	pmcu
嘌	pnku
螵	pniu
骠	pbmu
嫖	pnnu
票	pnxu
缥	pzsu
玭	pnwb
牝	pvnb
频	bbvy
帡	pljk
洴	pldk
玶	plwp
荓	plck
蚲	plip
涄	pkdk
屏	bauk
淜	pldo
淜	phdo
苹	pgcp
皤	ppbt
粕	pimb
笸	pqvk
哱	pikz
哱	bakz
酦	poyf
酦	fayf
迫	pgzb
魄	tibg
魄	bpbg
裒	pxyj
垺	pxtz
垺	fitz
掊	pcfk
掊	pxfk
墣	pitf
穙	pihf
蒱	picf
酺	piyf
氆	pomo
瀑	bxdu
朴	pomb
仆	purb
愭	qoxo
畦	qott
綦	qocx
蛴	qoiq
蜞	qoib
颀	qojy
鲯	qoyb
汔	qudv
炁	quwh
磜	quuu
葺	quce
呇	qpuk
婍	qpnk
桤	qimj
郪	qiue
其	jicb
奇	jidk
齐	juwl
齐	ziwl
齐	vdwl
岂	kguj
跂	qpzv
妻	quun
砌	qoud
契	qofd
契	xofd
槭	swmx
耆	uulo
栖	ximx
蹊	qizd
踦	qizk
圻	yntj
𨙸	qove
𨙸	vive
拤	qvfb
葜	qxcd
墘	qztv
伣	qnrj
椠	qnim
蒨	qnco
肷	qxoq
圲	qmtq
褰	qmby
鹐	qmdn
乾	gjuv
浅	jmdj
嵌	khuq
荨	qzcc
堑	zhit
堑	jnit
襁	qspi
镪	qsji
蜣	qliv
玱	qlwv
玱	chwv
蔃	qaci
蔃	jkci
跄	qlzv
跄	qkzv
抢	qlfv
抢	igfv
强	qsgi
强	jkgi
硚	qmul
鞒	qmgl
缲	qnsm
缲	scsm
鞘	ucgo
睄	qmoo
睄	uxoo
睄	xnoo
俏	xbro
癿	qqbv
茄	jxck
趄	qotq
趄	jvtq
且	jvoa
郄	xuxe
嗪	qnkh
螓	qnih
锓	qmjy
嵚	qbuq
骎	qbmy
慬	jvxw
慬	jmxw
勍	qlwl
碃	qjuo
苘	qack
箐	jkvo
綮	qphx
鲭	vgyo
䓖	qdcl
筇	qdve
銎	qdgj
訄	qwjk
鼽	qwzj
鹙	qqhn
湫	jzdh
蝤	yxiy
劬	qbjl
氍	qbom
癯	qbbv
磲	qbum
㭕	qvmq
坥	qvtq
岖	qvuq
胠	qvoq
麹	qvfm
黢	qvlw
趣	cyty
趋	cyte
渠	jcdm
瞿	jcov
焌	qvhw
焌	jthw
竘	qnlj
竘	kclj
觑	qvhj
曲	qvkc
朐	qboj
朐	xcoj
朐	iioj
瑔	qtwu
鬈	qtev
鳈	qtyu
畎	qytq
悛	qrxw
婘	qtnv
婘	jenv
棬	qrmv
棬	jemv
圈	jekv
圈	jrkv
券	xejd
卻	qrge
悫	qrtx
棤	qrmo
榷	qrmv
炔	gchg
傕	qrrv
埆	jyty
𨟠	qroe
𨟠	jyoe
𨟠	qroe
雀	qnxv
阙	qtmq
碏	qruo
碏	xiuo
逡	qyzw
䎃	rlrx
禳	rjpx
蘘	rjcx
瀼	rjdx
瀼	nkdx
儴	rjrx
儴	xlrx
荛	rvcw
桡	nvmw
娆	rbnw
仞	rdrr
纴	rdst
衽	rdpt
讱	rdyr
饪	rdut
稔	rhhx
任	rgrt
蝾	rdim
薷	rice
铷	rijk
颥	riyy
洳	rydk
蓐	rycc
堧	rttd
瓀	rywe
媆	rynd
媆	ndnd
枘	rcmn
汭	rcdn
挼	rpfn
爇	rich
鄀	rice
婼	rink
婼	iink
若	rtck
撒	safw
洒	xpdx
塞	ssbt
塞	swbt
鳃	xpyx
毵	sjsm
潵	shdw
溞	scdi
缫	scsg
埽	sbtj
骚	sbmi
璱	swwb
洓	swdu
洓	qudu
洓	zudu
色	ugdb
㴔	swdx
㴔	yudx
唼	ulkn
歃	ulqq
嗄	askw
沙	uldu
煞	uadh
厦	xziw
墡	uhtk
嬗	uhnd
缮	uhsk
鄯	uhye
晱	uloh
潸	ujdo
芟	ujcu
跚	ujzc
杉	uamp
姗	uhnc
苫	ujcv
苫	uhcv
钐	ujjp
掞	uhfh
掞	yhfh
掞	ylfh
垧	uktk
上	ukba
玿	uvwk
筲	ucvo
杓	uvmu
梢	sxmo
柖	uvmk
柖	uxmk
少	uxxp
捎	uxfo
稍	uxho
滠	uwdy
猞	ueqg
奓	uedx
奓	ipdx
奓	vldx
摄	nofy
射	ywuc
射	yuuc
蛇	yoib
畬	uert
畬	ybrt
胂	udou
瞫	uhou
侁	ufre
娠	ufni
沈	igde
葚	udcb
葚	rdcb
甚	ugcb
莘	xbcx
嵊	ufur
眚	ujuo
晟	ufoi
省	xauo
炻	uohu
祏	uopu
䏡	uuou
奭	uudb
栻	uumg
襫	uupb
䴓	uibn
浉	uidj
邿	uite
鲺	uiyi
鸤	uiun
酾	udyd
拾	uwfk
什	ugru
食	surg
食	yurg
螫	uuii
螫	veii
识	vuyv
氏	vipv
倏	uurq
婌	uuny
摅	uufx
毹	uurm
琡	uuwy
鄃	uure
陎	uuew
熟	uiwh
数	uimw
术	uimd
术	vimd
澍	vydc
属	vouy
刷	uzud
衰	cvyv
腨	ueoe
礵	uluo
骦	ulmo
鹴	ulyn
帨	ucjx
谁	ubyv
楯	dtmo
铄	uijl
硕	uouy
说	ucyx
说	yryx
汜	suds
耜	sull
㟃	siuk
凘	sidj
楒	simx
飔	sifx
鸶	sisn
伺	curk
俟	qoru
思	sdtx
𪨊	sdur
㧐	sffy
娀	ssnu
忪	vsxg
瞍	scoy
擞	smfw
傃	syrx
僳	syrm
觫	sydu
蹜	syzb
骕	symb
鹔	syyn
苏	sycb
狻	srqw
𤭢	scww
𫟦	sciu
旞	scfu
璲	scwu
穟	schu
襚	scpu
荽	svcn
隋	dieo
孙	xtzx
溹	sidx
嗍	soko
桫	somu
挲	uadu
缩	sysb
遢	tlzx
阘	tlmx
鞳	tlgk
祂	tapy
嗒	tlkk
她	jwny
鲐	tfyk
榃	tkmt
郯	tkhe
锬	tkjh
璮	tlwd
菼	tlch
钽	tljd
啴	tjku
啴	toku
惔	tkxh
惔	dhxh
覃	tkxu
倓	thrh
䣘	tjxe
樘	tjmt
螗	tjik
耥	tklk
镋	tkjx
羰	thyh
倘	ijrk
淌	ikdk
帑	tknj
帑	ninj
汤	uhdp
趟	thtk
铴	tgjp
铴	thjp
啕	tvkf
洮	tvdv
鼗	tvvv
慆	tcxj
陶	yvef
忒	twyx
忒	twyx
䲢	thoy
熥	tghy
熥	tshy
媞	tonz
瑅	towz
薙	tucv
逖	tuzh
䴘	tiin
提	difz
提	dpfz
绨	tosd
醍	tpyz
体	tirb
趯	yrtv
禔	topz
禔	vppz
擿	tifg
擿	vufg
擿	vdfg
畋	tztw
阗	tzmb
掭	tnfx
晪	txob
淟	txdb
觍	txqj
瑱	tzwb
瑱	vdwb
填	vdtb
笤	tmvk
迢	tmzk
髫	tmek
龆	tmvk
粜	tbim
嬥	tznv
朓	tzov
佻	tnrv
祧	tnpv
调	vzyk
苕	tmck
跳	tvzv
条	tnwm
窕	yvbv
䗴	tlit
葶	tlcd
圢	tatd
烶	taht
颋	tazy
铤	djjt
町	tatd
渟	tldd
渟	tkdd
桯	tkmw
桯	ylmw
𦒍	tdlx
𫍣	tdyk
峂	tdud
茼	tdck
㛚	tfny
橦	iaml
峒	tduk
峒	dauk
烔	dahk
同	takk
穜	tdhl
穜	vfhl
僮	vkrl
头	tzdd
㻬	tiwk
凃	tidm
腯	tioo
葖	tucq
梌	timm
梌	ismm
稌	tihm
稌	uohm
菟	tict
吐	tykt
煓	trhe
猯	trqe
猯	teqe
魋	tbgv
暾	tyow
焞	tyhz
坉	tutt
坉	dttt
屯	vyav
忳	tuxt
忳	vyxt
忳	dtxt
箨	tivf
萚	ticf
侂	torq
柁	dimb
拓	vofu
腽	wlom
佤	wdrw
瓦	wlad
哇	wakt
呙	wdkn
呙	hrkn
呙	wqkn
呙	wakn
呙	gvkn
崴	wwun
芄	wkcw
卍	whvl
椀	wlmv
塆	wjtg
蜿	wjiv
万	miav
婠	wjnl
婠	wlnl
涴	wldv
涴	widv
妧	whny
宛	yrbv
箢	wlvv
菀	ytcv
菀	yccv
王	wgat
亡	wiwv
𣲗	wedw
峗	weuv
洈	wedv
闱	wemw
螱	wqui
霨	wqyc
鳚	wqyc
洧	wrdo
韪	wrow
溦	wwdj
葳	wwcn
逶	wwzn
鳂	wwyy
硊	wruv
硊	gcuv
隗	wreg
隗	kbeg
亹	wrwq
亹	mgwq
㧑	wefw
㧑	wrfw
碨	wruy
碨	wquy
委	wwhn
硙	weuj
硙	aouj
硙	gsuj
尾	ypum
琟	wewv
琟	ycwv
尉	ycuc
蔚	yccc
阌	wgmy
璺	wdjy
辒	wfim
鳁	wfym
汶	mgdw
纹	wdsw
榅	wfmm
榅	ytmm
蕹	wfcv
蓊	wjcx
滃	wjdx
滃	wgdx
偓	wirt
幄	wijt
莴	wocn
踒	wozn
斡	wiud
斡	gyud
倭	wwrn
峿	wiuk
浯	widk
珸	wiwk
鋈	wydj
靰	wygw
𣲘	wodw
仵	woru
牾	wonk
珷	wowv
迕	wozu
洿	wudk
芴	wycw
芴	hucw
无	mpay
旿	wyou
旿	woou
唔	wykk
吾	ycwk
铻	wijk
铻	ynjk
𠅤	xowx
嶍	xoub
隰	xoeh
鳛	xoyb
禊	xupd
舄	xujh
阋	xume
憙	xptx
枲	xpsm
葸	xpcx
蓰	xpcz
僖	xirk
巇	xiug
熻	xihx
爔	xihk
睎	xioj
肸	xiou
菥	xicj
螅	xiix
蟋	xiix
觿	xidk
豨	xiuj
酅	xiue
饻	xiuy
戏	huyg
恓	qixx
恓	xcxx
歙	xirq
裼	xipw
裼	tupw
傒	xurd
暿	xpok
洗	xxde
䜣	xiyj
䜣	xbyj
䜣	ynyj
柙	xcmj
硖	xcuj
翈	xcjx
黠	xclk
罅	xzfh
呷	gakj
虾	haix
挦	xzfc
鹇	xzmn
㬎	xxoh
崄	xxuq
燹	xxuh
禒	xxpu
忺	xmxq
籼	xmmu
跹	xmzq
锨	xmjq
莶	xmcq
莶	lxcq
孅	xmnj
孅	qmnj
盷	xzoy
盷	tzoy
铣	xxje
伭	xzrx
伭	xtrx
县	xtqs
珦	xkwk
瓖	xlwx
相	xkmo
详	yjyy
咲	xbkt
涍	xbdz
蟏	xnib
魈	xngo
嚣	apkk
恔	xbxf
恔	jzxf
蛸	ucio
肖	xbxo
敩	xyxw
㙦	xqrt
勰	xqlx
缬	xqsy
𤫉	xowy
偰	xord
廨	xogn
榍	xomo
澥	xodn
瀣	xodj
薢	xocn
躞	xozy
揳	xpfd
挟	jxfj
絜	xqfx
些	sive
血	xrpm
邪	ysye
邪	yrye
邪	ybye
邪	xbye
泄	yudu
炘	xvhj
衅	xvpb
信	ufrk
镡	xnju
镡	tkju
镡	ikju
芯	xvcx
硎	xlud
钘	xljk
铏	xljd
陉	xlej
婞	xjng
悻	xjxg
瑆	xkwu
荥	xlcu
荥	ykcu
诇	xayk
讻	xsyx
夐	xedw
珛	xpwo
滫	xedo
髹	xqem
鸺	xqrn
休	xnrm
冔	xboy
垿	xcty
婿	xcno
昫	xcoj
溆	xcdy
蓿	xccb
栩	xnmx
珝	xnwx
糈	xnmo
醑	xnyo
媭	xvpn
盱	xvoy
谞	xvyo
顼	xvwy
魆	xvgl
欻	ixhq
许	hoyu
砉	xvfu
砉	hxfu
嘘	uiky
旴	xcoy
旴	xvoy
湑	xndo
湑	xvdo
𫠊	xtmx
暶	xtoz
痃	xtbx
昡	xeox
琄	xewo
碹	xeud
愃	xrxd
晅	xrod
暅	xyod
暅	gfod
玹	xzwx
咺	xykd
咺	xrkd
峃	xyxu
茓	xycb
峋	xuuo
栒	xumo
珣	xuwo
噀	xtkg
獯	xyqh
郇	htbe
熏	xtqh
睚	ysot
揠	ylfn
玡	ylwy
垭	yaty
吖	yaky
猰	ylqd
猰	jcqd
猰	qoqd
哑	yaky
呀	yaky
压	ylid
轧	gsiv
虤	ykhj
蜒	ykiv
唁	yhkk
墕	yhth
烻	yhhv
觃	yhjz
兖	ylly
厣	ylij
戭	ylbg
扊	ylhh
甗	ylhw
罨	ylsd
蝘	ylin
郾	ylke
黡	ylih
鼹	yljn
崦	yjud
恹	yjxq
漹	yjdh
埏	yktv
埏	ujtv
剡	ylhd
研	yhuk
燕	yjch
棪	ylmh
棪	yhmh
奄	yjdd
渰	yjdc
渰	yldc
咽	yjky
咽	ywky
歅	yjxq
湮	ybdt
炀	yjhp
疡	yjbp
蛘	yjiy
钖	yjjp
咉	ykky
仰	ajre
卬	ykpe
羊	xabf
烊	yghy
鞅	yhgy
鞅	yggy
媱	yvnf
滧	yvdw
猺	yvqf
轺	yvik
靿	yxgl
鹞	yxvn
崾	ybun
窅	ybbo
要	ycxn
繇	yvvx
繇	vmvx
铘	yrje
馌	ywum
倻	yere
掖	yefw
匜	yoky
宧	yobi
嶷	youz
扅	yohx
椸	yomy
痍	yoby
簃	yovx
㑊	yurb
佾	yuro
劓	yuzd
勚	yuul
嫕	yunx
廙	yugg
杙	yumy
枍	yumk
殪	yudb
疫	yubu
癔	yubx
绎	yusf
肄	yuby
螠	yuim
裛	yuyb
镒	yujm
鹝	yugn
鹢	yubn
扆	yphy
酏	ypyy
繄	yikx
黟	yilx
眙	yook
眙	iuok
佁	yprk
佁	iurk
诒	dsyk
佚	dqrf
仡	yurv
仡	gerv
疑	npbz
荑	yocy
遗	wqzb
迤	ypzy
迤	yozy
椅	yimk
猗	ypqk
嚚	ynkk
夤	ynxb
崟	ynuj
訚	ynmk
䲟	yvye
慭	yvlx
溵	ybdu
禋	ybpt
骃	ybmy
珢	ynwg
珢	kdwg
龂	ynvj
龂	khvj
龈	khvg
吲	ymkl
吲	uhkl
蟫	xuiu
窨	xybo
殷	yjpu
殷	ympu
隐	yvex
溁	yldm
潆	yldx
茔	ylct
蓥	ylcj
媵	yjon
锳	ykjy
哟	yoku
㶲	yahy
埇	yfty
恿	yfsx
栐	yfmy
鲬	yfyy
墉	ysto
鄘	ysge
饔	yswg
鳙	ysyo
涌	isdy
澭	ysdv
澭	yfdv
喁	ydkd
喁	ybkd
尢	yxuv
蚰	yxiy
蝣	yxiz
鲉	yxyy
莠	yccn
耰	yzlw
麀	yzlb
槱	ycmh
槱	ibmh
浟	yzdw
浟	dodw
柚	yxmy
有	ymuo
揄	ybfd
狳	ybqm
窬	ybbd
臾	ybjr
艅	ybvm
蝓	ybid
褕	ybpd
邘	ybye
雩	ybyk
髃	ybgd
㳚	ycdd
妪	ycnq
棫	ycma
淯	ycdo
滪	ycdy
潏	ycdk
燏	ychk
燠	ychd
蓣	yccy
薁	yccd
饫	ycuy
鹆	ycgn
㺄	ynqd
伛	ynrq
敔	ynww
窳	ynbg
鄅	ynye
龉	ynvk
纡	yvsy
悆	ycrx
悆	uurx
愉	tzxd
於	wufd
矞	ycmk
矞	xcmk
矞	jymk
隃	ybed
隃	yved
隃	uyed
育	yowo
语	ycyk
雨	ycad
禺	yctd
禺	ootd
俞	ycrd
俞	uyrd
与	ycva
与	ybva
圫	yctq
圫	vytq
橼	ytmu
羱	ytyx
眢	yrxo
蜎	yrio
垸	htty
薳	yycy
芫	ykcy
媛	yeny
远	yezy
员	yukb
爚	yrhc
籥	yrvc
钥	yxjo
约	ycsu
沄	yudy
涢	yudb
纭	yusy
郧	yuke
郓	ytbe
酝	ytyy
筠	jyvy
蕰	ytcm
蕰	wfcm
韫	wfwm
馧	yyhm
馧	wihm
熨	ycuh
晕	ytoi
煴	yyhm
煴	yihm
缊	yysm
缊	wfsm
拶	zafx
拶	zlfx
咋	vakv
甾	zivt
寁	zlbz
趱	zltb
咱	zskz
咱	zdkz
脏	zgot
驵	zkmq
臧	zgvi
臧	cjvi
奘	vspd
𥖨	zxum
唣	zxkq
簉	zxvk
帻	zrjb
箦	zrvb
赜	zrib
昃	zwor
泽	uudf
责	vsfb
鲗	zeyd
矰	zguo
鄫	zgbe
缯	zfso
霅	vsyk
溠	vldg
痄	vlbv
蚱	vliv
䃎	vdux
拃	vdfv
鲝	vdyy
挓	vafq
齇	vazq
楂	ismd
栅	uimc
栅	cwmc
吒	vlkq
鲊	vdyv
鲊	vlyv
劄	vavd
劄	vsvd
瘵	vsbu
偡	vhrb
搌	vlfy
飐	vlfv
栴	vjmd
谵	vjyk
鹯	vjwn
崭	ikuj
辗	nxiy
嶦	vjuk
嶦	uhuk
鳣	vjyd
鳣	uhyd
占	vjbk
幛	vgju
嫜	vhnu
暲	vhou
涨	vgdi
旐	vxfv
朝	vcuo
爪	vbin
棹	vomu
磔	vrum
詟	vrlk
䗪	vwgi
啫	uuko
折	vefj
折	urfj
这	vqzw
着	vpyo
着	vvyo
着	vcyo
纼	vdsl
昣	vhop
畛	vhtp
稹	vhhb
袗	vhpp
鬒	vheb
浈	vfdb
砧	vfuv
葴	vfck
溱	vfdh
椹	vfmb
椹	udmb
揕	vdfb
揕	vffb
怔	vgxv
狰	vgqy
挣	vgfy
正	vgav
钲	vfjv
踯	voze
庤	vugc
忮	vuxv
晊	vuot
栉	vume
滍	vudi
觯	vudu
跱	vuzc
踬	vuzb
铚	vujt
锧	vujb
骘	vuem
鸷	vufn
咫	vpiv
扺	vpfu
茋	vpcu
轵	vpiv
黹	vpyx
𦭜	vicv
榰	vimo
泜	vidu
胝	viou
痓	vubt
痓	iubt
畤	ixtc
畤	uutc
疐	vuuz
疐	duuz
祇	vppu
枝	qomv
殖	vodq
殖	uidq
峙	uuuc
徵	vgrw
知	vuuk
织	vusv
只	vikb
茽	vacv
螽	vsdi
碡	vxum
㑇	vmre
籀	vmvt
酎	vmyc
赒	vzbk
辀	vziv
鸼	vzvn
婤	vznk
婤	iznk
粥	ycgm
啁	vzkk
啁	vckk
啁	tbkk
蠋	viii
杼	vymy
疰	vybv
纻	vysv
翥	vylx
苎	vycv
槠	vumo
邾	vupe
助	iiql
褚	vopo
竺	dove
苧	vycd
苧	nlcd
朱	uipw
筑	vivf
砫	vyuv
砫	vouv
著	vpco
著	veco
髽	vxer
挝	vxfc
拽	vkfy
拽	ywfy
僎	verg
瑑	vewu
颛	vruy
转	vaiv
惴	vcxe
椎	ibmv
隹	cvrv
隹	werv
追	dvzl
窀	vybt
衠	vyrb
谆	vyyz
肫	iuot
椓	vpmu
浞	vpdz
禚	vpph
诼	vpyu
棁	vomx
焯	vohu
汋	vpdu
汋	qrdu
叕	ypyy
叕	luyy
叕	jyyy
濯	vxdv
秭	zphd
虸	zpiz
嵫	ziuy
訾	zivk
趑	zitq
辎	ziit
鄑	ziye
锱	zijt
镃	zijy
鲻	ziyt
鼒	zico
茈	zpcb
茈	cocb
粢	codm
呲	zikb
孖	mazz
仔	zirz
觜	znvy
疭	zabr
倧	zsru
鬷	zsgw
纵	zfsr
鲰	zzyy
菹	zucq
卒	cywu
崒	ziuu
崒	ccuu
珇	zowq
珇	jcwq
槜	zcmn
僔	zirc
撙	zifc
噂	zykc
嶟	zyuc
鳟	zyyc
岞	ziuv
胙	ziov
阼	ziev
嘬	ijky
酢	cyyv
笮	zpvv
笮	zrvv
怍	vlxv
柞	vlmv
叉	ilyd
戌	qvwa
吁	yvky
芦	loch
饮	yvuq
和	hohk
的	dibu
经	jjsj
虹	jkig
咪	mpkm
拜	bfuf
俱	jvrb
通	tazy
蔓	mkcy
膀	phof
艮	ghoy
呃	eekv
豸	vspp
䏝	vrov
𬉼	oohq
骀	dsmk
荥	ylcu
枸	gzmj
眄	mnog
䥽	pojf
蛄	goig
挲	sadu
锔	jbjk
颏	krwy
蜊	loid
谩	mhyy
耥	thlk
蓿	xvcb
镏	lpjt
蕻	hdcg
䦃	vojo
氇	lumo
蠡	lohi
𬣙	xvyy
圫	totq
𬇕	whdw
𬣞	voyv
𬘓	xusi
𫭟	outq
𫭟	qvtq
𫭢	litl
㧑	hvfw
芘	bpcb
𫇭	wrcw
𫐄	yriw
𫵷	luul
呇	mduk
𬇙	bqdb
𬣡	jnyj
𫸩	kzgq
𫘜	wgmw
𬘘	dlse
𫘝	jymg
茋	dpcu
𬨂	qoiu
𬀩	wrow
𬀪	xnoj
岨	qvuq
𬬩	yujy
𬣳	hhyg
𬩽	xuee
𬮿	gsej
𬯀	jieq
𫰛	xlnj
𬳵	pimp
𬳶	jsmk
𬍛	luwl
鿍	ggtf
𬜬	mhck
𪾢	xnoj
虷	gjig
峛	loud
𪨰	qvuq
𫓧	fujf
𬬮	ikji
𬬱	jbjj
𬬭	lujl
侴	icrd
㳚	xcdd
𬘡	ybsy
𬳽	ufme
𬘩	tkst
𫄧	yksv
𪟝	jufl
𬍤	xuwc
𫭼	lvtl
𬜯	lscl
𬂩	jxmj
𨐈	glie
𬌗	hryk
晅	xyod
冔	xnoy
𫑡	mhke
𪨶	ueui
𬬸	uyju
𬬻	liju
𬬹	ugju
𬬿	vcjk
𬭁	mojm
𫢸	dhru
𫗧	syuu
烻	ujhv
𬊈	xuhc
浰	lndd
浟	yxdw
𬒈	qrxu
𬳿	timm
𫄨	iisj
𬘫	htsy
䂮	lrfu
琎	jvwj
埫	tktk
𫮃	uhtu
䓬	vpcu
䓨	ykcf
梣	qnmv
硔	gfug
鿎	dsud
鿎	tdud
硍	ynug
㫰	lgol
𬱖	doyy
蛃	bain
𬟽	dsid
𫓯	jijt
䝙	iuvq
䏲	tiod
𬇹	gpdy
𬍡	dgdy
𬤇	ybyt
𫍯	xzyk
𬤊	uuyz
𫍲	xzyy
艴	bpfb
𬯎	tbeb
婌	uiny
𬘬	qnso
𬘭	ifsm
𬴂	fwmf
𫘦	tvmf
𬘯	visz
𫘧	lymu
琡	iywy
堼	hftt
㙘	yctn
𪣻	lxtn
萳	nkcg
葰	sqcw
棤	cimo
𬃊	vumb
𬷕	bofn
𫐐	noie
𬹼	xovj
𫶇	dquj
𫖮	ypuy
鿏	msjw
𬭊	dyjt
𨱇	qwjq
𫓶	xrjo
𬭎	hdjs
𫖯	fovy
脿	bzoy
䐃	jtoh
𬱟	wrdy
𫛭	kaqn
𫷷	xbgq
𬮱	ybmt
𬊤	ilhu
㴔	jodx
湑	xcdo
𬴃	homu
𫘨	tomz
蓂	mucl
楙	mxmm
𬪩	ndyy
𬒔	gjuo
碈	hyuo
䃅	diuu
硿	kaug
𬨎	yxiy
𫐓	rxim
𫫇	ewkx
𫓹	jijb
𬭚	iujz
𬭛	bojp
𬕂	lfvb
𬶋	jvyj
𬶍	tpyb
𦝼	lxon
𦝼	lbon
𫔶	nomm
溹	sqdx
滧	xbdw
𫌀	jipb
𫖳	yyyy
𫘪	ytmx
𫘬	xomd
墕	yjth
𪤗	lbtp
蔈	pbcu
蔊	hlcg
𣗋	dkmx
𬸘	ylkn
䃎	vlux
𬒗	lkuj
𫚖	cpvy
𨱏	dajk
𬭤	hxju
𫚕	uiyj
𬶐	vxyv
𬶏	weyv
𬸚	yrqn
𬤝	hcyx
𬙂	ylsb
㻬	tuwk
薁	aicd
霅	vlyk
噂	zikc
𬭩	wgjx
𩾃	mxye
𬸣	xmbn
𫍽	xryy
𬴊	lnmf
𬞟	pncy
𬺈	ypvk
䗛	xqio
𪩘	yluq
𬭬	hcje
𨱑	hajh
𬭯	pwjw
𫗴	vjud
𬸦	vpfn
𫄷	yusx
𤩽	htwq
磹	tkuu
𬭳	xpjk
𬭶	hwjh
𫔍	fkjt
𬭸	lnjf
𨱔	zyjc
𬭼	scju
𫔎	jyjk
𬸪	fkcn
䲠	iyyo
𬶟	llyd
𬶠	lnyj
𬶨	jugy
𦈡	xvse
𫄸	xysh
𬟁	yucn
䎖	zgbx
𬙊	mist
𬶭	juyu
彟	ytey
𬶮	xpyk
瀼	rgdx
𬙋	xlsx
𬺓	iovz
𫚭	loyv
