的	debu
我	wqpd
是	uuor
了	levl
你	nprx
在	zsut
和	hrhk
都	dzle
不	byad
有	ycuo
就	jpwy
也	ytvv
好	hbnz
个	gwrl
人	rgpn
说	uoye
用	yakl
他	tary
这	vwzw
来	lfan
要	yxxn
去	qcts
会	hcrs
看	khuo
中	vsll
想	xsmx
没	medy
啊	aakk
那	nlve
吧	bakb
给	grsk
能	nhsb
对	dcyc
上	ugla
到	dxad
多	doxx
吗	makm
里	lpla
被	bqpy
做	zirw
又	ymvn
过	gizc
让	rgyu
还	hfzb
她	tany
打	ddfd
把	bdfb
而	etal
着	veyo
大	dlun
从	cdrr
它	tabb
写	xwby
再	zsar
字	zubz
得	deic
搞	gbfk
狗	gcqk
猫	mcqt
一	yiaa
真	vfub
下	xzab
但	dhrd
叫	jbkl
很	hhig
比	bpbb
呢	nekb
最	zcoy
更	gfan
地	duty
地	dety
等	djvc
吃	iikq
像	xkrn
后	hmpk
时	uooc
只	vpkb
点	dxlh
先	xmne
话	hzyk
与	ynaa
快	kjxg
玩	wkwe
当	dhxe
已	ypvv
问	wdmk
完	wkbe
以	ypvr
将	jldc
您	nnrx
找	vbfg
爱	aupy
太	tsdd
谁	ueyf
才	cfap
年	nzpl
新	xblj
跟	gfzg
别	bqkd
学	xyxz
哇	wakt
按	abfn
哎	aikx
前	qzbd
睡	ucoi
加	jxlk
所	sqpj
为	wedd
为	wqdd
可	ktdk
出	iuvk
该	gdyr
向	xkpk
却	qrte
哦	opkw
小	xzld
天	tmad
高	gcwk
买	mgvd
呀	yaky
刚	ghkd
事	uual
好	hxnz
坏	hjtb
发	favd
全	qtrw
开	kdac
万	whap
之	vidn
心	xbdd
帮	bhfj
回	hbkk
得	dric
牛	nwpl
家	jxbu
长	ijpn
月	yrka
卖	msud
岁	scex
成	ihwv
唉	auku
跑	pbzs
走	zctr
早	zbou
连	lzzi
滴	didk
越	yrtv
无	wiay
阿	aaek
送	sazt
分	ffbd
黑	hwlh
额	erbr
妈	manm
换	hefd
们	mfrm
难	nkyf
同	tdkk
祝	vype
恩	enkx
干	ghau
算	sevc
路	lyzk
并	bjbk
呗	bwkr
少	ubxp
猜	cdqo
放	fgfw
擦	cafx
转	vyiv
错	cijo
脸	lxoa
贴	tpkk
陪	peek
带	dsfj
笑	xbvy
敢	glvw
谱	poyo
拿	nsru
二	eeaa
煮	volh
鸡	jiyn
或	higa
书	uuvd
每	mrpm
画	hzak
坐	zirt
咯	kdkk
掉	dbfu
讲	jsyj
梦	mfmx
冷	ljds
花	hxcb
于	ybal
手	ucpl
咋	zdkv
哟	yoku
爆	bxhu
站	vhlk
变	bnwy
看	kjuo
哥	geak
版	blpy
水	unln
起	qptj
图	tikd
弄	nawc
住	vyrv
啦	lakl
够	gmbx
咩	mpky
累	lqtx
倒	dxrd
肉	rmnr
毛	mvpv
神	ugpu
请	qayo
拉	lafl
肿	vfov
听	tkkj
内	nqld
噢	ookd
唱	igko
骂	mlkm
装	vldy
三	sjae
蛮	mkwi
腿	tnoz
正	vfav
瘦	umby
卤	lolx
俺	azrd
老	lblb
俩	lvrl
抱	bxfs
忙	mjxw
超	ictk
疼	thbd
胖	pgob
喔	wokt
车	ieal
某	mcgm
第	duvp
教	jnlw
生	ugpf
中	vall
进	jvzj
假	jvry
差	ilyg
忘	wgwx
热	rwfh
选	xyze
啥	uskk
微	wwiw
求	qwad
若	rick
些	xpve
久	jepn
苦	kock
米	mpdm
约	ytsu
飞	fwvd
吓	xzkx
亲	qblm
照	vxoh
赢	ylwf
饿	ewuw
读	diyd
秒	mzhu
信	xvrk
另	ljkl
儿	etpv
靠	kxnf
聊	lmee
远	yyze
懂	dfxv
羯	jqyv
低	dird
呆	ddkm
晒	usox
追	vvzk
见	jnke
跳	tbzd
挂	gzft
哪	ndke
鸟	nzwd
呃	ewkv
挺	tafz
贵	gcvr
元	ytee
摩	mpgu
疯	fgbx
张	vhgi
萌	mhco
头	txdd
活	hpdk
行	xlii
哒	dakz
次	cudr
本	bhaa
骗	pnmc
店	dngk
考	kblv
歌	gear
喂	wqkn
强	qagi
死	spdb
收	uzvw
贱	jnkj
噗	pukn
恨	hdxg
撸	lufo
喵	mnkt
亮	lkwj
弱	rigd
破	piuy
哼	hgkl
拍	pdfb
躺	tkuk
抢	qsfv
吐	tokt
日	ruka
谈	tkyh
饭	fhuy
帅	ujlj
离	lowd
号	hxkv
闹	nxmj
办	bhld
还	htzb
养	ykyl
红	hdsg
猪	vuqo
刷	uxud
呐	nlkn
姐	jwnq
洗	xpde
种	vahv
喝	hekv
菜	cscm
如	rink
赞	zhnr
丢	dqps
捏	npft
非	fwla
粉	fhmd
怕	plxb
坑	kgtj
网	wkkx
总	zfbx
曾	chbo
爹	dpbx
蛋	dhvi
型	xlkt
咱	zkkz
屎	upum
纸	vpsu
杀	uaxm
自	zupo
白	bfpo
急	jodx
催	cvrf
吖	aaky
改	ggjw
特	twnc
包	bcbs
愿	yeix
妹	mqnw
唔	wikk
受	umpy
抓	vxfv
钱	qzjj
者	vtlo
喷	pfkr
鱼	ybda
瞎	xxok
此	cpvb
乱	leqv
滚	gidy
呦	yzkl
晚	wlov
留	lwpt
晕	yyoi
风	fgjx
抽	izfy
块	kjtg
怪	gjxt
度	dygy
戳	ioxg
往	wkiv
便	bnrg
楼	lxmn
党	dkxe
咬	ybkx
吹	ivkr
练	lnsd
删	ujcd
条	tmwm
耶	yree
丫	yabl
系	xupx
君	jyyk
丑	icva
件	jnrn
近	jvzj
两	lsad
雨	ynad
力	luvp
面	mnaa
球	qwwq
重	idpa
火	hqdr
爬	psvb
脚	jzoe
管	gyvk
偶	oory
行	hjii
痛	taby
黄	hacb
嘴	znky
戴	dsub
情	qlxo
各	gwwk
门	mgdv
卡	kdub
倒	dbrd
跪	gczv
道	dxzz
病	bjbb
边	bmzl
搜	szfy
短	dyua
混	htdb
呵	hekk
指	vpfo
翻	fjpx
词	coyk
招	vcfk
尿	nbuu
摸	mofd
嘤	ykkn
撒	sdfw
毁	hnjy
顶	dadr
马	mdva
喊	hlkk
由	yxla
悲	bwfx
组	zosq
帖	twjk
则	zrkd
爪	vvpn
配	pqyj
乃	ngvp
斤	jbpl
秀	xphn
伤	uhrl
喽	lzkn
蓝	lkcm
及	jopn
谢	xoyc
报	bxfy
因	ybkd
泡	pxds
未	wqan
款	kyur
定	djbr
深	ufdm
渣	vadd
粗	cumq
咔	kakb
爸	blbb
输	uuid
床	iagm
碗	wluv
外	wsxb
宅	vfbq
纯	iust
熊	xdsh
汗	hhdg
搭	dafk
药	yxcu
使	uprl
感	glxx
宫	gsbk
双	ulyy
演	yldb
木	myun
粑	bamb
班	bjww
赚	vekn
货	hirr
亿	yurv
拼	pbfk
嗨	hdkm
其	qoqb
名	mlxk
类	lqmd
棒	bgml
王	wjat
骑	qomk
片	pnpv
金	jbra
茶	iscm
处	iywb
砸	zsuj
查	ismd
光	glxw
气	qupv
枪	qlmv
句	jcbk
扔	rgfn
试	uuyg
嫁	jznu
且	qwla
切	qoqd
醒	xayu
惹	rtcx
停	tlrd
树	uymc
爽	usdx
台	tfsk
口	kcla
半	bhdl
鞋	xqgt
雪	xuye
任	rdrr
摔	ukfu
接	jpfn
操	ccfm
娶	qnen
入	rypn
提	tofr
狠	hhqg
背	bwlo
挖	wafv
烂	lhhs
级	josj
间	jmmo
乖	gkqb
达	dszd
云	yues
冲	isdv
团	ttkc
瓶	plbw
踢	tizw
主	vodw
硬	yjug
魔	mpgg
嘞	lwkl
女	nnva
动	dael
剪	jxbd
线	xnsj
叔	uuuy
念	nnrx
表	bzfy
挑	tnfd
致	vuaw
槽	cvmo
满	mldl
甩	uakv
油	yxdy
皆	jpbb
捡	jxfa
省	ujuo
八	bapn
皮	povy
子	zpva
酒	jedy
救	jpqw
穷	qdbl
亦	yuwd
忍	rhrx
妞	nqni
反	flpy
呜	wukw
部	byle
借	joro
插	iafj
街	jpii
烦	fkhr
关	grbt
草	cbcu
诗	uiyc
直	vouq
踩	cgzm
嘿	hwkh
课	kwyg
臭	imzq
城	ihti
票	pbxx
剩	ufqd
趣	qcty
握	wift
李	lpmz
嘛	makm
撞	vkfl
汤	thdp
刀	dcvp
挤	jpfl
替	tufo
夜	ywwn
至	vuat
扯	itfv
懒	llxr
房	fjhf
腰	ycon
香	xlho
安	anbn
奔	bfdc
穿	irby
凭	plrj
咦	yoky
杯	bwmb
泪	lqdo
慢	mhxy
虐	nrha
逛	gkzw
碎	scuu
既	jugv
痘	dmba
题	toor
舔	txqx
即	joge
凉	ladx
准	vidf
占	vhlk
屁	puub
记	juyj
胸	xsok
摆	bgfs
国	gpky
蛇	urib
派	psdn
称	ighx
拖	tofy
盘	pkvm
控	kafg
血	xwpm
咧	lwkd
忒	tvyx
味	wqkw
交	jnwx
四	suke
投	txfy
偷	tzrd
涨	vkdi
躲	dqum
推	tvff
抹	mqfm
副	fyad
式	uuyg
搬	bjfy
咪	mikm
尽	jvid
堵	doto
藏	cjci
山	ujlk
虎	hohj
乐	lwpd
左	zqug
吵	ibku
岂	qpej
欠	qndr
传	itrv
笨	bdvb
寄	jubk
麽	mpgm
修	xqrp
烧	uchw
眼	ylog
机	jimj
相	xlmo
套	txds
撑	igfu
蝎	xpiv
落	lick
绿	lcsu
折	vrfj
甜	tzqg
糖	tjmk
奥	aipd
鬼	gnps
份	fdrd
烤	kbhv
命	mjre
补	bopb
象	xkdn
节	jpce
惨	clxp
熟	uxwh
瞧	qmoh
群	quyy
海	hgdm
墙	qatk
作	zirv
鸭	yajn
样	ygmy
圆	ytkr
嫌	xznn
逗	dmza
身	ufpp
旧	jplo
断	demj
歪	wdbv
戏	xuyg
段	depy
罗	lpsx
窝	wobn
盖	gsym
羊	yjbl
闲	xzmm
美	mryd
夹	jcan
觉	jyxe
炒	ibhu
仍	rhrn
莫	micd
排	pfff
五	woaa
傻	udrw
篇	pmvc
性	xjxu
租	zuhq
几	jppv
周	vzkk
桥	qmml
区	qvkx
队	dcer
碰	pfuy
蹭	cfzo
哈	hakk
拆	idfi
卷	jyjv
哭	kukq
场	iktp
吻	whkw
男	nktl
应	ykga
哄	hfkb
签	qmva
法	fdds
色	swdb
需	xvye
流	lwdv
杨	yjmp
逼	bizt
娃	wsnt
劝	qeyl
圈	qrkv
集	jorm
语	ynyk
涂	tidh
平	plau
期	qiqo
暖	nyoy
座	zigt
缺	qtfg
矮	apun
空	ksbg
软	ryir
憋	bpdx
肥	feob
退	tczg
扑	pufb
耍	uven
牌	pfpu
烟	yjhd
狼	ljql
减	jxdk
抄	icfu
理	lpwl
劈	piud
印	yvpe
望	wgww
陈	iged
郑	vfbe
整	vjuv
郭	gowe
蹲	dyzc
恋	lnwx
兔	tydd
娘	nanl
知	viuk
驴	lbmh
辣	lllu
偏	pmrc
噶	gskv
据	jcfk
数	uymw
清	qkdo
游	yxdz
粮	laml
归	gvle
灰	hvuh
姓	xjnu
绝	jysb
么	meps
欲	ycbr
豆	dmaa
剧	jcud
待	dsic
待	ddic
那	nave
犯	fhqv
师	uilj
位	wqrl
捉	vofr
扣	kmfk
较	jbix
齐	qowl
灯	dghd
明	mloo
酸	sryw
帝	duwj
值	vorq
论	ltyb
季	juhz
土	toua
右	ymuk
啃	khko
熬	apfh
揍	zmft
赶	gltg
银	ynjg
合	hrrk
细	xust
厚	hmiz
西	xiaa
南	nkug
朝	ivuo
狂	kaqw
随	sbez
瞅	icoh
界	jotl
盯	dkod
趁	idtp
淡	dhdh
轻	qkig
岛	dbpe
嗷	apkw
拔	bsfd
猛	mjqm
扒	bafb
宝	bbby
脱	tooe
方	fhdw
刮	gxqd
费	fqfr
遍	bnzc
抠	kzfx
霜	ulyo
零	llys
星	xkou
夸	kxdk
邮	yxye
睇	duop
汪	whdw
取	qney
菇	guck
易	yuow
蒸	vgch
愁	ixhx
症	vfbv
化	hzrb
足	zikr
佛	fprf
揉	rxfm
六	lpwb
码	mdum
龙	ldud
糗	qemq
馋	ikud
刘	lwwd
服	fioy
蟹	xodi
牙	ysap
富	fybt
吾	wiwk
冰	bkdu
七	qiav
常	ijxj
底	dpgd
仅	jmry
习	xovd
粘	vjmk
奖	jsdd
妆	vldn
爷	yrbe
吼	hckv
弯	wjwg
炖	dtht
嫩	ndnw
文	wgwx
基	jiqt
经	jksg
坨	tptb
射	uwuc
单	djbl
薄	bvcc
隔	grel
史	upln
伞	slru
搓	cofg
跌	dpzu
雾	wyyl
必	budd
呸	pwkp
捧	pjfl
似	surr
困	ktkm
掰	bduu
令	ljrs
怎	zhvx
刺	cuad
答	dsvk
冒	mxko
凶	xsxk
船	itvk
酱	jkdy
趴	pazb
闪	ulmr
昂	ajoe
紧	jmlx
贼	zeku
电	dnlv
声	ugup
具	jcqb
压	yaid
雷	leyt
湿	uidy
钻	zrjk
登	dgva
啪	pakb
咋	zrkv
百	bgab
终	vssd
哆	dokx
酷	kyyk
波	body
林	lnmm
治	vudk
醉	zcyu
唯	wekf
弹	tkgl
砍	klur
原	ytix
咳	krkr
猿	ytqy
秤	ifhp
害	hsbk
甚	udqv
锅	gojn
官	grbk
遭	zczo
赌	doko
怒	nynx
飘	pnxx
炸	vlhv
胡	hiuo
村	cymc
仔	zprz
解	jwdn
订	djyd
卧	wiib
播	boft
捂	wofk
伐	fsrg
量	ladl
量	lkdl
割	gebd
淘	tvdf
埋	mftl
塞	sdbt
略	lrtk
淫	yndr
宽	krbe
透	tmzn
凑	cmdt
劲	jvvl
重	vapa
届	jouy
倍	bqrk
胃	wqto
嬛	xrny
举	jnxl
灭	moah
残	ckdj
封	fgtc
属	uouy
脑	nbok
粥	vzgg
福	fipt
扫	sbfe
韩	hkuw
废	fqgd
升	ugpc
煎	jmbh
征	vgiv
捞	lcfl
罚	fssd
慌	hlxv
价	jzrl
今	jbrv
叠	dqyq
饼	bauk
勒	lwgl
母	movd
存	cuuz
杜	dymt
胜	ufou
毒	difm
虽	svki
妖	ycny
叼	dnkd
负	fydr
根	gfmg
春	iyfo
虾	xxix
迷	mozm
啰	lokx
寸	ctad
体	tprb
供	gsrb
抛	pcfl
烫	tgdh
拽	vjfy
防	fjef
炮	pxhs
冻	dadd
编	bmsc
侠	xcrj
勿	wybp
共	gacb
纹	wgsw
闻	wgme
北	brlb
挡	dkfe
守	ucbc
拌	bhfb
甄	vfxw
牵	qmdn
发	flvd
克	kwue
摄	uwfy
布	byuj
降	jkel
怂	sfrx
笔	bpvm
奶	ngnn
曰	ytka
霾	mfyl
颗	kegr
九	jepv
泥	nodb
於	ybfd
教	jblw
瑟	swwb
遮	vezh
澡	zbdm
痒	ykby
锁	sqjr
吸	xikj
敷	fufw
德	drix
踹	ijze
介	jorl
吊	dbkj
舞	wopl
含	hkrk
浓	nddn
料	lbmu
蹦	bfzo
嘎	gakg
潮	ivdo
长	vkpn
现	xnwe
壳	kruj
调	tmyk
调	dbyk
罪	zcsf
证	vfyv
亏	kvev
剃	tubd
摇	yvff
肾	udlo
素	syfx
填	tztb
精	jkmo
沾	vjdk
盒	hrrm
闷	mdmx
犬	qydd
通	tszy
铁	twju
洞	dadk
架	jzlm
腻	nuor
公	gsbs
露	lmyk
著	vyco
晃	hkow
潘	pjdt
铺	pujf
砖	vruv
孔	kfzv
乳	ropv
食	uorl
垫	dnft
建	jnzy
什	uoru
键	jnjz
捅	tffy
饱	bbus
欧	oukr
伪	wrrw
兽	umbk
盼	phod
滑	hcdg
运	ytzs
绕	rxsw
缠	iksl
戒	jogc
散	shcw
散	slcw
拜	bsuf
嘘	xvky
枰	plmp
赵	vxtx
屏	pluk
脏	zhot
页	ywar
范	fhcv
逃	tvzd
馆	gyuk
结	jqsk
领	larr
巨	jcka
处	iowb
言	ykwk
梗	gjmg
攒	zlfr
翘	qbax
挠	nvfw
溜	lqdt
市	uuwj
伴	bhrb
分	fdbd
剑	jnrd
初	iupd
利	luhd
啧	zrkr
针	vfju
掐	qxfj
啵	boky
博	bpuc
否	fcbk
巧	qzgv
虚	xvhy
造	zxzk
寻	xuec
蠢	iifi
托	tofq
朵	dqjm
逆	nuzp
骚	scmi
层	chus
测	cwdd
何	hrrk
磨	mpgu
局	jbuk
剁	dijd
缘	ytsu
般	bjvy
代	dsry
诺	niyk
均	jytd
叶	ywku
肌	jioj
东	dsad
宠	ifbl
端	drle
税	uche
首	ucbz
容	rdbk
斯	siqj
物	wynw
录	lyeu
丽	luad
盐	yktm
吴	wikt
败	bskw
稍	ucho
咸	xzxk
摘	vdfk
矣	ypsu
众	varr
惊	jkxx
竟	jjle
敲	qnwy
嗲	dvkx
干	gjau
漏	lmdy
湖	hido
沉	igdj
截	jquf
朱	vupw
付	fyrc
醋	cyyo
撕	sifj
获	hicq
朕	vdot
冥	mlbb
轮	luib
丝	siva
河	hrdk
炫	xehy
塔	tdtk
袁	ytty
喜	xpuk
魂	hueg
挣	vffl
赔	pekk
耳	eyaa
碧	buwu
撤	iwfw
贪	tjrr
扛	kjfg
镇	vdjb
肺	fqol
祸	hipn
果	gqln
怀	hlxb
嚯	hikf
刑	xlkd
拱	gffb
顺	utir
器	qukk
秋	qqhh
孙	syzx
巴	basl
捐	jrfo
屋	wuut
沪	hydh
猴	hxqu
龟	gvdv
夏	xzaw
耐	nsec
转	veiv
仨	sars
争	vgdl
肯	khvo
歇	xpor
板	blmy
案	abbm
极	jomj
扭	nefi
观	grye
卸	xope
兼	jmbn
设	uwyy
趟	tgtk
攻	gsgw
抖	dcfu
除	iieh
静	jjfl
旁	pjwf
稳	whhx
董	dfcv
逢	fhzf
驾	jzlm
浅	qxdj
环	htwb
申	ufll
拒	jcfj
遇	yczy
绑	bkse
乘	ihqn
缩	sosb
泰	tsfu
紫	zpvx
认	rdyr
串	iell
痣	vubx
沙	uadu
友	ycuy
尼	noub
战	vhlg
臀	tuuo
员	ytkr
丁	dkal
股	gooy
步	byvp
档	dgme
嘻	xikk
鼻	bozl
叻	lwkl
识	uoyb
颇	povr
限	xneg
幅	fijt
响	xskk
旅	lnfn
跨	kzzk
崔	cvef
意	yulx
侬	ndrn
哩	likl
糕	gcmh
威	wwxn
麻	msgm
赛	ssbr
瓜	gxpn
拧	nafd
室	uubt
愣	lfxf
显	xxoy
尊	zybc
寒	hkbd
广	gsdi
率	lcwu
品	pmkk
休	xqrm
凹	aola
维	wesf
裤	kypi
蒙	mhcn
搂	lzfn
苏	sucb
斜	xqru
免	mxdv
居	jvuk
餐	cjll
膏	gcwo
染	rldm
轰	hsiy
唐	tjgk
幂	mubj
婚	hyno
摊	tjff
瑕	xcwy
皂	zxbq
桶	tfmy
立	luwa
客	kwbk
枕	vhmv
状	vkdq
闯	ismm
坟	fgtw
扶	fiff
故	gyuw
千	qmpu
尾	wrum
震	vdyn
粽	zamx
叹	thky
古	gouk
灵	lleh
堆	dvtf
恶	ewyx
损	sifr
呼	hukh
琴	qnwv
虫	idvd
展	vlun
善	uhyk
芙	ficf
抗	kgfj
狮	uiqj
科	kehu
松	ssms
徐	xbih
充	iswe
乡	xlvp
嗒	dakk
弄	lawc
拎	lbfs
须	xvpr
衫	ujpp
尖	jmxd
森	sfmm
扎	vafv
膜	mpod
晴	qloo
婊	bzny
衣	yiwy
棋	qomb
迟	iozi
酥	suyh
章	vhlu
产	illp
僧	sgro
竖	uyll
横	hhmb
兄	xske
聚	jcen
娇	jnnl
十	uoal
石	uoak
宋	sabm
尚	ugxk
依	yiry
瞄	mmot
旺	wgow
妙	mbnu
膘	bnox
甘	gjna
啾	jqkh
田	tzku
噜	luko
距	jczj
悬	xtqx
己	jpvv
青	qkfo
郎	ljde
糟	zcmo
雅	ydyf
惯	gexr
唷	yoko
噻	sdkt
麦	msfw
侃	klrv
钓	dbju
罢	blss
京	jkwx
丹	djpa
添	tmdx
曲	qnla
嚼	jmkc
扇	uhhx
芯	xbcx
赖	lsur
许	xnyw
音	yblo
葱	cscx
丸	wkpd
搁	gefk
娜	nlne
揪	jqfh
榜	bkmf
遛	lpzt
宰	zgbu
俩	lsrl
赏	ukxr
谷	gobk
曝	bxou
赐	cukw
黏	nzhk
腹	fyow
桌	volm
蜜	mubi
消	xndo
勺	uvbd
辞	coqu
江	jldg
兵	bkqb
裙	qupk
蝶	dqim
饮	ymur
蔡	cscx
侧	cwrd
告	gxnk
寺	sutc
仙	xmre
赴	fytb
甲	jvll
角	jzdy
钗	idji
薛	xtcu
止	vpla
港	gkds
磕	keum
曹	cvao
崽	zgex
巾	jbll
坎	kltr
评	plyp
窗	ilbw
勾	gzbs
罐	geff
艾	aucx
咖	kakk
斗	dmdu
凡	fkjd
继	jusv
刻	kwwd
保	bbrm
厄	ewiv
蕾	lrct
抬	tffk
驻	vymv
弟	dubp
喘	iyke
壮	vkdu
喇	ldkd
皱	vmdy
扎	zafv
唰	uxkd
附	fyec
格	grmk
失	uipf
暗	aboo
野	ytll
橙	ihma
裸	lqpg
桑	shym
蘸	vhch
嘉	jxuk
沟	gzds
民	mnvv
厂	ikap
袋	dsry
疤	babb
拨	bofd
靴	xtgb
涅	nodt
园	ytke
弃	quwc
汁	vidu
梨	lohm
列	lodd
灌	gedf
净	jjdl
温	wfdm
批	pifb
互	hyaa
罩	vxsu
尔	eydx
帐	vgji
柜	gcmj
圣	ufyt
馅	xnuj
挫	cift
粪	fdmb
曼	mhoy
肝	gjog
梁	ladm
然	rkph
仇	ixrj
披	pify
邪	xqye
支	viuy
扁	bxhc
翔	xayx
肩	jmho
液	ywdn
掏	tcff
末	mian
杠	ggmg
院	yeee
姜	jlyn
谨	jmya
瓦	wdad
扮	bhfd
焦	jnrh
湾	wjdg
堂	tjxt
湘	xldo
智	vuuo
钟	vsjv
辆	lkil
莎	uacu
联	lzet
瞪	dfoa
祭	jupx
项	xkgr
壶	hiuy
奇	qodk
枚	memw
兮	xibv
颜	ykir
薇	wwcw
术	uymd
镜	jjje
拐	gafl
兜	dzbe
俄	errw
围	wekw
优	yzry
贺	hwlr
景	jaox
余	ybrh
剥	bced
崩	bgeo
工	gsaa
盗	dxdm
吞	tytk
窄	vgbv
军	jybi
陆	lyej
携	xqfn
痴	iibk
影	yaop
煲	bcrh
当	dgxe
舌	urqk
衰	ukwy
骨	golo
铅	qmjk
划	hcgd
裹	gqwy
礼	lppv
饶	rvuw
顿	dttr
鼠	uojv
砂	uauu
盆	pgbm
恕	uynx
搅	jzfe
专	vrad
拦	lkfs
浪	lgdl
卯	mbpe
菊	jbcm
沈	uhdv
判	phbd
引	ymgl
复	fypw
制	vupd
漂	pndx
彩	cgpp
族	zifu
稿	gbhk
漫	mhdy
摁	ebfx
绛	jksl
伊	yiry
核	hrmr
郝	hbte
挨	aifu
挨	aofu
脉	msoy
扇	ujhx
妮	ninb
标	bnmx
创	ikrd
鹅	erwn
哔	buku
颤	ihwr
乔	qmyl
睁	vgol
梳	uumv
思	sitx
舒	uurl
凸	tula
框	kkmw
移	yohx
泼	podd
邓	dfye
俗	sirk
陷	xnej
恰	qzxk
碟	dqum
患	heix
鲜	xmay
阴	ybeo
帽	mxjo
磅	bguf
柳	leme
斩	vlij
忌	jujx
鲍	bxas
侯	hxru
熏	xyph
彭	phup
册	cwpa
邀	yczw
晾	lkox
掌	vkxu
弦	xzgy
玉	ycwd
楞	lhmf
业	ywla
汇	hcdk
社	uwpt
骆	limk
塌	tatx
暴	bxou
吨	dykt
坡	poty
雕	dnkf
懵	mjxo
蒜	secx
财	cfkc
赠	zfko
持	iofc
涮	uedd
怨	yexx
墨	miht
注	vydv
庙	mbgy
斑	bjww
靓	lkfe
吉	jouk
呲	cikb
券	qejd
玻	bowy
迎	ylze
霍	hiyf
筋	jbvl
嗑	kwkm
视	uupe
洒	sddx
乜	mpvv
译	yuyl
夫	fuan
柴	ifvm
铲	ilji
蒋	jscc
悟	wyxk
兰	lkbs
茬	isct
漆	qidu
恤	xcxx
华	hcru
垮	kvtk
孤	guzg
箭	jnvd
屯	tuav
削	xnxd
叉	iayd
普	pobo
英	ykcy
志	vuux
州	vzdl
禁	jvmx
商	uhwk
拣	jxfd
厅	tkid
载	zsui
詹	vjdk
私	sihs
腚	djor
浇	jndw
户	hydu
独	diqi
脆	ccov
瞒	mkol
蒂	ducj
壹	yiua
徒	tiir
欸	eosr
胎	tdok
简	jxvo
世	uuav
佬	lbrb
锤	ibji
亚	ylay
蛆	qviq
嘚	dekc
捶	ibfi
唇	iuik
宁	nlbd
增	zgto
禅	ikpl
仿	fkrf
铊	tajb
县	xnqs
忧	yzxy
权	qtmy
葬	zgcc
龚	gslb
羞	xqyi
劫	jqtl
童	tdll
希	xixj
蹬	dgza
癖	ppbu
尤	yxyd
职	voeb
粒	luml
瘫	tjbf
渡	dydy
绣	xpsn
尝	ijxs
欺	qiqr
毕	bubu
敌	doqw
梅	memm
差	iayg
实	uobd
腐	fogr
形	xlkp
杂	zsjm
藕	oocy
仗	vgrv
逮	dszn
糊	himo
讯	xtyu
墓	myct
萱	xrcg
浮	fidz
哉	zduk
源	ytdx
度	dpgy
织	visb
籽	zpmz
岗	gkex
腔	qlog
蒙	mgcn
喃	nkkg
备	bqwt
扬	yjfp
雄	xduf
牢	lvbn
眠	mzom
萨	slci
撮	cofy
耶	yeee
迈	mszw
焖	mdhx
漂	pbdx
续	xcsd
严	ykyp
奏	zmft
沃	widy
系	jupx
呈	ihkw
箱	xlvo
押	yafj
种	vfhv
堡	bbrt
冯	fhdm
购	gmks
倩	qnro
功	gsgl
憨	hjvx
愈	ycrx
脖	bpoz
嫖	pmnx
川	irpl
鹿	lygb
嗦	sokx
窜	cebi
撅	jtfr
樱	ykmn
邦	bhfe
皇	habw
镐	gbjk
忆	yuxv
挽	wlfv
讨	tbyc
栽	zdum
庆	qjgd
胶	jnox
卡	qvub
敬	jjcw
润	rtdw
永	yfdn
咒	vmkj
棍	gtmb
袭	xoly
井	jaal
俊	jtrw
嘭	pgkp
噎	yeka
陶	tvef
厝	ciio
痰	tkbh
嗅	xpkq
乌	wupa
甭	bhby
险	xxea
俾	bpru
邱	qqqe
钢	ghjx
坤	kytu
碳	thuh
采	cgpm
贝	bqkr
鼓	gouy
孟	mfzm
伸	ufru
蚝	hvim
缓	hysy
咽	yhkd
纵	zasr
卒	ziwu
吱	viky
裂	lody
钙	gsjg
翅	iuux
纪	jusj
耗	hxlm
棵	kemg
雀	qruf
彼	bpiy
挪	npfe
始	upnk
皿	mmla
钉	dkjd
冬	dswd
洋	yjdy
苗	mmct
盛	ufim
袜	wlpm
茧	jxci
纳	nlsn
啤	poku
妥	tqpn
暂	zhio
盲	mjwo
误	wyyt
菌	jych
浴	ycdk
孽	nocz
枉	wkmw
勇	yfsl
峰	fgef
父	fybx
汉	hhdy
嚷	rkky
晏	yhon
研	ykuk
库	kygi
榛	vfmh
噔	dgka
叽	jikj
陌	mieb
吒	vakq
闭	bumc
护	hyfh
贾	jvxr
捎	ucfo
俞	ybrd
垵	antn
抵	dpfd
莲	lzcz
肚	dyot
冤	yrbd
臣	igkl
椒	jnmy
獒	apfq
葛	grcv
仓	chrv
朗	lkdo
义	yudx
尸	uivp
唠	lxkl
唠	lvkl
辛	xblu
轴	vxiy
胆	dlod
煞	uldh
枣	zbad
途	tizh
稀	xihj
晨	igon
仁	rgre
熄	xihx
庄	vlgt
撩	lmfx
秃	tuhj
乙	ypvv
嗔	ifkb
临	lnla
灸	jejh
婶	uhnu
鲁	loao
宴	yhbn
币	bupj
速	syzu
佳	jxrt
索	squx
咕	gukk
姬	jinl
返	flzy
禾	hrpm
链	lnjz
誓	uufk
执	vofw
眯	miom
瓷	codw
绘	hcss
密	mube
恃	uuxc
吕	lnkk
仲	varv
探	thfm
番	fjpt
哀	aiwy
铝	lnjk
乎	hupl
蛙	wait
氪	kwqe
置	vusq
埃	aitu
芊	qmcq
掀	xmfr
裆	dhpe
镁	mrjd
兑	dcbe
卢	lilu
阔	kimk
谜	moyz
暮	myco
洲	vzdv
差	idyg
昏	hyuo
谓	wqyo
承	ihvn
忠	vsvx
潜	qzdo
瞟	pzox
驼	tpmb
欢	hryr
悔	hnxm
巫	wugr
诚	ihyi
崴	wgen
毙	bubb
呛	qlkv
呛	qkkv
涩	swdv
曾	zgbo
轶	yuiu
递	duzp
烙	lxhk
棉	mzmj
句	gzbk
霸	blyo
缝	fhsz
缝	ffsz
鹰	ykgn
嘀	dokk
切	qpqd
祛	qvps
舟	vzpd
鞭	bmgg
瘾	ymbx
黎	lohu
亭	tlwd
荼	tich
阉	yjmd
呕	ookx
雇	gyhf
顾	gyir
舍	utrk
镶	xljy
巷	xkcs
质	vupr
背	bqlo
剂	juwd
渴	ktdv
昨	zpov
间	jnmo
帖	tojk
叮	dkkd
姚	yvnd
御	ycie
蛤	hsik
谎	hsyv
乍	vlpa
阳	yjeo
荤	hyci
亲	qjlm
忽	huwx
账	vgki
剥	boed
舍	uwrk
枝	vimy
捷	jqfr
桃	tvmd
揭	jpfv
勤	qnnl
荡	dgcp
嗝	grkl
畔	phtb
薪	xbcj
喳	vakd
嘟	duke
奉	fffl
孝	xblz
售	umrk
挑	tzfd
桩	vlmt
犊	dind
徕	lfil
拳	qtju
溅	jndj
泯	mmdm
泡	pcds
铜	tdjk
助	vyql
盾	dtpo
措	cifo
焉	yjvh
悦	yrxe
夺	dpdc
伦	lurb
瑞	rcwe
诸	vuyo
萧	xncs
宜	yobq
跶	dazz
健	jnrz
拾	uofk
珠	vuwv
凤	ffjy
圭	gvtt
揽	llfe
池	iody
弓	gsvv
诛	vuyv
钩	gzjs
境	jjte
谦	qmyn
莪	ercw
阅	yrme
匿	nukk
渤	bpdl
隆	ldeu
审	uhbu
妾	qoln
渝	ybdd
硅	gvut
咻	xqkm
叭	bakb
触	iydi
缸	ghfg
喏	nikk
坊	fhtf
谭	tkyu
嚓	cakx
颠	dmur
窦	dmbd
莱	lfcl
旗	qofb
孩	hfzr
嗡	wgkx
裁	cfuy
哑	ydky
计	juyu
亡	wjwv
淌	tkdk
吆	ycky
硕	uiur
危	wwdv
颈	javr
倔	jyri
荣	rdcm
嗳	apky
泉	qtbu
淹	yjdd
钵	bojb
卵	lypd
谣	yvyf
恒	hhxg
债	vsrr
肠	ijop
嚎	hvku
拟	npfr
拴	urfw
垂	ibpa
妃	fwnj
伏	firq
撬	qbfm
恐	kfgx
媛	ytny
菲	fwcf
矗	iyuq
靡	mpgf
搏	bpfc
晓	xzow
抡	lyfb
睿	rclo
腌	yjod
颁	bjbr
程	ihhw
撇	pwfw
筒	tfvk
扳	bjfy
淋	lndm
鸣	mlkn
搽	isfm
娟	jrno
彪	bnhp
揣	iafe
拷	kbfv
目	myka
恁	ndrx
眨	vdof
兹	ziby
囤	dtkt
囤	tukt
脾	poou
绳	uhsd
蒽	encx
姆	monm
洁	jqdk
涌	yfdy
妻	qian
踏	tlzo
迁	qmzq
翼	yuxb
秦	qnfh
姨	yony
藏	zgci
称	idhx
柯	kemk
序	xcgl
束	uyan
异	yusc
康	khgn
嗓	skkm
篮	lkvm
觅	mupe
镑	bgjf
汀	tkdd
营	ylck
掺	ijfp
螨	mlil
俏	qbro
珊	ujwc
傍	bgrf
贫	pnbr
芭	bacb
司	sivk
崖	yset
嘣	bgko
传	verv
叁	sjss
豹	bxvu
哗	hcku
哗	hxku
献	xnuq
辨	bnlu
兆	vxed
瘪	bwbb
枯	kumk
芮	rccn
舰	jnve
蜡	llio
涛	tcdc
犹	yxqy
誉	ycxk
僵	jlra
阵	vdei
辫	bnlu
府	fogc
吡	bpkb
坛	tkts
煨	wwhn
幸	xjtg
栋	damd
刨	pvbd
刨	bxbd
瑛	ykwy
赫	hwtd
努	nonl
袄	aqpy
氏	uupv
椅	ypmk
痨	lvbl
玛	mdwm
吽	hskn
晋	jvyo
氧	ykqy
矬	cput
瘟	wfbm
武	woav
作	zorv
俱	jcrb
卫	wqea
捣	dbfe
蜀	uosi
柚	ymmy
坠	vcet
辱	roic
轩	xrig
吟	ynkv
渐	jndj
廖	lbgp
肖	xnxo
竹	vipl
柔	rxsm
奴	niny
棕	zsmx
祖	zopq
咚	dskd
洪	hddb
泛	fhdf
斋	vdwe
浑	hudi
眉	mevo
奔	bddc
卿	qkpe
穴	xybb
佑	ymrk
燥	zxhm
尘	igxt
校	xbmx
迪	dozy
扎	vsfv
雌	covf
馊	szuy
姿	zidn
胯	kzok
栏	lkms
确	qruy
席	xogj
擤	xafl
沿	ykdk
嗖	szky
遂	sczu
燕	yhnh
逾	ybzd
兴	xjxb
训	xtyi
咿	yiky
焗	jbhk
卷	jejv
默	mihq
奸	jmng
炕	kghj
摞	lifx
应	yjga
避	buzu
贰	eeyr
缁	zist
冠	grbc
冠	gebc
汝	rodn
厌	yhiq
颓	tbhr
殿	dnuy
掂	dmfk
呱	gxkg
馍	mpud
绮	qpsk
期	jiqo
哨	uxko
宣	xrbg
隐	ymex
荒	hlcv
累	letx
驱	qvmx
殇	uhdp
掖	ywfn
豪	hvwu
淇	qodb
魏	wqhg
糙	ccmz
妍	yknk
砰	pgup
砌	quud
瑜	ybwd
飙	bnqx
畅	igup
瘸	qybr
翁	wgbx
预	ycsr
刹	uaxd
空	kabg
腮	sdox
蛹	yfiy
宇	ynby
唬	hokj
袅	nzpy
施	uify
糯	nime
辩	bnlu
参	cjsp
嫂	sbny
阮	ryee
艘	szvy
癣	xyby
拥	ysfy
扩	kifg
倾	qkrr
叨	tckd
嬴	ylwf
挥	hvfi
豁	hobk
啷	lhke
楚	iomr
莉	lucd
遁	dtzo
厮	siij
潭	tkdu
滩	tjdf
辽	lmzl
貂	dnvk
唤	hekd
例	lurd
歼	jmdq
泄	xodu
玄	xtwy
宥	ymbo
耙	bllb
噌	cgko
脂	vioo
醇	iuyz
刁	dnva
积	jihb
捋	lofc
幺	ycvs
卦	gztb
纱	uasu
隋	sbeo
蚊	wgiw
鳖	bpda
痕	hgbg
齁	hzzk
数	uomw
颂	sabr
玮	wrww
霉	meym
杆	gjmg
杆	glmg
珂	kewk
炝	qkhv
栓	urmw
苯	bhcb
裱	bzpy
厨	iiic
筐	klvw
寂	juby
寨	vsbm
铰	jzjx
岭	laes
享	xswz
濯	vpdf
璐	lywk
瓣	bhlu
籍	jovo
囊	njay
映	yjoy
伯	bprb
符	fivc
煤	mehm
蔫	nmch
幼	ymyl
势	uufl
呷	xxkj
怡	yoxk
辈	bqfi
斌	bbwv
蛊	goim
激	jidw
佟	tdrd
奕	yuwd
韵	ytld
胀	vgoi
衬	idpc
酿	nkyl
歉	qnbr
访	fkyf
覆	fyxw
突	tubq
埸	yutw
弗	fivl
士	uuua
仪	yory
浩	hxdk
谋	mxym
谤	bgyf
簋	gnvm
尿	svuu
惜	xixo
掩	ylfd
孕	ytnz
遵	zyzc
辟	buuu
妇	fyne
杏	xjmk
啖	dhkh
棱	lhmw
耸	sfre
碑	bwuu
杵	iomw
农	nddn
坪	pltp
贬	bxkf
皎	jzbx
珞	liwk
嗜	uuko
蝉	ikil
姑	gunk
钦	qbjr
耽	djev
堪	kjtv
帘	lzbj
碘	dxub
捆	kifm
恼	nbxk
筛	udvj
倚	yprk
喀	kakk
棚	phmo
蚺	rkir
缇	tosr
町	dktd
笛	dovy
绞	jzsx
缴	jzsw
扰	rbfy
态	tstx
医	yiku
苑	yecv
傲	airw
尺	ipun
茨	cocr
磡	khul
劳	lvcl
笼	ldvl
撂	lbfk
穆	myhp
巢	ivvg
寝	qmby
涠	wedw
吓	hwkx
蕉	jnch
闰	rtmw
粤	yrpv
跋	bszd
刊	kjgd
葵	kbct
沐	mydm
帕	pljb
佐	zqrg
讹	eryb
坚	jmlt
岸	abeg
绷	bgso
荷	hrck
症	vgbv
堕	diet
凯	kgej
笋	sivy
黛	dsrh
亨	hgwl
攀	pjmu
棣	dumn
矫	jzul
绒	rdsu
虏	lohl
鹏	phon
熙	xikh
咏	yfky
幽	yzey
愚	ybyx
碍	auuc
虹	hdig
妓	juny
洛	lidk
彦	yhip
焕	hehd
岩	ykeu
警	jack
琳	lnwm
啄	vpkn
癌	aobe
悌	tuxp
霆	tlyz
祇	qopu
拘	jvfk
碾	nxun
脓	ndon
膈	grol
闫	ykms
叉	idyd
碇	djur
匪	frkf
津	jbdy
落	llck
葡	picf
腾	thom
杖	vgmv
绊	bhsb
拈	nmfk
溏	tjdk
蹄	tozj
膝	xiou
灾	zdbh
浣	hede
惧	jcxb
硌	gwuk
嘬	zoky
谗	ikyd
弧	higg
饺	jzux
晶	jkoo
璇	xtwr
掷	vufe
卜	bold
铬	gwjk
羹	ggyd
幻	heyv
郡	jtye
孬	ncbz
奈	nsdx
窃	qobd
宿	sybb
哏	ggkg
嘈	cvko
饬	iuul
稠	ixhk
癫	dmbr
擀	glfg
杰	jqmh
拄	vofv
舱	chvv
馕	njuy
辰	igin
茎	jkcg
肘	vcoc
攥	zefx
吠	fqkq
傅	fyrc
箍	guvj
尻	kcuj
导	dbsc
谴	qxyz
惟	wexf
钻	zejk
梵	fhmf
验	yhma
芳	fhcf
粿	gqmg
犟	jkgn
玫	meww
婆	ppdn
钛	tsjt
壁	buut
弹	dhgl
捯	dvfd
鳄	ewak
弩	nong
区	oukx
溶	rddk
息	xizx
慎	udxb
叙	xcry
锥	vvjf
卟	bokb
贷	dsrr
滇	dmdb
浸	jvdy
昆	kyob
撵	nxfi
琦	qowk
逝	uuzj
陀	tpeb
疣	yxby
渊	yrdl
察	isbx
屈	qvui
泽	zrdl
炸	vshv
嗬	hekk
溺	nudd
艳	yhfb
仔	zgrz
翠	ccxu
啐	ccku
谂	uhyx
嘶	sikj
种	idhv
锋	fgjf
良	ladg
栖	qimx
柄	bamb
肛	ghog
闵	mmmw
皖	wlbe
洇	ybdd
抻	iffu
咣	glkw
徽	hviw
媚	mqno
慕	mycx
坞	wytw
腥	xkou
估	gurk
掘	jyfi
逑	qwzq
痔	vubc
诉	syyi
逐	vizu
臂	buuo
剽	pnxd
哲	vrfk
烩	hchs
鲨	uada
萎	wrcn
曦	xiod
炎	ykhh
允	yise
袖	xppy
娥	ernw
俯	forc
瘤	lwbt
律	lciy
聂	noey
芽	yscy
羽	ynxx
钞	icju
赤	iutd
勒	lwgl
似	uurr
毯	tlmh
禹	ynpd
咂	zakj
宏	hdbs
瀑	pydu
廋	szgy
喧	xrkg
仰	ykre
丰	fgal
暨	jugd
剖	pzld
黍	uohu
鸿	hddn
盈	ylnm
螈	ytix
胗	vfop
苍	chcv
蔻	kmcy
禄	lypu
仕	uuru
夕	xipd
鑫	xbjj
尹	ymvp
熨	ytuh
吭	kgkj
苔	tfck
湉	tzdk
薜	bucu
铛	igje
锯	jcjk
叩	kmke
螺	lpix
蓉	rdck
藤	thcu
褪	tcpz
榨	vlmv
滋	zidy
宗	zsbx
锦	jmjj
竞	jjle
戾	luhq
浙	vwdj
啫	vtko
澳	aidd
勃	bpul
哺	bokf
韦	weal
炜	wrhw
藓	xxcy
邹	zzde
鲸	jkax
媒	menm
囡	njkn
曝	pyou
匀	yubd
溪	xidd
杭	hjmj
鳓	lwal
朴	pomb
屙	eeuk
遗	yozr
楹	ylmm
衩	idpi
伙	hqrh
魅	mqgw
倪	nore
嚄	hoky
纠	jqsl
艋	mjvm
幕	mycj
捻	nxfx
殴	ouky
磐	pkvu
屑	xouo
益	yubm
瘀	yvbd
规	gvfe
聋	ldle
燃	rkhh
狐	hiqg
寰	htby
论	luyb
瓢	pmxg
脐	qool
茜	xicx
镕	rdjk
盏	vljm
於	yvfd
庵	angd
候	hmru
鸠	jqjn
狷	jeqo
炆	wghw
宾	bbbb
赋	fykv
抹	mafm
伽	jxrk
姝	uunv
宵	xnbo
邢	xlke
灶	zxht
煸	bmhc
岔	ilbe
呔	ddkt
肱	gsos
蚶	hjig
皓	hxbk
历	luil
蟒	mkic
瘆	udbp
逸	yuzd
鼬	ymjy
锺	vsjv
涧	jndo
礁	jnuh
俚	lprl
孰	uiww
嘎	gskg
壳	qbuj
落	lxck
薰	xych
延	ykzv
翟	doxf
阁	grmk
喉	hxku
倦	jerv
戚	qiwx
氢	qkqg
烘	hshb
模	mpmd
诵	sayy
喆	vruk
渍	zudr
锉	cijt
浆	jldu
决	jydg
闷	mfmx
嵌	qner
塑	sybt
娅	ylny
噫	yikx
跃	yrzy
敝	budw
霏	fwyf
匹	ppke
韬	tcwj
艺	yucv
柱	vymv
檫	ismx
貌	mxve
政	vfvw
匙	ioob
担	djfd
铺	pyjf
淑	uudy
硪	wiuw
暇	xcoy
釉	ympy
酌	vpyu
炅	jfoh
蓬	phcz
痧	uabu
巳	suvv
帧	vfjr
逄	pjzl
丧	sgun
柏	bgmb
汞	gfgu
舅	jpjl
滥	lhdm
蘼	mocf
寿	umfc
昕	xboj
函	hklk
航	hjvj
啰	lokx
儒	rire
庭	tlgz
鄣	vhle
鄂	ewke
秆	glhg
轿	jbil
廊	ljge
鲤	lpal
怜	lzxs
浦	podf
汰	tsdt
坦	tltd
攒	ctfr
齿	ipvk
幢	vkjl
笃	dovm
玖	jewj
肋	lqol
炉	lihh
翘	qmax
嗄	ulkw
伢	ysry
笫	zpvp
谍	dqym
樊	fkmd
窥	kvbe
溜	lpdt
屡	lnun
啼	tokj
锌	xbju
泵	bfuu
陡	dcer
墩	dytw
固	gykk
径	jjig
酶	meym
娴	xznm
箸	vyvo
缀	vcsy
耻	ipev
斧	fobj
吮	uike
绾	wlsk
雁	yhif
喻	yckd
淤	yvdd
掴	gkfy
赣	ghlr
唧	jike
腊	lloo
蒲	picf
嘁	qikx
屠	tiuo
驮	tpmd
瓮	wfbw
浊	vpdi
慧	hcfx
辉	hvxi
偈	jurv
荐	jncz
鸥	oukn
萋	qicn
违	wezw
蟑	vhiu
埵	dqti
竿	gjvg
纲	ghsx
击	jiak
陋	lmev
寐	mqbw
挈	qofu
帖	tpjk
午	wopg
蚤	zbii
钝	dtjt
耄	mxlm
疏	uuvv
珍	vfwp
怔	vfxv
灿	chhe
婵	iknl
垢	gmtk
耒	lrfn
仑	lurb
胚	pwop
琪	qowb
昙	tkos
贤	xzlr
资	zidr
咀	jnkq
聘	pvev
肽	tsot
坍	tjtd
琛	ifwm
促	cyrr
饵	eyue
敛	lxrw
叛	phby
圃	pokf
暑	uooo
伍	worw
盅	vsvm
嗤	iiki
迩	eyzx
恢	hvxh
缰	jlsa
沫	midm
秾	ndhn
频	pnvr
唆	sokw
砣	tpub
枭	xnpm
窑	yvbf
舀	ybpj
惠	hcax
寮	lmbx
莓	mecm
朋	phoo
锡	xijw
览	llle
狸	loql
钳	qzjg
熵	uhhk
咝	siks
塘	tjtk
遥	yvzf
议	yuyy
铢	vujv
睬	cgom
孑	jqva
涉	uwdp
统	tfse
诈	vlyv
阻	zoeq
堇	jmna
蹿	crzi
悍	hhxg
牧	mynw
髂	qzgk
乾	qzuq
卅	slal
莺	ykcn
蛀	vyiv
锕	aajk
剐	gvkd
桂	gcmt
痂	jxbk
盟	mhom
祢	mopx
妄	wgwn
焐	wyhk
涯	ysdt
央	yhlg
糍	comy
壕	hvtu
幌	hsjw
猎	loqo
烹	pgwh
琼	qdwx
丘	qqpa
煽	ujhx
释	uupl
醍	toyr
樽	zymc
菖	ihco
崇	idex
戆	vklx
轨	gnij
技	jufy
脊	jpdo
鉴	jnlj
铃	lljs
凝	nldr
委	wrhn
泻	xody
疑	yobr
悠	yzrx
驳	bpmx
捕	boff
凳	dfvj
蠃	lqwf
敏	mmpw
蕊	rncx
挞	tlfz
阎	ykmj
垚	yvtt
荫	yvco
铞	dbjj
瑾	jmwa
泾	jkdg
哐	klkw
炼	lnhd
榴	lwmt
融	rdai
婷	tlnd
鱿	yxay
弊	budc
昌	ihoo
舵	divb
癸	gnvt
桔	jqmk
锰	mjjm
缅	mxsm
鼯	wijk
灞	bldo
菲	frcf
槛	klmm
俪	lurl
讷	nwyn
佩	pqrj
姘	pbnk
骟	uhmx
泫	xedy
裔	yuwk
冢	vfbn
卓	vplu
查	vamd
谔	ewyk
抿	mmfm
玥	yrwo
黯	abho
唵	azkd
簿	byvc
狄	doqh
枫	fgmx
棘	joan
烈	lodh
橹	lomo
碌	lyuu
乜	novv
嗫	noky
务	wywl
旋	xtfr
孵	fulz
晗	hkok
匠	jkkj
濂	lzdn
泷	lddl
箩	lpvx
萝	lpcx
昇	ugou
搋	ikfj
鼎	daov
检	jxma
哩	likl
泠	llds
龄	llvs
寞	mibd
甯	njby
启	qphk
锐	rcje
台	tdsk
销	xnjo
骁	xnmw
驿	yuml
胤	yvpv
泳	yfdy
躁	zxzm
窘	jfbk
描	mmft
濮	pidn
糁	slmp
率	ujwu
酮	tdyk
吁	ycky
尧	yvaw
绗	hjsi
筷	kjvg
搂	lcfn
漂	pzdx
赎	uikd
朔	uibo
娼	ihno
狙	jvqq
溢	yudm
择	zrfl
闸	vsmj
唛	mskw
浜	bhdb
澹	dhdk
谛	duyj
诡	gnyv
橘	jbmk
挎	kzfk
笠	luvl
凌	lldw
陕	ulej
拂	fiff
铭	mljk
硼	phuo
祥	xapy
馨	xbuo
埂	gjtg
茅	mvcp
亩	mowt
沏	qidd
毅	yuly
爰	ytpy
褶	vtpb
综	zssx
丙	baan
枷	jxmk
冏	jfkk
剌	llud
霖	lnym
瞥	ppdo
企	qprv
壬	rgqa
饰	uuuj
灏	hxdr
澜	lkdj
咛	nlkd
逊	xtzx
彧	ycad
蛛	vuiv
岗	ghex
厕	cwid
阶	jpel
矛	mvsp
楠	nkmg
昵	nuob
疲	poby
擒	qnfd
龌	wivt
巡	xuzv
迅	xtzu
滢	yldy
臻	vfah
澄	ihda
碉	dnuk
蛾	eriw
旱	hhog
婕	jqnr
垒	lrst
淼	mzuu
纽	nesi
侵	qbry
膳	uhok
嫣	yjnh
援	ytfy
璧	buuy
倡	igro
矿	kkug
袍	pvps
邵	uxde
渗	uddp
鲞	xsja
效	xbww
畜	xcwt
炙	vuph
怵	iyxu
蹉	cozg
典	dxlb
巅	dmer
跺	dizm
碱	jxuk
棠	tjxm
佗	tprb
鳌	apfa
褒	bcwy
摧	cvff
鹤	hwdn
嚼	jykc
宓	mubb
哞	mzkn
锈	xpjn
渔	ybda
捌	bafd
策	cwvn
繁	fkpx
疾	jobu
矜	jbsv
寇	kmby
缕	lnsn
糜	mogm
悯	mmxw
闽	mmmi
娜	npne
炳	bahb
磁	couy
苷	gjcg
戈	gead
钾	jvjj
骄	jnml
黔	qzhv
怯	qoxs
惕	tuxw
豚	tuou
腺	xnou
趾	vpzv
钚	byjb
蚕	ckti
搀	ijfd
喋	dqkm
饥	jiuj
娄	lxmn
钠	nljn
廷	tlzr
揸	vafd
蛰	vrfi
梓	zpmu
睹	dooo
贩	fhky
芬	ffcd
蜂	fgif
亥	hswr
嗟	jpkg
鳞	lnal
腩	nlog
滕	thou
剔	tiod
雯	wgyw
蓄	xcct
夷	yoan
庸	ysgl
酉	ycxa
芋	yccy
株	vumv
呤	ljks
澈	iwdw
汾	fgdd
绫	llsw
拢	lffl
葩	pacb
坯	pitp
仆	pirb
梯	timp
伟	wrrw
堤	ditr
寡	gvbd
浒	hodw
莰	klcr
邻	lnre
哂	uhkx
霞	xcyy
霰	xnyw
偕	xqrb
欣	xbjr
疮	ilbv
旦	dhoa
斗	dcdu
鸽	gern
苟	gcck
惑	higx
跤	jnzx
犁	lohn
掳	lofl
蜷	qtiv
旭	xcjo
炊	ivhr
恭	gscx
猾	hcqg
馁	nrun
裘	qwqy
韧	rdwr
寅	ynbb
筑	vyvf
斥	iupd
肤	fuof
绢	jeso
镌	jrjn
恪	kwxk
诓	klyw
缈	mzsu
湜	uodr
慰	wqux
愉	ybxd
炷	vyhv
姊	zpnp
猹	isqd
趸	diwr
焊	hhhg
衿	jbpv
洺	mldk
哝	ndkn
裴	pefy
芃	phcf
璞	piwn
蔷	qack
沁	qvdx
蚀	uoui
莳	uucc
箫	xnvs
狱	ycqq
责	zrfr
瞻	vjok
芝	vicv
谶	idyj
妲	dsnd
盖	gtym
阙	qrmr
瓤	rjwg
搔	scfi
署	uoso
梭	somw
瞳	tdol
庹	tqgi
瑶	yvwf
裕	ycpk
凿	zvyk
暧	auoy
瑷	auwy
锝	drjc
璟	jawx
睛	jkoo
廉	lzgn
昧	mqow
钼	myjo
畏	wqtn
颖	yabr
芸	yucs
仄	zwir
召	vxdk
粢	zidm
鬓	bvab
沸	fqdf
葭	jxcy
鹃	jrkn
岚	lkex
萁	qocb
檀	tkmd
蚁	ypiy
漪	yidk
簪	zjvo
伲	norb
彬	bbmp
泊	bpdb
稻	dxhj
掼	gefr
姣	jnnx
槿	jmma
揩	kdfb
糠	khmn
涝	lxdl
瞭	lbox
痞	ppbk
冉	rlla
莎	socu
跎	tpzb
兀	wyae
薏	yucx
焯	ichu
钣	bljy
耕	gglj
苛	keck
磷	lnul
玲	llws
跷	qnzw
穗	schx
腆	txob
硝	xnuo
诱	ymyn
筠	yuvd
鞍	angn
昶	ikyo
缚	fysc
渺	mzdu
刃	rddd
擅	uhfd
腕	whov
贯	gevr
冀	julb
监	jmlm
陆	lpej
惬	qoxj
汐	xidx
爻	yvxx
蜇	vefi
卑	bwpu
锄	iijl
抚	fofw
钴	gojk
辑	joie
芥	jocl
铐	kxjv
芈	mpll
耨	nmlc
悭	qmxt
狨	rdqu
慑	uwxy
淞	ssds
羡	xnyr
昭	vcok
祗	vipd
渚	vodo
敖	apfw
拗	aifl
拗	npfl
枞	csmr
呋	fukf
革	grnl
夯	hhdl
佶	jork
珑	ldwl
契	qufd
膻	dhod
杉	ujmp
涡	wodn
倭	worn
熹	xiuh
鳐	yvaf
刈	yuxd
岳	yrqe
肇	vxhy
酯	vpyo
坝	bltr
乏	fspv
艮	gden
贡	gagr
秽	hchx
况	kkde
厉	luiw
牟	mxsn
培	petk
柒	qidm
禽	qnrd
奢	uedo
苕	uvck
衔	xzii
椰	yeme
域	ycta
樾	yrmv
匾	bxkc
镖	bnjx
储	ioro
帆	fjjf
核	himr
甪	lypy
滤	lcdx
秘	muhb
姥	lbnb
萍	plcp
迫	pizb
泣	qudl
戊	wyad
郁	ycue
盹	diot
斐	frfw
蒿	hcck
髻	juak
窟	kubi
匡	klkw
胧	ldol
茗	mlck
齉	ngzy
霓	noye
茑	nzcn
劁	qnrd
渠	qbdm
述	uyzu
隼	siru
痿	wrbn
诌	vzye
氨	anqn
禀	bawx
丛	cdra
沣	fgdf
横	hfmb
剋	kwud
恳	khgx
磊	lruu
锣	lpjx
蜱	poiu
祺	qopb
适	uuzk
艇	tavz
玹	xtwy
耀	yxxf
淳	iudz
踮	dxzk
否	ppbk
概	gsmv
耿	gjeh
瑰	gvwg
闺	gvmt
蕙	hccx
伶	llrs
钮	neji
蹼	pozn
遣	qxzk
虱	uivi
瞬	utol
庥	xqgm
昱	ycol
噪	zxkm
拙	vofi
欸	epsr
欸	apsr
酣	hjyg
薅	hccc
踝	hlzg
矶	jiuj
藉	joco
靓	jjfe
琅	ljwl
蔓	mhcy
耪	pklf
锵	qljc
恬	tzxk
拓	tifu
蔚	wqcc
硒	xiux
漾	ygdy
予	ynsl
嘱	voky
嗞	ziky
靶	bdgb
磋	coug
敦	dyww
涐	erdw
焚	fgmh
尕	gdnx
圜	htky
戟	jpug
济	judl
禁	jbmx
鞠	jvgm
篓	lcvn
虑	lchx
琶	pswb
庞	pjgl
乞	qppv
茄	qqck
囚	qwkr
茸	rdce
讪	uhye
矢	uppt
舜	utpl
炭	theh
悉	xipx
削	xtxd
役	yuiy
婴	ykkn
昀	yuod
稚	vuhf
逞	ijzw
愤	fdxr
肓	hlwo
栾	ltwm
臊	scom
眺	tbod
翕	xirx
峡	xcej
戌	xvwa
轧	yliv
抑	yufe
蝇	ylid
毓	ycpv
载	zgui
滞	vudj
坂	blty
禅	uhpl
橱	iimc
龊	iivr
祠	copk
辅	foif
洹	htdg
恺	kgxj
硫	lwuv
芒	mjcw
宁	njbd
铊	tpjb
杳	ybmo
辙	vriw
贞	vflr
鄙	bpke
豳	bbeu
材	cfmc
翀	isxv
氮	dhqh
镀	dyjy
獾	hrqf
亟	jola
闾	lbmk
侣	lnrk
昴	mboe
楸	qqmh
示	uuex
凇	ssds
详	xayy
憎	zgxo
枳	vpmb
尢	whuv
卞	bndx
怖	byxj
岑	cgev
嘲	ivko
簇	cyvu
珰	dhwe
氟	fiqf
涵	hkdk
栗	luxm
赦	uwtw
犀	xiun
鼋	yted
甑	zfbw
振	vdfn
钡	bqjr
蔽	bucw
驰	iomy
撮	zqfy
铎	dpjl
柑	gjmg
冈	ghkx
棺	grmk
铪	hajk
诀	jyyg
髋	krge
唳	lukq
镰	lzjn
绺	lesk
祕	mupb
侨	qmrl
茕	qdcu
纬	wrsw
污	wudk
鲜	xxay
夭	ycpd
莹	ylcy
雍	yswf
育	ycwo
员	ytkr
赟	yywr
铡	vsjd
灼	vphu
畀	butl
豺	ifvc
掣	iwpu
慈	cobx
沌	dtdt
甫	foad
衮	giwy
践	jnzj
厥	jyir
陵	llew
麓	lymb
沦	ludb
骡	lpmx
弥	mogx
衾	qbry
笙	ugvu
侍	uurc
授	umfy
彤	tddp
剜	wjbd
匝	zakj
栅	vlmc
筝	vgvl
遢	tazx
婢	bunu
铂	bpjb
掸	dlfl
扼	ewfv
绯	fwsf
鲎	hmxa
旷	kkog
擂	lqft
圙	lrkm
殁	midy
攮	nkfy
咆	pvks
膨	phop
佘	urrx
叟	scpy
榻	tlmx
蹚	thzt
鹀	wign
协	xqub
岫	xpey
暄	xrog
虞	ybht
彘	vuvb
芷	vpcv
佰	bgrb
滨	bbdb
跛	bqzy
玚	yjwp
筹	ixvc
蹙	cywr
啡	fwkf
旮	gajo
庚	gggn
沽	gudk
卉	hcuc
箕	jivb
圐	kukf
谅	lkyx
茂	mxcw
摹	mpcu
疱	pxbs
梢	ucmo
柿	uumj
漱	uydr
啸	xbks
兴	xkxb
祐	ympk
觜	zivy
唑	zikt
胺	abon
舛	iyxl
扉	fwhf
羔	gcyh
琯	gywk
诃	heyk
嫉	jonu
霁	juyl
婧	jjno
掠	lrfx
绵	mzsj
镊	nojy
佺	qtrw
嗽	smkr
忻	xbxj
铀	yxjy
吱	ziky
褚	iopo
獴	mjqu
蚌	bgif
焙	bqhk
钉	djjd
糊	hymo
迹	juzd
柬	jxan
粱	ladm
啰	lpkx
勉	mxdl
仟	qmrq
雀	qzuf
扫	sxfe
绅	ufsu
盛	ihim
纨	wksw
媳	xonx
蚬	xxie
巽	xtsb
栈	vhmj
障	vgeu
址	vptv
椎	vvmf
孖	zizz
脯	piof
逮	dgzn
岱	dsre
葛	gtcv
躬	gsug
贾	goxr
氦	hsqr
昊	hxot
桓	htmg
茴	hbck
汲	jodj
菌	jtch
履	lnuw
乸	ndym
祈	qopj
芡	qncr
嚷	rhky
榕	rdmk
舐	uuqu
蓑	socy
逍	xnzo
猩	xkqu
絮	xcnx
瑄	xrwg
循	xuio
颐	yokr
侑	ymro
寓	ycby
郅	vuae
苞	bccs
堡	bort
侪	ifrl
怼	dcyx
祼	gepg
毫	hvwm
凰	hajw
晖	hvoi
岬	jvej
滘	jbdk
靖	jjlo
堃	kyft
醪	lvyp
锂	lpjl
撩	lnfx
锚	mvjt
湄	medo
呶	nvky
埔	potf
蕖	qbcm
趋	qvte
挟	xqfj
殉	xtdo
腋	ywon
嗌	yukm
嗌	aukm
妤	ybnl
愠	ytxm
轴	vmiy
胞	bcos
庇	bugb
碴	isud
蟾	ikik
宸	igbn
汆	crru
番	pjpt
腓	feof
喙	hcku
麂	jpgj
屐	jiuy
赍	jiur
蒹	jmcn
窖	jbbk
疗	lmbl
翎	llrx
熘	lqht
鹭	lyzn
眯	moom
苹	plcp
愀	qzxh
襦	ripe
粟	syxm
饕	tckl
醺	xyyh
鸦	yayn
檐	ykmk
曜	yxof
殷	ybpy
庾	yngy
瑗	yewy
丈	vgan
侄	vort
艾	yucx
痹	bubl
雏	iidf
啜	iiky
聪	csex
爨	ceph
怛	dsxd
藩	fjct
蕃	boct
尬	glyl
槐	hlmg
际	juex
玦	jywg
勘	kjql
璃	lowd
貘	mivd
驽	ninm
毗	potb
厦	uliw
驶	upmu
薯	uoco
肆	suay
娑	sodn
蜕	tcie
毋	wiva
昔	xico
羲	xiyd
旬	xubo
茚	yvce
植	vomq
烛	vihi
龅	bcvs
镚	bfjo
镲	idjx
俶	iyry
椿	iymo
邨	cyte
悼	dxxu
奋	fddt
罡	ghsv
饹	leuk
撼	hhfx
濠	hvdu
饸	hruk
煌	hahw
迦	jxzk
谏	jnyj
蕨	jycr
诳	kayw
烙	lihk
䁖	lzon
茫	mjcw
拇	mofm
飒	sllx
麝	uwgc
绦	tcsm
婉	wlnv
鹟	wgbn
皙	ximb
霄	xnyo
勋	xykl
曳	ywlp
铱	yijy
洞	tddk
谙	anyo
椴	demy
腭	ewok
淦	ghdj
淮	hldf
晦	hcom
荚	jccj
笺	jmvj
垃	latl
酪	lxyk
氓	mjwm
暝	mlob
凄	qidn
虔	qzhw
噙	qnkd
厍	uwii
析	ximj
飨	xsxl
厢	xlio
踅	xyfr
荀	xuco
呓	yukv
俑	yfry
屿	yney
札	vsmv
昼	vmid
狈	bqqr
弁	bnsc
馃	gqug
憾	hhxx
翰	hhux
泓	hdds
镬	hijy
颊	jcjr
珈	jxwk
诫	joyc
掬	jvfm
邝	kkge
励	luil
谝	pxyc
娆	rvnw
茹	rick
赊	uekx
嵩	ssek
蹋	tlzx
桐	tdmk
菀	wlcv
渥	widt
檄	xomw
铉	xejy
佯	yjry
盂	ybym
臧	zhwi
喳	iakd
瘴	vgbu
祯	vfpr
铸	vyjc
赘	vcfr
骓	vvmf
镯	vpji
咨	zidk
腙	zsox
濒	bbdr
摒	bjfk
粲	chlm
彻	iwid
埕	ihtw
疵	cibb
跐	cizb
殆	dsdk
硐	dauk
坊	fjtf
缶	fcwk
绀	ghsg
郜	gxne
睾	gcpg
鹳	gecn
僭	jnro
啉	lnkm
嘹	lmkx
髅	lxgn
纶	lusb
檬	mhmu
谬	mpyp
牡	mont
廿	nnca
泮	phdb
螃	pjif
乓	phqd
箧	qovj
擎	qlcu
拭	uufg
殊	uudv
溯	sydo
娲	wann
惘	wkxw
禧	xppk
叶	xqku
乂	yupn
囿	ymko
驭	ycmy
鸳	yrxn
嗳	auky
坳	aitl
碜	ihup
椽	itmu
毳	ccmm
歹	dgax
镉	grjl
构	gmms
褐	hwpv
究	jqbj
铠	kgjj
慷	khxn
魁	kbgu
癞	lsbr
阑	lkmj
仂	lwrl
羸	lewf
菱	llcw
陇	lfel
镂	lmjn
嫚	mhny
缦	mhsy
靡	mogf
捺	nlfx
彷	pjif
铅	ykjk
蛳	siij
沱	tpdb
懿	yuux
姻	ybnd
迂	yvzy
诏	vxyk
诊	vhyp
铮	vgjl
葆	bbcm
缤	bbsb
偲	cdrx
铳	iaje
舂	isfj
创	ilrd
凋	dndk
督	duuo
惶	haxw
讳	hcyw
笳	jxvk
笕	jxve
蛟	jnix
驹	jvmk
颏	kewr
溃	kcdr
喱	lokl
涟	lzdz
麟	lngl
淋	lvdm
栊	ldml
馒	mkuy
沤	oydx
醅	pwyk
撇	ppfw
祁	qope
戕	qlpg
樵	qmmh
俅	qwrq
醛	qtyw
艏	ucvz
沓	tluo
蜗	woin
晤	wyok
懈	xoxn
魇	ylig
旸	yjop
秧	yhhy
烨	ywhu
钰	ycjy
鸢	yryn
哕	yukx
哕	hckx
撰	vefb
磅	pjuf
叱	iukb
炽	iuhb
哧	iikd
迭	dqzu
惰	dixo
燔	fkht
嗐	hskk
艰	jmyg
犍	jmnz
桨	jsdm
鲛	jnax
诘	jqyk
襟	jbpx
钜	jcjj
骏	jtmw
侉	kvrk
厘	loil
劣	loul
聆	lles
琉	lwwv
氯	lcqu
玟	wgww
颞	noer
颦	pnvu
麒	qogb
熔	rdhk
轼	uuig
驷	sume
锑	tijp
猥	wrqn
奚	xipd
嬉	xink
偃	ylrn
鄢	yjve
谒	ywyv
苡	ypcr
茵	ybcd
娱	ybnt
陨	yier
疹	vhbp
桢	vfmr
蹩	bqdr
埗	bytp
鹾	cplg
娣	dunp
氐	dpud
妒	dynh
阜	fypu
褂	gzpb
胍	gxog
罕	hlbg
笏	hyvw
涣	hedd
恍	hsxw
疖	jpbe
荆	jkcd
炯	jfhk
僦	jpry
倔	jrri
珺	jtwk
侩	kjrs
括	kifk
醨	loyd
沥	ludl
砺	luuw
络	lisk
鳗	mkay
朦	mhou
旻	mnow
茉	micm
募	mycl
砷	ufuu
蟀	ujiu
倘	tkrk
涕	tudp
隈	wwen
唏	xikj
酰	xmye
校	jbmx
榭	xomc
歆	xblr
琇	xpwn
晔	ywou
翊	yulx
缨	yksn
佣	ysry
蕴	ytcm
奘	zgpd
琢	vpwn
龇	zivb
镗	tjjt
铵	azjn
梆	bhme
敕	iuuw
嫡	donk
菂	ducu
幡	fjjt
纺	fksf
巩	gfgf
辜	guuu
呱	gukg
鹫	jpwn
锎	kdjk
奎	kbdt
愧	kcxg
琨	kywb
崂	lvel
鬣	loav
蚂	mdim
嫫	mpnd
钕	nnjn
埤	putu
铍	pojy
骞	qmbm
窍	qbbv
锹	qnjh
偌	rirk
石	dhak
庶	uygh
嗵	tskz
圩	wety
宪	xnbe
潇	xnds
谐	xqyb
绪	xcso
绚	xeso
砚	yhue
湮	yjdt
肴	yvxo
罂	ykkf
蚴	ymil
瘐	ynby
棹	vxmu
踏	tazo
咥	xukt
耙	pslb
阪	bley
犇	bfnn
迸	bfzk
弼	bugg
俵	bbry
秉	bapn
晡	buof
槎	ismg
刹	ilxd
憧	isxl
槌	ibmz
绰	iisu
篡	cevs
皴	cysy
鞑	dsgz
怠	dssx
诞	dhyz
谠	dkye
筜	dhve
氘	dcql
萼	ewck
阀	fsmg
芣	ficb
馥	fyhw
哽	gjkg
骸	hfgr
骇	hsmr
捍	hhfg
阖	hrmm
缳	htsy
咴	hvkh
镓	jxju
枧	jxme
蹇	jxbr
戋	jmad
爵	jypc
隽	jern
瞰	khow
哙	kjks
喟	kcko
濑	lsdr
镭	lejt
髎	lmgp
凛	lmdx
鸰	llrn
娈	ltwn
鸾	ltwn
捋	lnfc
莽	mkcc
镍	nojm
爿	pkvp
僻	puru
噼	piku
鳍	qoao
羟	qsyg
羌	qlyv
戗	qlrg
衢	qbii
鳃	sdax
疝	uhbe
曙	uooo
唾	tiki
罔	wkkw
窸	xibx
狭	xcqj
冼	xxde
溴	xpdq
靥	ywim
祎	yipw
峪	ycek
煜	ychl
筼	yuvr
辄	vriv
诤	vfyl
徵	vpiw
钯	bdjb
赑	bukr
采	cspm
垞	istq
偿	ijrs
瞋	ifob
丞	ihla
辍	iiiy
脞	cqot
惦	dnxk
胴	daok
昉	fkof
讽	fjyx
尴	gjym
眭	svot
纮	hdss
骺	hxgk
桦	hzmu
戢	jokd
玑	jiwj
缉	jise
烬	jvhd
胩	kdob
阚	khmw
亢	kgwj
眶	kkow
夔	kbbw
邋	lazv
藜	locu
蓼	lzcp
嬷	mpnm
蘑	mpcu
懦	nixe
怄	oyxx
澎	phdp
莆	picf
玘	qpwj
悄	qnxo
袪	qvps
濡	ride
箬	rivk
铯	swjb
芍	uvcu
蜃	udii
燊	ufhm
殳	uujy
姒	sunr
悚	sfxu
祟	scix
髓	sngz
琐	sqwr
獭	tdqr
渭	wqdo
鲔	wrao
芜	wicw
晞	xioj
纤	xmsq
橡	xkmn
鸮	xnkn
煦	xcoh
询	xuyo
埙	xytr
鸯	yhyn
冶	ytdk
毡	vjmk
彰	vhlp
跖	vozu
癿	bqbv
膀	bkof
褙	bqpo
咇	bukb
匕	bppv
辟	puuu
扁	pmhc
璨	chwm
漕	cvdo
杈	iami
彳	iupr
仇	qwrj
揣	ikfe
扽	ddft
奠	dnbd
颚	ewkr
酚	ffyd
蝠	fiit
釜	foba
莞	wlce
颌	hrrr
弘	hdgs
藿	hicf
乩	jilv
伎	jury
荠	jucl
俭	jxra
疆	jlga
剿	jzvd
喈	jpkb
靳	jvgj
颈	gjvr
噱	xyku
匮	kckr
栎	luml
琏	lxwz
燎	lmhx
骝	lwmt
耧	lxln
缪	mxsp
蘖	nocm
辔	pqsk
霹	piyu
歧	qovy
扦	qmfq
氰	qlqo
呻	ufku
晟	ihoi
俟	suru
鳎	tdax
膛	tjot
叨	dckd
嚏	tukr
鸵	tpnb
顽	wker
魍	wkgw
蜥	xiij
醯	xiym
芗	xlcx
楔	xpmd
眩	xeoy
驯	xtmi
谚	yhyp
龈	ynvg
瀛	yldf
舆	ybpb
隅	ybey
豫	ycsn
昝	zlwo
藻	zbcm
绽	vhsr
秩	vuhu
潴	vudo
荷	hwck
卜	bold
浐	ildi
敞	ikxw
豉	ipay
惆	ixxk
酬	ixyv
雠	ixrf
泚	cpdb
囱	cspw
蠹	dyai
踱	dpzy
筏	fsvg
舫	fkvf
钆	gsjv
丐	gsav
觚	gudg
颔	hhrr
蘅	hhci
黉	hdxb
珲	huwi
圾	jitj
祭	vspx
矫	jmul
桀	jqxm
噤	jvkx
胫	jjog
蝲	llid
阆	lgml
吏	luan
釐	xiwl
璘	lnwl
窿	ldbu
椤	lpmx
髦	mvam
贸	mxpr
邈	mzze
脲	nbou
湃	psdf
鞘	qbgo
湫	qqdh
龋	qnvy
诠	qtyw
蹂	rxzm
潵	sddw
弑	uuxg
墅	uylt
抒	uufl
泗	sude
饲	suuk
忑	twxx
骰	txgy
鹜	wysn
烯	xihj
匣	xckj
缐	xnsu
漩	xtdr
鳕	xuae
浔	xudc
氩	ylqy
焰	yhhj
琰	ylwh
奄	yldd
荧	ylch
痈	ysby
攸	yzrw
榆	ybmd
辗	vlin
钊	vcjd
挚	vufu
肢	vioy
峙	vuec
衷	vswy
绉	vmse
纂	zyvx
绷	bjso
舶	bpvb
蛏	igit
魑	iigd
绸	ixsk
粹	ccmu
玳	dswy
骶	dpgd
钿	dnjt
鲽	dqam
锻	dejy
俘	firz
孚	fipz
诟	gmyk
刿	gced
壑	hwlt
堠	hmtu
葫	hico
瓠	hydg
烀	huhh
遑	hazw
戛	jcag
鳉	jlac
玠	jowl
菁	jkco
迥	jfzk
韭	jefa
蒟	jnck
裾	jvpk
涓	jrdo
崛	jyei
箜	ksvg
喹	kbkt
壸	kiuy
悃	kixm
涞	lfdl
俐	lurd
醴	lpya
蠊	lzin
蔺	lvcf
垄	lflt
芦	lich
颅	lilr
扪	mgfm
冕	mxkv
睦	myot
丕	piba
翩	pmhx
岐	qoey
碛	quur
讫	quyq
鸲	qbbn
诎	qvyi
痊	qtbw
阕	qrmt
鞣	rxgm
蒻	ricd
鳝	uhak
莘	ufcu
澍	uydc
烁	uihl
澌	sidj
稣	suah
螣	thoi
忝	txtx
仝	tdrg
僮	tdrl
柝	timi
帷	wejf
钨	wujw
隙	xuex
晰	xioj
巷	hgcs
械	xomc
邂	xozn
匈	xsbk
欻	xvhr
堰	yhtn
沂	yodj
贻	yokk
挹	yufb
邑	yukb
瑀	ynwy
赃	zhkt
沼	vbdk
斟	vfqu
箴	vfvk
烝	vglh
旨	vpbo
纣	vmsc
镦	dyjw
氾	fkdv
嫒	auny
霭	apyv
岜	baeb
悖	bqxz
锛	bfjc
毖	bubb
亳	bpwq
馇	iaud
阐	ilml
殂	cidq
疍	dhvd
铛	dhje
靛	dnfr
渎	didd
愕	ewxk
尜	gsxx
诰	gxyk
胳	geok
毂	gouy
菰	gucg
吭	hjkj
曷	hrov
珩	hhwi
糇	hxmu
唿	hukx
蝗	haiw
诲	hcym
虺	hnwi
睢	svof
蓟	jucd
讥	jiyj
稽	jiho
稼	jzhu
胛	jvoj
狡	jzqx
郊	jnwe
睫	jqor
蚧	joil
疚	jpbj
眷	jejo
峻	jtew
龛	kjrl
轲	keik
骷	kugk
盔	kvum
锟	kyjb
斓	lkwj
螂	ljie
骊	loml
埒	lotc
庐	ligh
鲈	liau
犸	mdqm
幔	mhjy
蠓	mjiu
泌	mudb
秣	mihm
眸	mxon
柰	nsmx
馕	nkuy
坭	notb
瓯	oukw
珀	piwb
芩	qncv
颧	qtcr
苒	rlcr
戎	rdgu
冗	rfbj
搡	skfm
汕	uhde
杓	bnmu
牲	ugnu
枢	uumx
绥	sbsn
狲	syqx
苔	tdck
誊	thjk
湍	trde
褪	ttpz
惋	wlxv
宛	wlbv
巍	wweg
邬	wuwe
屃	xuur
饷	xsuk
朽	xemv
勖	xckl
墟	xvty
渲	xedg
谖	xryy
胰	yooy
猗	yiqk
莜	yxcw
垣	yttg
沅	ytde
锃	zfjw
樟	vhmu
鹧	vwgn
祉	vppv
蜘	viik
肫	vyot
斫	vpuj
眦	zuob
蕞	zccy
酢	ziyv
鹡	jodn
螯	apfi
堡	pyrt
襞	buuy
蝙	bmic
骉	bnmm
帛	bpbj
膊	bpoc
簸	bqvy
惭	ckxj
沧	chdv
忏	ihxq
怅	igxi
骋	ijmv
弛	iogy
绌	iysi
黜	iyhi
揣	ijfe
钏	ieji
璁	cswx
撺	crfi
淬	ccdu
埭	dstn
绐	dssk
担	dhfd
荻	doch
翟	vfxf
簟	dnvu
甸	dnbt
鲷	dnak
篼	dzve
蔸	dzce
阇	dumo
垛	dqtm
锇	erjw
矾	fkuf
苻	ficc
赅	gdkr
皋	gcbu
鲧	giax
焓	hkhk
郃	hrre
貉	hrvk
糊	humo
徊	hlik
奂	hedd
恚	hctx
攉	hoff
畸	jitk
铗	jcjj
鹣	jmbn
徼	jbiw
竭	jqlv
旌	jkfu
咎	jpwk
矩	jnuj
苣	jccj
蹶	jyzr
楷	kgmb
蝌	keiu
喾	kyxk
栳	lbmb
潦	lmdx
呖	lukl
赁	lvrr
咙	ldkl
瘘	lmbn
戮	lyxg
漉	lydb
簏	lyvb
泺	lidl
汨	mudo
忞	mnwx
漠	midd
缪	mbsp
氖	ngqn
瑙	nbwx
淖	nxdu
啮	nokk
俳	pfrf
哌	pskn
沛	pqdl
篷	phvz
乒	pkqp
抔	pxfb
潽	pudo
杞	qpmj
茜	qncx
綮	qjhx
瞿	qbof
荃	qtcw
纫	rdsr
丧	shun
觞	uhdp
噬	uukr
蔬	uucv
嗣	sukk
伺	surk
崧	sses
菘	sscs
隧	scez
骀	tfmk
砼	tdug
恸	taxl
椭	tqmo
洼	wadt
淅	xidj
岘	xnee
庠	xagy
囟	xvpx
洵	xudo
讶	ylyy
衍	ylii
殃	yhdy
浥	yudb
翳	yukx
蜴	yuiw
谊	yuyq
诒	yoyk
铟	ybjd
萤	ylci
萦	ylcx
聿	ycvl
耘	yuls
谮	zdyo
湛	vhdv
锗	vtjo
雉	vuuf
骤	vmmn
鬃	zsax
咉	yhky
媞	uunr
柏	bpmb
褓	bbpm
蓓	bqck
篦	buvb
蓖	bucb
髀	bugu
裳	uhxy
坼	iwti
裎	ihpw
螭	iiid
楮	iomo
氚	irqi
鹑	iuwn
蔟	cycu
忖	cixc
痤	cpbt
耷	dade
瘩	dabk
焘	tcfh
涤	dodm
邸	dpde
锭	djjr
玎	dkwd
酊	dkyd
铥	dqjs
钭	dcju
肚	doot
缎	desy
碓	dcuf
哚	dqkm
咄	doki
匐	fibt
茯	ficq
辐	fiit
溉	gsdv
缟	gbsk
蛄	guik
氿	jedj
姮	hhng
衡	hhii
逅	hmzk
鹄	hinn
婳	hznk
宦	hebi
鲩	heae
荟	hccs
绩	jusr
羁	jism
纪	jpsj
菅	jmck
茭	jncx
疥	jobl
痉	jjbg
柩	jpmj
倨	jcrk
莒	jnck
琚	jvwk
雎	jvqf
咀	znkq
慨	kgxv
窠	kebg
垦	khgt
刳	kudd
夼	ksdi
蝰	kbit
鲲	kyab
榄	llme
酹	lqyc
蛎	luiw
蠡	lpvi
寥	lmbp
蒌	lxcn
潞	lydk
虻	mhiw
瞢	mhco
岷	mnem
珉	mnwm
溟	mldb
镆	mijd
囔	nhky
辇	nxfi
徘	pfif
庖	pvgs
貔	povb
嫔	pnnb
匍	pibf
朴	pmmb
蕲	qocj
汽	qudq
欹	qidr
槭	qumx
蹊	xizd
钤	qzjv
阡	qmeq
慬	qnxa
磬	qjuu
罄	qjuf
蝤	qwiy
鹊	qrcn
瘙	sxbi
赡	uhkk
韶	uvlk
潲	uxdo
纾	uusl
蒐	szcg
飕	szjy
跆	tfzk
忐	tlux
慝	twkx
珽	tawz
钍	tojt
驮	dimd
烷	wkhe
脘	wloe
杌	wymw
诬	wuyr
潟	xudh
徙	xpir
辖	xcik
涎	xzdz
铣	xpje
枵	xnmv
惺	xkxu
嬿	yhnh
焱	yhhh
峄	yuel
诣	yuyo
镱	yujx
揖	yife
荑	tocy
霪	ynyr
颍	yabr
甬	yfsy
镛	ysjl
阈	ycma
俣	ynrt
湲	ytdy
刖	yrod
钺	yrjv
錾	zhij
崭	vlej
晢	vrfo
轸	vhip
拯	vjfa
摭	vofh
卮	vipv
踪	zszx
诹	zzyy
遂	sbzu
稗	bshu
邶	bqle
孛	bquz
陂	poey
苄	bncb
飑	bnjs
僰	bpar
钹	bpjd
砵	boub
艚	cvvo
谄	ilyj
鲳	ihao
蚩	iivi
亍	iyad
蹴	cyzy
缞	cvsy
凼	dguk
砥	dpud
蚪	dciu
婀	eenk
铒	eyje
璠	fkwt
钒	fkjf
妨	fjnf
淝	fedb
忿	fdbx
氛	ffqd
俸	ffrl
酆	fgee
桴	fimz
腑	fooc
麸	fuff
垓	gdtr
觥	gsdw
倌	grrk
毌	geva
菡	hhck
菏	hrck
斛	hidu
惚	huxx
篁	havw
蕺	joca
浃	jxdj
睑	jxoa
缄	jmsk
槛	jnmm
醮	jbyh
珒	jbwy
儆	jarw
臼	jppa
鬏	jqah
讵	jcyj
踞	jczk
橛	jymr
珏	jywy
捃	jtfk
岢	ktek
炣	kthk
髁	kegg
铿	kgjt
筘	kmvk
揆	kbft
焜	kyhb
睐	lsol
痢	lubd
奁	lzdx
鲢	lzaz
缭	lmsx
冽	lodd
捩	lofq
洌	lodd
羚	llys
苓	llcs
崚	lhew
茏	ldcl
泷	uldl
泸	lidu
镥	lojo
蟆	msid
劢	mswl
牤	mhnw
媄	mrnd
醚	moyz
麋	mogm
沔	mxdm
蓦	micm
萘	nscx
艿	ngcn
睨	nuoe
旎	npfb
柠	nlmd
狍	pvqs
罴	posh
圮	pptj
鄱	pppe
魄	pibg
亓	qoel
骐	qomb
憩	quqx
洽	qzdk
慊	qnxn
慊	qoxn
荨	xucc
嫱	qank
穹	qdbg
蚯	qqiq
铨	qtjw
绻	qysv
髯	rkar
壤	rkty
攘	rkfy
桡	rvmw
糁	ufmp
绍	uxsk
珅	ufwu
埘	uotc
谥	uuym
祀	sups
竦	sflu
夙	syjd
邰	tfse
倓	tkrh
铤	tajz
疃	tytl
饨	tuut
琬	wlwv
豌	wjav
沩	wedw
玺	xpdy
歙	uwrr
舷	xzvy
祆	xmpt
筱	xzvw
嚣	xnkk
吁	xvky
楦	xemg
儇	xrry
旋	xefr
谑	xrya
曛	xyoh
岈	ysey
琊	yswe
赝	yhir
酽	yhyy
邺	ywye
弈	yuwc
潩	yudb
缢	yusm
臆	yuox
荫	ybco
郢	yake
璎	ykwn
踊	yfzy
壅	yswt
欤	ybyr
鹬	ycsn
芫	ytce
龠	yrrc
甾	zdvt
择	vffl
咤	vlkq
旃	vjfd
曌	vxog
谪	vryk
赭	vtto
鸩	vddn
缜	vhsb
溱	qndh
峥	vgel
窒	vubt
蛭	vuit
栀	vimv
茱	vucv
篆	vevu
擢	vpff
叕	vpyy
髭	ziab
馇	vaud
骜	aifm
靬	qzgg
腌	aaod
叆	auey
隘	auem
埯	aztd
懊	aixd
鲃	baab
荜	bucu
濞	budl
摽	bbfx
髌	bvgb
箔	bpvb
鲌	bpab
泊	podb
埠	bytu
瓿	bylw
汊	ildi
刬	ihjd
晁	ivod
郴	ifme
宬	ihbi
澂	ihdw
匙	uiob
瘳	izbp
梼	tvmc
莼	iuct
琮	cdwx
萃	cccu
傣	dgru
纛	dxfx
蹈	dbzj
嶝	dfea
镫	dfja
戥	djog
籴	dorm
耋	dqlt
昳	dqou
氡	dsqd
椟	dimd
噩	ewwk
鹗	ewkn
珥	eywe
珐	flws
狒	fqqf
翡	frfx
痱	fqbf
鲼	fdar
凫	fipj
黻	fiyd
驸	fymc
冮	ghdg
圪	getq
疙	gebq
鲠	gjag
赓	gggr
彀	gmuy
锢	gyjk
汩	godo
胱	glow
庋	gngy
鲑	gvat
腘	gpoy
嗥	hvku
鞨	hrgv
鸻	hhin
薨	hscb
煳	hiho
蝴	hiio
怙	hyxk
镮	htjy
鬟	htay
痪	hebd
徨	haiw
洄	hbdk
蛔	hbik
贿	hcko
夥	hqgx
鲫	juae
踺	jnzz
酵	jbyz
肼	jaoj
兢	jkue
扃	jshk
厩	jpiv
阄	jqmv
炬	jchj
飓	jcjb
枸	jnmk
谲	jyyk
钧	jyjd
崁	kher
疴	kebk
脍	kjos
浍	hcds
圹	kktg
铑	lbjb
簕	lwvl
诔	lryl
莅	lucl
魉	lsgl
獠	lmqx
躏	lvzf
懔	lmxx
蛉	llis
垆	litu
胪	liou
葎	lccy
孪	ltwz
峦	ltwe
蟊	mvsi
铆	mbje
袂	mqpg
宓	fibb
眇	mzou
篾	movu
蔑	mocu
靺	migm
衲	nlpn
猱	nvqm
佞	njrn
耦	ooly
滂	phdf
脬	pcoz
椪	pfmy
蚍	poib
譬	puuk
淠	pudl
苤	pwcp
鲆	plap
娉	pknv
哱	bokz
埼	qotk
迄	quzq
耆	qolo
缱	qxsz
樯	qamk
荞	qmcl
锲	qojd
郄	qoxe
黥	qlhx
顷	qabr
蜻	qkio
箐	qjvo
蛩	qdgi
泅	qwdr
酋	qwby
鳅	qqah
觑	qche
傕	jyrf
嵘	rdem
糅	rxmm
蠕	riie
颡	skyr
啬	swuk
霎	ulyn
蟮	uhik
姗	ujnc
墒	uhtk
莳	uocc
秫	uihu
沭	uydu
槊	uibm
溲	szdy
涑	sydu
肃	syvd
燧	schz
濉	svdf
榫	simu
闼	tlmz
覃	qnxu
瑭	tjwk
傥	tkre
嘡	thkt
弢	tcgy
铽	twjx
鹈	tobn
屉	tuuu
莛	tlcz
蜓	tliz
彖	tevu
呙	gokn
妧	ytne
猬	wqqo
偎	wwrn
尉	wquc
汶	wddw
肟	wiok
侮	worm
庑	wogw
忤	woxw
圬	wutk
郤	xube
浠	xidj
粞	ximx
遐	xczy
氙	xmqe
襄	xlwy
骧	xlmy
崤	xmeo
皛	xzbb
绡	xnso
胁	xqob
亵	xowy
荇	xjci
煋	xkhu
芎	xscg
酗	xcyk
胥	xvvo
畜	iywt
烜	xyhg
鲟	xuac
蕈	xtcu
衙	ysii
滟	yhdb
餍	yhil
䶮	yllt
卬	ajpe
烊	yjhy
窈	ybbl
怿	yuxl
熠	yuhb
燚	yuhh
媖	ykny
鹦	ykkn
慵	ysxl
牖	ycpf
铕	ycjo
黝	ychl
嵛	ybed
玙	ybwy
萸	ybcy
谀	ybyy
堉	ycto
圉	ynkg
禺	ybld
嫄	ytnx
钥	yrjo
恽	ytxi
殒	yidr
氲	yyqm
哳	vakj
楂	vamd
嶂	vgeu
圳	vdti
禛	vfpb
陟	vuep
宙	vmby
帚	vcej
伫	vyra
馔	veub
隹	vvrf
茁	vpci
恣	zudx
滓	zpdu
耔	zplz
淄	zidt
兹	coby
俎	zorq
祚	zipv
訾	zpvk
嵴	joeo
镝	dijk
奓	vadx
皑	aobj
桉	anmn
盎	agym
肮	ahoj
奡	aial
岙	aiye
鲅	blad
笆	bavb
枹	bcms
栟	bfmk
甏	bfuw
绷	bfso
滗	budm
箅	buvl
陛	buet
昪	bnoc
鳔	bbax
膑	bvob
伯	bgrb
逋	buzf
黪	clhp
伧	chrv
嶒	cheo
姹	ilnq
孱	ikuz
鬯	igxb
猖	ihqo
琤	igwl
茺	isce
樗	iumk
遄	itze
怆	ikxv
幢	iajl
蝽	iyio
踔	iozu
苁	cscr
枞	zsmr
辏	cmit
徂	ciiq
瘁	ccbu
璀	cnwf
褡	dapk
淀	dndr
啶	djkr
疔	dkbd
牍	dipd
耑	dree
惇	dyxz
礅	dyuw
垩	ewyt
苊	ewcv
洱	eyde
鲂	fjaf
诽	fryf
棻	ffcm
纷	ffsd
葑	fgcc
罘	fisb
矼	ghug
杲	gbom
槁	gbmk
舸	gtvk
袼	gepk
亘	gdad
茛	gdcg
唝	hfkr
觏	gmae
姤	gmnk
牯	gonk
诂	goyk
鹘	hign
绲	gisb
辊	giib
蜾	gqig
咍	hdkk
瀚	hhdx
鼾	hjzg
沆	hgdj
翮	hrax
桁	hhmi
闳	hdms
槲	himu
戽	hyhu
豢	heju
圜	ytky
彗	hcfe
翙	hcex
翚	hvxi
麾	hvgm
隳	hvex
馄	huub
溷	htdu
诨	htyi
钬	hqjh
濩	hidy
岌	joej
楫	jome
殛	joda
徛	juik
洎	judz
芰	jucy
骥	jumb
墼	jiit
嵇	jihe
笄	jivk
济	jpdl
泇	jxdk
戬	jxyg
謇	jxbk
湔	jmdd
耩	jslr
侥	jzrw
褯	jopj
芥	gscl
藉	joco
觐	jvne
遽	jczu
沮	jndq
孓	jyvn
抉	jyfg
攫	jyfy
爝	jyhc
矍	jyoy
噘	jtkr
竣	jtlw
锴	kgjb
墈	khtl
㸆	kxhf
犒	kxnk
瞌	keom
矻	kuuq
贶	kkke
蒉	kccr
籁	lsvr
漤	lldn
榔	ljme
埌	lgtl
罍	letf
擂	left
塄	lhtf
棱	lgmw
篱	lovd
缡	losd
罹	losf
蓠	locd
枥	luml
砾	luul
隶	luvn
娌	lpnl
跞	luzl
郦	lule
僚	lmrx
尥	lbyu
蹽	lnzx
吝	lvwk
鎏	lwdj
尨	mjud
嵝	lcen
舻	livu
渌	lydu
辘	lyib
偻	lnrn
挛	ltwu
锊	lrjc
猡	lpqx
逻	lpzx
荦	licn
瘰	lqbx
蔓	whcy
邙	mjwe
懋	mxmx
峁	mbee
渼	mrdd
懑	mddx
勐	mjzl
蜢	mjim
猕	moqx
谧	muym
敉	mpmw
丏	mxav
藐	mzce
缗	mnso
黾	mmkd
谟	mpyd
瘼	mibd
模	mimd
苜	myco
鼐	nsnv
忸	nexi
杻	nemi
杻	icmi
衄	ncxi
疟	nrba
锘	nijk
杷	psmb
匏	pvds
霈	pqyl
湓	pgdm
怦	pgxp
枇	pomb
琵	powb
伾	pirp
邳	pipe
骠	bnmx
缥	pnsx
氕	ppqp
叵	pqkk
菩	pick
溥	podc
崎	qoek
碶	quud
屺	qpej
棨	qphm
芑	qpcj
佥	qmra
钎	qmjq
堑	qnit
谯	qmyh
峭	qbeo
橇	qnmm
硗	qnuw
伽	gark
芹	qncj
吣	qvkx
揿	qvfr
檠	qlcm
巯	qwvv
璆	qwwp
遒	qwzy
囷	qykh
穰	rjhy
妊	rdnr
驲	rumo
瑢	rdwk
褥	rypc
脎	slom
靸	sdgj
馓	sluw
臊	sxom
穑	swhk
裟	uady
膻	ujod
畲	uert
鲥	uoac
鼫	uoju
豕	upan
蓍	uico
塾	uiwt
腧	uyod
菽	uucy
闩	urma
兕	suae
笥	suvk
锶	sijx
嗾	scku
薮	sccw
嗉	sykx
蔌	sycr
谡	syyw
甦	sugu
宿	xebb
宿	xpbb
谇	scyu
邃	sczu
唢	sqkr
酞	tsyt
啴	ilkl
搪	tjfk
萄	tvcf
縢	thox
绨	tusp
沺	tzdt
殄	txdp
窕	tzbd
餮	todl
萜	tpck
侹	tarz
烃	tkhg
梃	tamz
梃	tjmz
哃	tdkk
曈	tdol
潼	tddl
抟	ttfv
煺	tchz
鲀	tuat
拓	tlfu
窊	wabg
嵬	weeg
帏	wejw
潍	wedf
艉	wrvm
苇	wrcw
诿	wryn
涡	godn
梧	wimk
蜈	wiit
寤	wybk
鹉	woan
屣	xpur
穸	xibx
谿	xipk
猃	xxqa
缃	xlso
葙	xlco
哓	xnkw
虓	xnjj
蛸	xnio
獬	xoqn
伈	xmrx
脩	xqro
诩	xnyx
煊	xrhg
禤	xrpx
翾	xrsx
蚜	ysiy
轧	vsiv
怏	ygxy
恙	ygyx
泱	yhdy
峣	yvew
彝	yovc
弋	yuad
羿	yuxc
狺	ynqk
鄞	ynne
愔	ybxo
氤	ybqd
瘿	yabn
膺	ykgo
猷	yxbq
竽	ybvy
腴	yboy
谕	ycyd
予	ybsl
塬	yttx
掾	yefu
垸	yete
狁	yiqe
慥	zxxz
迮	zrzv
缯	zgso
栅	ujmc
璋	vhwu
笊	vxvv
蜇	vrfi
柘	vwmu
赈	vdkn
侦	vfrr
埴	votq
桎	vumt
豸	vupp
轾	vuit
稙	vihq
畤	vutc
踵	vfzv
舯	vsvv
妯	vxny
胄	vmyo
荮	vmcc
柷	vyme
贮	vyka
瞩	vooy
麈	vogv
侏	vurv
橥	vuqm
竺	vive
啭	vekv
晫	vpou
孜	zizw
驺	zzme
镞	ziju
诅	zoyq
怍	zixv
叨	dvkd
拤	qcfb
炘	xbhj
蜚	frfi
嘌	pbkx
镪	qlji
垯	datz
崀	lgel
硊	hcuv
崾	yxen
砹	auux
蔼	apcv
锿	aijy
鹌	andn
璈	apww
聱	apfe
遨	apzw
鏊	aifj
攽	bjbw
癍	bjbw
塝	bgtf
蚌	bfif
雹	bvys
鸨	bbbn
碚	bquk
鞴	bqgy
庳	bugu
坌	bdbt
畚	bhst
荸	bocz
嬖	buun
苾	bucb
妣	bpnb
舭	bpvb
贲	bfur
睥	puou
砭	bmuf
笾	bmvz
摈	bvfb
殡	bvdb
玢	ffwd
菠	bocy
擘	biuu
醭	biyn
骖	cjmp
螬	cvio
涔	cgdv
𥻗	ismd
侘	ilrq
诧	ilyq
潺	ikdz
躔	ikzt
羼	ihuy
襜	ijpk
伥	ihri
阊	ihmo
怊	icxk
忱	igxv
谌	igyv
棽	ifmv
棽	ufmv
惩	ihix
酲	ihyw
澄	dfda
漦	iowu
茌	iocu
褫	ippj
笞	iivk
艟	isvl
漴	iddx
畴	ixtc
帱	ixjc
滁	iidh
憷	iyxr
搐	iyft
础	ioui
圌	ibke
惙	iixy
匆	csbd
猝	cyqu
漼	cndf
溚	dsdk
轪	dsid
迨	dszk
殚	djdl
眈	djov
箪	djvl
澹	tkdk
垱	dgte
宕	dgbu
忉	dcxd
磴	dfua
玓	duwu
缔	dusj
诋	dpyd
柢	dpmd
扂	dnhk
琔	dnwr
癜	dnby
佃	dnrt
窎	dbbn
铫	yvjd
堞	dqtm
牒	dqpm
绖	dqst
蹀	dqzm
楪	dqmm
仃	dkrd
耵	dked
胨	daod
垌	datk
侗	dark
煅	dehy
蹾	dyzw
峨	erew
轭	ewiv
遏	ewzv
咡	eeke
耏	etep
垡	fsrt
砝	fdus
蘩	fkcx
畈	fhty
繁	pppx
枋	fhmf
悱	frxf
芾	ficl
偾	fdrr
烽	fghf
涪	fidk
祓	fipd
绋	fisf
蚨	fiif
蜉	fiiz
咐	fykc
赙	fykc
拊	fofc
黼	foyf
趺	fuzf
鄜	fuge
脯	foof
戤	gsng
澉	gldw
鳡	glax
玕	gjwg
酐	gjyg
堽	ghtv
锆	gxjk
篙	gcvk
饹	geuk
绠	gjsg
蚣	gsis
岣	gcek
篝	gzvr
鞲	gzgr
崮	gyek
梏	gymk
牿	gynk
榖	gouy
瀔	gody
酤	guyk
坬	gztg
夬	gjvn
筦	gyve
莞	gyce
洸	gldw
妫	gvnw
珪	gvwt
皈	gvby
桧	gcms
鳜	gcar
帼	gpjy
馘	gpba
聒	goek
蝈	goiy
醢	hgym
垾	hhtg
扞	hhfg
撖	hhfw
暵	hhon
淏	hxdt
涸	hrdk
龢	hrrh
熇	hwhk
竑	hdls
翃	hdux
篌	hxvu
垕	hmpt
鲘	hmak
醐	hiyo
鹕	hiun
浒	xndw
铧	hcju
峘	hteg
漶	hedx
湟	hadw
璜	hawb
癀	habb
簧	havb
锽	hajw
隍	haew
诙	hvyh
阍	hymo
笈	jovj
悸	juxz
穄	juhx
觊	juee
剞	jidd
芨	jicj
荠	qocl
觭	jidk
郏	jcje
跏	jxzk
袷	qxpk
毽	jnmz
腱	jnoz
翦	jxbx
谫	jxyd
搛	jmfn
缣	jmsn
鲣	jmat
糨	jkmi
噍	jbkh
漖	jbdw
藠	jbcb
檞	jwmn
湝	jpdb
拮	jqfk
颉	xqur
妗	jvnv
祲	jvpy
缙	jvso
荩	jvcd
馑	jmua
迳	jjzg
憬	jaxx
阱	jaej
岠	jcej
窭	jcbn
醵	jcyu
榉	jnml
龃	jnvq
娵	jvny
疽	jvbq
苴	jvcq
枸	gcmk
岨	jveq
鄄	jexe
蠲	jrbi
垲	kgtj
闿	kgmj
忾	ksxq
钪	kgjj
栲	kbmv
缂	kwsg
牁	kepk
裉	kdpg
绔	kysk
姱	kxnk
郐	kjre
鲙	kjas
蒯	kacd
睽	kbot
逵	kbzt
馗	kbjz
愦	kcxr
馈	kcur
跬	knzt
裈	kypi
鹍	kyon
旯	lsoj
镴	lljv
赉	lslr
褴	lkpm
襕	lkpj
谰	lkyj
镧	lkjj
缆	llse
稂	ljhl
锒	ljjl
塱	lkdt
烺	lkhl
泐	lwdl
檑	lemt
儡	lrrt
礌	leut
嫠	lown
鹂	loln
黧	lohh
苈	lucl
荔	lucl
詈	lusk
雳	luyl
澧	lpda
疠	lubw
楝	lnmj
墚	latm
椋	lamx
燎	lzhx
钌	lzjl
漻	lmdp
趔	lotd
躐	lozv
粼	lnmv
遴	lnzl
檩	lmmx
棂	llmh
舲	llvs
酃	llye
浏	lwdd
镏	lwjt
锍	lejv
眬	ldol
琭	lywu
蕗	lyck
榈	lbmk
碌	lpuu
滦	ltdm
囵	lukb
纶	grsb
雒	liwf
杩	mlmm
荬	mgcd
鬘	mkay
镘	mhjy
漭	mkdc
牦	mvnm
瑁	mxwo
嵋	meeo
楣	memo
鹛	mevn
浼	mrdv
钔	mgjm
醾	moym
糜	megm
娩	mxnv
腼	mxom
愍	mmmx
湣	mmdo
瞑	mlob
酩	mayk
侔	mxrn
仫	myrm
𧿹	mozm
蝻	nlig
曩	nkoy
铙	nvjw
怩	noxb
猊	noqe
铌	nojb
麑	noge
埝	nntx
陧	noet
搦	nifd
讴	ouyx
筢	psvb
蒎	pscn
槃	pkvm
蟠	pkit
襻	phpu
抨	pgfp
郫	pope
砒	piub
仳	pprb
纰	pisb
殍	pzdz
俜	pkrv
钷	pqjk
钋	pojb
镤	pijn
镨	pojo
埔	bytf
朴	pimb
芪	qocu
锜	qojk
跂	qozy
踦	ypzk
圻	qotj
掮	qzfo
岍	qmek
愆	qmix
搴	qmbu
杄	qmmq
汧	qmdk
锖	qljo
戗	qkrg
憔	qmxh
诮	qbyo
悄	qzxo
伽	qqrk
檎	qnmd
庼	qagr
圊	qkko
鲭	qkao
邛	qdge
犰	qwqj
虬	qwiv
赇	qwkq
萩	qqch
鞧	qqgy
灈	qbdf
璩	qbwu
蘧	qbcz
蠼	qbiy
鼩	qbjk
阒	qcmq
蛐	qviq
躯	qvux
筌	qtvw
辁	qtiw
炔	qthg
埆	qrty
轫	rdir
荏	rhcr
嚅	rike
嬬	rine
孺	rize
溽	rydc
缛	rysc
蕤	rbcu
蚋	rcin
磉	skum
埽	sxtj
铩	uajm
舢	ujve
钐	uhjp
绱	ugsk
晌	ukok
劭	uxdl
艄	ucvo
矧	uhuy
屾	ufee
甡	ufuu
诜	ufye
鲹	ufap
甥	ugul
陞	uget
筮	uuvr
贳	uuur
铈	uujj
酾	uiyl
狩	umqc
绶	umsy
戍	uywd
孀	ulno
楯	uimo
妁	uinu
搠	uifo
蒴	uico
涘	sudu
缌	sisx
虒	sipj
讼	says
忪	ssxs
螋	sziy
锼	szjy
擞	scfw
愫	syxx
簌	syvr
窣	subu
荪	sycx
飧	syxl
睃	soow
羧	soyw
挲	sodu
溻	tadx
褟	tapx
趿	tazj
沓	dsuo
炱	tfsh
薹	tfct
袒	tlpd
螳	tjit
鄌	tjge
镗	thjt
绹	tvsf
滔	tcdj
鳀	toar
倜	turk
趯	tutf
黇	tmck
瑱	tnwb
蜩	tmik
鲦	tmam
鲖	tdak
橦	tdml
烔	tdhk
酴	tiyh
堍	tytd
菟	tycd
橐	tpam
酡	tpyb
鼍	tpkd
柁	tpmb
畖	watg
畹	wltv
涴	yrdv
箢	yrvv
辋	wkiw
尪	whyw
桅	wemv
煟	wqho
娓	wrnm
硙	wquj
圩	xvty
芠	wgcw
刎	whwd
紊	whwx
郚	wiwe
婺	wysn
屼	wyew
痦	wybk
骛	wysm
妩	wonw
怃	woxw
觋	xoge
绤	xusk
饩	xuuq
俙	xirj
樨	ximn
牺	xinx
舾	xivx
郗	xixe
鼷	xijd
恓	xixx
傒	xird
暿	xiok
狎	xcqj
痫	xzbm
苋	xnce
狝	xxqx
筅	xxve
跣	xxze
暹	xmzf
纤	qnsq
洨	xmdx
淆	xmdo
哮	xbkz
猇	xnqj
翛	xnrx
敩	xbxw
撷	xqfr
渫	xodm
燮	xohy
绁	xosu
薤	xocj
絜	jqfx
饧	xlup
骍	xkmu
汹	xsdk
夐	xadw
貅	xqvm
馐	xqui
洫	xcdx
衒	xeii
恂	xuxo
徇	xtio
汛	xtdu
郇	xube
堐	ystt
砑	yluy
迓	ylzy
桠	yamy
筵	ykvz
谳	yhyq
俨	ylry
弇	ylrc
沇	ylde
胭	yjod
剡	uhhd
歅	ybxr
垟	yjty
徉	yjiy
飏	yjjp
羕	ygyy
徭	yvif
珧	yvwd
繇	yxpx
揶	yrfe
圯	yots
饴	youk
屹	yueq
悒	yuxb
瘗	yubt
翌	yuxl
旖	ypfk
舣	ypvy
钇	ypjv
洢	yidy
佚	yuru
垠	yntg
蚓	ymiy
喑	ybko
堙	ybtt
蟫	yniu
窨	yvbo
撄	ykfn
颙	ydyr
臃	ysof
邕	ysvb
佣	yary
莸	yxcy
卣	ycla
羑	ycyj
嵎	ybey
舁	ybjc
觎	ybre
蜮	ycia
遹	yczk
鬻	ycgl
圄	ynkk
辕	ytiy
薳	wrcz
瀹	yrdc
妘	yuns
鋆	yutj
韫	ytwm
缊	ytsm
臜	zaor
瓒	zhwr
糌	zjmo
牂	zhpy
璪	zbwm
舴	zrvv
罾	zgso
砟	vduv
仉	vkrj
漳	vhdu
獐	vhqu
召	uxdk
蔗	vwch
瑧	vfwh
蓁	vfch
钲	vgjv
絷	vofx
帙	vuju
帜	vujb
梽	vumx
贽	vufr
沚	vpdv
柊	vsmd
瘃	vibn
舳	vivy
躅	vizi
洙	vudv
挝	wofz
缒	vcsz
倬	voru
涿	vodn
琢	zpwn
孳	zibz
赀	zivr
偬	zfrx
综	zfsx
鄹	zzee
陬	zzey
缵	zysr
躜	zrzr
捽	zpfu
柞	zimv
玡	yswy
戛	gaag
涫	gedk
嫚	mjny
坬	watg
叚	xcvy
陴	poeu
锪	hojx
禔	vipr
漴	uldx
藦	mpcu
啊	aakk
啊	askk
啊	adkk
啊	alkk
阿	eeek
捱	aoft
毐	apuw
唉	aiku
嗳	aiky
荌	abcn
垵	aztn
揞	azfo
𩽾	anan
盦	anrm
廒	apgw
翱	apbx
鏖	apgj
骜	apfm
垇	aita
媪	aqnm
嶅	apfe
嶅	aife
熬	aofh
拗	aqfl
凹	wala
奥	ycpd
隩	aied
隩	yced
妭	bsnd
胈	bsod
菝	bscd
魃	bsgd
朳	bamb
羓	bayb
蚆	baib
把	blfb
吧	bakb
鲃	blab
罢	bass
罢	poss
㞎	bdub
㞎	fiub
㞎	psub
钯	psjb
扒	psfb
捭	bgfu
柏	bimb
靽	bhgb
昄	bloy
粄	blmy
𨭉	bjwj
瘢	bjby
般	bovy
般	pkvy
湴	bhdy
湴	pkdy
拌	phfb
玤	bgwf
蒡	bgcf
𠳐	bhke
榜	bgmf
膀	pjof
搒	bgff
搒	phff
棓	bgmk
棓	pcmk
棓	bqmk
棓	bwmk
孢	bczs
趵	bxzu
趵	bozu
薄	bpcc
薄	bicc
枹	fims
暴	pyou
惫	bqwx
琲	bqwf
糒	bqmy
鐾	bquj
鞁	bqgy
鹎	bwpn
呗	bskr
北	bqlb
庳	bwgu
庳	pogu
孛	bpuz
被	pipy
椑	bwmu
椑	pomu
陂	bwey
陂	poey
倴	bdrc
栟	bkmk
坋	bdtd
坋	fdtd
揼	bffu
琫	bjwl
祊	bgpf
祊	fhpf
佖	burb
坒	bubt
愎	buxw
狴	buqt
珌	buwb
皕	bubb
筚	buvu
萆	bucu
觱	buxy
诐	buyy
跸	buzu
邲	bube
铋	bujb
馝	buhb
沘	bpdb
秕	bphb
屄	biub
鲾	biat
臂	bwuo
贲	buur
芘	bucb
芘	pocb
裨	bupu
裨	popu
濞	pudl
睥	buou
𨚕	bnse
忭	bnxb
抃	bnfb
汴	bndb
碥	bxuc
褊	bxpc
萹	bmcc
鳊	bmac
便	pzrg
儦	bnrh
幖	bnjx
瀌	bndh
熛	bnhx
猋	bnqq
瘭	bnbx
脿	bnoy
蔈	bncx
镳	bnjh
髟	bnap
摽	bnfx
藨	bnch
藨	pcch
别	bokd
瘪	bpbb
傧	bbrb
邠	bbbe
镔	bbjb
槟	bbmb
槟	bkmb
玢	bbwd
抦	bafb
昺	baob
邴	babe
仌	bkrr
蛃	bkib
并	bkbk
欂	bpmc
浡	bpdz
礴	bpuc
袯	bppd
踣	bpzk
镈	bpjc
馞	bphz
鹁	bpun
檗	bium
嶓	boet
癶	bovn
饽	bouz
鲌	blab
擘	bduu
伯	blrb
勃	bqul
簸	bivy
桲	bpmz
桲	pomz
蔀	byce
簿	bpvc
不	fcad
嚓	iakx
啋	cgkm
偲	sirx
䅟	clhp
参	ufsp
参	cfsp
参	sjsp
喰	cjkl
喰	sykl
喰	qikl
鸧	chrn
伧	ifrv
𥕢	cvuo
肏	cxrr
恻	cwxd
侧	zwrd
侧	vdrd
噌	igko
嵖	ised
衩	ilpi
蹅	idzd
锸	iajj
碴	iaud
杈	ilmi
叉	isyd
差	ciyg
虿	iswi
拆	cafi
瘥	isbg
瘥	cpbg
茝	igcl
茝	vpcl
巉	iked
廛	ikgt
澶	ikdd
瀍	ikdt
镵	ikjd
韂	ihgk
冁	ilbn
旵	iloe
蒇	ilcr
骣	ilmz
觇	ijle
辿	ijze
孱	chuz
儳	ikrd
儳	ihrd
刬	iljd
掺	xmfp
掺	chfp
掺	ulfp
梴	ijmz
梴	ykmz
颤	vhwr
嫦	ijnj
徜	ijik
苌	ijci
鲿	ijas
氅	ikxm
厂	anap
厂	hhap
场	ijtp
倡	ihro
裳	ijxy
惝	ikxk
惝	tkxk
玚	igwp
耖	ixlu
弨	icgk
吵	icku
嘲	vcko
㬚	iwow
唓	ieki
砗	ieui
車	ieal
車	jval
车	jval
煁	ighv
莀	igcn
榇	idmm
疢	idbh
龀	idvb
梣	igmv
梣	cgmv
谌	udyv
塍	ihot
枨	ihmi
珵	ihww
珹	ihwi
铖	ihji
庱	ijgw
柽	igmt
瞠	igot
赪	igtr
偁	igrr
偁	idrr
称	ifhx
裎	ijpw
牚	igxy
牚	ifxy
憕	ihxa
憕	dfxa
憕	vfxa
㨃	ihfz
㨃	dnfz
乘	ufqn
墀	iotn
篪	iovj
踟	iozk
傺	iurx
啻	iuwk
瘛	iubx
侈	iprx
胣	ipoy
媸	iini
摛	iifd
瓻	iixw
眵	iiox
鸱	iidn
黐	iihd
尺	itun
㳘	isde
忡	isxv
摏	isfj
珫	iswe
冲	iadv
埫	iftk
埫	uktk
漴	vkdx
俦	ixrc
踌	ixzc
犨	izrn
䌷	izsy
䌷	ixsy
帱	dxjc
裯	ixpk
裯	dcpk
梼	ixmc
梼	dxmc
臭	xpzq
椆	ixmk
椆	vmmk
椆	dnmk
刍	iide
蜍	iiih
蹰	iizc
躇	iizo
斶	iyji
濋	iodr
䢺	iuie
摴	iufk
㤘	iyxe
㤘	cyxe
㤘	vmxe
俶	tury
揣	ttfe
揣	vvfe
巛	irvv
圌	itke
堾	iyto
堾	iyto
噇	iakl
倕	ibri
棰	ibmi
陲	ibei
瑃	iywo
䏝	iuov
䏝	vyov
淳	vydz
逴	iozu
绰	icsu
啜	ijky
惙	icxy
鹚	cobn
佽	curr
莿	cucd
刺	ciad
玼	ciwb
玼	cpwb
跐	cpzb
悰	cdxx
淙	cddx
骢	csmx
从	zarr
熜	cshx
熜	zfhx
腠	cmot
麤	cugb
蹴	jqzy
镩	crji
悴	ccxu
榱	cvmy
漼	cvdf
啐	qiku
缞	svsy
缞	uksy
膥	cymr
嵯	cpeg
莝	cict
瑳	cowg
酂	cpne
酂	zhne
𫟼	dsjz
垯	dstz
炟	dshd
笪	dsvd
荙	dscz
跶	dszz
靼	dsgd
瘩	dsbk
答	davk
打	dsfd
大	dsun
大	tsun
溚	tddk
叇	dsez
垈	dsrt
甙	dsyg
呔	tgkt
憺	dhxk
萏	dhcj
赕	dlkh
妉	djnv
聃	djer
郸	djbe
惮	dhxl
惮	dsxl
疸	dlbd
疸	dabd
瘅	dhbl
瘅	djbl
亶	dlwd
亶	dhwd
儋	djrk
儋	dhrk
担	dlfd
掸	uhfl
单	uhbl
单	ikbl
砀	dgup
菪	dgcu
挡	dgfe
祷	dbpc
舠	dcvd
鱽	dcad
焘	dxfh
嘚	dwkc
得	dric
的	dobu
的	dubu
璒	dgwa
觌	doue
镝	dojk
髢	doay
𤧛	duwj
䗖	duij
俤	durp
碲	duuj
禘	dupj
踶	duzr
啲	diku
羝	diyd
鞮	digr
坻	dptd
坻	iotd
柢	iomd
棣	dsmn
棣	tumn
底	degd
氐	diud
杕	dumd
杕	dimd
媂	dunj
媂	tonj
遆	duzj
遆	tozj
弟	tubp
弟	tbbp
蹢	dozk
蹢	vozk
坫	dntk
玷	dnwk
磹	dnuu
佃	tzrt
钿	tzjt
甸	tzbt
甸	ufbt
阽	dnek
阽	ykek
屌	dzuj
汈	dndd
铫	dbjd
铫	tmjd
䏲	dqop
垤	dqtt
瓞	dqgu
哋	doky
哋	duky
咥	dqkt
咥	xikt
楪	ywmm
昳	yuou
喋	vskm
萣	djcr
酊	dayd
丁	vgal
恫	daxk
岽	dsed
鸫	dsdn
垌	tdtk
侗	tdrk
侗	tfrk
唞	dxku
都	dule
髑	digi
黩	dihd
芏	dyct
厾	duvs
毒	dsfm
渎	dmdd
读	dmyd
阇	urmo
塅	dety
瑖	dewy
簖	devj
耑	vree
祋	dcpy
镦	dvjw
兑	rcbe
兑	yrbe
砘	dtut
蹲	cuzc
顿	ditr
敦	dcww
沌	vedt
饳	diui
亸	dqwl
㙍	doty
剟	doyd
掇	dofy
裰	dopy
垛	ditm
堕	hvet
喥	dpky
喥	vlky
𥔲	ewuk
崿	ewek
锷	ewjk
堨	ewtv
堨	autv
堨	ywtv
恶	wyyx
恶	etyx
恶	wuyx
姶	ewnk
姶	ylnk
阏	ewmd
阏	yjmd
蛾	ypiw
欸	eisr
欸	eusr
诶	eiyu
诶	eoyu
诶	epyu
诶	euyu
诶	xiyu
奀	enbd
陑	etee
鲕	etae
鸸	eten
耏	nsep
佴	eere
佴	nsre
墦	fktt
蹯	fkzt
氾	fhdv
噃	fjkt
噃	bokt
蕃	fjct
蕃	fkct
肪	fjof
牥	fhnf
邡	fhfe
钫	fhjf
蚄	fhif
蚄	bgif
枋	bjmf
房	pjhf
剕	fqfd
镄	fqjr
棐	frfm
榧	frmf
篚	frvf
蜚	fwfi
鲱	fwaf
痱	febf
斐	fwfw
芾	fqcl
朏	froi
朏	kuoi
妃	pqnj
𣸣	fgdr
棼	fgmd
豮	fgur
鼢	fgjd
瀵	fddb
瞓	fdoi
吩	ffkd
翂	ffxd
份	bbrd
赗	ffko
唪	fjkl
凨	fgjs
凬	fgjo
堼	fgtt
崶	fgec
沨	fgdx
砜	fgux
风	fjjx
浲	fhdf
浲	hddf
冯	pldm
佛	firf
佛	burf
佛	bprf
幞	fijn
怫	fixf
绂	fisd
艴	fifb
茀	ficf
菔	ficy
袱	fipq
郛	fipe
韨	fiwd
㳇	fydx
蝮	fyiw
讣	fyyb
鲋	fyac
滏	foda
簠	fovm
玞	fuwf
砆	fuuf
稃	fuhz
跗	fuzc
拂	buff
服	fyoy
洑	fidq
洑	fydq
琈	fiwz
琈	fuwz
父	fobx
夫	fian
榑	fimc
榑	fymc
榑	bpmc
䓛	foci
䓛	goci
䓛	qvci
呒	fokw
副	puad
莩	ficz
莩	pzcz
脯	poof
㕮	fokx
㕮	tbkx
嘎	gdkg
晐	gdor
荄	gdcr
陔	gder
盖	hrym
㽏	ghdg
骭	ghgg
橄	glmw
坩	gjtg
泔	gjdg
疳	gjbg
矸	gjug
旰	ghog
旰	hhog
筻	ggvg
㭎	ghmx
杠	ghmg
钢	ggjx
港	jsds
矼	qlug
矼	kaug
戆	gglx
筶	gxvk
藁	gbcm
槔	gcmu
膏	gxwo
镐	hxjk
皋	hvbu
塥	grtl
槅	grml
滆	grdl
骼	grgk
虼	gwiq
嗰	gtkk
个	gtrl
各	gtwk
搁	grfk
胳	grok
蛤	grik
革	jonl
哿	gtlk
哿	jxlk
镉	lujl
鬲	gral
鬲	lual
疙	yubq
给	jpsk
哏	hhkg
浭	ggdg
畊	ggtj
鹒	gggn
更	ggan
珙	gfwb
䢼	gsce
共	gscb
供	garb
唝	gakr
唝	gfkr
蚣	vsis
媾	gmnr
遘	gmzr
雊	gmbf
玽	gcwk
笱	gcvk
耇	gclk
缑	gzsu
姤	dynk
勾	gmbs
芶	gzcs
芶	gccs
佝	gzrk
佝	kmrk
堌	gytk
痼	gybk
鲴	gyak
𦙶	gook
瞽	gouo
罟	gosk
羖	goyy
臌	gooy
馉	gouo
巭	gugf
蓇	guco
轱	guik
鸪	guun
骨	gulo
估	gyrk
鹘	gogn
嘏	gouy
嘏	jvuy
汩	ycdo
谷	ycbk
啩	gzkb
诖	gzyt
鸹	gxqn
呱	gvkg
栝	gxmk
栝	txmk
栝	kimk
爟	gehf
瓘	gewf
盥	gepm
鳤	gyak
涫	grdk
蒄	grcc
鳏	grad
观	geye
莞	grce
毌	wjva
広	gsgs
犷	gsqg
垙	gltw
珖	glww
广	andi
桄	glmw
桄	gkmw
刽	gcrd
攰	gcul
筀	gcvt
匦	gnkj
姽	gnnv
宄	gnbj
晷	gnok
邽	gvte
鬶	gvfl
桧	hcms
氿	gndj
柜	jnmj
鳜	jyar
龟	jydv
龟	qqdv
眭	gcot
廆	gvgg
廆	wrgg
廆	hcgg
嶲	gvev
嶲	xiev
嶲	jeev
鲑	xqat
磙	giuy
棍	htmb
掴	gpfy
虢	gppj
椁	gqmz
菓	gqcg
埚	gotn
崞	goez
过	gozc
过	gozc
哈	hdkk
哈	hlkk
铪	kejk
胲	hgor
嗨	hwkm
崡	hkek
嵅	hkek
浛	hkdk
琀	hkwk
虷	hkig
邗	hkge
邯	hkge
蔊	hhcg
顸	hjgr
犴	hjqg
犴	abqg
汗	hkdg
㘎	hlkw
㘎	hhkw
颃	hjwr
夯	bddl
行	hhii
行	hgii
侴	hxrd
恏	hxnx
皞	hxbu
鄗	hxwe
颢	hxor
嚆	hckk
号	hvkv
劾	hrwl
姀	hrnh
盉	hrhm
盍	hrtm
阂	hrmr
鹖	hron
龁	hrvq
垎	hwtk
翯	hwxk
呵	aakk
呵	kekk
颌	grrr
合	gtrk
纥	hrsq
纥	gesq
貉	hvvk
貉	mivk
何	herk
何	hwrk
和	hwhk
和	hphk
和	hihk
和	hihk
喝	hwkv
喝	ywkv
熇	xnhk
嘿	mikh
桁	hjmi
亨	pgwl
𫟹	hdjb
玒	hdwg
硔	hdub
荭	hdcg
谼	hdbb
蕻	hacb
讧	hayg
訇	hsbk
红	gssg
哄	hskb
哄	hakb
瘊	hxbu
郈	hmpe
犼	hcqv
吽	hckn
吽	oukn
侯	hmru
囫	hikw
猢	hiqo
瑚	hiwo
縠	hiuy
觳	hiuy
冱	hydh
嫭	hynh
嫮	hynk
岵	hyek
扈	hyhb
昈	hyoh
祜	hypk
鄠	hyye
鳠	hyay
鹱	hyny
琥	howj
昒	huow
淴	hudx
滹	hudh
轷	huih
鹄	gonn
鹄	hwnn
隺	hidf
隺	hwdf
唬	xzkj
骅	hcmu
嬅	hznl
化	hxrb
华	hzru
华	hxru
划	hzgd
划	hkgd
划	gigd
划	gqgd
觟	hzdt
觟	xodt
坏	pwtb
坏	pitb
坏	petb
澴	htdy
荁	htcg
萑	htcf
锾	htjy
鹮	htsn
擐	hefy
逭	hezk
㬊	hyoy
貆	htvg
貆	hrvg
嬛	htny
嬛	qdny
喤	hakw
媓	hanw
瑝	haww
磺	haub
艎	havw
蟥	haib
鳇	haaw
㿠	hkbw
滉	hkdw
潢	hadb
潢	gldb
晃	hsow
橞	hcmx
蟪	hcix
袆	hvpw
豗	hvwu
隳	diex
烠	hbho
烠	hnho
虺	hvwi
会	kjrs
睢	hvof
珲	hvwi
混	hudb
婫	htnb
婫	kynb
惛	hyxo
惛	mdxo
荤	xyci
佸	hprk
㸌	hihf
彟	hiey
蠖	hiiy
锪	hijx
劐	hocd
耠	holk
喐	hike
喐	gpke
喐	xcke
濩	hydy
豁	hibk
豁	hcbk
漷	hqde
漷	hide
漷	kide
嚄	hiky
嚄	oqky
伋	jorj
堲	jogt
姞	jonk
瘠	jobo
蒺	jocu
蹐	jozo
垍	jutz
惎	juqx
漈	judx
瀱	judd
稷	juhw
罽	jusd
跽	juzx
鲚	jual
嵴	jpeo
掎	jpfk
虮	jpij
鱾	jpaj
枅	jimk
犄	jink
畿	jiyt
跻	jizl
鹡	jidn
齑	jiwl
几	jipv
耤	jolo
耤	jolo
偈	jqrv
亟	qula
䓫	juck
䓫	qock
伎	qory
觭	qodk
稽	qpho
缉	qise
恝	jcfx
蛱	jcij
叚	jvvy
斝	jvku
槚	jvmr
袈	jxly
假	jzry
夹	jxan
夹	gaan
家	jxbu
家	jpbu
价	jorl
价	jprl
袷	jcpk
袷	jqpk
瘕	jvby
瘕	xcby
瘕	xxby
楗	jnmz
牮	jnrn
饯	jnuj
硷	jxua
裥	jxpo
趼	jxzk
锏	jxjo
瑊	jmwk
靬	jmgg
鞯	jmgz
鳒	jman
渐	jmdj
溅	jmdj
鞬	jngz
鞬	jmgz
篯	jxvj
篯	jmvj
监	jnlm
暕	jxoj
暕	lkoj
囝	jxkz
囝	njkz
犍	qznz
见	xnke
弶	jkgx
洚	jkdl
膙	jsoi
礓	jlua
茳	jlcg
豇	jlag
将	jkdc
浆	jkdu
疆	qaga
降	xael
嘦	jbkn
斠	jbau
皭	jbbc
佼	jzrx
敫	jzbw
璬	jzww
皦	jzbw
䴔	jnwn
僬	jnrh
峧	jnex
鹪	jnrn
剿	icvd
徼	jziw
筊	jzvx
筊	jbvx
脚	jyoe
角	jydy
嚼	jbkc
峤	jbel
峤	qmel
蕉	qmch
燋	jnhh
燋	qmhh
燋	jyhh
燋	vphh
艽	jncj
艽	qwcj
姣	xmnx
侥	yvrw
缴	vpsw
㛃	jqfn
劼	jqul
岊	jqbe
蜐	jqil
讦	jqyg
鲒	jqak
骱	jogl
毑	jwmy
秸	jphk
诘	joyk
拮	jcfk
结	jpsk
节	jqce
解	jodn
解	xodn
桔	jbmk
悈	joxc
悈	kwxc
揭	qufv
颉	jqur
颉	jcur
碣	jquv
碣	yluv
墐	jvta
殣	jvda
浕	jvdd
溍	jvdo
瑨	jvwo
赆	jvkd
卺	jmlv
堇	jbna
琎	jbwz
尽	jmid
仅	jvry
劲	jjvl
廑	jmga
廑	qnga
矜	qnsv
矜	grsv
瀞	jjdl
獍	jjqe
竫	jjll
丼	jaad
刭	javd
汫	jadj
澋	jadx
璥	jaww
䴖	jkfn
猄	jkqx
粳	jkmg
腈	jkoo
麖	jkgx
鼱	jkjo
净	igdl
景	yaox
䌹	jfsk
䐃	jfoh
囧	jfkv
泂	jfdk
颎	jfbr
坰	jstk
炅	gcoh
㠇	jpey
桕	jpmj
赳	jqtl
䴗	jbon
屦	jcun
澽	jcdu
犋	jcnb
秬	jchj
弆	jntc
筥	jnvk
踽	jnzy
崌	jvek
椐	jvmk
泃	jvdk
砠	jvuq
腒	jvok
锔	jvjk
鞫	jvgk
苴	iscq
拘	gzfk
据	jvfk
沮	jcdq
岨	jneq
苣	qncj
桊	jejm
罥	jeso
锩	jyjv
焆	jrho
焆	ywho
㵐	jydr
劂	jyid
桷	jymy
獗	jyqr
玃	jyqy
砄	jyug
觖	jydg
镢	jyjr
觉	jbxe
蹶	juzr
撅	jyfr
噱	jyku
晙	jtow
畯	jttw
葰	jtcw
皲	jyby
莙	jyck
鲪	jyak
隽	jtrn
麇	jygh
麇	qugh
浚	jtdw
浚	xtdw
佧	kdrb
咔	kdkb
咖	gakk
炌	kshl
剀	kged
蒈	kgcb
嘅	kgkv
嘅	gtkv
楷	jpmb
忾	xuxq
衎	khii
冚	klbe
戡	kjqg
嵁	kjev
嵁	vhev
伉	kgrj
𡐓	khtn
𩾌	khan
扛	ghfg
闶	kgmj
闶	khmj
洘	kbdv
洘	kxdv
溘	kwdm
锞	kwjg
骒	kwmg
稞	kehg
蚵	keik
咳	hdkr
苛	heck
可	kwdk
嗑	kekm
坷	ketk
坷	kttk
匼	kekk
匼	qzkk
剋	kwud
硍	kdug
硍	xnug
硍	giug
硍	ymug
硁	kgug
埪	kstg
崆	kseg
硿	ksug
倥	ksrg
倥	kfrg
空	kfbg
眍	kzox
芤	kzcv
堀	kuti
姱	hynk
挎	kufk
夸	kzdk
狯	kjqs
㧟	kafk
浍	kjds
纩	kksg
洭	kldw
戣	kbvg
暌	kbot
櫆	kbmu
骙	kbmt
篑	kcvr
聩	kcer
𫠆	knur
煃	knht
岿	kvee
匮	gckr
傀	knrg
傀	gvrg
溃	hcdr
蒉	kjcr
悝	kvxl
悝	lpxl
阃	kimm
崑	kyeb
醌	kyyb
髡	kyaw
廓	kige
蛞	kiik
括	gxfk
鞡	lagl
瘌	llbd
菈	lacl
剌	lsud
啦	lakl
拉	lsfl
腊	xioo
蜡	vlio
俫	lfrl
崃	lfel
梾	lfml
铼	lfjl
癞	llbr
徕	lsil
婪	lkmn
躝	lkzj
罱	llsg
啉	lkkm
桹	ljml
蒗	lgcl
㫰	lkol
㮾	lkdm
崀	lkel
朤	lkoo
蓢	lkco
筤	ljvl
筤	lgvl
郎	lgde
莨	lgcl
莨	lacl
铹	lvjl
嫪	lxnp
耢	lxll
咾	lbkb
荖	lbcb
潦	lbdx
潦	lxdx
玏	lwwl
砳	lwuu
了	lzvl
乐	yrpd
乐	yxpd
乐	lxpd
嫘	lenx
缧	lesx
癗	lrbt
藟	lrct
嘞	lekl
肋	leol
礌	lrut
累	lrtx
堎	lftw
棱	llmw
㰀	lomu
嚟	loku
漓	lodd
鲡	loal
傈	lurm
凓	ludm
坜	lutl
朸	luml
浰	ludd
溧	ludm
猁	luqd
珕	luwl
疬	lubl
篥	luvm
粝	lumw
蜊	luid
轹	luil
峛	lped
浬	lpdl
逦	lpzl
鳢	lpaa
砬	luul
砬	laul
砬	lsul
疠	lsbw
丽	load
哩	lpkl
跞	lizl
釐	lowl
釐	xpwl
栎	yrml
郦	vole
裢	lzpz
殓	lnda
潋	lndw
瑓	lnwj
蔹	lxcw
裣	lxpa
梿	lzmz
梿	lxmz
磏	lzun
磏	qmun
𫟅	lasx
俍	larl
辌	laix
悢	lkxl
倞	lkrx
倞	jjrx
凉	lkdx
踉	lazl
踉	lkzl
嫽	lmnx
敹	lmlw
橑	lmmx
簝	lmvx
鹩	lman
镣	lbjx
憭	lzxx
憭	lmxx
瞭	lzox
钌	lbjl
漻	lwdp
蓼	lycp
䴕	lodn
脟	looc
裂	lwdy
咧	lpkd
咧	lqkd
咧	lpkd
冧	lnbm
嶙	lnel
潾	lndl
瞵	lnol
粦	lnml
翷	lnmx
辚	lnil
膦	lvol
廪	lmgx
箖	lnvm
箖	lmvm
〇	llvv
㥄	llxw
呤	llks
囹	llks
坽	llts
姈	llns
昤	llos
柃	llms
澪	llds
瓴	llrw
祾	llpw
鲮	llaw
崚	llew
岭	lles
令	llrs
令	lars
旒	lwfv
瑠	lwwt
瑬	lwdy
疁	lwtp
镠	lwjp
飗	lwjt
鹠	lwpn
鹨	lpxn
珋	lewe
罶	lest
馏	lput
馏	lwut
六	lywb
咯	lokk
咯	likk
咯	gekk
昽	ldol
漋	lddu
癃	ldbu
砻	ldlu
哢	lakc
垅	lftl
笼	lfvl
尨	ldud
尨	mhud
尨	pjud
剅	lxad
溇	lxdn
蝼	lxin
喽	lxkn
露	lyyk
栌	limu
轳	liiu
鸬	liln
僇	lyrp
勠	lyxl
稑	lyht
箓	lyvu
菉	lycu
赂	lykk
辂	lyik
逯	lyzu
氇	lomo
澛	lodo
垏	lcty
梠	lnmk
稆	lnhk
膂	lnfo
褛	lnpn
偻	lxrn
绿	lysu
脔	ltwr
銮	ltwj
抡	lufb
攞	lpff
脶	lpon
倮	lqrg
蓏	lqcg
硌	liuk
络	lxsk
泺	podl
漯	lidx
漯	tldx
呣	mxkm
唛	mlkw
祃	mlpm
嘛	mskm
杩	mdmm
吗	mskm
吗	mdkm
蚂	maim
蚂	mlim
蟆	miid
埋	mktl
脉	mioy
谩	mkyy
墁	mhty
颟	mjcr
瞒	mgol
鞔	mkgv
鞔	mdgv
厖	mjid
杧	mjmw
牻	mjnd
硭	mjuw
蟒	mjic
楙	mvmm
茆	mvce
蝥	mvsi
眊	mxom
瞀	mxso
袤	mxwy
鄚	mxce
冇	mbuk
泖	mbde
旄	mvfm
旄	mxfm
芼	mvcm
芼	mxcm
猫	mvqt
冒	miko
么	mpps
么	maps
么	ycps
槑	mekm
瑂	mewo
郿	meve
镅	mejo
躾	mrud
没	midy
𫞩	mgwl
们	mgrm
㠓	mheu
幪	mhju
濛	mhdu
獴	mhqu
甍	mhcw
礞	mhuu
艨	mhvu
鹲	mhcn
擝	mgfm
氓	mhwm
瞢	mjco
蒙	mjcn
縻	mogx
嘧	muke
弭	mpge
洣	mpdm
渳	mpde
脒	mpom
泌	budb
祕	bupb
秘	buhb
沵	mpdx
沵	ludx
谜	mqyz
弥	mpgx
偭	mxrm
勔	mxml
愐	mxxm
湎	mxdm
眄	mxom
渑	mxdd
渑	uhdd
鹋	mmcn
杪	mzmu
搣	mofh
慜	mnpx
碈	mnuo
苠	mncm
鳘	mmpa
湣	hydo
黾	mxkd
黾	mjkd
玟	mnww
忞	mmwx
忞	whwx
蓂	mlcb
螟	mlib
尛	mpxx
耱	milu
藦	micu
貊	mivb
摩	magu
麽	megm
麽	magm
磨	migu
抹	mifm
莫	mycd
蛑	mxin
踎	mxzk
鍪	mxsj
缪	mpsp
缪	mysp
缪	lzsp
牟	mysn
毪	mimn
莯	mycm
姥	monb
嗱	nsku
镎	nsju
肭	nlon
雫	ndyx
那	ndve
那	nqve
那	nwve
那	npve
呐	nwkn
哪	nrke
哪	nake
哪	nrke
𦰡	nlce
𦰡	npce
迺	ngzx
婻	nhng
萳	nlcg
赧	nlty
南	naug
难	nhyf
难	npyf
囊	nhay
峱	nvqe
硇	nvux
蛲	nviw
臑	nxoe
垴	nbtk
嫐	nbnn
淖	iidu
淖	vodu
呢	nokb
内	nlld
恁	nnrx
能	nssb
嗯	egkx
𫠜	nove
鲵	noae
𨺙	nuee
氼	nuur
薿	npcr
妳	npnx
妳	ngnx
泥	nudb
婗	none
婗	npne
伲	nprb
伲	nurb
溺	nbdd
鲇	nzak
鲶	nzax
唸	nnkx
惗	nnxx
撚	nxfh
捻	npfx
粘	nzmk
嬢	nany
孃	nany
嬲	nztl
鸟	dzwd
苶	nqcx
嵲	noem
糵	nocm
臬	nozm
蹑	nozy
菍	nocx
菍	rhcx
狞	nlqd
聍	nled
泞	njdd
甯	nlby
拧	nlfd
拧	njfd
宁	vybd
狃	neqi
妞	hxni
孥	ninz
笯	nivy
傉	nyrc
砮	nonu
胬	nonr
恧	ncex
朒	ncor
朒	gdor
女	rova
疟	yxba
傩	nprf
喏	rtkk
哦	oikw
哦	erkw
喔	ookt
𠙶	oolk
沤	oudx
呕	oukx
呕	oykx
潖	psdb
舥	pavb
簰	pfvu
派	padn
排	pgff
丬	pkdl
蹒	pkzl
袢	phpb
柈	pkmb
柈	bhmb
磻	pkut
磻	bout
鳑	pjaf
膖	phoz
雱	phyf
旁	bgwf
彷	fkif
胖	pkob
胖	phob
炮	pvhs
炮	bchs
麃	pvgh
麃	bngh
跑	pvzs
锫	pejk
帔	pqjy
旆	pqfl
珮	pqwj
衃	pwxb
喷	pdkr
弸	phgo
蟛	phip
彭	bhup
堋	phto
堋	bfto
泙	pgdp
泙	pldp
鲏	poay
鼙	pouu
䴙	puun
媲	punb
澼	pudu
甓	puuw
嚭	ppuk
苉	ppce
狉	piqp
陴	pieu
吡	ppkb
淠	pqdl
埤	potu
铍	pijy
仳	porb
劈	ppud
纰	posb
纰	bpsb
潎	pudw
潎	ppdw
㛹	pzng
楩	pzmg
胼	pzok
蹁	pzzc
骈	pzmk
𡎚	pxtc
犏	pmnc
片	pmpv
薸	pmcx
嘌	pnkx
螵	pnix
骠	pbmx
嫖	pnnx
票	pnxx
缥	pzsx
玭	pnwb
牝	pvnb
榀	pmmk
频	bbvr
呯	plkp
帡	pljk
洴	pldk
玶	plwp
荓	plck
蚲	plip
涄	pkdv
砯	pkuu
屏	bauk
淜	pldo
淜	phdo
苹	pgcp
皤	ppbt
粕	pimb
笸	pqvk
哱	pikz
哱	bakz
酦	poyd
酦	fayd
迫	pgzb
魄	tibg
魄	bpbg
裒	pxwy
垺	pxtz
垺	fitz
掊	pcfk
掊	pxfk
墣	pitn
穙	pihn
蒱	picf
酺	piyf
氆	pomo
瀑	bxdu
朴	pomb
仆	purb
愭	qoxo
畦	qott
碁	qoqu
綦	qoqx
蛴	qoil
蜞	qoib
颀	qojr
鲯	qoab
汔	qudq
炁	quah
磜	quux
葺	quce
呇	qpuk
婍	qpnk
桤	qimj
郪	qiae
其	jiqb
奇	jidk
齐	juwl
齐	ziwl
齐	vdwl
岂	kgej
跂	qpzy
妻	quan
砌	qoud
契	qofd
契	xofd
槭	swmx
耆	uulo
栖	ximx
蹊	qizd
踦	qizk
圻	yntj
𨙸	qoue
𨙸	viue
拤	qvfb
葜	qxcd
墘	qztq
伣	qnre
椠	qnim
蒨	qnco
肷	qxor
圲	qmtq
褰	qmby
鹐	qmdn
乾	gjuq
浅	jmdj
嵌	kher
荨	qzcc
堑	zhit
堑	jnit
襁	qspi
镪	qsji
蜣	qliv
玱	qlwv
玱	chwv
蔃	qaci
蔃	jkci
跄	qlzv
跄	qkzv
抢	qlfv
抢	igfv
强	qsgi
强	jkgi
硚	qmul
鞒	qmgl
缲	qnsm
缲	scsm
鞘	ucgo
睄	qmoo
睄	uxoo
睄	xnoo
俏	xbro
癿	qqbv
茄	jxck
趄	qotq
趄	jvtq
且	jvla
郄	xuxe
嗪	qnkh
螓	qnih
锓	qmjy
嵚	qber
骎	qbmy
慬	jvxa
慬	jmxa
勍	qlwl
暒	qlou
碃	qjuo
靘	qjfb
苘	qack
郬	qkfe
箐	jkvo
綮	qphx
鲭	vgao
䓖	qdcl
筇	qdve
跫	qdgr
銎	qdgj
㞗	qwuq
訄	qwjk
鼽	qwzj
鹙	qqhn
湫	jzdh
蝤	yxiy
佢	qbrj
劬	qbbl
欋	qbmf
氍	qbom
癯	qbbf
磲	qbum
㭕	qvms
坥	qvtq
岖	qvex
胠	qvos
麹	qvfm
黢	qvhw
趣	cyty
趋	cyte
渠	jcdm
瞿	jcof
焌	qvhw
焌	jthw
竘	qnlk
竘	kclk
觑	qvhe
曲	qvla
朐	qbok
朐	xcok
朐	iiok
瑔	qtwu
鬈	qtav
鳈	qtau
畎	qytq
悛	qrxw
婘	qtnv
婘	jenv
棬	qrmv
棬	jemv
圈	jekv
圈	jrkv
券	xejd
悫	qrux
棤	qrmo
榷	qrmf
炔	gchg
傕	qrrf
埆	jyty
𨟠	qroe
𨟠	jyoe
𨟠	qroe
雀	qnuf
阙	qtmr
碏	qruo
碏	xiuo
逡	qyzw
䎃	rlrx
珃	rlwr
禳	rjpy
蘘	rjcy
瀼	rjdy
瀼	nkdy
儴	rjry
儴	xlry
荛	rvcw
桡	nvmw
娆	rbnw
忈	rgex
仞	rdrr
纴	rdsr
衽	rdpr
讱	rdyr
饪	rdur
稔	rhhx
任	rgrr
礽	rhpn
蝾	rdim
薷	rice
铷	rijk
颥	riyr
洳	rydk
蓐	rycc
堧	rttd
朊	ryoe
瓀	rywe
媆	rynd
媆	ndnd
枘	rcmn
汭	rcdn
挼	rpfn
叒	riyy
爇	rich
鄀	rice
婼	rink
婼	iink
若	rtck
撒	safw
洒	xpdx
嗮	sgkx
嘥	sdkr
塞	ssbt
塞	swbt
鳃	xpax
毵	sjsm
潵	shdw
溞	scdi
缫	scsg
埽	sbtj
骚	sbmi
璱	swwb
洓	swdn
洓	qudn
洓	zudn
色	ugdb
閪	semx
閪	ximx
㴔	swdx
㴔	yudx
唼	ulkn
歃	ulqr
嗄	askw
沙	uldu
煞	uadh
厦	xziw
墡	uhtk
嬗	uhnd
缮	uhsk
鄯	uhye
晱	uloh
搧	ujfx
潸	ujdo
羴	ujyy
芟	ujcy
跚	ujzc
杉	uamp
姗	uhnc
苫	ujck
苫	uhck
钐	ujjp
彡	ujpp
彡	xxpp
掞	uhfh
掞	yhfh
掞	ylfh
恦	ugxk
垧	uktk
上	ukla
玿	uvwk
筲	ucvo
杓	uvmu
梢	sxmo
柖	uvmk
柖	uxmk
少	uxxp
捎	uxfo
稍	uxho
滠	uwdy
猞	ueqk
奓	uedx
奓	ipdx
奓	vldx
摄	nofy
射	ywuc
射	yuuc
蛇	yoib
畬	uert
畬	ybrt
胂	udou
瞫	uhou
侁	ufre
娠	ufnn
沈	igdv
葚	udcv
葚	rdcv
甚	ugqv
莘	xbcu
嵊	ufen
琞	ufoy
眚	ujuo
湦	ugdu
焺	ughu
晟	ufoi
省	xauo
実	uobn
炻	uohu
祏	uopu
䏡	uuox
奭	uudb
昰	uuov
栻	uumg
襫	uupb
䴓	uian
浉	uidj
邿	uite
鲺	uiai
鸤	uiun
酾	udyl
拾	uwfk
什	ugru
食	surl
食	yurl
螫	uuti
螫	veti
识	vuyb
氏	vipv
倏	uurq
婌	uuny
摅	uufx
毹	uurm
琡	uuwy
鄃	uure
陎	uuev
熟	uiwh
数	uimw
术	uimd
术	vimd
澍	vydc
属	vouy
刷	uzud
衰	cvwy
腨	ueoe
灀	ukdo
礵	uluo
骦	ulmo
鹴	ulyn
帨	ucje
谁	ubyf
楯	dtmo
铄	uijl
硕	uour
说	ucye
说	yrye
亖	suee
汜	suds
耜	sulk
㟃	siek
凘	sidj
楒	simx
飔	sijx
鸶	sisn
伺	curk
俟	qoru
思	sdtx
𪨊	sdur
㧐	sffy
娀	ssnu
忪	vsxs
瞍	scoy
擞	smfw
傃	syrx
僳	syrm
玊	sywd
觫	sydu
蹜	syzb
骕	syms
鹔	sysn
苏	sycb
狻	srqw
𫟦	sciz
旞	scfz
璲	scwz
穟	schz
襚	scpz
荽	svcn
隋	dieo
孙	xtzx
溹	sidx
嗍	soko
桫	somu
惢	sqxx
惢	rnxx
挲	uadu
缩	sysb
遢	tlzx
阘	tlmx
鞳	tlgk
祂	tapy
嗒	tlkk
她	jwny
鲐	tfak
榃	tkmt
郯	tkhe
锬	tkjh
璮	tlwd
菼	tlch
钽	tljd
怹	tjrx
啴	tjkl
啴	tokl
惔	tkxh
惔	dhxh
覃	tkxu
倓	thrh
䣘	tjxe
樘	tjmt
螗	tjik
耥	tklk
镋	tkje
劏	thxd
羰	thyh
倘	ijrk
淌	ikdk
帑	tknj
帑	ninj
汤	uhdp
趟	thtk
铴	tgjp
铴	thjp
啕	tvkf
洮	tvdd
鼗	tvey
慆	tcxj
陶	yvef
忒	twyx
忒	twyx
䲢	thoa
熥	tghz
熥	tshz
媞	tonr
瑅	towr
薙	tucf
逖	tuzh
䴘	tipn
提	difr
提	dpfr
绨	tosp
醍	tpyr
体	tirb
趯	yrtf
禔	topr
禔	vppr
擿	tifz
擿	vufz
擿	vdfz
畋	tztw
畑	tzht
阗	tzmb
掭	tnfx
晪	txob
淟	txdb
觍	txqe
兲	tmwb
瑱	tzwb
瑱	vdwb
填	vdtb
笤	tmvk
迢	tmzk
髫	tmak
龆	tmvk
粜	tbim
嬥	tznf
朓	tzod
佻	tnrd
祧	tnpd
调	vzyk
苕	tmck
跳	tvzd
条	tnwm
窕	yvbd
䗴	tliz
葶	tlcd
圢	tatd
烶	tahz
颋	tarr
铤	djjz
町	tatd
渟	tldd
渟	tkdd
桯	tkmw
桯	ylmw
𦒍	tdlx
𫍣	tdyk
峂	tded
茼	tdck
㛚	tfny
橦	iaml
峒	tdek
峒	daek
烔	dahk
同	takk
穜	tdhl
穜	vfhl
僮	vkrl
头	tzdd
㻬	tiwk
腯	tioo
葖	tucq
梌	timh
梌	ismh
稌	tihh
稌	uohh
菟	ticd
吐	tykt
煓	trhe
猯	trqe
猯	teqe
魋	tbgf
氽	tiru
暾	tyow
焞	tyhz
坉	tutt
坉	dttt
屯	vyav
忳	tuxt
忳	vyxt
忳	dtxt
箨	tivl
萚	ticl
侂	torq
柁	dimb
拓	vofu
腽	wlom
佤	wdrw
瓦	wlad
哇	wakt
搲	wafg
搲	wdfg
搲	wlfg
喎	wdkk
呙	wdkn
呙	hrkn
呙	wqkn
呙	wakn
呙	gvkn
崴	wwen
芄	wkcw
卍	whvv
椀	wlmv
塆	wjtg
蜿	wjiv
万	miap
婠	wjnk
婠	wlnk
涴	wldv
涴	widv
妧	whne
宛	yrbv
箢	wlvv
菀	ytcv
菀	yccv
王	wgat
亡	wiwv
𣲗	wedw
峗	weev
洈	wedv
闱	wemw
螱	wqui
霨	wqyc
鳚	wqac
洧	wrdo
韪	wrow
溦	wwdw
烓	wwht
葳	wwcn
逶	wwzn
鳂	wwan
硊	wruv
硊	gcuv
隗	wreg
隗	kbeg
亹	wrwq
亹	mgwq
㧑	wefw
㧑	wrfw
碨	wrun
碨	wqun
委	wwhn
硙	weuj
硙	aouj
硙	gsuj
尾	ypum
琟	wewf
琟	ycwf
尉	ycuc
蔚	yccc
阌	wgmy
揾	wdfm
璺	wdpy
辒	wfim
鳁	wfam
汶	mgdw
纹	wdsw
榅	wfmm
榅	ytmm
蕹	wfcf
蓊	wjcx
滃	wjdx
滃	wgdx
偓	wirt
幄	wijt
莴	wocn
踒	wozn
斡	wiuu
斡	gyuu
倭	wwrn
峿	wiek
浯	widk
珸	wiwk
鋈	wydj
阢	wyee
靰	wygw
𣲘	wodw
仵	worw
牾	wonk
珷	wowv
迕	wozw
洿	wudk
芴	wycw
芴	hucw
无	mpay
旿	wyow
旿	woow
唔	wykk
吾	ycwk
铻	wijk
铻	ynjk
𠅤	xowx
喺	xokx
嶍	xoeb
隰	xoeh
鳛	xoab
係	xurx
卌	xual
禊	xupd
舄	xujh
阋	xume
憙	xpux
枲	xpsm
葸	xpcx
蓰	xpcr
僖	xirk
嚱	xikg
巇	xieg
熻	xihx
爔	xihd
睎	xioj
矽	xiux
肸	xiou
菥	xicj
螅	xiix
蟋	xiix
觿	xidk
豨	xiuj
酅	xiee
饻	xiuy
娭	xinu
娭	ainu
戏	huyg
盻	xuov
盻	plov
恓	qixx
恓	xcxx
歙	xirr
裼	xipw
裼	tupw
傒	xurd
暿	xpok
洗	xxde
䜣	xiyj
䜣	xbyj
䜣	ynyj
柙	xcmj
硖	xcuj
翈	xcjx
黠	xchk
罅	xzfh
呷	gakj
虾	haix
挦	xzfc
鹇	xzmn
㬎	xxoh
崄	xxea
燹	xxuh
禒	xxpu
忺	xmxr
籼	xmme
跹	xmzz
锨	xmjr
咁	xzkg
咁	gjkg
莶	xmca
莶	lxca
孅	xmnj
孅	qmnj
盷	xzod
盷	tzod
铣	xxje
伭	xzry
伭	xtry
县	xtqs
珦	xkwk
瓖	xlwy
相	xkmo
详	yjyy
咲	xbkt
涍	xbdz
婋	xnnj
蟏	xnis
魈	xngo
嚣	apkk
恔	xbxx
恔	jzxx
蛸	ucio
肖	xbxo
敩	xyxw
㙦	xqrt
勰	xqlx
缬	xqsr
𤫉	xowy
偰	xord
廨	xogn
榍	xomo
澥	xodn
瀣	xodj
薢	xocn
躞	xozy
揳	xpfd
嚡	xqkt
嚡	hfkt
挟	jxfj
絜	xqfx
些	sive
血	xrpm
邪	ysye
邪	yrye
邪	ybye
邪	xbye
泄	yudu
枔	xnmv
炘	xvhj
衅	xvxb
妡	xbnj
杺	xbmx
信	ufrk
镡	xnju
镡	tkju
镡	ikju
芯	xvcx
硎	xlud
钘	xljk
铏	xljd
陉	xleg
倖	xjrg
婞	xjng
悻	xjxg
瑆	xkwu
荥	xlcu
荥	ykcu
诇	xayk
讻	xsyk
夐	xedw
珛	xpwo
滫	xedo
髹	xqam
鸺	xqrn
休	xnrm
冔	xbky
垿	xctl
婿	xcno
昫	xcok
溆	xcdy
蓿	xccb
栩	xnmx
珝	xnwx
糈	xnmo
醑	xnyo
媭	xvpn
盱	xvoy
谞	xvyo
顼	xvwr
魆	xvgv
欻	ixhr
许	hoyw
砉	xvfu
砉	hxfu
嘘	uiky
旴	xcoy
旴	xvoy
湑	xndo
湑	xvdo
𫠊	xtmy
暶	xtor
痃	xtby
昡	xeoy
琄	xewo
碹	xeug
愃	xrxg
揎	xrfg
昍	xroo
晅	xrog
翧	xrbx
暅	xyog
暅	gfog
玹	xzwy
咺	xykg
咺	xrkg
峃	xyxe
茓	xycb
峋	xueo
栒	xumo
珣	xuwo
噀	xtkb
獯	xyqh
郇	htbe
熏	xtph
睚	ysot
揠	ylfn
玡	ylwy
蕥	ydcf
垭	yaty
吖	yaky
猰	ylqd
猰	jcqd
猰	qoqd
哑	yaky
呀	yaky
压	ylid
轧	gsiv
啱	ykku
琂	ykwk
虤	ykhj
蜒	ykiz
唁	yhkk
墕	yhth
烻	yhhz
觃	yhkz
兖	ylwe
厣	ylij
戭	ylbg
扊	ylhh
甗	ylhw
罨	ylsd
蝘	ylin
郾	ylke
黡	ylih
鼹	yljn
崦	yjed
恹	yjxq
漹	yjdh
埏	yktz
埏	ujtz
剡	ylhd
夵	yldx
夵	tcdx
研	yhuk
燕	yjnh
棪	ylmh
棪	yhmh
奄	yjdd
渰	yjdc
渰	yldc
咽	yjkd
咽	ywkd
歅	yjxr
湮	ybdt
炀	yjhp
疡	yjbp
蛘	yjiy
钖	yjjp
咉	ykky
仰	ajre
卬	ykpe
羊	xabl
烊	yghy
鞅	yhgy
鞅	yggy
媱	yvnf
滧	yvdw
猺	yvqf
轺	yvik
靿	yxgl
鹞	yxpn
崾	yben
窅	ybbo
要	ycxn
繇	yvpx
繇	vmpx
铘	yrje
馌	ywum
嘢	ytkl
埜	ytmt
倻	yere
吔	yeky
掖	yefn
匜	yoky
宧	yobl
嶷	yoer
扅	yohx
椸	yomy
痍	yoby
簃	yovx
㑊	yurd
佾	yuro
劓	yuzd
勚	yuul
嫕	yunx
廙	yugb
晹	yuow
杙	yumy
枍	yumv
殪	yuda
疫	yuby
癔	yubx
绎	yusl
肄	yuby
螠	yuim
裛	yuwy
镒	yujm
鹝	yuan
鹢	yubn
扆	yphy
酏	ypyy
嫛	yikn
繄	yikx
黟	yihx
眙	yook
眙	iuok
佁	yprk
佁	iurk
诒	dsyk
佚	dqru
仡	yurq
仡	gerq
疑	npbr
荑	yocy
遗	wqzr
迤	ypzy
迤	yozy
椅	yimk
猗	ypqk
嚚	ynkk
夤	ynxb
崟	ynej
烎	ynkh
訚	ynmk
䲟	yvae
慭	yvlx
溵	ybdy
禋	ybpt
骃	ybmd
珢	ynwg
珢	kdwg
龂	ynvj
龂	khvj
龈	khvg
吲	ymky
吲	uhky
蟫	xuiu
窨	xybo
殷	yjpy
殷	ympy
隐	yvex
溁	yldm
潆	yldx
茔	ylct
蓥	ylcj
媵	yjon
桜	ykmn
锳	ykjy
哟	yoku
㶲	yahy
埇	yfty
恿	yfsx
栐	yfmy
鲬	yfay
墉	ystl
鄘	ysge
饔	yswl
鳙	ysal
涌	isdy
澭	ysdf
澭	yfdf
喁	ydky
喁	ybky
尢	yxuv
蚰	yxiy
蝣	yxiz
鲉	yxay
莠	yccn
耰	yzlw
麀	yzgb
槱	ycmh
槱	ibmh
浟	yzdw
浟	dodw
柚	yxmy
有	ymuo
揄	ybfd
狳	ybqh
窬	ybbd
臾	ybpn
艅	ybvh
蝓	ybid
褕	ybpd
邘	ybye
雩	ybyk
髃	ybgy
㳚	ycdu
妪	ycnx
棫	ycma
淯	ycdo
滪	ycdr
潏	ycdk
燏	ychk
燠	ychd
蓣	yccr
薁	yccd
饫	ycuy
鹆	ycbn
㺄	ynqd
伛	ynrx
敔	ynww
窳	ynbg
鄅	ynye
龉	ynvk
纡	yvsy
込	yvzr
悆	ycrx
悆	uurx
愉	tzxd
於	wufd
矞	ycsk
矞	xcsk
矞	jysk
隃	ybed
隃	yved
隃	uyed
育	yowo
语	ycyk
雨	ycad
禺	ycld
禺	oold
俞	ycrd
俞	uyrd
与	ycaa
与	ybaa
圫	yctq
圫	vytq
円	ytka
橼	ytmu
羱	ytyx
眢	yrxo
蜎	yrio
垸	htte
薳	yycz
芫	ykce
媛	yeny
远	yeze
员	yukr
爚	yrhc
籥	yrvc
妜	yrng
妜	jyng
钥	yxjo
约	ycsu
沄	yuds
涢	yudr
纭	yuss
郧	yuke
郓	ytbe
酝	ytys
筠	jyvd
蕰	ytcm
蕰	wfcm
韫	wfwm
馧	yyhm
馧	wihm
熨	ycuh
晕	ytoi
煴	yyhm
煴	yihm
缊	yysm
缊	wfsm
拶	zafx
拶	zlfx
咋	vakv
甾	zivt
寁	zlbr
趱	zltr
咱	zskz
咱	zdkz
脏	zgot
驵	zkmq
臧	zgwi
臧	cjwi
奘	vspd
𥖨	zxum
唣	zxkq
簉	zxvz
帻	zrjr
沢	zrdi
箦	zrvr
赜	zrkr
昃	zwor
泽	uudl
责	vsfr
鲗	zead
矰	zguo
鄫	zgbe
缯	zfso
霅	vsyk
溠	vldg
痄	vlbv
蚱	vliv
䃎	vdux
拃	vdfv
鲝	vdya
挓	vafq
齇	vazq
楂	ismd
栅	uimc
栅	cwmc
吒	vlkq
鲊	vdav
鲊	vlav
劄	vavd
劄	vsvd
瘵	vsbx
砦	vsvu
偡	vhrv
搌	vlfn
飐	vljk
栴	vjmd
谵	vjyk
鹯	vjwn
崭	ikej
辗	nxin
嶦	vjek
嶦	uhek
鳣	vjad
鳣	uhad
占	vjlk
僝	vhrz
僝	verz
僝	ikrz
幛	vgju
嫜	vhnu
暲	vhou
涨	vgdi
旐	vxfd
朝	vcuo
炤	vxhk
炤	vchk
爪	vbpn
棹	vomu
磔	vrum
詟	vrlk
䗪	vwgi
啫	uuko
折	vefj
折	urfj
嗻	vekh
嗻	vwkh
嗻	vykh
嗻	vekh
这	vqzw
着	vpyo
着	vvyo
着	vcyo
纼	vdsy
昣	vhop
畛	vhtp
稹	vhhb
袗	vhpp
鬒	vhab
浈	vfdr
砧	vfuk
葴	vfck
溱	vfdh
椹	vfmv
椹	udmv
揕	vdfv
揕	vffv
怔	vgxv
狰	vgql
掟	vjfr
掟	djfr
挣	vgfl
正	vgav
钲	vfjv
踯	voze
庤	vugc
忮	vuxy
晊	vuot
栉	vume
滍	vudi
觯	vudl
跱	vuzc
踬	vuzr
铚	vujt
锧	vujr
骘	vuem
鸷	vufn
凪	vpjv
咫	vpib
扺	vpfu
茋	vpcd
轵	vpib
黹	vpyd
𦭜	vicb
榰	vimo
泜	vidd
胝	viod
痓	vubt
痓	iubt
畤	ixtc
畤	uutc
疐	vuur
疐	duur
祇	vppu
枝	qomy
殖	vodq
殖	uidq
峙	uuec
徵	vgiw
知	vuuk
织	vusb
只	vikb
茽	vacv
螽	vswi
碡	vxum
㑇	vmre
籀	vmvt
酎	vmyc
赒	vzkk
辀	vziv
鸼	vzvn
婤	vznk
婤	iznk
粥	ycgg
啁	vzkk
啁	vckk
啁	tbkk
蠋	viii
杼	vyml
疰	vybv
纻	vysa
翥	vylx
苎	vyca
槠	vumo
邾	vuve
助	iiql
褚	vopo
竺	dove
苧	vycd
苧	nlcd
朱	uipw
筑	vivf
砫	vyuv
砫	vouv
著	vpco
著	veco
髽	vxat
挝	vxfz
跩	vazy
拽	vkfy
拽	ywfy
僎	verb
瑑	vewu
颛	vrer
转	vaiv
惴	vcxe
椎	ibmf
隹	cvrf
隹	werf
追	dvzk
窀	vybt
衠	vyii
谆	vyyz
肫	iuot
椓	vpmn
浞	vpdr
禚	vpph
诼	vpyn
棁	vome
焯	vohu
汋	vpdu
汋	qrdu
叕	ypyy
叕	luyy
叕	jyyy
濯	vxdf
秭	zphp
虸	zpiz
姕	zivn
嵫	ziey
訾	zivk
趑	zitr
辎	ziit
鄑	ziye
锱	zijt
镃	zijy
鲻	ziat
鼒	zicv
茈	zpcb
茈	cocb
粢	codm
呲	zikb
孖	mazz
仔	zirz
觜	znvy
疭	zabr
倧	zsrx
鬷	zsaw
纵	zfsr
鲰	zzay
菹	zucq
卒	cywu
崒	zieu
崒	cceu
珇	zowq
珇	jcwq
槜	zcmn
僔	zirc
撙	zifc
噂	zykc
嶟	zyec
鳟	zyac
咗	zokg
岞	ziev
胙	ziov
阼	ziev
嘬	ijky
酢	cyyv
笮	zpvv
笮	zrvv
怍	vlxv
柞	vlmv
叉	ilyd
戌	qvwa
吁	yvky
芦	loch
饮	yvur
和	hohk
的	dibu
经	jjsg
虹	jkig
咪	mpkm
拜	bfuf
俱	jvrb
通	tazy
蔓	mkcy
膀	phof
艮	ghen
呃	eekv
豸	vspp
䏝	vrov
𬉼	oohx
骀	dsmk
荥	ylcu
枸	gzmk
眄	mnom
䥽	pojd
蛄	goik
挲	sadu
锔	jbjk
颏	krwr
蜊	loid
谩	mhyy
耥	thlk
蓿	xvcb
镏	lpjt
蕻	hdcb
䦃	vojo
氇	lumo
蠡	lovi
𬣙	xvyy
圫	totq
𬇕	whdw
𬣞	voya
𬘓	xusi
𫭟	outx
𫭟	qvtx
𫭢	litb
㧑	hvfw
芘	bpcb
𫇭	wrcw
𫐄	yriw
𫵷	luel
呇	mduk
𬇙	bqdr
𬣡	jnyj
𫸩	kzgx
𫘜	wgmw
𬘘	dlsv
𫘝	jymn
茋	dpcd
𬨂	qoiu
𬀩	wrow
𬀪	xnoe
岨	qveq
𬬩	yujy
𬣳	hhyg
𬩽	xuee
𬮿	gsej
𬯀	jiel
𫰛	xlng
𬳵	pimp
𬳶	jsmk
𬍛	luwl
鿍	ggtl
𬜬	mhck
𪾢	xnoe
虷	gjig
峛	loed
𪨰	qveq
𫓧	fujf
𬬮	ikji
𬬱	jbjj
𬬭	lujb
侴	icrd
㳚	xcdu
𬘡	ybsd
𬳽	ufme
𬘩	tksz
𫄧	yksz
𪟝	jufl
𬍤	xuwc
𫭼	lvtl
𬜯	lscl
𬂩	jxmj
𨐈	gliw
𬌗	hryk
晅	xyog
冔	xnky
𫑡	mhke
𪨶	ueei
𬬸	uyju
𬬻	liju
𬬹	ugju
𬬿	vcjk
𬭁	mojm
𫢸	dhrl
𫗧	syuu
烻	ujhz
𬊈	xuhc
浰	lndd
浟	yxdw
𬒈	qrxu
𬳿	timh
𫄨	iisj
𬘫	htse
䂮	lrfu
琎	jvwz
埫	tktk
𫮃	uhtl
䓬	vpcu
䓨	ykcf
梣	qnmv
硔	gfub
鿎	dsuz
鿎	tduz
硍	ynug
㫰	lgol
𬱖	doyr
蛃	baib
𬟽	dsid
𫓯	jijt
䝙	iuvx
䏲	tiop
𬇹	gpdy
𬍡	dgdy
𬤇	ybyt
𫍯	xzyk
𬤊	uuyr
𫍲	xzyy
艴	bpfb
𬯎	tber
婌	uiny
𬘬	qnso
𬘭	ifsm
𬴂	fwmf
𫘦	tvmf
𬘯	visz
𫘧	lymu
琡	iywy
堼	hftt
㙘	yctn
𪣻	lxtn
萳	nkcg
葰	sqcw
棤	cimo
𬃊	vumr
𬷕	bofn
𫐐	noie
𬹼	xovl
𫶇	dqej
𫖮	yper
鿏	msjw
𬭊	dyjt
𨱇	qwjq
𫓶	xrjo
𬭎	hdjs
𫖯	foer
脿	bzoy
䐃	jtoh
𬱟	wrdr
𫛭	kaqn
𫷷	xbgr
𬮱	ybmt
𬊤	ilhl
㴔	jodx
湑	xcdo
𬴃	homu
𫘨	tomr
蓂	mucb
楙	mxmm
𬪩	ndyn
𬒔	gjuo
碈	hyuo
䃅	diul
硿	kaug
𬨎	yxiy
𫐓	rxim
𫫇	ewkx
𫓹	jijb
𬭚	iujz
𬭛	bojy
𬕂	lfvr
𬶋	jvak
𬶍	tpab
𦝼	lxon
𦝼	lbon
𫔶	nomm
溹	sqdx
滧	xbdw
𫌀	jipr
𫖳	yyyr
𫘪	ytmx
𫘬	xomd
墕	yjth
𪤗	lbtp
蔈	pbcx
蔊	hlcg
𣗋	dkme
𬸘	ylkn
䃎	vlux
𬒗	lkue
𫚖	cpva
𨱏	dajk
𬭤	hxju
𫚕	uiaj
𬶐	vxav
𬶏	weav
𬸚	yrqn
𬤝	hcyx
𬙂	ylsb
㻬	tuwk
薁	aicd
霅	vlyk
噂	zikc
𬭩	wgjx
𩾃	mxav
𬸣	xmbn
𫍽	xryy
𬴊	lnml
𬞟	pncr
𬺈	ypvk
䗛	xqio
𪩘	yleq
𬭬	hcje
𨱑	hajb
𬭯	pwjw
𫗴	vjud
𬸦	vpfn
𫄷	yusx
𤩽	htwq
磹	tkuu
𬭳	xpjk
𬭶	hwjh
𫔍	fkjt
𬭸	lnjl
𨱔	zyjc
𬭼	scjz
𫔎	jyjk
𬸪	fkpn
䲠	iyao
𬶟	llad
𬶠	lnaj
𬶨	juga
𦈡	xvse
𫄸	xysh
𬟁	yucn
䎖	zgbx
𬙊	mist
𬶭	juax
彟	ytey
𬶮	xpak
瀼	rgdy
𬙋	xlsy
𬺓	iovr
𫚭	loav
