的	d
我	w
是	u
了	l
你	n
在	z
和	h
都	dz
不	b
有	y
就	j
也	yt
好	hb
个	g
人	r
说	uo
用	ya
他	t
这	v
来	lf
要	yx
去	q
会	hc
看	k
中	vs
想	x
没	m
啊	a
那	nl
吧	ba
给	gr
能	nh
对	dc
上	ug
到	dx
多	do
吗	ma
里	lp
被	bq
做	zi
又	ym
过	gi
让	rg
还	hf
她	ta
打	dd
把	bd
而	e
着	ve
大	dl
从	c
它	tab
写	xw
再	zs
字	zu
得	de
搞	gb
狗	gc
猫	mc
一	yi
真	vf
下	xz
但	dh
叫	jb
很	hh
比	bp
呢	ne
最	zc
更	gf
地	du
地	det
等	dj
吃	i
像	xk
后	hm
时	uoo
只	vp
点	dxd
先	xm
话	hz
与	yn
快	kj
玩	wk
当	dhx
已	yp
问	wd
完	wkb
以	ypr
将	jl
您	nn
找	vb
爱	au
太	ts
谁	ue
才	cf
年	nz
新	xb
跟	gfz
别	bqd
学	xy
哇	wa
按	ab
哎	ai
前	qz
睡	uc
加	jx
所	s
为	we
为	wq
可	kt
出	iu
该	gd
向	xkp
却	qr
哦	o
小	xza
天	tm
高	gcw
买	mg
呀	yak
刚	gh
事	uu
好	hx
坏	hj
发	f
全	qt
开	kd
万	wh
之	vi
心	xbd
帮	bh
回	hbk
得	dr
牛	nw
家	jxb
长	ij
月	yr
卖	ms
岁	sc
成	ih
唉	auk
跑	p
走	zct
早	zb
连	lz
滴	di
越	yrz
无	wi
阿	aa
送	sa
分	ff
黑	hw
额	er
妈	man
换	he
们	mf
难	nk
同	td
祝	vy
恩	en
干	gha
算	se
路	ly
并	bj
呗	bw
少	ub
猜	cd
放	fg
擦	ca
转	vyi
错	ci
脸	lx
贴	tp
陪	pe
带	ds
笑	xbv
敢	gl
谱	po
拿	ns
二	ee
煮	vo
鸡	ji
或	hi
书	uua
每	mr
画	hza
坐	zit
咯	kdk
掉	db
讲	js
梦	mfm
冷	lj
花	hxc
于	yb
手	ucp
咋	zd
哟	yo
爆	bx
站	vh
变	bn
看	kjo
哥	ge
版	bl
水	un
起	qp
图	ti
弄	na
住	vyr
啦	la
够	gm
咩	mp
累	lq
倒	dxr
肉	rm
毛	mv
神	ugu
请	qa
拉	laf
肿	vfo
听	tk
内	nq
噢	oo
唱	ig
骂	ml
装	vl
三	sj
蛮	mk
腿	tn
正	vfa
瘦	um
卤	lo
俺	az
老	lb
俩	lv
抱	bxf
忙	mj
超	ic
疼	th
胖	pg
喔	wo
车	ie
某	mcg
第	duv
教	jn
生	ugn
中	va
进	jv
假	jvr
差	il
忘	wg
热	rw
选	xyz
啥	us
微	ww
求	qw
若	ri
些	xp
久	je
苦	ko
米	mpd
约	yts
飞	fw
吓	xzk
亲	qb
照	vx
赢	yl
饿	ew
读	diy
秒	mz
信	xv
另	ljk
儿	et
靠	kx
聊	lm
远	yy
懂	df
羯	jq
低	dir
呆	ddk
晒	uso
追	vv
见	jna
跳	tb
挂	gz
哪	nd
鸟	nzn
呃	ewk
挺	taf
贵	gcb
元	yta
摩	mpm
疯	fgb
张	vhg
萌	mh
头	tx
活	hp
行	xl
哒	da
次	cu
本	bha
骗	pn
店	dn
考	kb
歌	geq
喂	wqk
强	qag
死	sp
收	uz
贱	jnb
噗	pu
恨	hd
撸	lu
喵	mn
亮	lk
弱	rig
破	pi
哼	hg
拍	pd
躺	tku
抢	qs
吐	to
日	ru
谈	tky
饭	fh
帅	uj
离	low
号	hxk
闹	nx
办	bhl
还	ht
养	yk
红	hds
猪	vu
刷	ux
呐	nlk
姐	jw
洗	xpd
种	vah
喝	hek
菜	cs
如	rin
赞	zh
丢	dq
捏	np
非	fwa
粉	fhm
怕	pl
坑	kg
网	wkk
总	zf
曾	ch
爹	dp
蛋	dhi
型	xlt
咱	zk
屎	up
纸	vps
杀	ua
自	zup
白	bf
急	jo
催	cv
吖	aak
改	gg
特	tw
包	bc
愿	ye
妹	mq
唔	wik
受	umv
抓	vxf
钱	qzj
者	vt
喷	pf
鱼	ybd
瞎	xx
此	cp
乱	le
滚	gid
呦	yz
晚	wl
留	lw
晕	yyo
风	fgj
抽	iz
块	kjt
怪	gj
度	dy
戳	io
往	wkx
便	bnr
楼	lxm
党	dk
咬	ybk
吹	iv
练	ln
删	ujd
条	tmw
耶	yre
丫	yab
系	xu
君	jy
丑	ica
件	jnr
近	jvz
两	ls
雨	yna
力	lug
面	mna
球	qww
重	id
火	hq
爬	ps
脚	jz
管	gy
偶	oor
行	hjx
黄	ha
嘴	zn
戴	dsg
情	ql
各	gw
门	mgd
卡	kdb
倒	dbr
跪	gcz
道	dxz
病	bjb
边	bm
搜	sz
短	dyu
混	htd
指	vpf
翻	fj
词	co
招	vc
尿	nb
摸	mo
嘤	ykk
撒	sd
毁	hn
顶	dad
马	md
喊	hl
由	yxa
悲	bwx
组	zo
帖	twj
则	zr
爪	vvp
配	pq
乃	ng
斤	jbp
秀	xph
伤	uh
喽	lzk
蓝	lkc
及	jon
谢	xo
泡	px
未	wqe
款	ky
定	djb
深	uf
渣	vad
粗	cum
咔	ka
爸	blf
输	uui
床	ia
碗	wlu
外	ws
宅	vfb
纯	ius
熊	xd
汗	hhd
搭	daf
药	yxc
使	upr
感	glx
宫	gs
双	ul
演	yld
木	my
粑	bam
班	bjd
赚	veb
货	hib
亿	yu
拼	pb
嗨	hdk
其	qo
名	mlx
类	lqm
棒	bg
王	wj
骑	qom
片	pnp
金	jbr
茶	is
处	iy
砸	zsu
查	ism
光	gle
气	qu
枪	qlm
句	jc
扔	rgf
试	uuy
嫁	jzn
且	qwa
切	qod
醒	xa
惹	rt
停	tl
树	uy
爽	usd
台	tf
口	kc
半	bhb
鞋	xq
雪	xuy
任	rd
摔	uk
接	jp
操	cc
娶	qn
入	ry
提	tof
狠	hhq
背	bwo
挖	waf
烂	lh
级	jos
间	jm
乖	gk
达	dsz
云	yue
冲	isd
团	tt
瓶	plw
踢	tiz
主	vod
硬	yj
魔	mpg
嘞	lwk
女	nna
动	dal
剪	jxd
线	xn
念	nnx
表	bz
挑	tnf
致	vuw
槽	cvm
满	mld
甩	uap
油	yxd
皆	jpb
捡	jxf
省	ujo
八	bap
皮	poa
子	zp
酒	jed
救	jpw
穷	qd
亦	yuw
忍	rh
妞	nqn
反	fl
呜	wu
部	by
借	jor
插	iaf
街	jpr
烦	fk
关	grb
草	cb
诗	ui
直	voa
踩	cg
嘿	hwk
课	kw
臭	im
城	iht
票	pbx
剩	ufd
趣	qc
握	wif
李	lpm
嘛	mak
撞	vk
汤	thd
刀	dcg
挤	jpf
替	tu
夜	yw
至	vut
扯	it
懒	ll
房	fjh
腰	yc
香	xlh
安	an
奔	bfd
穿	ir
凭	plj
咦	yok
杯	bwm
泪	lqd
慢	mhx
虐	nr
逛	gkz
碎	scu
既	ju
痘	dm
题	tou
舔	txu
即	joe
凉	lad
准	vid
占	vhb
屁	puu
记	juy
胸	xs
摆	bgf
国	gp
蛇	ur
派	psd
称	igh
盘	pk
控	kaf
血	xwp
忒	tv
交	jnl
四	su
投	txf
偷	tz
涨	vkd
躲	dqu
推	tvf
抹	mqf
副	fy
式	uug
搬	bjf
咪	mi
尽	jvi
堵	dot
藏	cj
山	uja
虎	ho
乐	lwp
左	zq
吵	ib
岂	qpu
欠	qnd
传	itr
笨	bdv
寄	jub
修	xqr
烧	uch
眼	ylo
机	jim
相	xlm
套	txd
撑	igf
蝎	xpi
落	li
绿	lc
折	vr
甜	tzu
糖	tj
奥	aid
鬼	gn
份	fd
烤	kbh
命	mjr
补	bo
象	xkd
节	jpc
惨	cl
熟	uxh
瞧	qm
群	quy
海	hgd
墙	qat
作	zir
鸭	yan
样	yg
圆	ytk
嫌	xzn
逗	dmz
身	ufp
旧	jpa
断	dej
歪	wdb
段	deu
罗	lps
窝	wox
盖	gsm
羊	yjd
闲	xzm
美	mrd
夹	jcf
觉	jyd
炒	ibh
仍	rhr
莫	mic
排	pff
五	woa
傻	ud
篇	pm
性	xj
租	zuh
几	jpp
周	vz
桥	qmm
区	qv
队	dce
碰	pfu
蹭	cfz
哈	hak
拆	idf
卷	jye
哭	ku
场	ik
吻	whk
男	nkt
应	ykg
哄	hfk
签	qmv
法	fdd
色	sw
需	xvy
流	lwd
杨	yjm
逼	bi
娃	wsn
劝	qe
圈	qrk
集	jom
语	yny
涂	tid
平	pla
期	qi
暖	ny
座	zig
缺	qtf
矮	ap
空	ks
软	ryi
憋	bpx
肥	fe
退	tc
扑	puf
耍	uv
牌	pfp
烟	yjh
狼	ljq
抄	icf
理	lpw
劈	pid
印	yv
望	wgw
陈	ige
郑	vfe
整	vj
郭	go
蹲	dyz
恋	lnx
兔	ty
娘	nan
知	viu
驴	lbm
辣	llx
偏	pmr
噶	gsk
数	uyw
清	qk
粮	lam
归	gv
灰	hv
姓	xjn
绝	jys
么	me
欲	ycg
豆	dma
剧	jcd
待	dsx
待	ddx
那	nae
犯	fhq
师	uia
位	wqr
捉	vof
扣	km
较	jbi
齐	qow
灯	dg
明	mlo
酸	sr
帝	duj
值	vor
论	lt
季	juh
土	toa
右	ymk
啃	kh
熬	aph
揍	zm
赶	glz
银	ynj
合	hr
细	xus
厚	hmi
西	xi
南	nku
朝	ivo
狂	kaq
随	sb
瞅	ico
界	jot
盯	dko
趁	idz
淡	dhd
轻	qki
岛	dbn
嗷	apk
拔	bs
猛	mjq
扒	baf
宝	bb
脱	too
方	fhd
刮	gx
费	fq
遍	bnz
抠	kz
霜	uly
零	lly
星	xko
夸	kxd
邮	yxe
睇	duo
汪	whd
取	qne
菇	gu
易	yuo
蒸	vg
愁	ix
化	hzr
足	zik
佛	fp
揉	rx
码	mdu
龙	ld
糗	qem
馋	iku
服	fi
蟹	xoi
牙	ys
富	fyb
吾	wiw
冰	bk
七	qia
常	ijj
底	dpg
仅	jmr
习	xog
粘	vjm
奖	jsd
妆	vlj
爷	yrf
吼	hck
弯	wjg
炖	dt
嫩	ndn
基	jit
经	jk
坨	tpt
射	uw
薄	bv
隔	gre
史	upa
伞	sl
搓	cof
跌	dpz
雾	wy
必	bu
呸	pw
捧	pj
似	sur
困	ktk
掰	bdf
令	ljr
怎	zhx
刺	cud
答	dsv
冒	mx
凶	xsi
船	itv
酱	jky
趴	pa
闪	ulm
昂	aj
紧	jms
贼	ze
电	dna
具	jcb
压	yai
雷	ley
湿	uid
钻	zrj
登	dgd
啪	pak
咋	zrk
百	bga
终	vss
哆	dok
酷	kyy
波	bod
林	lnm
治	vud
醉	zcy
唯	wek
弹	tkg
砍	kl
原	yti
咳	kr
猿	ytq
秤	if
害	hs
甚	udq
锅	goj
遭	zcz
赌	dob
怒	nyx
飘	pnf
炸	vlh
胡	hio
村	cy
仔	zpr
解	jwj
订	djy
卧	wib
播	bof
捂	wof
伐	fs
量	lao
量	lko
割	ged
淘	tvd
埋	mft
塞	sdt
略	lr
淫	ynd
宽	krb
透	tmz
凑	cm
劲	jvl
重	vap
届	jou
倍	bqr
胃	wqo
嬛	xr
举	jnd
灭	moa
残	ck
封	fgc
属	uou
脑	nbo
粥	vzg
福	fiu
扫	sbf
韩	hk
废	fqg
升	ugp
煎	jmh
征	vgx
捞	lcf
罚	fss
慌	hlx
价	jzr
叠	dqq
饼	bau
勒	lwl
存	cuu
杜	dym
胜	ufo
毒	dif
虽	sv
妖	ycn
叼	dnk
负	fyd
根	gfm
春	iyo
虾	xxi
迷	moz
啰	lok
寸	ct
体	tpr
供	gsr
抛	pc
烫	tg
拽	vjf
防	fje
炮	pxh
编	bms
侠	xc
勿	wyg
共	ga
纹	wgs
闻	wge
北	br
挡	dkf
守	ucb
拌	bhf
甄	vfw
牵	qmn
发	fla
克	kwe
摄	uwf
布	byj
降	jke
怂	sf
笔	bpv
奶	ngn
霾	mfy
颗	ke
九	jep
泥	no
於	ybf
教	jbw
瑟	sww
遮	vez
澡	zbd
痒	ykb
锁	sq
吸	xik
敷	fu
德	drx
踹	ijz
吊	dbk
舞	wor
含	hkk
浓	ndd
蹦	bfz
嘎	gak
潮	ivd
长	vkp
现	xnw
壳	kru
调	tmy
调	dby
罪	zcs
证	vfy
亏	kv
剃	tud
摇	yvf
肾	udo
素	sy
填	tzt
精	jkm
沾	vjd
盒	hrm
闷	mdm
犬	qy
通	tsz
架	jzm
腻	nu
公	gss
露	lmy
著	vyc
晃	hko
潘	pjd
铺	puj
砖	vru
孔	kf
乳	ro
食	uor
垫	dnt
建	jnz
键	jnj
捅	tff
饱	bbu
欧	ou
伪	wr
兽	umk
盼	ph
滑	hcd
运	ytz
绕	rxs
缠	iks
戒	jog
散	sh
散	slw
拜	bsp
嘘	xvk
枰	plm
赵	vxz
屏	plu
脏	zho
页	ywa
范	fhc
逃	tvz
馆	gyu
结	jqs
领	lay
巨	jck
处	iow
言	ykd
梗	gjm
攒	zl
翘	qbg
挠	nv
市	uuw
伴	bhr
分	fdb
初	iuy
利	luh
针	vfj
掐	qx
啵	bok
博	bpu
否	fc
巧	qzg
虚	xvh
造	zx
寻	xuc
蠢	ii
朵	dqm
逆	nuz
骚	scm
层	chu
测	cw
何	hrr
局	jbu
剁	did
般	bjv
代	dsr
诺	ni
均	jyt
叶	ywk
肌	jio
东	dsa
宠	ifb
端	drl
首	ucq
容	rdb
斯	si
物	wyn
录	lya
丽	lua
盐	ykm
败	bsb
咸	xzg
摘	vd
矣	yps
众	var
惊	jkx
竟	jj
敲	qng
嗲	dv
干	gja
漏	lmd
湖	hid
沉	igd
截	jqg
朱	vup
付	fyr
醋	cyy
撕	sif
获	hic
朕	vdo
冥	mlb
轮	lui
丝	sia
河	hrd
炫	xe
塔	tdt
袁	ytt
喜	xpu
魂	hu
挣	vff
赔	peb
耳	ey
碧	buu
撤	iw
贪	tjb
扛	kjf
镇	vdj
肺	fqo
祸	hiu
果	gq
嚯	hik
刑	xld
拱	gff
顺	ut
器	quk
秋	qq
孙	syz
巴	baa
捐	jr
屋	wuu
沪	hy
猴	hxq
龟	gvd
夏	xzw
耐	nsc
转	vei
仨	sar
争	vgd
肯	kho
歇	xpq
板	blm
案	abb
扭	nef
观	grj
卸	xoe
兼	jmb
设	uwy
趟	tgz
攻	gsg
抖	dcf
除	iie
静	jjq
旁	pjw
稳	whh
董	dfc
逢	fhz
浅	qxd
环	htw
申	ufa
遇	ycz
绑	bks
乘	ihp
缩	so
泰	tsf
紫	zps
认	rdy
串	iea
痣	vub
沙	uad
友	ycy
尼	nou
臀	tuo
丁	dka
股	goo
步	byv
档	dgm
鼻	boz
识	uoy
颇	poy
限	xne
幅	fij
响	xsk
旅	lnf
跨	kzz
崔	cvu
意	yux
侬	ndr
哩	lik
糕	gcm
威	wwg
麻	msg
赛	ss
瓜	gxp
拧	naf
室	uub
愣	lfx
显	xxo
尊	zy
寒	hkb
广	gsd
率	lcw
品	pmk
凹	ao
维	wes
蒙	mhc
搂	lzf
苏	suc
斜	xqd
免	mxd
居	jvu
餐	cju
膏	gco
染	rl
轰	hsi
唐	tjg
幂	mu
婚	hyn
摊	tjf
瑕	xcw
皂	zxb
桶	tfm
立	lud
客	kwb
枕	vhm
状	vkj
坟	fgt
扶	fif
故	gyw
千	qmp
尾	wru
震	vdy
粽	za
叹	thk
古	gou
灵	llh
堆	dvt
恶	ewx
呼	huk
琴	qnw
虫	ida
展	vlu
善	uhy
芙	fic
抗	kgf
狮	uiq
科	keh
松	ssm
徐	xbx
乡	xla
嗒	dak
弄	lac
拎	lbf
须	xvp
衫	ujy
尖	jmx
森	sfm
扎	vaf
膜	mpo
晴	qlo
婊	bzn
衣	yid
迟	ioz
酥	suy
章	vhl
产	ild
僧	sg
竖	uyl
横	hhm
聚	jce
娇	jnn
十	uoa
石	uok
宋	sab
尚	ugx
依	yir
瞄	mm
旺	wgo
妙	mb
膘	bno
啾	jqk
田	tza
噜	luk
距	jcz
悬	xt
青	qko
郎	lje
糟	zcm
雅	yd
惯	gex
噻	sdk
麦	msf
侃	klr
钓	dbj
罢	bls
京	jkw
丹	djp
添	tmd
曲	qna
嚼	jmk
扇	uhh
芯	xbc
赖	lsu
许	xny
音	ybl
葱	csc
丸	wkj
搁	gef
娜	nln
揪	jqf
榜	bkm
遛	lpz
宰	zg
俩	lsr
赏	ukb
谷	gob
曝	bxo
赐	cub
黏	nzh
腹	fyo
桌	vom
蜜	mui
消	xnd
勺	uvg
辞	cou
江	jld
兵	bkq
蝶	dqi
饮	ymu
侧	cwr
告	gxk
仙	xmr
赴	fyz
甲	jva
角	jzd
钗	idj
薛	xtc
止	vpa
港	gkd
磕	keu
曹	cvo
崽	zgu
巾	jba
坎	klt
评	ply
窗	ilx
勾	gzg
艾	auc
咖	kak
斗	dmd
凡	fkd
继	jus
刻	kwd
保	bbr
厄	ewi
蕾	lrc
驻	vym
弟	dub
喘	iyk
喇	ldk
皱	vm
扎	zaf
唰	uxk
附	fye
格	grm
失	uip
暗	abo
野	ytl
橙	ihm
裸	lqy
桑	shm
蘸	vhc
嘉	jxu
沟	gzd
厂	ika
袋	dsy
疤	bab
靴	xtg
涅	nod
弃	quc
梨	lom
列	lod
净	jjd
温	wf
批	pif
互	hya
罩	vxs
尔	eyd
帐	vgj
圣	uft
馅	xnu
挫	cif
粪	fdm
曼	mho
肝	gjo
然	rk
仇	ixr
邪	xqe
扁	bxh
翔	xay
液	ywd
掏	tcf
末	mia
杠	ggm
院	yee
姜	jln
谨	jmy
瓦	wda
焦	jnh
湾	wjd
堂	tjt
智	vuo
钟	vsj
辆	lki
莎	uac
联	lze
瞪	dfo
祭	juu
项	xkg
枚	mem
兮	xib
颜	yky
薇	wwc
术	uym
镜	jjj
拐	gaf
兜	dze
俄	err
优	yzr
贺	hwb
景	ja
余	ybr
剥	bcd
崩	bgu
工	gsa
盗	dxm
吞	tyk
军	jyb
陆	lye
携	xqf
痴	iib
影	yap
煲	bch
当	dgx
舌	urq
衰	uky
骨	gog
铅	qmj
裹	gqw
礼	lpu
饶	rv
顿	dty
鼠	uoj
砂	uau
盆	pgm
恕	uyx
搅	jzf
专	vra
拦	lkf
浪	lg
卯	mbe
菊	jbc
沈	uhd
判	phd
引	ymg
复	fyp
漂	pnd
彩	cgp
族	zif
稿	gbh
漫	mhd
摁	eb
绛	jks
郝	hbe
挨	aif
挨	aof
脉	mso
扇	ujh
妮	nin
标	bnm
创	ikd
鹅	ern
哔	buk
颤	ihy
睁	vgo
梳	uum
思	sit
凸	tua
框	kk
移	yoh
泼	pod
邓	dfe
俗	sir
恰	qzx
患	hex
鲜	xmy
阴	ybe
帽	mxj
柳	lem
斩	vli
忌	juj
鲍	bxy
侯	hxr
熏	xyh
彭	php
册	cwk
掌	vku
玉	yca
楞	lhm
社	uwu
骆	lim
塌	tat
吨	dyk
坡	pot
雕	dnv
懵	mjx
蒜	sec
财	cfb
赠	zfb
持	iof
涮	ued
怨	yex
墨	mit
注	vyd
庙	mbg
斑	bjw
靓	lkj
吉	jok
呲	cik
券	qed
玻	bow
迎	ylz
霍	hiy
筋	jbv
嗑	kwk
视	uuj
洒	sdd
译	yuy
夫	fua
柴	ifm
铲	ilj
蒋	jsc
悟	wyx
兰	lkb
茬	isc
漆	qid
恤	xcx
华	hcu
垮	kvt
孤	guz
箭	jnv
叉	iad
普	poo
英	ykc
志	vuu
州	vzi
商	uhw
厅	tki
载	zsg
私	sih
腚	djo
户	hyd
独	diq
脆	cco
瞒	mko
蒂	duc
壹	yiu
徒	tix
欸	eo
胎	tdo
简	jxv
世	uuc
佬	lbr
锤	ibj
亚	yla
蛆	qvi
嘚	dek
捶	ibf
唇	iui
宁	nlb
增	zgt
仿	fkr
铊	taj
县	xns
忧	yzx
权	qtm
葬	zgc
龚	gsl
羞	xqy
劫	jql
童	tdl
希	xij
蹬	dgz
癖	pp
职	voe
粒	lum
渡	dyd
绣	xps
尝	ijd
欺	qiq
毕	bub
敌	dow
差	iay
实	uob
腐	fo
形	xlp
杂	zsj
藕	ooc
仗	vgr
糊	him
讯	xty
墓	myt
萱	xrc
浮	fid
哉	zdk
源	ytd
织	vis
籽	zpm
岗	gku
蒙	mgc
喃	nkk
备	bqw
扬	yjf
雄	xdv
牢	lvb
眠	mzo
萨	slc
迈	msz
焖	mdh
漂	pbd
续	xcs
严	yka
奏	zmf
沃	wid
系	jup
呈	ihk
箱	xlv
押	yaf
种	vfh
堡	bbt
购	gmb
倩	qnr
愈	ycx
脖	bpo
嫖	pmn
川	irp
鹿	lyg
嗦	sok
窜	ce
撅	jt
邦	bhe
皇	hab
镐	gbj
挽	wlf
讨	tby
栽	zdg
庆	qj
胶	jno
卡	qvb
敬	jjw
润	rtd
永	yf
咒	vmk
棍	gt
袭	xol
井	jaa
俊	jtr
嘭	pgk
噎	yek
陶	tve
厝	cii
痰	tkb
嗅	xpk
乌	wup
险	xxe
俾	bpr
邱	qqe
钢	ghj
坤	kyt
碳	thu
采	cgm
贝	bqa
鼓	gov
伸	ufr
蚝	hvi
缓	hys
咽	yh
纵	zas
卒	ziw
吱	vik
裂	loy
钙	gsj
翅	iuv
耗	hxl
棵	kem
雀	qrv
挪	npf
始	upn
皿	mma
钉	dkj
冬	dsw
苗	mmc
盛	ufm
袜	wly
茧	jxc
纳	nls
啤	pok
妥	tq
盲	mjo
误	wyy
菌	jyc
浴	ycd
孽	noc
枉	wkm
勇	yfl
峰	fgu
嚷	rkk
晏	yho
研	yku
库	kyg
榛	vfm
噔	dgk
叽	jik
陌	mie
吒	vak
闭	bum
护	hyf
贾	jvb
捎	ucf
垵	ant
抵	dpf
莲	lzc
肚	dyo
冤	yrb
臣	iga
椒	jnm
獒	apq
葛	grc
仓	chr
义	yud
唠	lxk
唠	lvk
辛	xbl
轴	vxi
胆	dlo
煞	ulh
枣	zbc
稀	xih
晨	igo
仁	rgr
庄	vlg
撩	lmf
秃	tuh
乙	ypa
嗔	ifk
临	lna
灸	jeh
婶	uhn
宴	yhb
币	bup
佳	jxr
索	sqs
咕	guk
姬	jin
返	flz
禾	hrp
链	lnj
眯	mio
瓷	cow
绘	hcs
密	muu
恃	uux
吕	lnk
探	thf
番	fjt
哀	aiw
乎	hup
蛙	wai
氪	kwq
置	vus
埃	ait
芊	qmc
掀	xmf
裆	dhy
镁	mrj
兑	dcb
卢	lib
阔	ki
谜	moy
暮	myo
洲	vzd
差	idy
昏	hyo
谓	wqy
承	iha
忠	vsx
潜	qzd
瞟	pz
驼	tpm
欢	hry
悔	hnx
巫	wug
崴	wgu
呛	qlk
呛	qkk
涩	swd
曾	zgo
轶	yui
递	duz
烙	lxh
棉	mzm
霸	bly
缝	fhs
缝	ffs
切	qpd
祛	qvu
舟	vzp
鞭	bmg
瘾	ymb
黎	loh
亭	tlw
荼	tic
呕	ook
雇	gyh
顾	gyy
舍	utr
镶	xlj
背	bqo
剂	jud
渴	ktd
昨	zpo
帖	toj
叮	dkk
姚	yvn
谎	hsy
乍	vlp
阳	yje
荤	hyc
亲	qjl
忽	hux
账	vgb
舍	uwr
枝	vim
桃	tvm
勤	qnl
荡	dgc
嗝	grk
畔	pht
嘟	duk
奉	fff
孝	xbz
挑	tzf
桩	vlm
犊	din
拳	qtu
泯	mmd
泡	pcd
铜	tdj
助	vyl
盾	dtp
焉	yjv
悦	yrx
夺	dpd
伦	lur
瑞	rc
诸	vuy
萧	xnc
宜	yob
跶	daz
拾	uof
凤	ffj
圭	gvt
揽	llf
池	iod
钩	gzj
境	jjt
谦	qmy
莪	erc
阅	yrm
匿	nuk
渤	bpd
隆	lde
审	uhb
妾	qon
硅	gvu
咻	xqk
叭	bak
触	iyi
缸	ghf
喏	nik
坊	fht
嚓	cak
颠	dmy
窦	dmx
莱	lfc
旗	qof
孩	hfz
嗡	wgk
裁	cfg
哑	ydk
淌	tkd
吆	yck
硕	uiu
危	wwd
颈	jay
倔	jyr
荣	rdc
泉	qtb
钵	boj
卵	lyp
谣	yvy
恒	hhx
债	vsr
肠	ijo
嚎	hvk
拴	urf
垂	ibp
妃	fwn
伏	fir
撬	qbf
恐	kfx
媛	ytn
菲	fwc
矗	iyv
靡	mpf
搏	bpf
晓	xzo
抡	lyf
睿	rcb
腌	yjo
颁	bjy
程	ihh
撇	pwf
筒	tfv
淋	lnd
鸣	mlk
搽	isf
娟	jrn
彪	bnh
拷	kbf
目	mya
恁	ndx
兹	zib
囤	dtk
囤	tuk
绳	uhs
蒽	enc
姆	mon
洁	jqd
涌	yfd
妻	qin
踏	tlz
迁	qmz
秦	qnh
姨	yon
称	idh
序	xcg
束	uya
异	yuc
康	khg
嗓	sk
篮	lkv
觅	muj
镑	bgj
营	ylc
掺	ijf
螨	mli
俏	qbr
珊	ujw
傍	bgr
贫	pnb
芭	bac
司	sig
崖	ysu
嘣	bgk
传	ver
叁	sjs
豹	bxv
献	xnq
辨	bnd
兆	vxe
瘪	bwb
枯	kum
芮	rcc
蜡	lli
涛	tcd
犹	yxq
僵	jlr
阵	vde
辫	bns
府	fog
吡	bpk
坛	tkt
煨	wwh
幸	xjt
栋	dam
刨	pv
刨	bxd
瑛	ykw
赫	hwi
努	nol
袄	aq
氏	uup
椅	ypm
玛	mdw
吽	hsk
晋	jvo
氧	ykq
矬	cpu
瘟	wfb
武	wov
作	zor
俱	jcr
捣	dbf
蜀	uos
柚	ymm
坠	vct
辱	roc
轩	xri
吟	ynk
廖	lbg
肖	xno
竹	vig
柔	rxm
棕	zsm
祖	zou
咚	dsk
洪	hdd
斋	vdw
浑	hud
眉	meo
奔	bdd
卿	qkm
穴	xyb
佑	ymr
燥	zxh
尘	igt
校	xbm
迪	doz
扎	vsf
雌	cov
馊	szu
姿	zin
胯	kzo
栏	lkm
确	qru
席	xoj
擤	xaf
嗖	szk
遂	scz
燕	yhc
逾	ybz
兴	xjb
咿	yik
焗	jbh
卷	jee
默	mih
奸	jmn
炕	kgh
摞	lif
应	yjg
避	buz
贰	eeb
缁	zis
冠	geb
汝	rod
厌	yhi
殿	dnu
掂	dmf
馍	mpu
绮	qps
宣	xrb
隐	yme
荒	hlc
累	les
驱	qvm
掖	ywf
豪	hvu
魏	wqg
糙	ccm
妍	ykn
砰	pgu
砌	quu
瑜	ybw
飙	bnf
畅	igu
瘸	qyb
翁	wgy
空	kax
腮	sdo
蛹	yfi
宇	ynb
唬	hok
袅	nzy
施	uif
糯	nim
辩	bnx
参	cjs
嫂	sbn
阮	rye
艘	szv
拥	ysf
扩	kif
倾	qkr
叨	tck
嬴	yln
挥	hvf
豁	hog
啷	lhk
楚	iom
莉	luc
遁	dtz
厮	sii
滩	tjd
辽	lmz
歼	jmd
泄	xod
玄	xtw
耙	bll
噌	cgk
脂	vio
刁	dng
积	jih
捋	lof
卦	gzb
纱	uas
隋	sbe
蚊	wgi
鳖	bpy
痕	hgb
齁	hzb
数	uow
颂	say
玮	wrw
霉	mey
杆	glm
珂	kew
炝	qkh
栓	urm
苯	bhc
裱	bzy
厨	iii
筐	klv
寨	vsm
铰	jzj
岭	lau
享	xsd
濯	vpd
璐	lyw
瓣	bhg
籍	jov
囊	nj
符	fiv
煤	meh
蔫	nm
幼	yml
势	uul
呷	xxk
怡	yox
辈	bqi
斌	bbw
蛊	goi
激	jid
佟	tdr
韵	yty
酿	nky
歉	qnq
访	fky
覆	fyx
突	tux
埸	yut
弗	fia
仪	yor
浩	hxd
谋	mxy
谤	bgy
簋	gnv
尿	svu
惜	xix
掩	ylf
遵	zyz
辟	bux
妇	fyn
杏	xjk
啖	dhk
耸	sfe
碑	bwu
农	ndb
坪	plt
贬	bxb
皎	jzb
珞	liw
嗜	uuk
蝉	iki
姑	gun
钦	qbj
耽	dje
帘	lzb
碘	dxu
恼	nbx
筛	udv
棚	phm
蚺	rki
缇	tos
町	dkt
笛	dov
绞	jzs
扰	rb
态	tsx
苑	yec
傲	air
尺	ip
茨	coc
磡	khu
劳	lvc
笼	ldv
穆	myh
巢	ivi
寝	qmb
涠	wed
蕉	jnc
闰	rtm
粤	yrp
跋	bsz
刊	kjd
葵	kbc
沐	myd
佐	zqr
讹	ery
坚	jmt
岸	abu
绷	bgs
荷	hrc
堕	dit
凯	kgj
笋	siv
黛	dsh
亨	hgw
攀	pju
棣	dum
矫	jzu
绒	rds
鹏	phn
咏	yfk
幽	yzu
愚	ybx
碍	auu
虹	hdi
妓	jun
洛	lid
彦	yhd
焕	heh
琳	lnw
啄	vpk
癌	aob
霆	tly
祇	qou
拘	jvf
碾	nxu
脓	ndo
膈	gro
叉	idd
碇	dju
匪	fr
津	jbd
落	llc
葡	pic
腾	tho
杖	vgm
绊	bhs
拈	nmf
蹄	toz
膝	xio
灾	zdb
浣	hed
惧	jcx
硌	gwu
嘬	zok
谗	iky
弧	hig
晶	jko
掷	vuf
卜	boa
铬	gwj
羹	ggg
幻	hey
郡	jte
孬	nc
奈	nsd
窃	qox
宿	syb
哏	ggk
嘈	cvk
饬	iuu
稠	ixh
癫	dmb
擀	glf
杰	jqh
舱	chv
馕	nju
辰	igi
茎	jkc
肘	vco
攥	zef
吠	fqk
箍	guv
尻	kcu
导	dbc
谴	qxy
惟	wex
钻	zej
梵	fhf
验	yhm
粿	gqm
犟	jkn
玫	mew
婆	ppn
钛	tsj
壁	but
弹	dhg
捯	dvf
鳄	ewy
弩	nog
区	ouk
溶	rdd
慎	udx
叙	xcy
锥	vvj
贷	dsb
浸	jvd
昆	kyo
撵	nxf
逝	uuz
陀	tpe
疣	yxb
渊	yrd
察	isb
泽	zrd
炸	vsh
溺	nud
艳	yhf
仔	zgr
翠	ccy
啐	cck
嘶	sik
栖	qim
肛	gho
闵	mmm
皖	wlb
抻	iff
咣	glk
徽	hvx
媚	mqn
慕	myc
坞	wyt
估	gur
掘	jyf
逑	qwz
诉	syy
逐	viz
臂	buo
哲	vrk
烩	hch
鲨	uay
萎	wrc
炎	ykh
允	yis
袖	xpy
俯	for
瘤	lwb
律	lcx
聂	noe
芽	ysc
羽	ynx
钞	icj
赤	iut
似	uur
毯	tlm
禹	ynp
咂	zak
宏	hdb
瀑	py
廋	szg
喧	xrk
仰	ykr
丰	fga
剖	pzd
黍	uoh
盈	ylm
苍	chc
蔻	kmc
禄	lyu
夕	xip
鑫	xbj
尹	yma
熨	yth
吭	kgk
苔	tfc
湉	tzd
薜	buc
铛	igj
锯	jcj
叩	kmk
螺	lpi
藤	thc
褪	tcy
滋	zid
宗	zsb
锦	jmj
竞	jjl
浙	vw
啫	vtk
勃	bpl
韦	wea
炜	wrh
藓	xxc
邹	zz
媒	men
囡	njk
曝	pyo
匀	yug
溪	xid
杭	hjm
鳓	lwy
朴	pom
屙	eeu
遗	yoz
伙	hqr
魅	mqg
倪	nor
艋	mjv
幕	myj
殴	ouu
磐	pku
屑	xou
益	yum
瘀	yvb
规	gvf
燃	rkh
狐	hiq
寰	htb
论	luy
瓢	pmg
脐	qoo
茜	xic
镕	rdj
庵	ang
候	hmr
鸠	jqn
狷	jeq
炆	wgh
宾	bbb
抹	maf
姝	uun
宵	xnb
邢	xle
煸	bmh
岔	ilu
肱	gso
蚶	hji
皓	hxb
蟒	mki
瘆	udb
逸	yuz
礁	jnu
俚	lpr
孰	uiw
壳	qbu
落	lxc
薰	xyc
延	ykz
翟	doy
倦	jer
戚	qig
氢	qkq
烘	hsh
喆	vrj
渍	zud
锉	cij
浆	jlu
嵌	qnu
塑	syt
敝	buw
霏	fwy
匹	ppk
韬	tcw
貌	mxv
匙	iob
担	djf
铺	pyj
淑	uud
硪	wiu
暇	xco
釉	ymp
酌	vpy
炅	jf
蓬	phc
痧	uab
巳	sua
逄	pjz
丧	sgt
柏	bgm
汞	gfg
舅	jpj
滥	lhd
蘼	moc
寿	umc
昕	xbo
航	hjv
儒	rir
庭	tlg
鄣	vhe
鄂	ewe
秆	glh
廊	ljg
鲤	lpy
怜	lzx
汰	tsd
坦	tlt
攒	ctf
齿	ipv
玖	jew
肋	lqo
炉	lih
翘	qmg
嗄	ulk
伢	ysr
笫	zpv
谍	dqy
窥	kvx
溜	lpd
屡	lnu
啼	tok
泵	bfu
墩	dyt
固	gyk
径	jjx
箸	vyv
缀	vcs
耻	ipe
斧	fof
吮	uik
绾	wls
淤	yvd
掴	gkf
赣	ghd
腊	llo
嘁	qik
屠	tiu
瓮	wfw
慧	hcx
辉	hvg
偈	jur
鸥	oun
萋	qic
违	wez
蟑	vhi
埵	dqt
竿	gjv
纲	ghs
击	jia
陋	lme
寐	mqb
帖	tpj
午	wop
蚤	zbi
钝	dtj
耄	mxl
怔	vfx
灿	chh
婵	ikn
垢	gmt
耒	lra
胚	pwo
昙	tko
贤	xzb
咀	jnk
聘	pve
肽	tso
琛	ifw
促	cyr
饵	eyu
敛	lxw
叛	phf
嗤	iik
迩	eyz
缰	jls
沫	mid
秾	ndh
频	pny
砣	tpu
枭	xnm
窑	yvx
舀	ybv
寮	lmb
莓	mec
朋	pho
览	llj
狸	loq
遥	yvz
铢	vuj
睬	cgo
孑	jqa
涉	uwd
统	tfs
诈	vly
阻	zoe
堇	jmc
蹿	cr
牧	myn
乾	qzu
卅	sla
锕	aaj
盟	mhm
祢	mou
妄	wgn
焐	wyh
涯	ysd
央	yha
糍	com
壕	hvt
幌	hsj
烹	pgh
琼	qdw
丘	qqp
醍	toy
樽	zym
菖	ihc
崇	idu
戆	vkx
轨	gni
技	juf
脊	jpo
凝	nld
驳	bpm
凳	dfj
敏	mmw
蕊	rn
挞	tlf
垚	yvt
荫	yvc
瑾	jmw
泾	jkd
哐	klk
炼	lnh
榴	lwm
融	rdi
婷	tln
鱿	yxy
昌	iho
舵	div
癸	gnd
桔	jqm
锰	mjj
缅	mxs
灞	bld
菲	frc
槛	klm
讷	nwy
佩	pqr
姘	pbn
骟	uhm
泫	xed
卓	vpb
查	vam
抿	mmf
玥	yrw
黯	abh
唵	azk
狄	doq
枫	fgm
棘	joc
嗫	nok
务	wyw
旋	xtf
孵	ful
匠	jkj
濂	lzd
泷	ldd
箩	lpv
萝	lpc
昇	ugo
搋	ikf
鼎	dao
检	jxm
泠	lld
寞	mib
甯	njb
启	qph
锐	rcj
台	tds
销	xnj
胤	yvp
躁	zxz
窘	jfx
糁	slm
酮	tdy
尧	yvg
绗	hjs
筷	kjv
赎	uib
朔	uio
娼	ihn
狙	jvq
择	zrf
唛	msk
浜	bhd
谛	duy
诡	gny
橘	jbm
挎	kzf
笠	luv
陕	ule
铭	mlj
硼	phu
祥	xau
馨	xbu
埂	gjt
茅	mvc
亩	mow
毅	yul
爰	ytv
褶	vty
综	zss
冏	jfk
霖	lny
瞥	ppo
企	qpr
壬	rgp
饰	uuu
澜	lkd
逊	xtz
蛛	vui
岗	ghu
厕	cwi
阶	jpe
矛	mvs
楠	nkm
昵	nuo
疲	pob
擒	qnf
龌	wii
巡	xuz
臻	vfv
澄	ihd
蛾	eri
旱	hho
垒	lrs
淼	mzu
纽	nes
膳	uho
嫣	yjn
援	ytf
倡	igr
矿	kku
袍	pvy
邵	uxe
渗	udd
鲞	xsj
效	xbw
畜	xct
炙	vuh
怵	iyx
蹉	coz
典	dxb
巅	dmu
跺	diz
鳌	apy
褒	bcw
摧	cvf
鹤	hwn
嚼	jyk
宓	mub
哞	mzk
锈	xpj
策	cwv
繁	fks
疾	job
寇	kmb
缕	lns
糜	mom
悯	mmx
闽	mmi
娜	npn
炳	bah
苷	gjc
戈	gea
钾	jvj
黔	qzh
趾	vpz
蚕	cki
喋	dqk
饥	jiu
钠	nlj
蛰	vri
睹	doo
贩	fhb
芬	ffc
蜂	fgi
亥	hsd
嗟	jpk
腩	nlo
蓄	xcc
夷	yoa
庸	ysg
芋	ycc
株	vum
澈	iwd
汾	fgd
绫	lls
拢	lff
葩	pac
坯	pit
仆	pir
梯	tim
伟	wrr
寡	gvb
浒	hod
莰	klc
邻	lne
哂	uhk
欣	xbq
疮	ilb
旦	dho
斗	dcd
鸽	gen
苟	gcc
惑	hix
犁	lon
蜷	qti
炊	ivh
猾	hcq
馁	nru
裘	qwy
韧	rdw
斥	iuj
肤	fuo
绢	jes
镌	jrj
恪	kwx
诓	kly
缈	mzs
湜	uod
慰	wqx
炷	vyh
姊	zpn
猹	isq
焊	hhh
衿	jby
哝	ndk
裴	pey
璞	piw
蔷	qac
沁	qvd
箫	xnv
狱	ycq
责	zrb
瞻	vjo
芝	vic
妲	dsn
盖	gtm
阙	qrm
瓤	rj
搔	scf
梭	som
庹	tqg
瑶	yvw
凿	zv
暧	auo
瑷	auw
锝	drj
璟	jaw
廉	lzg
昧	mqo
畏	wqt
颖	yah
仄	zw
召	vxd
粢	zim
鬓	bvi
沸	fqd
岚	lku
萁	qoc
檀	tkm
蚁	ypi
簪	zj
彬	bbm
稻	dxh
槿	jmm
揩	kdf
糠	khm
涝	lxd
瞭	lbo
痞	ppb
冉	rla
莎	soc
跎	tpz
兀	wya
焯	ich
钣	blj
耕	ggl
苛	kec
玲	llw
跷	qnz
穗	sch
腆	txo
诱	ymy
筠	yuv
昶	iko
缚	fys
渺	mzd
擅	uhf
腕	who
陆	lpe
爻	yvi
卑	bwp
锄	iij
辑	joi
铐	kxj
芈	mpa
耨	nml
悭	qmx
狨	rdq
慑	uwx
淞	ssd
敖	apw
枞	csm
呋	fuk
革	gra
珑	ldw
契	qud
杉	ujm
涡	wod
岳	yru
肇	vxh
坝	blt
乏	fsp
艮	gda
贡	gab
况	kkd
培	pet
苕	uvc
衔	xzr
椰	yem
域	yct
匾	bxk
镖	bnj
储	ior
帆	fjj
滤	lcd
秘	muh
姥	lbn
萍	plc
迫	piz
郁	yce
盹	dio
斐	frw
蒿	hcc
髻	jui
窟	kux
胧	ldo
茗	mlc
齉	ngb
霓	noy
茑	nzc
渠	qbm
述	uyz
隼	siu
痿	wrb
诌	vzy
氨	anq
禀	bad
丛	cda
横	hfm
磊	lru
锣	lpj
蜱	poi
艇	tav
耀	yxg
淳	iud
耿	gje
瑰	gvw
闺	gvm
伶	llr
钮	nej
蹼	poz
遣	qxz
虱	uii
瞬	uto
庥	xqg
昱	yco
噪	zxk
欸	ep
酣	hjy
踝	hlz
琅	ljw
耪	pkl
锵	qlj
恬	tzx
拓	tif
蔚	wqc
硒	xiu
漾	ygd
予	yns
嘱	vok
靶	bdg
敦	dyw
涐	erd
焚	fgh
尕	gdx
圜	htk
戟	jpg
鞠	jvg
篓	lcv
虑	lch
琶	psb
庞	pjg
乞	qpp
茄	qqc
囚	qwk
矢	upp
舜	utv
削	xtd
愤	fdx
肓	hlo
栾	ltm
臊	sco
眺	tbo
翕	xiy
峡	xcu
戌	xvg
轧	yli
抑	yuf
毓	ycm
载	zgg
禅	uhu
橱	iim
辅	foi
恺	kgx
硫	lwu
芒	mjc
杳	ybm
鄙	bpe
材	cfm
翀	isy
氮	dhq
镀	dyj
獾	hrq
亟	joa
侣	lnr
昴	mbo
楸	qqm
示	uue
憎	zgx
枳	vpm
尢	wha
怖	byx
岑	cgu
嘲	ivk
簇	cyv
珰	dhw
氟	fiq
涵	hkd
栗	lux
赦	uwi
犀	xin
鼋	ytm
甑	zfw
振	vdf
钡	bqj
撮	zqf
铎	dpj
冈	ghk
铪	haj
诀	jyy
髋	krg
镰	lzj
侨	qmr
茕	qdc
纬	wrs
污	wud
鲜	xxy
夭	ycp
雍	ysw
赟	yyb
灼	vph
豺	ifv
掣	iwu
慈	cox
沌	dtd
甫	foa
衮	gil
厥	jyi
陵	lle
麓	lyl
弥	mog
衾	qby
笙	ugv
授	umf
彤	tdp
匝	zaj
筝	vgv
遢	taz
婢	bun
铂	bpj
掸	dlf
扼	ewf
绯	fws
鲎	hmd
旷	kko
擂	lqf
圙	lrk
攮	nkf
咆	pvk
佘	urr
叟	scj
蹚	thz
鹀	win
协	xqu
暄	xro
虞	ybh
彘	vua
芷	vpc
滨	bbd
跛	bqz
玚	yjw
筹	ixv
蹙	cyz
啡	fwk
旮	gaj
沽	gud
箕	jiv
圐	kuk
谅	lky
茂	mxc
摹	mpc
疱	pxb
梢	ucm
漱	uyd
啸	xbk
兴	xkb
觜	zij
扉	fwh
羔	gcd
婧	jjn
掠	lrf
镊	noj
佺	qtr
嗽	sm
铀	yxj
褚	ioy
蚌	bgi
焙	bqh
钉	djj
糊	hym
迹	juz
柬	jxa
啰	lpk
雀	qzv
扫	sx
绅	ufs
纨	wks
媳	xon
障	vge
址	vpt
椎	vvm
孖	ziz
脯	pio
岱	dsu
葛	gtc
躬	gsu
氦	hsq
昊	hxo
桓	htm
茴	hbc
汲	jod
菌	jtc
乸	ndy
芡	qnc
嚷	rhk
榕	rdm
逍	xnz
猩	xkq
瑄	xrw
循	xux
颐	yoy
寓	ycb
郅	vue
苞	bcc
堡	bot
侪	ifr
怼	dcx
祼	geu
毫	hvm
晖	hvo
醪	lvy
锚	mvj
湄	med
呶	nvk
蕖	qbc
趋	qvz
腋	ywo
嗌	yuk
妤	ybn
愠	ytx
轴	vmi
胞	bco
庇	bug
碴	isu
宸	igb
汆	crr
番	pjt
腓	feo
麂	jpl
赍	jib
窖	jbx
熘	lqh
鹭	lyn
眯	moo
襦	riy
粟	sym
饕	tcu
醺	xyy
曜	yxo
殷	ybp
庾	yng
瑗	yew
丈	vga
聪	cse
爨	ceh
藩	fjc
蕃	boc
尬	gly
槐	hlm
际	jue
玦	jyw
勘	kjl
貘	miv
厦	uli
驶	upm
薯	uoc
娑	son
蜕	tci
毋	wia
旬	xug
烛	vih
龅	bci
镚	bfj
俶	iyr
椿	iym
邨	cye
悼	dxx
饹	leu
撼	hhf
濠	hvd
饸	hru
煌	hah
迦	jxz
谏	jny
诳	kay
䁖	lzo
拇	mof
飒	slf
麝	uwl
绦	tcs
婉	wln
勋	xyl
铱	yij
洞	tdd
谙	any
椴	dem
腭	ewo
淮	hld
晦	hco
荚	jcc
笺	jmv
垃	lat
酪	lxy
氓	mjw
噙	qnk
析	xim
飨	xsu
厢	xli
俑	yfr
屿	ynu
狈	bqq
弁	bnc
馃	gqu
翰	hhy
镬	hij
颊	jcy
珈	jxw
诫	joy
邝	kke
励	lul
谝	pxy
娆	rvn
茹	ric
赊	ueb
嵩	ssu
桐	tdm
菀	wlc
檄	xom
铉	xej
佯	yjr
臧	zhg
喳	iak
祯	vfu
铸	vyj
赘	vcb
镯	vpj
腙	zso
粲	chm
彻	iwx
疵	cib
跐	ciz
殆	dsd
硐	dau
缶	fcp
郜	gxe
睾	gcp
嘹	lmk
髅	lxg
纶	lus
谬	mpy
螃	pji
乓	phq
箧	qov
擎	qlu
拭	uuf
溯	syd
娲	wan
乂	yup
鸳	yrn
碜	ihu
椽	itm
歹	dga
构	gmm
褐	hwy
究	jqx
慷	khx
魁	kbg
癞	lsb
仂	lwr
羸	lew
陇	lfe
镂	lmj
嫚	mhn
缦	mhs
捺	nlf
彷	pjx
铅	ykj
沱	tpd
诏	vxy
诊	vhy
葆	bbc
缤	bbs
偲	cdr
铳	iaj
凋	dnd
惶	hax
讳	hcy
蛟	jni
驹	jvm
颏	key
溃	kcd
麟	lnl
淋	lvd
栊	ldm
馒	mku
沤	oy
醅	pwy
撇	ppf
祁	qoe
戕	qlg
俅	qwr
醛	qty
艏	ucv
沓	tlo
蜗	woi
晤	wyo
懈	xox
魇	ylg
秧	yhh
烨	ywh
钰	ycj
撰	vef
叱	iuk
炽	iuh
迭	dqz
惰	dix
燔	fkh
桨	jsm
诘	jqy
骏	jtm
侉	kvr
厘	loi
劣	lol
琉	lww
氯	lcq
麒	qol
熔	rdh
驷	sum
锑	tij
猥	wrq
奚	xiv
偃	ylr
谒	ywy
苡	ypc
茵	ybc
陨	yie
埗	byt
鹾	cpl
娣	dun
氐	dpp
妒	dyn
褂	gzy
胍	gxo
罕	hlb
笏	hyv
恍	hsx
炯	jfh
倔	jrr
珺	jtw
侩	kjr
砺	luu
络	lis
鳗	mky
旻	mno
募	myl
砷	ufu
蟀	uji
倘	tkr
隈	wwe
琇	xpw
缨	yks
蕴	ytc
奘	zgd
琢	vpw
龇	zii
镗	tjj
铵	azj
梆	bhm
嫡	don
辜	guu
鹫	jpn
锎	kdj
奎	kbd
愧	kcx
琨	kyw
崂	lvu
蚂	mdi
嫫	mpn
钕	nnj
埤	put
铍	poj
窍	qbx
锹	qnj
庶	uyg
嗵	tsk
圩	wet
绚	xes
砚	yhu
肴	yvo
蚴	ymi
棹	vxm
咥	xuk
耙	psl
阪	ble
犇	bfn
憧	isx
槌	ibm
绰	iis
篡	cev
皴	cyp
怠	dss
谠	dky
筜	dhv
氘	dcq
萼	ewc
阀	fsm
馥	fyh
哽	gjk
骸	hfg
骇	hsm
缳	hts
镓	jxj
戋	jma
爵	jyv
隽	jen
哙	kjk
喟	kck
濑	lsd
镭	lej
髎	lmg
鸰	lln
娈	ltn
莽	mkc
爿	pka
僻	pur
噼	pik
鳍	qoy
羟	qsy
羌	qly
鳃	sdy
唾	tik
狭	xcq
冼	xxd
靥	ywi
峪	ycu
煜	ych
徵	vpx
钯	bdj
垞	ist
偿	ijr
瞋	ifo
脞	cq
惦	dnx
昉	fko
讽	fjy
尴	gjy
眭	svo
骺	hxg
桦	hzm
玑	jiw
缉	jis
烬	jvh
胩	kdo
亢	kgw
夔	kbw
邋	laz
藜	loc
懦	nix
怄	oyx
玘	qpw
悄	qnx
袪	qvy
濡	rid
箬	riv
铯	swj
蜃	udi
燊	ufh
姒	sun
悚	sfx
祟	sci
髓	sn
琐	sqw
獭	tdq
渭	wqd
鲔	wry
芜	wic
纤	xms
橡	xkm
鸮	xnn
煦	xcd
埙	xyt
鸯	yhn
彰	vhp
跖	voz
癿	bqb
膀	bko
褙	bqy
匕	bpp
辟	pux
扁	pmh
璨	chw
漕	cvd
杈	iam
彳	iup
扽	ddf
酚	ffy
蝠	fii
弘	hdg
乩	jig
荠	juc
疆	jlg
噱	xyk
燎	lmh
耧	lxl
辔	pqi
霹	piy
扦	qmf
氰	qlq
呻	ufk
膛	tjo
叨	dck
鸵	tpn
顽	wky
魍	wkg
蜥	xii
芗	xlc
楔	xpm
眩	xeo
驯	xtm
谚	yhy
龈	yni
舆	ybb
昝	zlo
绽	vhs
荷	hwc
敞	ikw
豉	ipd
惆	ixx
酬	ixy
泚	cpd
囱	csp
蠹	dya
筏	fsv
舫	fkv
觚	guj
蘅	hhc
珲	huw
祭	vsu
矫	jmu
噤	jvk
胫	jjo
阆	lgm
釐	xil
窿	ldx
髦	mvi
贸	mxb
邈	mzz
湫	qqd
龋	qni
蹂	rxz
墅	uyt
泗	sud
饲	suu
忑	twx
骰	txg
匣	xck
浔	xud
氩	ylq
琰	ylw
痈	ysb
钊	vcj
衷	vsw
绉	vms
纂	zyv
绷	bjs
魑	iig
绸	ixs
钿	dnj
诟	gmy
壑	hwt
堠	hmt
瓠	hyg
烀	huh
遑	haz
戛	jca
鳉	jly
玠	jow
迥	jfz
韭	jef
裾	jvy
涓	jrd
崛	jyu
箜	ksv
喹	kbk
壸	kiu
悃	kix
涞	lfd
蠊	lzi
垄	lfl
芦	lic
颅	liy
扪	mgf
冕	mxo
丕	pia
翩	pmy
鸲	qbn
鞣	rxg
莘	ufc
烁	uih
澌	sid
忝	txt
帷	wej
钨	wuj
隙	xue
巷	hgg
邂	xoz
匈	xsg
欻	xvq
堰	yht
沂	yod
瑀	ynw
赃	zhb
沼	vbd
斟	vfd
烝	vgh
嫒	aun
悖	bqx
馇	iau
阐	ilm
殂	cid
疍	dhp
铛	dhj
靛	dnq
尜	gsx
诰	gxy
胳	geo
菰	guc
吭	hjk
曷	hro
珩	hhw
糇	hxm
蝗	hai
虺	hni
讥	jiy
稼	jzh
狡	jzq
郊	jne
睫	jqo
眷	jeo
峻	jtu
轲	kei
骷	kug
盔	kvm
锟	kyj
斓	lkw
螂	lji
埒	lot
庐	lig
犸	mdq
幔	mhj
蠓	mji
泌	mud
柰	nsm
坭	not
瓯	ouw
苒	rlc
戎	rdg
冗	rf
搡	skf
绥	sbs
狲	syq
苔	tdc
誊	thj
湍	tr
褪	tty
惋	wlx
巍	wwu
邬	wue
屃	xuu
朽	xem
勖	xcl
墟	xvt
谖	xry
胰	yoo
猗	yiq
锃	zfj
鹧	vwn
祉	vpu
蜘	vii
肫	vyo
眦	zuo
蕞	zcc
酢	ziy
螯	api
堡	pyt
襞	buy
蝙	bmi
帛	bpb
簸	bqv
惭	ckx
沧	chd
忏	ihx
怅	igx
骋	ijm
弛	iog
绌	iys
黜	iyh
钏	iej
璁	csw
撺	crf
淬	ccd
埭	dst
担	dhf
荻	doc
鲷	dny
篼	dzv
蔸	dzc
锇	erj
矾	fku
赅	gdb
鲧	giy
焓	hkh
郃	hre
貉	hrv
糊	hum
攉	hof
旌	jkf
蹶	jyz
楷	kgm
喾	kyd
漉	lyd
簏	lyv
忞	mnw
缪	mbs
氖	ngq
瑙	nbw
淖	nxd
俳	pfr
哌	psk
沛	pqd
篷	phv
乒	pkj
抔	pxf
潽	pud
杞	qpm
綮	qjs
瞿	qbv
荃	qtc
丧	sht
觞	uhj
嗣	suk
菘	ssc
隧	sce
砼	tdu
恸	tax
椭	tqm
洼	wad
庠	xag
讶	yly
铟	ybj
谮	zdy
湛	vhd
锗	vtj
骤	vmm
鬃	zsi
咉	yhk
褓	bby
蓓	bqc
篦	buv
坼	iwt
氚	irq
鹑	iun
蔟	cyc
忖	cix
痤	cpb
耷	dae
瘩	dab
焘	tch
涤	dod
邸	dpe
玎	dkw
铥	dqj
钭	dcj
缎	des
碓	dcu
匐	fig
缟	gbs
蛄	gui
姮	hhn
逅	hmz
鹄	hin
婳	hzn
宦	heb
纪	jps
痉	jjb
柩	jpm
琚	jvw
咀	znk
窠	kex
刳	kud
夼	ksd
蝰	kbi
榄	llm
虻	mhi
岷	mnu
镆	mij
囔	nhk
辇	nxi
徘	pfx
庖	pvg
貔	pov
嫔	pnn
匍	pig
朴	pmm
槭	qum
蹊	xiz
阡	qme
磬	qju
罄	qjf
蝤	qwi
鹊	qrn
瘙	sxb
韶	uvy
潲	uxd
纾	uus
蒐	szc
飕	szf
跆	tfz
忐	tlx
珽	taw
驮	dim
烷	wkh
脘	wlo
杌	wym
诬	wuy
徙	xpx
辖	xci
涎	xzd
惺	xkx
峄	yuu
镱	yuj
揖	yif
荑	toc
颍	yay
甬	yfs
镛	ysj
俣	ynr
钺	yrj
錾	zhj
晢	vro
卮	vip
踪	zsz
诹	zzy
遂	sbz
稗	bsh
邶	bqe
陂	poe
砵	bou
艚	cvv
谄	ily
亍	iya
缞	cvs
砥	dpu
蚪	dci
婀	een
铒	eyj
璠	fkw
钒	fkj
妨	fjn
淝	fed
氛	ffq
俸	ffr
酆	fge
桴	fim
腑	foo
麸	fum
垓	gdt
倌	grr
篁	hav
睑	jxo
儆	jar
鬏	jqi
橛	jym
捃	jtf
岢	ktu
炣	kth
髁	keg
筘	kmv
焜	kyh
睐	lso
痢	lub
鲢	lzy
缭	lms
崚	lhu
茏	ldc
泷	uld
镥	loj
蟆	msi
劢	msl
媄	mrn
麋	mol
艿	ngc
柠	nlm
狍	pvq
圮	ppt
鄱	ppe
魄	pib
亓	qoa
憩	qux
嫱	qan
穹	qdx
蚯	qqi
铨	qtj
绻	qys
壤	rkt
攘	rkf
桡	rvm
绍	uxs
珅	ufw
埘	uot
竦	sfl
夙	syj
邰	tfe
疃	tyt
饨	tuu
琬	wlw
歙	uwq
舷	xzv
祆	xmu
嚣	xnk
儇	xrr
旋	xef
曛	xyo
邺	ywe
缢	yus
郢	yae
踊	yfz
欤	ybq
龠	yrr
甾	zdi
咤	vlk
曌	vxk
谪	vry
赭	vti
鸩	vdn
峥	vgu
窒	vux
茱	vuc
篆	vev
馇	vau
骜	aim
腌	aao
叆	auy
隘	aue
埯	azt
懊	aix
鲃	bay
濞	bud
摽	bbf
髌	bvg
瓿	byw
郴	ife
宬	ihb
瘳	izb
莼	iuc
琮	cdw
萃	ccc
傣	dgr
蹈	dbz
嶝	dfu
戥	djg
籴	dor
耋	dql
昳	dqo
氡	dsq
噩	eww
鹗	ewn
珥	eyw
珐	flw
狒	fqq
翡	fry
痱	fqb
鲼	fdy
黻	fib
驸	fym
圪	get
赓	ggb
彀	gmu
锢	gyj
汩	god
胱	glo
庋	gng
鲑	gvy
腘	gpo
鞨	hrg
薨	hsc
煳	hih
蝴	hii
怙	hyx
镮	htj
鬟	hti
洄	hbd
蛔	hbi
贿	hcb
夥	hqg
肼	jao
兢	jkk
扃	jsh
厩	jpi
炬	jch
钧	jyj
疴	keb
圹	kkt
铑	lbj
簕	lwv
诔	lry
魉	lsg
獠	lmq
躏	lvz
懔	lmx
垆	lit
胪	lio
葎	lcc
孪	lty
峦	ltu
铆	mbj
袂	mqy
篾	mov
靺	mig
衲	nly
猱	nvq
佞	njr
耦	ool
脬	pco
椪	pfm
譬	puy
苤	pwc
娉	pkn
埼	qot
迄	quz
缱	qxs
樯	qam
锲	qoj
黥	qlh
顷	qab
箐	qjv
蛩	qdi
泅	qwd
酋	qwb
鳅	qqy
觑	qcj
嵘	rdu
蠕	rii
颡	sky
啬	swt
蟮	uhi
姗	ujn
墒	uht
槊	uim
溲	szd
肃	sya
濉	svd
榫	sim
瑭	tjw
弢	tcg
鹈	ton
莛	tlc
蜓	tli
彖	te
呙	gok
猬	wqq
偎	wwr
汶	wdd
肟	wio
庑	wog
圬	wut
遐	xcz
氙	xmq
胁	xqo
荇	xjc
煋	xkh
芎	xsc
胥	xvo
畜	iyt
䶮	yll
卬	aje
熠	yuh
慵	ysx
嵛	ybu
谀	yby
禺	yba
氲	yyq
圳	vdt
宙	vmb
馔	veu
恣	zux
滓	zpd
耔	zpl
兹	cob
俎	zoq
祚	ziu
訾	zpy
镝	dij
桉	anm
盎	ag
肮	ah
奡	aia
岙	aiu
笆	bav
枹	bcm
栟	bfm
甏	bfw
绷	bfs
陛	bue
膑	bvo
黪	clh
姹	iln
猖	ihq
琤	igw
樗	ium
遄	itz
怆	ikx
辏	cmi
瘁	ccb
璀	cn
褡	day
啶	djk
疔	dkb
牍	dip
耑	dru
惇	dyx
垩	ewt
罘	fis
杲	gbo
槁	gbm
舸	gtv
袼	gey
茛	gdc
觏	gmj
姤	gmn
牯	gon
诂	goy
绲	gis
辊	gii
蜾	gqi
鼾	hjb
闳	hdm
戽	hyh
豢	hej
彗	hcf
翚	hvy
隳	hve
馄	huu
诨	hty
钬	hqj
徛	jux
骥	jum
济	jpd
戬	jxg
耩	jsl
芥	gsc
孓	jya
爝	jyh
矍	jyo
噘	jtk
竣	jtl
墈	kht
㸆	kxh
犒	kxn
瞌	keo
矻	kuu
贶	kkb
蒉	kcc
籁	lsv
榔	ljm
埌	lgt
罍	lef
塄	lht
篱	lov
缡	los
娌	lpn
跞	luz
郦	lue
僚	lmr
尥	lby
蹽	lnz
鎏	lwj
尨	mja
嵝	lcu
舻	liv
辘	lyi
锊	lrj
猡	lpq
瘰	lqb
蔓	whc
邙	mje
懋	mxx
峁	mbu
懑	mdx
勐	mjl
猕	moq
谧	muy
丏	mxa
藐	mzc
缗	mns
黾	mmk
模	mim
鼐	nsn
忸	nex
杻	nem
杻	icm
衄	ncx
疟	nrb
锘	nij
杷	psm
匏	pvb
霈	pqy
湓	pgd
怦	pgx
琵	pow
邳	pie
缥	pns
氕	ppq
叵	pqk
芑	qpc
堑	qnt
橇	qnm
伽	gar
吣	qvk
揿	qvf
囷	qyk
穰	rjh
妊	rdn
驲	rum
褥	ryy
脎	slo
靸	sdg
馓	slu
臊	sxo
穑	swh
畲	uer
蓍	uic
塾	uit
腧	uyo
兕	sue
笥	suv
锶	sij
嗾	sck
薮	scc
嗉	syk
蔌	syc
甦	sug
宿	xeb
宿	xpb
谇	scy
唢	sqk
酞	tsy
啴	ilk
萄	tvc
绨	tus
餮	tod
萜	tpc
侹	tar
烃	tkh
梃	tam
梃	tjm
哃	tdk
抟	ttf
鲀	tuy
窊	wax
嵬	weu
艉	wrv
梧	wim
寤	wyb
鹉	won
谿	xig
猃	xxq
缃	xls
蛸	xni
獬	xoq
煊	xrh
禤	xru
蚜	ysi
轧	vsi
怏	ygx
峣	yvu
弋	yua
狺	ynq
鄞	yne
腴	ybo
予	ybs
掾	yef
垸	yet
慥	zxx
迮	zrz
缯	zgs
璋	vhw
笊	vxv
柘	vwm
赈	vdb
侦	vfr
埴	vot
踵	vfz
舯	vsv
妯	vxn
胄	vmo
荮	vmc
贮	vyb
瞩	voo
麈	vol
侏	vur
竺	viv
啭	vek
晫	vpo
驺	zzm
诅	zoy
怍	zix
叨	dvk
拤	qcf
炘	xbh
蜚	fri
嘌	pbk
垯	dat
崀	lgu
崾	yxu
蔼	apc
锿	aij
鹌	ann
聱	ape
遨	apz
塝	bgt
蚌	bfi
雹	bvy
鸨	bbn
碚	bqu
鞴	bqg
坌	bdt
妣	bpn
贲	bfb
睥	puo
砭	bmu
笾	bmv
摈	bvf
殡	bvd
玢	ffw
擘	biu
醭	biy
骖	cjm
螬	cvi
涔	cgd
𥻗	ismi
侘	ilr
躔	ikz
襜	ijy
伥	ihr
怊	icx
谌	igy
棽	ifl
棽	ufl
澄	dfd
漦	iou
茌	ioc
褫	ipy
笞	iiv
艟	isv
畴	ixt
帱	ixj
滁	iid
搐	iyf
圌	ibk
惙	iix
匆	csg
猝	cyq
漼	cnd
轪	dsi
殚	djd
箪	djv
垱	dgt
宕	dgb
玓	duw
缔	dus
诋	dpy
柢	dpm
扂	dnh
琔	dnw
癜	dnb
佃	dnr
窎	dbx
铫	yvj
牒	dqp
绖	dqs
仃	dkr
耵	dke
侗	dar
煅	deh
峨	eru
遏	ewz
咡	eek
耏	etp
垡	fst
砝	fdu
蘩	fkc
繁	pps
悱	frx
偾	fdr
咐	fyk
趺	fuz
鄜	fue
澉	gld
玕	gjw
堽	ght
锆	gxj
篙	gcv
绠	gjs
蚣	gsi
岣	gcu
篝	gzv
梏	gym
牿	gyn
榖	goh
酤	guy
坬	gzt
筦	gyv
莞	gyc
妫	gvn
鳜	gcy
帼	gpj
馘	gpu
聒	goe
醢	hgy
垾	hht
龢	hrh
熇	hwh
竑	hdl
翃	hdy
篌	hxv
鲘	hmy
铧	hcj
峘	htu
湟	had
璜	haw
隍	hae
芨	jic
觭	jij
翦	jxy
搛	jmf
噍	jbk
檞	jwm
妗	jvn
缙	jvs
荩	jvc
迳	jjz
憬	jax
阱	jae
岠	jcu
蠲	jry
垲	kgt
忾	ksx
栲	kbm
缂	kws
牁	kep
裉	kdy
绔	kys
郐	kje
鲙	kjy
蒯	kad
睽	kbo
逵	kbz
馗	kbj
跬	kn
鹍	kyn
稂	ljh
锒	ljj
塱	lkt
烺	lkh
儡	lrr
燎	lzh
趔	loz
檩	lmm
舲	llv
蕗	lyc
滦	ltd
纶	grs
杩	mlm
漭	mkd
牦	mvn
瑁	mxw
嵋	meu
钔	mgj
娩	mxn
酩	may
侔	mxr
仫	myr
𧿹	mozm
蝻	nli
曩	nko
铙	nvj
怩	nox
猊	noq
埝	nnt
搦	nif
讴	ouy
筢	psv
蒎	psc
槃	pkm
蟠	pki
襻	phy
抨	pgf
砒	piu
仳	ppr
纰	pis
俜	pkr
钷	pqj
镤	pij
朴	pim
跂	qoz
踦	ypz
掮	qzf
岍	qmu
汧	qmd
戗	qkg
伽	qqr
鲭	qky
邛	qde
犰	qwq
鞧	qqg
灈	qbd
璩	qbw
蠼	qbi
阒	qcm
筌	qtv
炔	qth
埆	qrt
荏	rhc
嚅	rik
孺	riz
溽	ryd
缛	rys
蕤	rbc
蚋	rci
磉	sku
埽	sxt
铩	uaj
舢	ujv
绱	ugs
晌	uko
劭	uxl
诜	ufy
陞	uge
筮	uuv
酾	uiy
狩	umq
绶	ums
孀	uln
妁	uin
缌	sis
虒	sip
忪	ssx
螋	szi
锼	szj
愫	syx
簌	syv
窣	sux
飧	syu
睃	soo
羧	soy
挲	sou
溻	tad
褟	tay
沓	dso
炱	tfh
螳	tji
鄌	tje
绹	tvs
倜	tur
趯	tuz
黇	tmh
瑱	tnw
蜩	tmi
烔	tdh
酴	tiy
菟	tyc
橐	tpa
酡	tpy
鼍	tpk
畖	wat
畹	wlt
箢	yrv
辋	wki
尪	why
桅	wem
煟	wqh
娓	wrn
硙	wqu
芠	wgc
紊	whs
郚	wie
屼	wyu
俙	xir
郗	xie
筅	xxv
跣	xxz
暹	xmz
纤	qns
洨	xmd
翛	xnr
燮	xoh
绁	xos
薤	xoc
饧	xlu
夐	xad
貅	xqv
衒	xex
徇	xtx
堐	yst
砑	ylu
桠	yam
筵	ykv
垟	yjt
徉	yjx
羕	ygy
繇	yxv
圯	yot
饴	you
瘗	yub
旖	ypf
舣	ypv
钇	ypj
佚	yur
垠	ynt
堙	ybt
撄	ykf
颙	ydy
臃	yso
佣	yar
蜮	yci
妘	yun
韫	ytw
臜	zao
瓒	zhw
糌	zjm
牂	zhp
璪	zbw
舴	zrv
砟	vdu
仉	vkr
獐	vhq
蔗	vwc
蓁	vfc
絷	vos
瘃	vib
琢	zpw
偬	zfr
综	zfs
鄹	zze
缵	zys
捽	zpf
戛	gaa
嫚	mjn
叚	xca
锪	hoj
