的	d
一	y
是	u
我	w
在	z
人	r
有	yz
这	v
他	t
来	l
个	g
说	uo
上	uh
到	dc
就	j
大	da
那	n
也	ye
嗯	e
嗯	enk
吗	m
或	h
地	de
子	zi
请	q
下	x
时	ui
看	k
要	yc
她	ta
放	f
中	vs
没	mw
但	dj
然	rj
里	li
为	ww
过	go
自	zip
好	hc
得	der
得	dwr
去	qu
会	hv
天	tm
还	hd
后	hz
以	yi
小	xn
和	he
对	dv
想	xl
级	ji
起	qi
神	uf
深	ufd
啊	a
集	jiv
手	uz
而	er
只	vi
生	ug
头	tz
事	uih
多	do
家	jx
面	mm
知	viu
开	kd
如	ru
无	wu
很	hf
点	dm
前	qm
发	fa
经	jk
按	an
把	b
老	lc
些	xp
话	hx
已	yik
又	yzv
声	ugu
意	yil
啦	la
回	hvw
笑	xnv
哦	o
眼	yj
了	le
成	i
年	nm
见	jm
当	dh
女	nv
真	vf
两	ll
力	liv
做	zo
气	qir
从	c
用	ys
长	ih
长	vhp
动	ds
间	jmm
国	gow
晒	ud
走	zz
让	rh
被	bw
不	bu
给	gw
正	vg
问	wf
打	daf
明	mk
儿	erp
法	fad
才	cd
几	jip
行	hh
行	xkr
定	dk
此	ci
进	jb
再	zd
种	vsh
将	jl
实	uig
同	ts
最	zv
本	bf
向	xlp
分	ff
学	xt
高	gc
第	di
感	gj
怎	zf
连	lm
听	tk
边	bm
作	zor
其	qic
吧	ba
却	qt
口	kz
觉	jt
因	yb
白	bd
次	cid
出	iu
洗	xi
外	wd
新	xb
光	gl
风	fg
住	vu
果	goo
与	yu
全	qr
二	erh
候	hzr
公	gs
相	xla
等	dg
别	bp
张	vh
部	bul
太	td
日	ri
少	uc
理	liw
重	vsp
王	wh
像	xlr
脸	lmo
比	bi
快	kk
何	her
水	uv
名	mkx
东	dsq
叫	jn
西	xih
应	yk
便	bmr
马	ma
难	nj
轻	qk
更	gg
美	mwb
位	wwr
关	gr
机	jia
接	jp
先	xm
文	wfw
处	iuw
并	bk
望	whw
常	ihx
完	wj
着	ve
于	yue
飞	fw
师	uiu
者	vet
清	qkd
刚	gh
心	xbd
跟	gf
信	xbr
山	uj
爱	ai
内	nw
龙	ls
空	ks
带	dd
找	vc
原	yr
入	rup
李	lia
吃	ii
场	iht
平	p
林	lb
变	bmy
你	ni
使	uir
由	yzo
受	uza
亲	qb
命	mkr
目	mu
强	ql
男	njt
任	rf
该	gd
路	lu
车	ie
今	jbr
海	hdd
加	jxl
远	yre
活	ho
特	te
解	jpd
电	dmo
世	uin
性	xk
表	bn
许	xu
它	tag
立	lil
黑	hw
红	hs
花	hxc
转	vr
总	zs
城	ig
队	dve
孩	hdz
反	fj
工	gsh
满	mj
兵	bkq
物	wun
非	fws
云	yy
万	wjh
至	vih
干	gjh
通	tss
认	rfy
失	uip
火	hod
哥	ge
之	vid
五	wuh
惊	jkx
现	xmw
魔	mo
竟	jkl
姐	jpn
乎	hu
主	vud
剑	jmr
往	whr
量	llo
早	zc
结	jps
怕	pa
流	lq
删	ujk
湿	uid
突	tu
音	ybl
紧	jbu
指	vif
半	bj
记	jiy
且	qp
利	lih
倒	dcr
书	uu
步	buv
们	mf
教	jnt
喜	xiu
可	ke
越	yt
影	yko
谁	uvy
谁	uwy
冷	lg
道	dcb
告	gcn
落	lo
象	xld
容	rs
怪	gk
传	ir
钱	qmj
季	jih
提	ti
言	yjw
养	yh
每	mwr
双	ul
服	fu
击	jif
急	jid
哪	na
换	hr
数	uum
站	vj
奇	qid
房	fh
安	ang
管	grv
刻	kew
啥	ua
题	tio
衣	yiw
周	vz
样	yha
静	jkf
伤	uhr
百	bde
哇	wa
拿	nar
妈	man
办	bjl
星	xko
化	hxr
功	gsg
绝	jts
令	lk
般	bjv
必	bix
业	yeu
尔	erd
血	xtp
血	xpp
代	ddr
精	jkm
弟	dib
终	vss
近	jbj
条	tn
战	vjb
值	vir
青	qkf
界	jpt
整	vgh
字	zig
晚	wjo
民	mb
帮	bh
切	qpq
即	jig
忙	mh
交	jnl
暗	ano
夫	fue
员	yrk
根	gfa
石	uie
哈	ha
灵	lkx
夜	yew
父	fub
制	vin
友	yzu
阿	aa
息	xiz
冲	is
九	jq
保	bc
片	pm
形	xkk
阵	vfe
南	nju
决	jtd
各	gew
报	bcf
兴	xkx
阳	yhe
语	yuy
亿	yir
错	co
超	ic
刘	lqw
度	du
识	uiy
备	bww
慢	mjx
雪	xty
苦	ku
若	ro
领	lkr
收	uzv
底	dig
准	vy
体	tir
答	dav
众	vsr
千	qmp
消	xnd
筛	udv
罗	los
敢	gjv
留	lqp
克	keg
乐	lep
够	gz
跑	pc
显	xmo
嘴	zvk
官	grg
断	dr
未	wwh
势	uif
巨	ju
求	qq
论	ly
达	dad
则	ze
害	hdg
八	bap
单	djb
酒	jqd
脚	jno
脑	nc
楚	iua
雨	yuh
响	xlk
刀	dcv
确	qte
玉	yuw
沉	if
北	bwu
格	gea
停	tkr
陈	ife
市	uiw
朝	icu
喝	hek
组	zu
江	jld
团	tr
母	muv
章	vhl
装	vl
亮	llw
举	jux
照	vco
乱	lr
易	yio
足	zuk
黄	hl
修	xq
破	po
台	tds
球	qqw
呀	ya
包	bcb
义	yid
围	www
玩	wjw
复	fur
况	kl
楼	lz
痛	tsb
梦	mg
呼	huk
摇	ycf
期	qiq
英	ykc
低	dir
帝	dil
兄	xs
背	bwb
持	iif
爷	yeb
皇	hlb
七	qih
穿	irx
都	dz
运	yye
叶	yek
热	re
校	xna
谢	xpy
曾	cg
古	gu
细	xis
产	ij
睡	uvm
希	xii
旁	ph
另	lkk
露	luy
饿	ee
写	xpg
鬼	gv
娘	nl
取	que
式	uiq
除	iue
建	jmy
愿	yri
招	vcf
饭	fju
布	buu
续	xus
程	igh
首	uzb
观	gry
务	wuw
掉	dn
赶	gjz
忽	hub
身	ufp
术	uua
甚	ufq
差	ia
展	vju
争	vgd
品	pb
宝	bcg
香	xlh
斗	dzd
故	gug
雷	lw
念	nmr
段	drp
顿	dy
角	jnd
疑	yib
护	huf
闪	ujm
木	muu
月	ytk
需	xuy
调	dny
调	tny
类	lwm
妹	mwn
爸	bab
线	xms
左	zou
游	yzd
派	pd
谈	tj
呃	eek
冰	bkd
敌	diq
跳	tnz
居	juu
约	yts
巴	bak
您	nb
顾	gui
肯	kf
醒	xky
铁	tp
淡	djd
造	zcn
伙	hor
资	zid
群	qy
联	lme
商	uhl
号	hck
节	jpc
键	jmj
讲	jly
掌	vhx
赵	vcz
密	mi
久	jqx
病	bkb
卫	wwe
米	mib
继	jis
渐	jmd
追	vv
亚	yah
简	jmv
练	lms
基	jiq
选	xr
推	tv
噢	oo
改	gdk
退	tvg
味	wwk
份	ffr
忍	rfd
历	lii
器	qik
恐	ksg
引	ybg
皮	pi
习	xiv
靠	kc
导	dck
存	cy
莫	moc
区	quk
汉	hj
什	ufr
严	yjh
态	tdd
套	tc
买	md
幸	xkt
佛	fo
议	yiy
块	kkt
守	uzg
毛	mc
挥	hvf
胡	hug
板	bja
隐	ybe
怒	nu
床	il
拖	to
股	guo
忌	jik
班	bjw
图	tuw
礼	liu
独	duq
初	iuy
福	fuu
顺	uy
狂	klq
默	moh
证	vgy
否	fz
恶	eeh
缓	hrs
排	pdf
费	fwf
寒	hjg
哭	kuk
温	wfd
府	fug
担	djf
余	yur
钟	vsj
泪	lwd
仍	rg
具	juj
恩	en
毕	bib
警	jkc
蓝	lj
吸	xik
陆	lue
旧	jqu
压	yai
救	jqh
呆	ddk
河	hed
迷	mim
枪	qla
族	zuf
权	qra
叹	tjk
卷	jr
查	iaa
毫	hcw
春	iy
察	iag
圣	ugy
草	cc
较	jni
胜	ugo
遇	yuo
充	isw
史	uik
防	fhe
据	juf
猛	mgq
骑	qim
土	tuu
卡	ka
助	vuq
京	jkw
银	ybj
贵	gvv
永	ysd
质	vip
屋	wuu
须	xup
副	fuh
刺	cic
属	uuu
闻	wfm
境	jkt
禁	jba
负	fud
弄	ns
翻	fjp
虎	huh
层	cgu
喊	hjk
逃	tcv
晓	xno
座	zog
情	qkx
雅	yay
参	cj
射	ue
险	xme
划	hxg
坚	jmu
价	jxr
扬	yhf
科	keh
狠	hfq
野	yeo
秦	qbs
秘	mih
熟	uzw
置	vis
仙	xmr
模	moa
模	mua
波	bo
肉	rz
齐	qiw
舞	wur
脱	too
广	gld
姑	gun
麻	mag
投	tzf
顶	dkd
责	zef
景	jko
维	wws
设	uey
坏	hk
秀	xqh
败	bdb
眉	mwm
州	vzd
药	ycc
承	igl
狼	lh
专	vre
偷	tzr
画	hxh
吴	wuk
店	dmg
弹	djg
弹	tjg
欲	yub
抬	tdf
标	bna
秋	qqh
良	lld
际	jie
状	vld
烦	fjh
摆	bdf
戏	xiy
方	fhd
桌	vo
船	irv
短	dru
村	cya
某	mz
摸	mof
演	yjd
规	gve
萧	xnc
封	fgt
握	wo
田	tmw
藏	ch
震	vfy
混	hy
虚	xuh
透	tzh
凌	lkd
休	xqr
嘛	mak
梅	mwa
紫	ziv
歌	gek
临	lbu
毒	duf
宗	zsg
著	vuc
印	ybp
寻	xy
湖	hud
劲	jbs
职	vie
恨	hfx
婆	pod
杰	jpa
羽	yux
咱	zj
凡	fjj
飘	pn
嘿	hwk
呗	bwk
普	pu
宁	nk
均	jy
吓	xx
夏	xxe
读	duy
街	jpr
牛	nq
仿	fhr
胸	xso
浪	lhd
尚	uhx
宇	yug
骨	guk
纷	ffs
升	ugp
婚	hyn
善	ujy
弱	rog
卖	mdu
网	whk
朱	vup
雄	xsu
略	lt
杯	bwa
墙	qlt
环	hrw
罪	zvs
窗	ilx
柳	lqa
厅	tki
搞	gcf
端	drl
洞	dsd
拥	ysf
洋	yhd
肩	jmh
魂	hye
闹	ncm
蒙	mgc
灯	dgh
伯	bor
免	mmd
菜	cdc
验	yjm
测	ce
凤	fgj
鱼	yud
徐	xur
娜	nan
暴	bco
君	jyx
讨	tcy
辈	bwf
懂	dsx
腿	tvo
灭	mp
妙	mn
效	xnl
危	wwd
优	yzr
盘	pj
丁	dkh
趣	quz
妖	ycn
束	uuh
迎	ykp
舍	uer
彩	cda
挂	gx
笔	biv
狗	gzq
鲜	xmy
抗	kh
探	tjf
韩	hju
尼	niu
控	ksf
惜	xix
珠	vuw
抽	iz
创	ilr
归	gvu
挺	tkf
奋	ffd
陪	pw
硬	yke
避	biu
园	yrw
托	tof
训	xyy
勇	yss
聊	ln
奶	nd
庄	vlg
奔	bfd
镇	vfj
拳	qrb
研	yje
料	lnm
配	pwy
尊	zy
冒	mco
军	jyg
丹	djk
舒	uur
蛋	djp
哼	hg
妇	fun
句	jub
犯	fjq
欣	xbj
甲	jxo
欧	ou
课	key
扑	puf
菲	fwc
燕	yjn
曲	quo
躲	dou
玄	xrw
幻	hry
茶	iac
折	vef
傻	uar
姓	xkn
源	yrd
洛	lod
遍	bmh
臣	ifk
犹	yzq
漂	pnd
挑	tnf
获	hoc
绿	lv
峰	fgu
俊	jyr
疯	fgb
列	lp
恋	lmy
误	wuy
移	yih
纳	nas
党	dhx
罢	bas
腰	yco
巧	qn
孤	guz
闭	bim
碰	pg
镜	jkj
软	rr
厚	hzi
累	lwt
昨	zoo
幽	yzy
丈	vhh
牌	pdp
降	jle
降	xle
颜	yjl
劳	lcc
偏	pmr
省	ugx
糊	hum
馆	gru
烧	uch
谓	wwy
财	cdb
汗	hjd
奈	ndd
操	ccf
悄	qnx
残	cjh
尖	jmx
圈	qrw
项	xlg
撞	vlf
瞬	uym
忆	yix
盖	gdb
徒	tur
乡	xls
概	gda
荡	dhc
艺	yic
增	zg
祖	zuu
困	ky
殿	dmu
迅	xyv
横	hga
范	fjc
律	lvr
门	mfd
惨	cjx
聚	jue
含	hjr
凭	pk
躺	th
缘	yrs
抢	qlf
替	tie
孔	ksz
批	pif
康	khg
惑	hog
率	lvw
惯	grx
登	dgd
盯	dkm
宣	xrg
唱	ihk
诚	igy
剩	ugq
咬	yck
诸	vuy
触	iud
晨	ifo
疼	tg
漫	mjd
补	buy
吐	tuk
纯	iys
艾	aic
谷	gub
庭	tkg
挡	dhf
晃	hlo
吉	jiu
吹	iv
仇	izr
凝	nkd
鼓	guu
农	nsg
席	xig
征	vgr
帅	uk
缺	qtp
杜	dua
努	nun
判	pjb
谋	mzy
胆	djo
尘	ifx
扎	va
滚	gy
酷	kuy
闷	mfm
迟	iiu
稳	wfh
诺	no
闲	xmm
灰	hvu
朵	doj
盛	igw
盛	ugw
餐	cjb
爆	bch
伦	lyr
娇	jnn
侧	cer
愣	lgx
鼻	biz
轮	lyi
昏	hyu
抖	dzf
敏	mbr
词	ciy
慌	hlx
愤	ffx
怜	lmx
颤	ijw
阶	jpe
苍	chc
距	juz
郑	vgb
川	irp
逼	bih
县	xmq
忧	yzx
童	tsl
丢	dq
荣	rsc
逐	vuu
傲	ao
戴	ddt
芒	mhc
庆	qkg
伴	bjr
供	gsr
遥	yca
阻	zue
例	lir
睁	vgm
岛	dcn
遗	yiv
瞪	dgm
慕	muc
博	bou
猜	cdq
净	jkd
泽	zed
炼	lmh
珍	vfw
绍	ucs
爬	pap
丫	yab
炸	vah
凶	xsi
郎	lhl
宿	xqg
怨	yrx
醉	zvy
拼	pbf
迫	pob
革	gen
瞧	qnm
奥	aop
输	uui
莉	lic
忠	vsv
肏	ccp
颗	keo
呢	ne
旅	lvf
仁	rfr
鸟	nn
骗	pmm
浩	hcd
塔	tat
胖	pho
枫	fga
拔	baf
赞	zjn
炮	pch
凯	kdu
芳	fhc
浑	hyd
夺	dod
宽	kr
堆	dvt
裂	lph
遭	zch
赤	iit
旋	xrf
扭	nqf
悉	xip
擦	ca
典	dmk
匆	cs
评	pky
纵	zss
莲	lmc
乌	wub
跃	ytz
贴	tpb
丰	fgs
隔	gee
辛	xbl
抵	dif
竹	vur
彻	ier
摩	mog
轰	hsi
编	bms
肚	duo
插	iaf
哎	aik
耐	nde
辉	hvx
扶	fuf
貌	mcp
额	eeg
票	pnx
录	lux
膀	bho
鹰	ykg
撸	luf
孟	mgz
瑞	rv
唇	iyi
暂	zji
琴	qbw
踪	zsz
码	mae
慰	wwu
蛇	uei
玲	lkw
晕	yyo
吖	aak
轩	xri
粗	cu
掩	yjf
屁	piu
仰	yhr
零	lky
盟	mgo
贼	zw
洪	hsd
悟	wux
固	guw
冬	dsw
滑	hxd
甜	tmq
郁	yuu
琳	lbw
辆	lli
乃	ndv
暖	nr
妮	nin
挣	vgf
估	gur
坦	tjt
甘	gjn
佩	pwr
莱	ld
享	xlw
吼	hzk
构	gza
粉	ffm
吻	wfk
潜	qmd
瓶	pkb
偶	our
戒	jpg
浓	nsd
毁	hvj
销	xnj
迪	diy
绕	rc
勒	leg
勒	lwg
帐	vhj
废	fwg
延	yjp
敲	qnw
烂	ljh
曼	mjo
厌	yji
宜	yig
羞	xqy
吟	ybk
滴	did
爹	dp
晴	qko
协	xpu
央	yhk
肖	xnx
缠	ijs
脆	cv
痕	hfb
翔	xly
薄	bcc
劝	qry
鸣	mkk
倾	qkr
彼	bir
扔	rgf
检	jma
耀	ycx
痴	iib
姆	mun
篇	pmv
椅	yia
厂	ihh
董	dsc
熊	xss
埋	mdt
乖	gkq
狐	huq
蒋	jlc
踏	taz
隆	lse
括	ko
潮	icd
穷	qs
聪	cse
唤	hrk
版	bjp
旗	qif
焦	jnv
猫	mcq
盗	dcd
款	kru
荒	hlc
域	yut
脉	mdo
授	uzf
融	rsh
狱	yuq
访	fhy
桥	qna
霸	bay
池	iid
钻	zr
港	ghd
喃	njk
廷	tkq
乘	igq
玛	maw
扯	ief
岳	ytq
弯	wjy
夹	jxh
辞	ciq
岸	anu
岂	qiu
屈	quu
恼	ncx
召	vcd
嘞	lwk
载	zdt
皆	jpb
颇	pop
染	rjd
爽	uld
亏	kv
吞	ty
惹	rec
哀	aiw
乔	qnp
趁	ifz
铺	puj
脏	zh
吕	lvk
倍	bwr
汤	thd
振	vff
婷	tkn
牢	lcg
扰	rcf
溜	lqd
庞	phg
臭	izz
悦	ytx
赫	het
赢	ykw
跪	gvz
麦	mdf
枝	via
侠	xxr
泥	nid
赌	dub
弓	gsk
罩	vcs
疾	jib
符	fuv
垂	ivp
漠	mod
脖	boo
饮	ybu
懒	ljx
肤	fuo
堪	kj
燃	rjh
卓	vob
赖	ldh
宾	bb
贾	jxx
喘	irk
吵	ick
冥	mkg
库	kug
碗	wje
航	hhv
踢	tiz
姨	yin
啸	xnk
龄	lkv
阁	gem
舌	ueq
箱	xlv
冯	fgd
邦	bhf
钢	ghj
霞	xxy
促	cur
泡	pcd
重	isp
盾	dyp
羊	yhb
碧	biw
援	yrf
抹	maf
倩	qmr
锐	rvj
喷	pf
拦	ljf
嘉	jxu
辰	ifi
繁	fjr
抛	pcf
嫁	jxn
咒	vzk
虫	isk
审	ufg
献	xmu
拉	laf
杀	uai
葛	gec
袁	yrt
摔	ukf
序	xug
筑	vuv
斜	xpr
瓦	wah
涂	tud
湾	wjd
莎	uac
崇	isu
猎	lpq
娃	wan
梯	tia
桃	tca
豆	dzh
径	jkr
疲	pib
搬	bjf
瓜	gxp
润	ry
铃	lkj
蛮	mjy
蒂	dic
拨	bof
涛	tcd
予	yus
勾	gzb
惠	hvh
析	xia
砍	kje
撑	igf
措	cof
币	bip
薇	wwc
督	duu
祥	xlu
怖	bux
侵	qbr
岩	yju
糟	zcm
盈	ykn
斩	vji
签	qmv
掏	tcf
夸	kx
液	yed
姬	jin
愧	kvx
汇	hvd
柱	vua
粮	llm
堡	bcr
仗	vhr
笨	bfv
奏	zzs
歉	qmb
甩	uko
怔	vgx
允	yys
祸	hou
耶	yee
拆	id
爵	jta
穴	xtg
租	zuh
培	pwt
咋	za
井	jke
窝	wox
弥	mig
匹	pik
凑	cz
奸	jmn
陌	moe
核	hea
卧	wok
幅	fuj
眨	vam
耗	hcl
卢	lub
扣	kzf
丑	izv
孝	xnt
矛	mcy
氛	ffq
衡	hgr
陶	tce
腾	tgo
汪	whd
僵	jlr
疗	lnb
妃	fwn
罚	fas
棋	qia
咐	fuk
泛	fjd
愁	izh
慈	cib
肥	fwo
屌	dnu
笼	lsv
篮	ljv
俱	jur
惟	wwx
柜	gva
捉	vof
悬	xrq
霍	hoy
泄	xpd
咽	yjk
齿	iiv
秒	mnh
勤	qbn
扩	kof
屏	pku
霜	uly
袍	pcy
蝶	dpi
祭	jix
厨	iui
胁	xpo
朋	pgo
赚	vrb
尬	ga
尴	gjy
昌	iho
贺	hel
巾	jbk
描	mnf
捕	buf
陵	lke
咳	kek
扇	ujh
绵	mms
催	cvr
宠	isg
贪	tjr
辱	rui
寸	cyh
搂	lzf
饶	rcu
跌	dpz
肌	jio
抑	yif
纹	wfs
柔	rzy
宏	hsg
萍	pkc
驻	vum
丛	csr
俄	eer
蕾	lwc
挨	aif
迈	mdw
辩	bml
埃	ait
灾	zdg
渡	dud
抓	vx
雕	dnk
鼠	uuj
辣	lal
刷	ux
斥	iij
裙	qyy
翠	cvx
饱	bcu
掠	ltf
矮	aiu
瑶	ycw
捏	np
渴	ked
谅	lly
昂	ah
沟	gzd
涉	ued
驶	uim
摄	uef
婉	wjn
姜	jlb
碍	aie
荷	hec
魅	mwg
玫	mww
裁	cdt
坡	pot
邓	dgy
歪	wdb
乏	fap
申	ufo
割	geg
巫	wug
棒	bha
阔	kom
贯	grm
柄	bka
社	ueu
覆	fux
婴	ykb
锅	goj
陛	bie
遮	veg
帕	paj
咖	kak
嫌	xmn
胳	geo
挖	waf
啪	pak
矿	kle
爪	vcp
爪	vxp
眠	mmm
穆	muh
啡	fwk
脾	pio
恒	hgx
玻	bow
曰	ytw
驱	qum
猴	hzq
佣	ysr
舅	jqj
铜	tsj
娟	jrn
淫	ybd
吩	ffk
诡	gvy
姻	ybn
晰	xio
亭	tkw
邀	ycb
哄	hsk
柯	kea
筋	jbv
崔	cvu
捷	jpf
淋	lbd
辑	jii
棍	gya
绳	ugs
频	pbv
廊	lhg
畏	wwt
苗	mnc
盼	pjm
耍	uxe
煞	uad
寝	qbg
瞒	mjm
添	tmd
纠	jqs
慨	kdx
嚷	rhk
驰	iim
拐	gkf
宴	yjg
津	jbd
岚	lju
耻	iie
挽	wjf
牲	ugn
乳	rua
仓	chr
逛	glq
樱	yka
兼	jmb
戈	geq
哗	hxk
涯	yad
捧	pgf
铭	mkj
障	vhe
跨	kxz
妥	toa
揉	rzf
晋	jbh
寨	vd
污	wud
乾	qmu
馨	xbu
呈	igk
卿	qkp
楠	nja
囧	js
裸	loy
链	lmj
灌	grd
昆	kyo
帽	mcj
阅	ytm
蹲	dyz
踩	cdz
窜	cr
哑	yak
趴	paz
逢	fgw
韵	yyl
尹	ybx
谦	qmy
档	dha
沾	vjd
订	dky
朴	pua
瞎	xxm
鞭	bmg
俺	anr
斤	jbp
雀	qtx
慎	ufx
盆	pff
迁	qmq
镖	bnj
芬	ffc
崖	yau
丘	qqj
庙	mng
潘	pjd
拓	taf
纱	uas
漏	lzd
谨	jby
珊	ujw
仆	pur
宙	vzg
传	vrr
叮	dkk
捂	wuf
诧	iay
柴	idv
杆	gja
坠	vve
赔	pwb
涨	vhd
嘟	duk
崩	bg
薛	xtc
藤	tgc
税	uvh
枯	kua
糖	thm
怀	hkx
骄	jnm
羡	xmb
糕	gcm
彬	bba
疏	uup
堵	dut
眸	mzm
芸	yyc
考	kct
溪	xid
谎	hly
能	ng
稿	gch
哟	yo
冤	yrg
咧	lpk
宛	wjg
嫩	nf
憾	hjx
偿	ihr
腔	qlo
哩	lik
豹	bcp
瑰	gvw
绑	bhs
澡	zcd
兮	xib
雯	wfy
邻	lbr
骇	hdm
坑	kg
伐	far
烁	uoh
葬	zhc
诀	jty
兰	ljb
鄙	bik
鹿	lug
柏	bda
柏	boa
溃	kvd
朕	vfo
舟	vzp
躁	zcz
趟	thz
霉	mwy
侦	vfr
娅	yan
庸	ysg
削	xtx
砰	pge
耿	gge
牺	xin
筒	tsv
旭	xuj
胎	tdo
淑	uud
龟	gvd
儒	rur
宅	vdg
押	yaf
旨	vib
册	cek
弦	xmg
栏	lja
衷	vsw
刮	gxq
艇	tkv
岗	ghu
赴	fuz
策	cev
囊	nh
颊	jxj
疆	jlg
炉	luh
旺	who
烤	kch
逊	xyz
狸	liq
愕	eex
叠	dpy
晌	uho
麟	lbg
粒	lim
拟	nif
俏	qnr
杖	vha
芝	vic
衬	ify
捡	jmf
遵	zyb
桶	tsa
滩	tjd
琼	qsw
昊	hco
颈	jks
蹦	bgz
寡	gxg
贞	vfb
凰	hlj
哨	uck
茹	ruc
劣	lpx
嘱	vuk
沃	wod
厢	xli
摘	vdf
砸	zae
坤	kyt
匙	uio
拢	lsf
谭	tjy
翁	wg
竭	jpl
廉	lmg
械	xpa
辅	fui
讽	fgy
呐	nak
斌	bbw
辽	lnl
填	tmt
窃	qpx
抄	icf
妒	dun
吁	xuk
掀	xmf
芙	fuc
栋	dsa
吱	vik
吱	zik
撇	pp
禅	iju
妨	fhn
倦	jrr
衰	ukw
循	xyr
挪	nof
蓬	pgc
惩	igr
垃	lat
账	vhb
驳	bom
署	uus
姥	lcn
圾	jit
熬	aof
蘸	vjc
枕	vfa
丐	gdx
茜	qmc
茜	xic
厕	cei
捅	tsf
攀	pja
拽	vk
壶	huu
於	yuf
寇	kzg
鹤	heg
钥	ycj
骤	vzm
渺	mnd
刊	kjg
肢	vio
烛	vuh
孕	yyn
绽	vjs
棉	mma
盔	kvu
诞	djy
兜	dzp
岭	lku
笛	div
舱	chv
鸭	yao
债	vdr
钉	dkj
躬	gsu
缕	lvs
咚	dsk
撼	hjf
蕊	rvc
隶	lix
践	jmz
拱	gsf
沐	mud
菊	juc
蜂	fgi
兆	vce
搅	jnf
尿	nnu
黯	anh
歹	ddh
蓄	xuc
嘀	dik
纽	nqs
朝	vcu
聘	pbe
腻	nio
剥	bcx
剥	box
彪	bnh
沸	fwd
氓	mhw
壳	keu
储	iur
憋	bpb
匠	jlk
昧	mwo
泊	bod
篷	pgv
狡	jnq
轨	gvi
汹	xsd
携	xpf
磊	lwe
隙	xie
堂	thx
摧	cvf
瞄	mnm
胧	lso
挠	ncf
煌	hlh
擅	ujf
卒	zuw
饼	bku
狭	xxq
丸	wjj
瞅	izm
犬	qrd
矣	yis
楞	lga
骆	lom
雇	guh
唐	thg
妞	nqn
墅	uuo
焚	ffa
谱	puy
绘	hvs
肿	vso
魁	kvg
耽	dje
擒	qbf
陡	dze
璋	vhw
茂	mcc
瞥	ppb
瞳	tsm
髅	lzg
绣	xqs
硕	uoe
兹	zib
炒	ich
届	jpu
嗡	wgk
娱	yun
喧	xrk
膛	tho
沧	chd
疚	jqb
盐	yjt
搁	gef
坟	fft
邱	qqq
茵	ybc
旷	klo
翘	qnq
郝	hct
诈	vay
粹	cvm
琢	vow
腊	lao
钦	qbj
喻	yuk
锻	drj
睹	dum
露	lzy
侃	kjr
粘	vjm
媛	yrn
恳	kfg
锤	ivj
淮	hkd
蔽	bic
聂	npe
彭	pgu
贩	fjb
翩	pmh
呻	ufk
枉	wha
煮	vut
址	vit
敦	dyw
冉	rjk
薪	xbc
峻	jyu
氪	keq
荐	jmc
傍	bhr
秃	tuh
磕	kee
见	xmk
禀	bkw
珑	lsw
坎	kjt
邵	ucd
窄	vdx
阮	rre
蹈	dcz
碑	bwe
婶	ufn
煤	mwh
栈	vja
倘	thr
杭	hha
暇	xxo
狈	bwq
峡	xxu
芦	luc
蔓	mjc
蒸	vgc
禄	luu
胀	vho
醋	cuy
姊	zin
钩	gzj
衍	yjr
妾	qpl
嘎	gak
蝴	hui
萝	loc
祷	dcu
徽	hvr
衙	yar
陋	lze
罐	grw
霄	xny
汝	rud
灼	voh
澜	ljd
姗	ujn
倪	nir
咪	mik
钧	jyj
捣	dcf
眶	klm
澈	ied
焕	hrh
酬	izy
筷	kkv
宵	xng
揪	jqf
缚	fus
蚁	yii
喇	lak
拎	lbf
咙	lsk
哧	iik
棺	gra
肝	gjo
敛	lmr
剂	jiw
沮	jud
廖	lng
皓	hcb
勋	xyk
恕	uun
虐	nt
瘾	ybb
驴	lvm
卦	gxt
陀	toe
堕	doe
哆	dok
葡	puc
帖	tpj
垫	dmf
屡	lvu
鹅	eep
蛛	vui
碟	dpe
狞	nkq
裴	pwf
捞	lcf
铮	vgj
萄	tcc
盏	vjj
霆	tky
吭	kgk
蔑	mpc
麒	qig
喽	lzk
绷	bgs
惚	hux
桓	hra
坊	fht
桩	vla
璐	luw
巢	icv
樊	fja
锡	xij
棚	pga
芹	qbc
僻	pir
絮	xun
杏	xka
啧	zek
瘫	tjb
磁	cie
冈	ghk
逮	ddx
赠	zgb
噩	eew
呕	ouk
嚼	jnk
杂	zaj
揣	ik
拧	nkf
伺	cir
霖	lby
驼	tom
惕	tix
卸	xpw
炽	iih
框	kla
捆	kyf
眩	xrm
蝉	iji
谜	miy
炫	xrh
塘	tht
膜	moo
亨	hgw
蚂	mai
猩	xkq
滨	bbd
沁	qbd
跋	baz
捐	jrf
歧	qiv
蹭	cgz
甄	vfx
蜡	lai
缸	ghw
垒	lws
掘	jtf
乍	var
孽	npc
毯	tjm
槐	hka
铠	kdj
嗅	xqk
纲	ghs
渠	qud
扛	khf
朽	xqa
忖	cyx
匈	xsb
扒	paf
雍	ysw
闺	gvm
霓	niy
斋	vdw
夭	ycp
沦	lyd
揍	zzf
瞟	pnm
苟	gzc
窟	kux
钓	dnj
萱	xrc
倭	wor
鞘	qng
沛	pwd
噜	luk
绞	jns
颓	tvh
睿	rvb
噗	puk
幢	vlj
诅	zuy
涕	tid
谣	ycy
葱	csc
婢	bin
铸	vuj
绮	qis
畔	pjt
绸	izs
熏	xyp
蹬	dgz
诏	vcy
咆	pck
梧	wua
垮	kxt
澳	aod
浙	ved
甸	dmb
鲍	bcy
刁	dnv
厥	jti
蚊	wfi
鞠	jug
茗	mkc
眷	jrb
骏	jym
踹	ikz
漓	lid
蝇	yki
擂	lwf
沌	dyd
蚩	iic
酿	nly
唾	tok
澄	igd
猾	hxq
窒	vix
虾	xxi
钞	icj
觑	quh
哽	ggk
娥	een
耕	ggl
葫	huc
暧	aio
嗨	hdk
兢	jkg
啼	tik
绅	ufs
杉	uja
炯	jsh
霎	uay
迭	dpp
彷	phr
觅	mia
抿	mbf
稻	dch
怠	dds
龚	gsy
绒	rss
讳	hvy
勺	ucb
函	hjl
喳	vak
哒	dak
搀	ijf
撩	lnf
擎	qkc
仔	zir
仔	zdr
镶	xlj
藉	jic
膏	gcw
戳	io
呛	qlk
凹	aou
叩	kzk
懊	aox
懈	xpx
亢	khw
呸	pwk
慑	uex
跺	doz
跄	qlz
铲	ijj
坪	pkt
筝	vgv
顷	qkb
踉	llz
狰	vgq
苑	yrc
秉	bkp
猿	yrq
堤	dit
佟	tsr
悯	mbx
唠	lck
憨	hjv
肘	vzo
拇	muf
僚	lnr
霹	piy
禹	yup
啃	kfk
匀	yyb
晖	hvo
聋	lsy
忿	fff
韧	rfw
邹	zzd
梢	uca
肋	lwo
窘	jsx
浦	pud
炭	tju
簇	cuv
螺	loi
屯	tyh
匡	klk
倔	jtr
橙	iga
陕	uje
淳	iyd
菱	lkc
浊	vod
囔	nhk
朔	uon
睫	jpm
睬	cdm
鸽	ger
臀	tyu
吨	dyk
笙	ugv
昕	xbo
懦	nox
厄	eei
峨	eeu
曹	cch
轴	vzi
伽	gar
雳	liy
卵	lrp
捶	ivf
檐	yja
卍	wjv
钗	idj
袜	way
炕	khh
窦	dzx
蝎	xpi
溶	rsd
幺	ycv
徊	hkr
衅	xbp
砂	uae
冇	mcu
舵	dov
昼	vzu
迸	bgb
斟	vfq
椒	jna
靓	llf
旬	xyb
涟	lmd
疙	geb
瘩	dab
侥	jnr
匿	nik
镯	voj
兑	dvb
尧	ycq
徘	pdr
芽	yac
狙	juq
闵	mbm
嗷	aok
禾	hep
澎	pgd
绊	bjs
蜘	vii
憎	zgx
嚓	cak
嚓	iak
崽	zdu
贬	bmb
惮	djx
婵	ijn
涅	npd
恬	tmx
慷	khx
穹	qsx
渣	vad
屉	tiu
缭	lns
绢	jrs
袱	fuy
黝	yzh
袅	nnn
茄	jxc
茄	qpc
赦	uet
榻	taa
蛙	wai
唰	uxk
咏	ysk
凿	zcy
噪	zck
菌	jyc
蝙	bmi
庶	uug
邸	diu
攒	zjf
旱	hjo
虔	qmh
琛	ifw
忑	tex
匣	xxk
谬	mq
蟒	mhi
钝	dyj
廓	kog
惘	whx
漉	lud
佬	lcr
赎	uub
壤	rht
忡	isx
筠	yyv
彤	tsk
蜷	qri
癌	aib
嘈	cck
蚕	cjt
剖	pz
缀	vvs
汀	tkd
懵	mgx
缪	mzs
蔷	qlc
诫	jpy
恤	xux
馒	mju
矫	jnu
橘	jua
氧	yhq
贿	hvb
肮	aho
瑾	jbw
烙	lch
攘	rhf
攥	zrf
芭	bac
戎	rsg
褐	hey
漩	xrd
棕	zsa
鹃	jrk
帜	vij
搐	iuf
怦	pgx
亩	muw
撰	vrf
梓	zia
绚	xrs
阀	fam
烘	hsh
惋	wjx
驯	xym
栩	xua
墟	xut
鬟	hri
褪	tvy
峭	qnu
祯	vfu
暄	xro
韶	ucl
缎	drs
锥	vvj
辙	vei
惦	dmx
铛	dhj
枣	zcc
桦	hxa
遏	eeo
嫖	pnn
苛	kec
锣	loj
蹑	npz
喋	dpk
糙	ccm
貂	dnp
葵	kvc
榆	yua
皂	zcb
眈	djm
扼	eef
眺	tnm
孜	ziz
偌	ror
蹿	crz
蓓	bwc
弛	iig
庇	big
檀	tja
枭	xnn
螂	lhi
趾	viz
醇	iyy
驿	yim
槽	cca
抡	lyf
酣	hjy
宦	hrg
筐	klv
琅	lhw
飙	bnq
湃	pdd
跷	qnz
栅	vaa
呱	gxk
缰	jls
猝	cuq
衮	gyl
肴	yci
蔬	uuc
婧	jkn
阐	ijm
侈	iir
霏	fwy
瘟	wfb
芜	wuc
亥	hdw
畴	izt
杠	gha
鬓	bbi
晏	yjo
瘸	qtb
钮	nqj
珏	jtw
钰	yuj
傀	kvr
噔	dgk
驭	yum
靶	bag
韬	tcw
懿	yiu
荀	xyc
嘭	pgk
菇	guc
恃	uix
儡	lwr
呦	yzk
榕	rsa
躇	iuz
啰	lok
酌	voy
丙	bkh
涎	xmd
冽	lpd
砌	qie
鸾	lry
烨	yeh
驹	jum
咎	jqw
冕	mmo
雌	civ
剃	tib
蹙	cuw
笃	duv
崛	jtu
勘	kjq
桀	jpx
锈	xqj
磅	bhe
娄	lzm
撮	zof
祠	ciu
黏	nmh
珀	pow
睽	kvm
栓	ur
绫	lks
阑	ljm
瑕	xxw
磋	coe
讷	ney
岑	cf
娼	ihn
伎	jir
鲸	jky
坝	bat
铐	kcj
洼	wad
蹊	qiz
肾	ufu
崆	ksu
哝	nsk
靳	jbg
差	idy
约	ycs
落	lac
婊	bnn
扉	fwh
疮	ilb
坞	wut
膳	ujo
剌	lah
鳄	eey
捺	naf
悼	dcx
毋	wuv
簸	bov
忒	tw
忒	tvq
拴	urf
嬷	mon
蛤	hai
么	me
羹	ggb
瑚	huw
惆	izx
燎	lnh
籁	ldv
髦	mci
迢	tnd
汩	gud
狩	uzq
惴	vvx
胯	kxo
烹	pgw
咣	glk
锄	iuj
硝	xne
蕉	jnc
垢	gzt
楷	kda
炊	ivh
忻	xbx
腆	tmo
褒	bcw
酋	qqb
赃	zhb
拈	nmf
抒	uuf
孰	uuw
袄	aoy
褂	gxy
孺	ruz
赘	vvf
嫡	din
礁	jne
珉	mbw
啜	iok
窿	lsx
度	dog
骋	igm
槛	kja
莞	wjc
猖	ihq
麾	hvg
猥	wwq
篝	gzv
殉	xyh
枷	jxa
皎	jnb
窖	jnx
檬	mga
乒	pkq
凋	dnd
纺	fhs
泌	mid
刨	pcb
忏	ijx
盎	ahk
咀	juk
挎	kxf
羔	gcb
殃	yhh
庚	ggg
淼	mnu
淀	dmd
缨	yks
璨	cjw
跤	jnz
锵	qlj
摁	enf
嫔	pbn
臻	vfh
泯	mbd
睦	mum
喵	mnk
缥	pns
褥	ruy
蜿	wji
墩	dyt
棣	dia
沓	tau
喏	nok
琶	paw
缈	mns
缔	dis
酝	yyy
拷	kcf
柿	uia
琵	piw
蕙	hvc
闯	ilm
帛	bob
柠	nka
饵	eru
娓	wwn
乓	phq
轲	kei
髯	rji
娉	pkn
圭	gvt
璀	cvw
苔	tdc
肪	fho
吮	uyk
啄	vok
帷	wwj
箍	guv
蟑	vhi
炖	dyh
梗	gga
捎	ucf
鹊	qtg
羌	qly
舷	xmv
矗	iuu
掣	ien
匾	bmk
瀛	ykd
珞	low
衲	nay
惰	dox
嘤	ykk
啷	lhk
黠	xxh
虬	qqi
钵	boj
舜	uya
龌	wov
簪	zjv
蹂	rzz
恻	cex
簧	hlv
缤	bbs
潺	ijd
獠	lnq
筏	fav
阙	qtm
粤	ytp
瞌	kem
琏	lmw
龊	iov
椎	vva
煦	xuo
嵋	mwu
碳	tje
躏	lbz
睨	nim
鼾	hjz
娆	rcn
蜻	qki
徨	hlr
碾	nme
粼	lbm
啐	cvk
称	ifh
篡	crv
晤	wuo
肇	vch
咂	zak
帚	vzx
瘤	lqb
嚅	ruk
镔	bbj
裆	dhy
骁	xnm
坷	ket
箐	qkv
螃	phi
冢	vsg
锢	guj
晁	ico
蝗	hli
烽	fgh
莘	ufc
辘	lui
撬	qnf
瓮	wgb
亘	gfh
钊	vcj
篓	lzv
缇	tis
宸	ifg
胄	vzy
鞑	dag
荤	hyc
慵	ysx
跚	ujz
浣	hrd
痪	hrb
荼	tuc
骰	tzg
涮	urd
踵	vsz
炬	juh
瞑	mkm
麓	lua
铿	kgj
埔	but
埔	put
噘	jtk
涓	jrd
怏	yhx
莓	mwc
萃	cvc
呲	cik
蹒	pjz
睐	ldm
摞	lof
卞	bmd
谙	any
啕	tck
搪	thf
纨	wjs
霭	aiy
纶	lys
垛	dot
嗫	npk
拄	vuf
踝	hkz
臧	zhw
璞	puw
缄	jms
圈	jrw
翱	aob
逅	hzp
靥	yei
磐	pjv
壑	heb
斓	ljw
佗	tor
阖	hem
垠	ybt
迥	jsk
咛	nkk
痘	dzb
藕	ouc
媲	pin
湄	mwd
癞	ldb
恪	kex
砾	lie
痉	jkb
蜕	tvi
椰	yea
纣	vzs
馁	nwu
蜈	wui
镐	gcj
悖	bwx
涔	cfd
桅	wwa
孚	fua
阚	kjm
卡	qxu
掖	yef
菡	hjc
昙	tjo
滤	lvd
潦	lnd
覃	qbx
覃	tjx
硫	lqe
俸	fgr
蟠	pji
弋	yiq
驸	fum
虑	lvh
窕	tnx
珅	ufw
徙	xir
舫	fhv
赣	gjl
逵	kvt
揩	kdf
霾	mdy
蔫	nmc
跛	boz
脐	qio
糗	qqm
螳	thi
哺	buk
鹭	luz
蚣	gsi
褶	vey
恸	tsx
隽	jrv
籽	zim
磷	lbe
谄	ijy
酪	lcy
溟	mkd
峒	dsu
芋	yuc
筵	yjv
盹	dym
劾	hew
趔	lpz
殇	uhh
噌	cgk
轧	vai
玷	dmw
趄	qpz
皖	wjb
邺	yey
镀	duj
匍	pub
崴	wdu
幔	mjj
蝈	goi
镑	bhj
蜗	woi
侬	nsr
缆	ljs
洵	xyd
蟀	uki
瓒	zjw
邋	lav
竣	jyl
骥	jim
贲	bfu
胴	dso
潼	tsd
弑	uii
谤	bhy
蛐	qui
糯	nom
愠	yyx
噙	qbk
嘣	bgk
脓	nso
阜	fup
峥	vgu
遢	tao
瑙	ncw
碉	dne
荃	qrc
颀	qij
阿	eee
篆	vrv
辎	zii
踮	dmz
鳅	qqy
馍	mou
蜃	ufi
倌	grr
氤	ybq
戌	xuw
馗	kvj
匮	kvk
和	hoh
胚	pwo
啻	iil
珈	jxw
锹	qnj
摒	bkf
啾	jqk
菠	boc
槌	iva
燮	xph
褛	lvy
礴	boe
豚	tyo
氲	yyq
湍	trd
殡	bbh
核	hua
毗	pit
耙	bal
耙	pal
褴	ljy
恁	nfr
瘁	cvb
蚌	bhi
铝	lvj
蔻	kzc
濑	ldd
鬃	zsi
祢	miu
苒	rjc
蘅	hgc
豺	idp
町	dkt
掇	dof
戛	jxe
贮	vub
孬	ncb
镣	lnj
夥	hoo
斡	wou
潢	hld
臃	yso
嘹	lnk
阪	bje
闳	hsm
皿	mbk
囡	njw
辍	ioi
浚	jyd
闰	rym
臼	jqp
怵	iux
囤	tyw
蚓	ybi
碴	iae
堑	qmi
箴	vfv
嵘	rsu
箩	lov
艮	gfx
碱	jme
谆	vyy
粽	zsm
蔺	lbc
刽	gvr
锷	eej
惇	dyx
缜	vfs
贰	erq
坳	aot
镂	lzj
笆	bav
壬	rfq
叵	pok
坨	tot
姹	ian
赳	jqz
恰	qx
琮	csw
焊	hjh
淬	cvd
圳	vft
恹	yjx
淙	csd
酵	jny
犒	kcn
饪	rfu
嗟	jpk
钙	gdj
谚	yjy
鲲	kyy
谟	moy
虱	uiv
糠	khm
旮	gaj
峋	xyu
跆	tdz
潸	ujd
偻	lzr
绺	lqs
沱	tod
囱	csp
铳	isj
袤	mcw
苯	bfc
佻	tnr
繇	yza
獗	jtq
鞅	yhg
贾	gux
蹶	jtz
绔	kus
蔗	vec
奘	zhp
芍	ucc
殒	yyh
麝	ueg
浃	jxd
坂	bjt
佝	gzr
蒯	kkc
钺	ytj
玳	ddw
蛹	ysi
睾	gcp
螭	iii
俅	qqr
侗	dsr
宕	dhg
绰	ios
纂	zrv
厩	jqi
帔	pwj
蓁	vfc
熨	yyu
觐	jbn
阗	tmm
钏	irj
夔	kvb
缮	ujs
邕	ysv
柩	jqa
耆	qit
漕	ccd
鹄	hun
餮	tph
幄	woj
爰	yra
锃	zgj
纰	pis
绡	xns
鏖	aog
氢	qkq
妫	gvn
岫	xqu
骧	xlm
璜	hlw
聒	goe
椿	iya
琊	yaw
骅	hxm
闩	urm
踊	ysz
痿	wwb
皈	gvb
啵	bok
昶	ihd
篑	kvv
陲	ive
亟	jil
樽	zya
琨	kyw
邈	mnp
棂	lka
抻	iff
铉	xrj
怩	nix
嚯	hok
茁	voc
膘	bno
酩	mky
榔	lha
娩	mmn
忸	nqx
扪	mff
呶	nck
仃	dkr
佞	nkr
裨	biy
黜	iuh
滂	phd
戕	qlp
埂	ggt
纫	rfs
溉	gdd
猊	niq
跻	jiz
蒿	hcc
钛	tdj
掐	qxf
磺	hle
岷	mbu
葩	pac
苋	xmc
肛	gho
桠	yaa
铤	tkj
滦	lrd
稔	rfh
锲	qpj
哙	kkk
獐	vhq
喙	hvk
讧	hsy
氨	anq
缯	zgs
赊	ueb
炅	jso
戗	qlr
钠	naj
镌	jrj
铀	yzj
逖	tiq
砥	die
衢	qur
狒	fwq
骞	qmg
禅	uju
盥	grp
睚	yam
夯	hhd
掴	gof
蜞	qii
乜	mpv
蹴	cuz
谯	qny
鸵	ton
韫	yyw
仄	zei
孀	uln
斫	voe
腚	dko
牍	dup
佃	dmr
懋	mca
赡	ujb
榷	qta
镭	lwj
铄	uoj
媾	gzn
嫒	ain
尕	gan
蝼	lzi
闱	wwm
篙	gcv
逡	qys
膑	bbo
荥	xkc
罄	qku
蕨	jtc
郓	yyg
囵	lyw
诰	gcy
蹇	jmg
榈	lva
绶	uzs
罹	lis
槁	gca
秸	jph
裱	bny
牦	mcn
荑	tic
砝	fae
荏	rfc
芈	mic
邝	klg
锟	kyj
粑	bam
诳	kly
鹑	iyw
徕	ldr
痢	lib
撺	crf
魉	llg
妊	rfn
矍	jtm
犸	maq
庖	pcg
俎	zur
墉	yst
佰	bdr
觥	gsd
哞	mzk
旃	vjf
伉	khr
猷	yzb
怄	oux
锨	xmj
泵	bge
擀	gjf
绻	qrs
绌	ius
纥	hes
釉	yzp
讫	qiy
殄	tmh
萼	eec
辔	pws
瘌	lab
诨	hyy
掼	grf
蹉	coz
醍	tiy
泷	lsd
蓼	lnc
梏	gua
鸩	vfg
嘬	zok
杲	gco
荞	qnc
涝	lcd
蛔	hvi
焖	mfh
魍	whg
跎	toz
锉	coj
喆	veu
殚	djh
镁	mwj
痂	jxb
胱	glo
醐	huy
糅	rzm
亲	qkl
笳	jxv
崂	lcu
揆	kvf
侩	kkr
裾	juy
姮	hgn
椁	goa
羸	lww
珲	hyw
镫	dgj
鼹	yjj
懔	lbx
咩	mpk
誊	tgb
韪	wwo
噱	xtk
铩	uaj
椤	loa
脍	kko
淖	ncd
聩	kve
泅	qqd
绦	tcs
铡	vaj
痨	lcb
蚪	dzi
觞	uhd
煅	drh
悱	fwx
茕	qsc
妲	dan
璠	fjw
珥	erw
舢	ujv
肱	gso
焙	bwh
冁	ijb
色	udd
蜢	mgi
莠	yzc
铨	qrj
旻	mbo
瑭	thw
踅	xtf
嶂	vhu
跹	xmz
徭	ycr
狍	pcq
鹌	and
埙	xyt
缛	rus
椽	ira
暝	mko
酮	tsy
貉	hcp
玠	jpw
囿	yzw
糨	jlm
畹	wjt
铖	igj
镝	dij
缦	mjs
轸	vfi
洽	qxd
舂	iss
碘	dme
芫	yjc
馔	vru
伽	qpr
氯	lvq
倬	vor
酡	toy
缱	qms
浜	bhd
柘	vea
猕	miq
桉	ana
砒	pie
蜮	yui
骢	csm
橐	toh
琚	juw
钿	dmj
貅	xqp
嫱	qln
笤	tnv
旸	yho
嗄	uak
艄	ucv
茏	lsc
辚	lbi
疟	ntb
骓	vvm
筌	qrv
刹	iai
匙	iio
娜	non
扎	zaf
朴	pna
𤭢	cw
傩	nor
珙	gsw
貊	mop
诟	gzy
鬣	lpi
鼐	ndn
獭	taq
獾	hrq
邛	qsg
擤	xkf
稗	bdh
氮	djq
竽	yuv
箓	luv
铧	hxj
褡	day
钨	wuj
綮	qkh
玕	gjw
阄	jqm
媪	aon
笏	huv
晷	gvo
宥	yzg
摈	bbf
儋	djr
葶	tkc
阡	qme
粕	pom
睇	dim
癣	xrb
珐	faw
酆	fgf
馏	lqu
龈	ybv
锒	lhj
钯	baj
菖	ihc
灞	bad
躅	vuz
珺	jyw
腩	njo
蠹	duh
瓤	rhw
薨	hsc
訇	hsb
镊	npj
镗	thj
苫	ujc
阆	lhm
螟	mki
骝	lqm
祧	tnu
犴	hjq
玎	dkw
侉	kxr
厝	coi
龅	bcv
胪	luo
抟	trf
莳	uic
筇	qsv
砭	bme
腱	jmo
挈	qpf
怼	dvy
镞	zuj
貔	pip
搠	uof
杷	paa
讴	ouy
铬	gej
闼	tam
歃	uaq
箜	ksv
彀	gzu
荩	jbc
恂	xyx
燊	ufh
癯	qub
缟	gcs
垓	gdt
矾	fje
氖	ndq
铰	jnj
陉	xke
妯	vzn
耄	mct
踟	iiz
镛	ysj
鲧	gyy
烙	loh
镱	yij
猡	loq
枰	pka
馕	nhu
鲇	nmy
佤	war
枇	pia
垭	yat
鹳	grc
恚	hvt
盱	xum
矬	cou
帑	thn
侪	idr
脶	loo
娌	lin
砀	dhe
蚋	rvi
缁	zis
箬	rov
猱	ncq
掮	qmf
龃	juv
郧	yyk
枞	csa
檑	lwa
莴	woc
禳	rhu
玢	ffw
镏	lqj
狯	kkq
淦	gjd
鲠	ggy
楝	lma
蚝	hci
楸	qqa
艨	mgv
棹	vca
筢	pav
柞	zoa
磔	vee
锰	mgj
堞	dpt
艟	isv
彘	viv
跶	daz
倥	ksr
椋	lla
崃	ldu
旒	lqf
耧	lzl
狴	biq
樾	yta
镕	rsj
欸	ais
欸	eis
穰	rhh
怛	dax
哏	gfk
逄	phw
沤	oud
珰	dhw
叻	lek
缗	mbs
蹁	pmz
脯	puo
茛	gfc
莼	iyc
媸	iin
褫	iiy
锛	bfj
瘆	ufb
塄	lgt
诂	guy
镢	jtj
氟	fuq
椹	ufa
栊	lsa
孢	bcz
郴	ifa
獬	xpq
箧	qpv
矸	gje
枋	fha
璺	wfp
啭	vrk
鞣	rzg
樘	tha
耦	oul
蛉	lki
箪	djv
鳟	zyy
痱	fwb
翮	heh
诔	lwy
曷	heo
髋	krg
乂	yip
铙	ncj
嫘	lwn
椴	dra
墒	uht
阋	xim
龋	quv
悭	qmx
谝	pmy
撄	ykf
鬲	geh
圪	get
嬛	hrn
笮	zev
砷	ufe
疴	keb
锱	zij
糍	cim
芎	xsc
蛤	gei
尻	kcu
捩	lpf
蹼	puz
裰	doy
偬	zsr
茑	nnc
蓊	wgc
秭	zih
瘢	bjb
茼	tsc
旄	mcf
汊	iad
殍	pnh
碇	dke
钡	bwj
凼	dhu
垆	lut
炔	qth
萘	ndc
蟮	uji
孓	jtl
龁	hev
痧	uab
蕖	quc
唵	ank
钚	buj
痈	ysb
埚	got
狷	jrq
酢	zoy
阍	hym
螫	uit
檩	lba
痤	cob
蔸	dzc
嘚	dek
赉	ldl
霪	yby
诹	zzy
糌	zjm
舸	gev
畈	fjt
笊	vcv
艉	wwv
阊	ihm
傧	bbr
攮	nhf
酚	ffy
塍	igo
氦	hdq
笸	pov
篌	hzv
谖	xry
髡	kyi
酯	viy
髫	tni
镬	hoj
卺	jbl
皴	cys
锞	kej
簟	dmv
坩	gjt
鄄	jrx
郯	tjh
嘡	thk
跬	kvz
蚧	jpi
柰	nda
遄	iru
麇	qyg
竑	hsl
趱	zjz
埸	yit
儇	xrr
绀	gjs
倮	lor
崁	kju
岜	bau
谵	vjy
帻	zej
梃	tka
缵	zrs
礅	dye
缶	fzw
刖	yto
瞋	ifm
砬	lae
磴	dge
炝	qlh
啉	lbk
驺	zzm
殂	cuh
铘	yej
辏	czi
悛	qrx
璩	quw
褙	bwy
尥	lny
轫	rfi
饧	xku
苷	gjc
熘	lqh
萏	djc
曩	nho
砗	iee
蚍	pii
阃	kym
桡	rca
耨	nz
豳	bbu
缑	gzs
蝾	rsi
榧	fwa
洫	xud
坜	lit
磙	gye
庋	gvg
抔	pzf
铍	pij
麈	vug
蝣	yzi
跏	jxz
柙	xxa
勰	xpl
獍	jkq
秾	nsh
锗	vej
漭	mhd
袢	pjy
鳎	tay
彖	trv
裉	kfy
磅	phe
坼	iet
埕	igt
尜	gax
瘊	hzb
墁	mjt
铊	taj
锂	lij
剋	kw
蔟	cuc
濞	bid
悃	kyx
蠖	hoi
谮	zfy
鲎	hzx
畀	bit
裒	pzw
蚬	xmi
锝	dej
镲	iaj
臜	zao
邡	fhf
怍	zox
螨	mji
陔	gde
汆	crp
钼	muj
劁	qnv
肫	vyo
蝰	kvi
胼	pmo
瘳	izb
锑	tij
暌	kvo
尢	whu
芗	xlc
诜	ufy
蒌	lzc
浈	vfd
栲	kca
袼	gey
踔	ioz
鲞	xlb
狨	rsq
疃	trt
飑	bnf
俵	bnr
溴	xqd
琇	xqw
畚	bfs
骖	cjm
堠	hzt
泖	mcd
硗	qne
隹	vvr
僦	jqr
哿	gel
嵫	ziu
隳	hve
篼	dzv
垴	nct
辊	gyi
绱	uhs
诎	quy
醢	hdy
陬	zze
啫	vek
锕	aaj
侔	mzr
戥	dgo
砼	tse
蚶	hji
呙	gok
藁	gcc
镡	tjj
昃	zeo
杪	mna
籴	dip
耪	phl
狃	nqq
萩	qqc
嘌	pnk
畎	qrt
蕞	zvc
脬	pco
缬	xps
荛	rcc
丏	mmh
廛	ijg
氚	irq
烃	tkh
蒽	enc
躞	xpz
铵	anj
鬯	ihi
绲	gys
遘	gzg
钣	bjj
莰	kjc
疔	dkb
刳	kud
虿	idw
匦	gvk
葑	fgc
钪	khj
崞	gou
蛞	koi
颃	hhw
镆	moj
嫜	vhn
茺	isc
蒗	lhc
圹	klt
焜	kyh
晡	buo
砉	hxf
龀	ifv
甾	zdv
鞔	mjg
锘	noj
髑	dug
弢	tcg
瘘	lzb
崾	ycu
甯	nkg
髌	bbg
鲭	qky
悫	qtu
溻	tad
蛏	igi
氆	pum
爝	jth
蛱	jxi
笾	bmv
罟	gus
埝	nmt
曛	xyo
楦	xra
亟	qil
幢	ilj
硭	mhe
轧	gai
钍	tuj
唪	fgk
栝	gxa
纩	kls
菹	zuc
馇	iau
莨	llc
鲳	ihy
齁	hzz
庹	tog
枘	rva
郄	qpi
髹	xqi
氘	dcq
湓	pfd
栳	lca
茈	zic
揸	vaf
犇	bfn
婼	ron
撙	zyf
擐	hrf
氇	lum
悰	csx
桄	gla
烝	vgl
疳	gjb
慝	tek
瀹	ytd
獯	xyq
榱	cva
苤	ppc
蒇	ijc
蛘	yhi
钋	poj
攉	hof
氩	yaq
钕	nvj
缂	kes
骀	tdm
肟	woo
哌	pdk
瘰	lob
籀	vzv
蜣	qli
砟	vae
薤	xpc
劓	yiz
垌	tst
忭	bmx
蛲	nci
俜	pkr
蟛	pgi
辋	whi
龠	ytr
堋	pgt
腠	czo
鞴	bwg
黉	hsx
恧	nve
杩	maa
胍	gxo
蒡	bhc
硐	dse
胲	hdo
檎	qba
砑	yae
墚	llt
瘼	mob
骺	hzg
鹨	lqx
肷	qmo
蛑	mzi
铒	erj
坫	dmt
夬	gkv
贶	klb
躜	zrz
铪	haj
玱	qlw
锊	ltj
碹	xre
肭	nao
坭	nit
嶝	dgu
脞	coo
锾	hrj
饹	leu
嵝	lzu
铽	tej
阼	zoe
鸸	ere
埯	ant
迺	ndx
堍	tut
硇	nce
苄	bmc
酴	tuy
夼	kld
艚	ccv
圊	qkw
淠	pid
矻	kue
砜	fge
饸	heu
筘	kzv
蠊	lmi
躔	ijz
犏	pmn
镧	ljj
馘	gob
垲	kdt
瘥	idb
糇	hzm
绠	ggs
坌	bff
蹯	fjz
钫	fhj
羰	thy
铋	bij
衄	nvp
酞	tdy
窀	vyx
赆	jbb
捃	jyf
罨	yjs
恝	jxf
蒴	uoc
跞	liz
锿	aij
鲻	ziy
巯	qqs
绗	hhs
掭	tmf
蛸	uci
蛸	xni
驵	zhm
崚	lgu
眍	kzm
搋	ikf
汭	rvd
瘭	bnb
泐	led
瘵	vdb
箨	tov
荬	mdc
蝻	nji
偲	cdr
胩	kao
钔	mfj
耖	icl
聍	nke
埏	ujt
猹	iaq
篚	fwv
仫	mur
痄	vab
螬	cci
鳙	ysy
耩	jll
螵	pni
铑	lcj
钐	ujj
犋	jun
腽	wao
鳓	ley
萜	tpc
稂	lhh
翟	dix
僇	lur
膦	lbo
癃	lsb
耢	lcl
铌	nij
绖	dps
镩	crj
仂	ler
怊	icx
耥	thl
铼	ldj
镄	fwj
缲	qns
脲	nno
宬	igg
戤	gdn
鼢	ffj
礞	mge
耔	zil
膙	jlo
洴	pkd
脒	mio
臑	nco
筻	ghv
赒	vzb
钖	yhj
镥	luj
鼽	qqz
斠	jng
禚	vou
簖	drv
耱	mol
椓	voa
铷	ruj
铈	uij
氕	ppq
涢	yyd
苠	mbc
蒎	pdc
驲	rim
祃	mau
荙	dac
鲕	ery
爟	grh
垺	fut
祊	bgu
腙	zso
荮	vzc
铥	dqj
骉	bnm
乜	npv
俩	llr
凹	wau
南	nau
参	cfs
叶	xpk
吭	hhk
哪	nek
唷	yok
喔	ook
奘	vlp
尺	ieu
屯	vyh
峒	tsu
巷	hhg
帱	dcj
帱	izj
忒	teq
戆	ghl
戆	vll
戛	gae
扛	ghf
挼	rx
数	uom
朴	poa
杉	uaa
桧	hva
沌	vrd
浍	kkd
涌	isd
涡	god
濛	mgd
瀑	bcd
牟	mus
番	pjp
种	ish
筠	jyv
粘	nmm
繁	por
络	lcs
绰	ics
胖	pjo
腌	aao
臭	xqz
苕	tnc
葜	qxc
虹	jli
蚌	bgi
螓	qbi
褪	tyy
诶	ei
读	dzy
迫	pdb
镐	hcj
陂	poe
驮	dom
髂	qxg
𰻝	bl
不	fze
业	qqu
丟	dqw
乂	aip
乃	aiv
乇	iip
乇	top
乇	vep
么	map
乔	jnp
乙	vev
乱	ljq
乾	gju
了	lnv
于	xue
亘	ggh
亲	vfl
仒	bkr
伛	kzr
伯	bar
佃	tmr
体	bfr
佗	tar
佧	kar
佰	mor
佴	err
俊	zyr
俩	lxr
倜	vzr
僜	dgr
僧	zgr
僮	vlr
儇	hrr
儿	rfp
兑	ytb
入	rip
关	xnb
冇	mzu
册	idk
冼	ugd
凸	dpu
刮	kaq
刳	kxd
剖	pcl
剖	pol
副	pih
勺	uob
匚	fhh
区	gzk
匾	pmk
卵	ljp
卵	lop
卵	rrp
厉	ldi
厓	yd
厝	cui
厾	dqv
叁	cjs
叵	pzk
吋	cyk
吡	bpk
吨	tyk
含	hfr
吭	khk
吼	ksk
呔	tdk
呗	bdk
呣	muk
呯	pkk
呱	wak
呶	nuk
咖	jxk
咳	kdk
哆	iek
哏	hfk
哪	nwk
哭	kck
哿	kel
唡	llk
唶	cuk
唸	nmk
唻	ldk
唼	qpk
啁	zzk
啂	nzk
啉	ljk
啪	pxk
啻	til
啾	qqk
喏	rek
嗍	uok
嗒	tak
嗥	gck
嗲	dx
嗽	uuk
嘌	bnk
嘏	jxg
嘬	ikk
嘲	vck
嘿	mok
噌	zgk
囜	nbw
囝	jmw
囱	ilp
囸	miw
囸	riw
圣	gky
圳	zyt
均	yyt
坏	bwt
坶	mut
垃	let
垅	lst
垓	hdt
垣	hrt
垧	jst
垩	ugh
埝	npt
培	pzt
堀	jtt
堀	kut
堋	bgt
堤	tit
