的	d
一	y
是	u
我	w
在	z
人	r
有	yz
这	v
他	t
来	l
个	g
说	uo
上	uh
到	dc
就	j
大	da
那	n
也	ye
嗯	e
嗯	enk
吗	m
或	h
地	de
地	dit
子	zi
请	q
下	x
时	ui
看	k
要	yc
她	ta
放	f
中	vs
没	mw
但	dj
然	rj
里	li
为	ww
过	go
自	zip
好	hc
得	der
得	dwr
去	qu
会	hv
天	tm
还	hd
后	hz
以	yi
小	xn
和	he
对	dv
想	xl
级	ji
起	qi
神	uf
深	ufd
啊	a
集	jir
手	uz
而	er
只	vi
生	ug
头	tz
事	uig
多	do
家	jx
面	mm
知	viu
开	kd
如	ru
无	wu
很	hf
点	dm
前	qm
发	fa
经	jk
按	an
把	b
老	lc
些	xp
话	hx
已	yik
又	yzv
声	ugt
意	yil
啦	la
回	hvk
笑	xnv
哦	o
所	s
眼	yj
了	le
成	i
年	nm
见	jm
当	dh
女	nv
真	vf
两	ll
力	liv
做	zo
气	qip
从	c
用	ys
长	ih
长	vhp
动	ds
间	jmm
国	gok
晒	ud
走	zz
让	rh
被	bw
不	bu
给	gw
正	vg
问	wf
打	daf
明	mk
儿	erp
法	fad
才	cd
几	jip
行	hh
行	xkr
三	sj
定	dk
此	ci
进	jb
再	zd
种	vsh
将	jl
实	uib
同	ts
最	zv
本	bf
向	xlp
分	ff
十	uia
学	xt
高	gc
第	di
感	gj
怎	zf
连	lm
听	tk
边	bm
作	zor
其	qic
吧	ba
却	qt
口	kz
觉	jt
因	yb
白	bd
次	cid
出	iu
洗	xi
外	wd
新	xb
光	gl
风	fg
住	vu
果	got
与	yu
全	qr
二	era
候	hzr
公	gs
相	xlm
等	dg
别	bp
色	se
死	si
张	vh
部	bul
太	td
日	ri
少	uc
理	liw
重	vsq
王	wh
像	xlr
脸	lmo
比	bi
快	kk
何	her
水	uv
名	mkx
东	dsa
叫	jn
西	xia
应	yk
便	bmr
马	ma
难	nj
轻	qk
更	gg
美	mwy
位	wwr
关	gr
机	jim
接	jp
先	xm
文	wfw
处	iuw
并	bk
望	whw
常	ihx
完	wj
着	ve
于	yua
四	sik
飞	fw
师	uil
者	vel
清	qkd
刚	gh
心	xbd
跟	gf
信	xbr
山	uj
爱	ai
内	nw
龙	ls
空	ks
带	dd
找	vc
原	yr
入	rup
李	lim
吃	ii
场	iht
平	p
思	sit
林	lb
变	bmw
你	ni
使	uir
由	yzl
受	uzv
亲	qb
命	mkr
目	mu
强	ql
屎	uiu
男	njt
任	rf
该	gd
路	lu
车	ie
今	jbr
海	hdd
加	jxl
远	yrz
活	ho
特	te
解	jpd
电	dmy
世	uic
性	xk
表	bn
许	xu
它	tab
黑	hw
红	hs
花	hxc
转	vr
总	zs
算	sr
城	ig
队	dve
孩	hdz
反	fj
工	gsa
始	uin
满	mj
兵	bkq
物	wun
非	fwl
虽	sv
云	yy
似	sir
万	wja
至	vig
干	gja
通	tsz
认	rfy
失	uip
火	hob
哥	ge
之	vid
五	wua
惊	jkx
现	xmw
魔	mo
竟	jkl
姐	jpn
乎	hu
主	vuw
剑	jmq
往	whr
量	llo
早	zc
结	jps
怕	pa
流	lq
删	ujc
湿	uid
突	tu
坐	zot
斯	sic
音	ybl
紧	jbl
指	vif
半	bj
记	jiy
且	qp
利	lih
倒	dcr
书	uu
步	buv
们	mf
教	jnl
喜	xit
可	ke
越	yt
影	yko
谁	uw
谁	uvy
冷	lg
道	dcz
告	gcn
落	lo
象	xld
容	rs
怪	gk
传	ir
钱	qmj
季	jih
提	ti
言	yjw
养	yh
随	sve
每	mwp
双	ul
服	fu
击	jif
急	jid
武	wug
哪	na
换	hr
数	uum
站	vj
奇	qid
房	fh
安	anb
管	grv
刻	kew
啥	ua
题	tio
衣	yiw
周	vz
样	yhm
静	jkf
伤	uhr
百	bda
哇	wa
拿	nar
妈	man
办	bjl
星	xko
化	hxr
功	gsg
绝	jts
令	lk
般	bjv
必	bix
业	yel
尔	erd
件	jmr
血	xpp
血	xtp
代	ddr
精	jkm
弟	dib
终	vss
近	jbz
条	tn
战	vjv
值	vir
青	qkf
界	jpt
司	siv
整	vgu
字	zib
晚	wjo
民	mb
帮	bh
切	qpq
即	jig
忙	mh
交	jnw
暗	ano
夫	fue
员	yrk
根	gfm
哈	ha
灵	lke
夜	yew
父	fub
制	vin
友	yzu
阿	aa
息	xiz
冲	is
九	jq
保	bc
片	pm
形	xkk
阵	vfe
南	nju
决	jtd
各	gew
报	bcf
兴	xkx
阳	yhe
语	yuy
亿	yir
错	co
超	ic
刘	lqw
度	du
识	uiy
备	bww
慢	mjx
雪	xty
苦	ku
若	ro
领	lkr
收	uzj
底	dig
尽	jbi
准	vy
体	tir
答	dav
众	vsr
千	qmp
消	xnd
筛	udv
罗	los
敢	gje
留	lqp
克	keu
乐	lep
够	gz
跑	pc
显	xmo
嘴	zvk
官	grb
断	dr
未	wwa
势	uif
巨	ju
求	qq
论	ly
达	daz
则	ze
害	hdb
八	bap
单	djb
酒	jqd
脚	jno
元	yra
脑	nc
楚	ium
睛	jko
响	xlk
刀	dcv
确	qtu
玉	yuw
沉	if
北	bwl
格	gem
停	tkr
陈	ife
市	uiw
朝	icu
喝	hek
组	zu
江	jld
团	tr
母	mum
章	vhl
装	vl
亮	llw
举	jux
客	keb
照	vco
乱	lr
易	yio
足	zuk
黄	hl
修	xq
破	po
台	tds
球	qqw
呀	ya
院	yre
送	ss
包	bcb
义	yid
诉	su
丝	sis
围	wwk
玩	wjw
复	fup
况	kl
楼	lz
丽	lia
痛	tsb
梦	mg
呼	huk
摇	ycf
英	ykc
低	dir
帝	diw
兄	xs
背	bwb
持	iif
爷	yef
皇	hlb
七	qia
穿	irb
都	dz
政	vgv
运	yyz
叶	yek
热	re
校	xnm
谢	xpy
曾	cg
古	gu
细	xis
产	ij
睡	uvo
希	xix
速	suz
旁	ph
另	lkk
露	luy
饿	ee
异	yis
写	xpb
鬼	gv
娘	nl
取	que
除	iue
建	jmz
愿	yri
招	vcf
饭	fju
布	buu
续	xus
程	igh
首	uzb
观	gry
务	wuw
掉	dn
赶	gjt
忽	huw
注	vud
身	ufz
甚	ufc
差	ia
展	vju
争	vgd
品	pb
香	xlh
斗	dzu
故	gug
雷	lw
念	nmr
段	drp
顿	dy
角	jnd
疑	yib
护	huf
闪	ujm
木	muu
月	ytk
需	xuy
调	dny
调	tny
类	lwm
妹	mwn
爸	baf
线	xms
左	zou
游	yzd
派	pd
谈	tj
呃	eek
冰	bkd
敌	diu
跳	tnz
居	juu
约	yts
巴	bas
您	nb
顾	gui
肯	kf
醒	xky
铁	tp
淡	djd
造	zcz
伙	hor
资	zid
群	qy
联	lme
商	uhw
号	hck
节	jpc
键	jmj
讲	jly
掌	vhx
赵	vct
密	mi
病	bkb
卫	wwe
米	mib
威	www
继	jis
渐	jmd
统	tss
追	vv
亚	yaa
简	jmv
练	lms
基	jic
选	xr
推	tv
噢	oo
改	gdj
退	tvz
份	ffr
示	uie
忍	rfr
历	lii
器	qik
恐	ksg
引	ybg
皮	pi
寄	jib
习	xiv
靠	kc
导	dcs
存	cy
莫	moc
志	vit
区	quk
汉	hj
什	ufr
严	yja
态	tdt
套	tc
买	md
幸	xkt
佛	fo
议	yiy
止	vil
块	kkt
毛	mc
挥	hvf
胡	hug
散	sjc
板	bjm
隐	ybe
怒	nu
床	il
苏	suc
拖	to
股	guo
忌	jij
班	bjw
图	tuk
己	jik
岁	svu
礼	lip
独	duq
初	iup
顺	uy
狂	klq
默	mol
松	ssm
证	vgy
否	fz
恶	eey
缓	hrs
排	pdf
费	fwf
耳	ero
寒	hjb
哭	kuk
温	wfd
府	fug
担	djf
余	yur
钟	vsj
泪	lwd
烟	yjh
仍	rg
具	juq
恩	en
毕	bib
警	jkc
蓝	lj
宫	gsb
吸	xik
陆	lue
旧	jql
压	yai
救	jqq
呆	ddk
河	hed
迷	miz
枪	qlm
族	zuf
权	qrm
叹	tjk
孙	sy
卷	jr
查	iam
毫	hcw
春	iy
察	iab
圣	ugy
草	cc
较	jni
胜	ugo
遇	yuz
充	isw
史	uik
还	hrz
防	fhe
据	juf
猛	mgq
骑	qim
土	tuu
卡	ka
助	vuq
京	jkw
银	ybj
贵	gvv
永	ysd
质	vii
屋	wuu
须	xup
副	fua
刺	ciu
属	uuu
闻	wfm
境	jkt
禁	jbm
共	gsc
负	fud
弄	ns
翻	fjc
虎	huh
层	cgu
喊	hjk
逃	tcz
晓	xno
座	zog
情	qkx
雅	yay
参	cj
射	ue
险	xme
划	hxg
坚	jml
价	jxr
扬	yhf
科	keh
狠	hfq
秦	qbi
秘	mih
熟	uzw
熟	uuw
置	vis
仙	xmr
模	mom
波	bo
肉	rz
齐	qiw
舞	wup
脱	too
广	gld
姑	gun
麻	mag
投	tzf
顶	dkd
责	zef
维	wws
设	uey
坏	hk
秀	xqh
败	bdb
眉	mwu
州	vzd
药	ycc
承	igl
狼	lh
专	vrt
偷	tzr
画	hxa
吴	wuk
店	dmg
弹	djg
弹	tjg
欲	yug
抬	tdf
标	bnm
秋	qqh
良	lld
际	jie
状	vll
烦	fjh
摆	bdf
戏	xiy
方	fhw
桌	vo
船	irv
短	dru
村	cym
某	mz
摸	mof
付	fur
演	yjd
规	gvf
萧	xnc
封	fgt
握	wo
田	tmk
藏	ch
震	vfy
混	hy
虚	xuh
透	tzz
凌	lkd
休	xqr
嘛	mak
梅	mwm
紫	ziv
歌	gek
临	lbl
毒	duf
宗	zsb
著	vuc
索	so
印	ybp
寻	xy
湖	hud
劲	jbj
职	vie
恨	hfx
婆	pod
杰	jpm
羽	yux
咱	zj
素	suf
凡	fjj
飘	pn
嘿	hwk
呗	bwk
普	pu
宁	nk
均	jy
吓	xx
夏	xxb
读	duy
街	jpr
牛	nq
仿	fhr
胸	xso
浪	lhd
尚	uhx
宇	yub
纷	ffs
升	ugp
婚	hyn
善	ujy
弱	rog
卖	mdu
网	whk
朱	vup
雄	xsu
赛	sd
略	lt
杯	bwm
墙	qlt
环	hrw
罪	zvs
牙	yag
窗	ilb
柳	lqm
厅	tki
搞	gcf
端	drl
洞	dsd
适	uiz
拥	ysf
洋	yhd
肩	jmh
魂	hyy
闹	ncm
蒙	mgc
灯	dgh
伯	bor
免	mmd
菜	cdc
验	yjm
测	ce
凤	fgj
鱼	yud
徐	xur
娜	nan
暴	bco
君	jyy
讨	tcy
辈	bwf
懂	dsx
腿	tvo
灭	mp
妙	mn
效	xnw
危	wwd
优	yzr
盘	pj
丁	dka
趣	qut
妖	ycn
束	uug
迎	ykz
舍	uer
究	jqb
委	wwh
挂	gx
笔	biv
狗	gzq
鲜	xmy
抗	kh
探	tjf
韩	hju
尼	niu
控	ksf
抽	iz
创	ilr
归	gvl
挺	tkf
奋	ffd
陪	pw
硬	yku
避	biz
托	tof
训	xyy
勇	yss
聊	ln
奶	nd
庄	vlg
奔	bfd
镇	vfj
拳	qrj
采	cdv
研	yju
料	lnm
配	pwy
尊	zy
冒	mco
军	jyb
丹	djk
舒	uur
蛋	djz
哼	hg
宋	ssb
妇	fun
句	jub
犯	fjq
欣	xbj
甲	jxt
欧	ou
课	key
扑	puf
菲	fwc
燕	yjc
躲	dou
玄	xrw
幻	hry
茶	iac
折	vef
傻	uar
姓	xkn
源	yrd
洛	lod
遍	bmz
臣	ifk
犹	yzq
占	vjb
漂	pnd
挑	tnf
获	hoc
绿	lv
峰	fgu
俊	jyr
疯	fgb
列	lp
森	sf
妻	qiu
恋	lmw
误	wuy
拜	bdu
移	yih
纳	nas
党	dhx
腰	yco
巧	qn
孤	guz
闭	bim
碰	pg
镜	jkj
软	rr
厚	hzi
累	lwt
昨	zoo
丈	vha
牌	pdp
降	jle
降	xle
劳	lcc
偏	pmr
省	ugu
糊	hum
馆	gru
烧	uch
谓	wwy
财	cdb
汗	hjd
奈	ndd
操	ccf
迹	jiz
悄	qnx
残	cjd
尖	jmx
圈	qrk
项	xlg
撞	vlf
瞬	uyo
忆	yix
盖	gdy
尤	yzy
徒	tur
乡	xlv
概	gdm
荡	dhc
艺	yic
增	zg
祖	zup
困	ky
殿	dmu
迅	xyz
横	hgm
律	lvr
门	mfd
企	qir
惨	cjx
聚	jue
含	hjr
凭	pk
躺	th
缘	yrs
抢	qlf
替	tif
孔	ksz
批	pif
康	khg
惑	hog
率	lvw
惯	grx
登	dgb
互	hua
盯	dko
宣	xrb
唱	ihk
诚	igy
剩	ugq
咬	yck
诸	vuy
触	iud
晨	ifo
疼	tg
漫	mjd
材	cdm
补	bup
私	sih
纯	iys
艾	aic
谷	gub
庭	tkg
挡	dhf
晃	hlo
吉	jit
吹	iv
仇	izr
凝	nkd
鼓	gut
农	nsb
席	xig
征	vgr
帅	uk
缺	qtf
塞	sdb
杜	dum
努	nun
判	pjb
谋	mzy
胆	djo
尘	ifx
扎	va
滚	gy
酷	kuy
闷	mfm
迟	iiz
稳	wfh
诺	no
闲	xmm
灰	hvu
朵	doj
盛	igi
盛	ugi
爆	bch
伦	lyr
娇	jnn
侧	cer
愣	lgx
轮	lyi
昏	hyu
抖	dzf
敏	mbp
词	ciy
慌	hlx
愤	ffx
怜	lmx
颤	ijw
阶	jpe
苍	chc
距	juz
郑	vgb
川	irp
扫	sc
县	xmq
忧	yzx
童	tsl
屄	biu
丢	dq
荣	rsc
逐	vuz
傲	ao
戴	ddg
芒	mhc
庆	qkg
伴	bjr
袭	xil
供	gsr
遥	ycz
阻	zue
例	lir
睁	vgo
岛	dcn
遗	yiz
瞪	dgo
慕	muc
博	bou
猜	cdq
净	jkd
泽	zed
炼	lmh
珍	vfw
绍	ucs
爬	pav
丫	yab
炸	vah
凶	xsk
郎	lhl
宿	sub
宿	xqb
怨	yrx
醉	zvy
拼	pbf
迫	poz
革	gec
瞧	qno
奥	aop
输	uui
莉	lic
忠	vsv
肏	ccr
颗	keg
呢	ne
旅	lvf
鸟	nn
骗	pmm
浩	hcd
塔	tat
胖	pho
枫	fgm
赞	zjn
炮	pch
凯	kdu
芳	fhc
浑	hyd
夺	dod
宽	kr
堆	dvt
裂	lpd
赤	iit
旋	xrf
扭	nqf
悉	xic
擦	ca
典	dmq
匆	cs
评	pky
纵	zss
莲	lmc
跃	ytz
贴	tpb
丰	fgs
隔	gee
辛	xbl
抵	dif
竹	vug
彻	ier
摩	mog
轰	hsi
编	bms
肚	duo
插	iaf
哎	aik
耐	nde
辉	hvg
扶	fuf
恢	hvx
貌	mcv
额	eeb
述	uuz
票	pnx
膀	bho
鹰	ykg
撸	luf
孟	mgz
递	diz
瑞	rv
唇	iyi
暂	zji
琴	qbw
踪	zsz
码	mau
慰	wwu
蛇	uei
玲	lkw
晕	yyo
损	syf
吖	aak
轩	xri
粗	cu
掩	yjf
屁	piu
仰	yhr
零	lky
盟	mgo
途	tuz
贼	zw
洪	hsd
悟	wux
固	guk
冬	dsw
滑	hxd
甜	tmu
郁	yuu
琳	lbw
辆	lli
乃	ndv
暖	nr
妮	nin
挣	vgf
估	gur
坦	tjt
甘	gjc
佩	pwr
莱	ld
享	xlw
吼	hzk
构	gzm
粉	ffm
吻	wfk
潜	qmd
瓶	pkb
偶	our
戒	jpg
浓	nsd
毁	hvj
销	xnj
绕	rc
勒	leg
勒	lwg
帐	vhj
废	fwg
延	yjz
敲	qnw
烂	ljh
曼	mjo
厌	yji
羞	xqy
吟	ybk
滴	did
爹	dp
晴	qko
缩	sos
协	xpu
央	yhk
艹	cca
肖	xnx
缠	ijs
脆	cv
痕	hfb
伍	wur
启	qih
翔	xly
薄	bcc
薄	boc
劝	qry
郭	gow
鸣	mkk
倾	qkr
彼	bir
扔	rgf
撒	sa
耀	ycg
痴	iib
姆	mun
篇	pmv
椅	yim
厂	iha
董	dsc
熊	xss
埋	mdt
乖	gkq
狐	huq
蒋	jlc
踏	taz
隆	lse
括	ko
潮	icd
穷	qs
聪	cse
唤	hrk
泰	tdi
版	bjp
末	moa
旗	qif
焦	jnr
猫	mcq
盗	dcd
款	krt
荒	hlc
域	yut
脉	mdo
授	uzf
俗	sur
融	rsg
狱	yuq
访	fhy
桥	qnm
锁	soj
霸	bay
池	iid
钻	zr
港	ghd
喃	njk
廷	tkz
乘	igq
玛	maw
奉	fgi
扯	ief
岳	ytq
夹	jxa
岸	anu
屈	quu
恼	ncx
召	vcd
丧	sh
嘞	lwk
载	zdg
皆	jpb
颇	pop
染	rjd
肃	suy
爽	uld
亏	kv
吞	ty
惹	rec
哀	aiy
乔	qny
趁	ift
铺	puj
脏	zh
吕	lvk
奖	jll
倍	bwr
汤	thd
振	vff
婷	tkn
牢	lcb
扰	rcf
溜	lqd
庞	phg
臭	izz
悦	ytx
赫	hei
赢	ykw
跪	gvz
麦	mdf
枝	vim
侠	xxr
泉	qrb
劫	jpq
泥	nid
赌	dub
弓	gsv
罩	vcs
符	fuv
垂	ivq
漠	mod
脖	boo
饮	ybu
懒	ljx
肤	fuo
桑	shy
堪	kj
燃	rjh
卓	vob
赖	ldu
宾	bb
贾	jxx
喘	irk
吵	ick
冥	mkb
鞋	xpg
库	kug
裤	kup
碗	wju
航	hhv
踢	tiz
姨	yin
酸	sry
啸	xnk
龄	lkv
舌	ueq
冯	fgd
邦	bhf
钢	ghj
霞	xxy
促	cur
泡	pcd
重	isq
盾	dyi
羊	yhb
碧	biw
援	yrf
抹	maf
倩	qmr
锐	rvj
喷	pf
拦	ljf
袖	xqp
殊	uud
辰	ifi
繁	fjp
抛	pcf
嫁	jxn
咒	vzk
虫	isv
审	ufb
献	xmu
贤	xml
拉	laf
杀	uax
袁	yrt
摔	ukf
序	xug
筑	vuv
斜	xpr
瓦	waa
涂	tud
湾	wjd
莎	uac
崇	isu
猎	lpq
娃	wan
梯	tim
桃	tcm
豆	dza
径	jkr
疲	pib
搬	bjf
瓜	gxi
润	ry
铃	lkj
蛮	mjw
蒂	dic
拨	bof
涛	tcd
予	yus
勾	gzb
惠	hvi
析	xim
砍	kju
撑	igf
措	cof
币	bip
薇	wwc
督	duu
怖	bux
侵	qbr
糟	zcm
盈	ykn
斩	vji
尺	iiu
签	qmv
稀	xih
掏	tcf
夸	kx
液	yed
姬	jin
愧	kvx
汇	hvd
柱	vum
粮	llm
堡	bcr
仗	vhr
笨	bfv
奏	zzi
甩	uky
怔	vgx
允	yys
祸	hop
耶	yee
拆	id
爵	jtv
穴	xtb
租	zuh
培	pwt
咋	za
么	mop
窝	wob
弥	mig
返	fjz
匹	pik
凑	cz
奸	jmn
陌	moe
着	voy
核	hem
卧	woi
幅	fuj
眨	vao
耗	hcl
洒	sad
卢	lub
扣	kzf
丑	izv
孝	xnl
矛	mcy
氛	ffq
衡	hgr
陶	tce
腾	tgo
汪	whd
僵	jlr
疗	lnb
妃	fwn
罚	fas
咐	fuk
泛	fjd
愁	izh
搜	sz
慈	cib
肥	fwo
屌	dnu
笼	lsv
篮	ljv
俱	jur
惟	wwx
柜	gvm
捉	vof
悬	xrq
霍	hoy
泄	xpd
咽	yjk
齿	iiv
秒	mnh
勤	qbc
扩	kof
屏	pku
霜	uly
袍	pcp
蝶	dpi
祭	jix
厨	iui
胁	xpo
朋	pgo
赚	vrb
尬	ga
尴	gjy
熙	xii
昌	iho
贺	hel
巾	jbk
描	mnf
捕	buf
咳	kek
扇	ujh
绵	mms
撕	sif
催	cvr
宠	isb
贪	tjr
辱	rui
寸	cyu
搂	lzf
饶	rcu
跌	dpz
肌	jio
售	uzr
抑	yif
纹	wfs
柔	rzm
宏	hsb
萍	pkc
丛	csr
俄	eer
刃	rfd
蕾	lwc
挨	aif
迈	mdz
违	wwz
辩	bmx
埃	ait
艘	szv
灾	zdb
僧	sg
渡	dud
卑	bwp
抓	vx
雕	dnk
鼠	uuj
辣	lax
刷	ux
艰	jmy
斥	iij
裙	qyp
翠	cvx
饱	bcu
掠	ltf
夕	xip
矮	aiu
瑶	ycw
捏	np
瑟	sew
渴	ked
谅	lly
昂	ah
沟	gzd
涉	ued
驶	uim
摄	uef
婉	wjn
荷	hec
魅	mwg
玫	mww
裁	cdg
坡	pot
邓	dgy
歪	wdb
乏	fap
申	uft
乐	ytp
割	geb
衫	ujp
棒	bhm
阔	kom
韦	wwf
贯	grm
魄	pob
柄	bkm
社	uep
患	hri
覆	fux
婴	ykb
锅	goj
陛	bie
遮	vez
帕	paj
咖	kak
嫌	xmn
胳	geo
挖	waf
啪	pak
矿	klu
爪	vci
爪	vxi
眠	mmo
穆	muh
啡	fwk
脾	pio
恒	hgx
玻	bow
础	iuu
耸	ssr
逆	niz
驱	qum
猴	hzq
佣	ysr
舅	jqj
铜	tsj
娟	jrn
眯	mio
淫	ybd
吩	ffk
诡	gvy
姻	ybn
晰	xio
亭	tkw
哄	hsk
骚	scm
柯	kem
筋	jbv
崔	cvu
灿	cjh
捷	jpf
淋	lbd
辑	jii
棍	gym
绳	ugs
频	pbv
廊	lhg
畏	wwt
裹	goy
苗	mnc
盼	pjo
耍	uxe
煞	uad
寝	qbb
添	tmd
嫂	scn
纠	jqs
慨	kdx
嚷	rhk
驰	iim
拐	gkf
宴	yjb
津	jbd
岚	lju
耻	iie
挽	wjf
页	yea
牲	ugn
乳	ruv
仓	chr
逛	glz
樱	ykm
兼	jmb
戈	gey
哗	hxk
涯	yad
捧	pgf
铭	mkj
障	vhe
跨	kxz
妥	tov
揉	rzf
晋	jby
寞	mob
寨	vd
污	wud
乾	qmu
馨	xbt
嗓	shk
呈	igk
卿	qkp
楠	njm
囧	js
籍	jiv
裸	lop
链	lmj
灌	grd
昆	kyo
畅	ihu
逍	xnz
帽	mcj
阅	ytm
逗	dzz
蹲	dyz
踩	cdz
窜	cr
哑	yak
趴	paz
逢	fgz
韵	yyl
谦	qmy
档	dhm
沾	vjd
订	dky
朴	pum
瞎	xxo
鞭	bmg
俺	anr
雀	qtx
慎	ufx
盆	pff
迁	qmz
镖	bnj
芬	ffc
崖	yau
丘	qqj
庙	mng
潘	pjd
拓	taf
纱	uas
漏	lzd
珊	ujw
仆	pur
宙	vzb
传	vrr
叮	dkk
捂	wuf
涩	sed
诧	iay
柴	idv
杆	gjm
坠	vve
赔	pwb
涨	vhd
嘟	duk
崩	bg
薛	xtc
藤	tgc
税	uvh
枯	kum
帘	lmb
糖	thm
怀	hkx
骄	jnm
糕	gcm
彬	bbm
疏	uuv
堵	dut
车	jua
眸	mzo
芸	yyc
考	kcl
溪	xid
谎	hly
能	ng
鼎	dkp
稿	gch
哟	yo
哟	yzk
冤	yrb
狄	diq
咧	lpk
宛	wjb
嫩	nf
肆	sie
憾	hjx
偿	ihr
腔	qlo
哩	lik
豹	bcv
瑰	gvw
绑	bhs
澡	zcd
兮	xib
雯	wfy
狮	uiq
邻	lbr
骇	hdm
坑	kg
伐	far
烁	uoh
葬	zhc
诀	jty
兰	ljb
鄙	bik
鹿	lug
柏	bdm
溃	kvd
朕	vfo
舟	vzp
趟	tht
侦	vfr
娅	yan
庸	ysg
削	xtx
砰	pgu
耿	gge
牺	xin
筒	tsv
遂	svz
旭	xuj
胎	tdo
竖	uul
龟	gvd
儒	rur
嫣	yjn
宅	vdb
押	yaf
旨	vib
册	cek
弦	xmg
栏	ljm
衷	vsy
刮	gxu
艇	tkv
岗	ghu
赴	fut
策	cev
囊	nh
颊	jxj
疆	jlg
炉	luh
旺	who
烤	kch
狸	liq
愕	eex
叠	dpy
晌	uho
拟	nif
俏	qnr
杖	vhm
芝	vic
夷	yia
衬	ifp
捡	jmf
遵	zyz
塑	sun
桶	tsm
滩	tjd
琼	qsw
昊	hco
蹦	bgz
寡	gxb
贞	vfb
凰	hlj
哨	uck
茹	ruc
劣	lpu
嘱	vuk
沃	wod
厢	xli
摘	vdf
砸	zau
坤	kyt
碌	luu
匙	uio
拢	lsf
谭	tjy
翁	wg
竭	jpl
廉	lmg
械	xpm
贸	mcp
辅	fui
讽	fgy
呐	nak
斌	bbw
辽	lnz
填	tmt
窃	qpb
抄	icf
妒	dun
吁	xuk
嗦	sok
掀	xmf
芙	fuc
栋	dsm
吱	vik
吱	zik
撇	pp
禅	ijp
妨	fhn
倦	jrr
循	xyr
挪	nof
蓬	pgc
惩	igr
垃	lat
账	vhb
驳	bom
署	uus
甫	fuu
顽	wjy
姥	lcn
熬	aof
蘸	vjc
枕	vfm
丐	gda
茜	qmc
厕	cei
捅	tsf
攀	pjm
拽	vk
壶	hut
寇	kzb
鹤	heb
钥	ycj
骤	vzm
渺	mnd
刊	kjg
肢	vio
烛	vuh
孕	yyn
绽	vjs
棉	mmm
盔	kvu
诞	djy
兜	dzp
岭	lku
笛	div
舱	chv
鸭	yaj
债	vdr
钉	dkj
躬	gsu
缕	lvs
咚	dsk
撼	hjf
蕊	rvc
隶	liy
拱	gsf
沐	mud
菊	juc
裕	yup
兆	vce
搅	jnf
尿	nnu
黯	anl
歹	dda
蓄	xuc
嘀	dik
怯	qpx
叨	dck
纽	nqs
朝	vcu
聘	pbe
腻	nio
剥	bce
剥	boe
彪	bnh
沸	fwd
氓	mhw
逻	loz
壳	ket
储	iur
憋	bpx
匠	jlk
昧	mwo
泊	bod
篷	pgv
狡	jnq
轨	gvi
汹	xsd
携	xpf
磊	lwu
隙	xie
堂	thx
摧	cvf
瞄	mno
胧	lso
挠	ncf
煌	hlh
擅	ujf
卒	zuw
饼	bku
狭	xxq
丸	wjl
瞅	izo
犬	qrd
砖	vru
楞	lgm
骆	lom
雇	guh
唐	thg
妞	nqn
谱	puy
绘	hvs
肿	vso
魁	kvg
耽	dje
擒	qbf
陡	dze
璋	vhw
茂	mcc
瞥	ppx
瞳	tso
髅	lzg
绣	xqs
硕	uou
炒	ich
弘	hsg
都	dul
届	jpu
嗡	wgk
娱	yun
喧	xrk
膛	tho
沧	chd
盐	yjt
扁	bmh
搁	gef
坟	fft
邱	qqq
茵	ybc
旷	klo
郝	hci
诈	vay
粹	cvm
琢	vow
琢	zow
腊	lao
钦	qbj
喻	yuk
宪	xmb
锻	drj
露	lzy
饥	jiu
侃	kjr
粘	vjm
媛	yrn
恳	kfg
厮	sii
锤	ivj
淮	hkd
蔽	bic
聂	npe
彭	pgt
贩	fjb
翩	pmh
呻	ufk
枉	whm
煮	vul
焉	yjv
览	ljl
敦	dyw
厦	uai
冉	rjk
薪	xbc
峻	jyu
氪	keq
荐	jmc
傍	bhr
秃	tuh
见	xmk
禀	bkw
珑	lsw
坎	kjt
邵	ucd
阮	rre
碑	bwu
婶	ufn
煤	mwh
倘	thr
杭	hhm
狈	bwq
峡	xxu
芦	luc
蔓	mjc
蒸	vgc
禄	lup
胀	vho
醋	cuy
伞	sjr
姊	zin
钩	gzj
衍	yjr
妾	qpl
嘎	gak
蝴	hui
萝	loc
祷	dcp
稚	vih
徽	hvr
衙	yar
陋	lze
罐	grf
霄	xny
汝	rud
灼	voh
澜	ljd
姗	ujn
倪	nir
咪	mik
钧	jyj
捣	dcf
燥	zch
乙	yiv
澈	ied
焕	hrh
酬	izy
筷	kkv
宵	xnb
揪	jqf
缚	fus
蚁	yii
喇	lak
拎	lbf
咙	lsk
梭	som
哧	iik
肝	gjo
敛	lmq
剂	jiq
疤	bab
沮	jud
廖	lng
皓	hcb
勋	xyk
恕	uun
虐	nt
虞	yuh
瘾	ybb
驴	lvm
卦	gxt
迦	jxz
陀	toe
窥	kvb
堕	doe
哆	dok
葡	puc
帖	tpj
垫	dmf
屡	lvu
鹅	eew
蛛	vui
碟	dpu
狞	nkq
囚	qqk
裴	pwf
捞	lcf
吏	lig
铮	vgj
萄	tcc
盏	vjj
霆	tky
喔	wok
勿	wub
吭	kgk
蔑	mpc
麒	qil
喽	lzk
栗	lix
绷	bgs
惚	hux
桓	hrm
坊	fht
桩	vlm
嗽	szk
璐	luw
巢	icv
畜	iux
樊	fjm
锡	xij
棚	pgm
僻	pir
絮	xun
杏	xkm
啧	zek
瘫	tjb
冈	ghk
逮	ddz
赠	zgb
觉	jnx
呕	ouk
嚼	jnk
嚼	jtk
杂	zaj
揣	ik
拧	nkf
伺	cir
霖	lby
驼	tom
惕	tix
卸	xpv
炽	iih
框	klm
捆	kyf
眩	xro
蝉	iji
谜	miy
炫	xrh
阱	jke
膜	moo
亨	hgw
蚂	mai
猩	xkq
滨	bbd
沁	qbd
跋	baz
捐	jrf
歧	qiv
蹭	cgz
甄	vfx
蜡	lai
缸	ghf
窍	qnb
垒	lws
掘	jtf
乍	vap
孽	npc
毯	tjm
槐	hkm
铠	kdj
襟	jbp
嗅	xqk
纲	ghs
渠	qud
扛	khf
朽	xqm
忖	cyx
匈	xsb
扒	paf
雍	ysw
霓	niy
斋	vdw
夭	ycp
沦	lyd
揍	zzf
瞟	pno
苟	gzc
暑	uuo
窟	kub
钓	dnj
萱	xrc
倭	wor
鞘	qng
沛	pwd
噜	luk
绞	jns
颓	tvh
睿	rvb
噗	puk
幢	vlj
诅	zuy
涕	tid
谣	ycy
葱	csc
婢	bin
铸	vuj
绮	qis
剿	jnv
畔	pjt
粥	vzg
绸	izs
茨	cic
熏	xyq
蹬	dgz
诏	vcy
叭	bak
咆	pck
梧	wum
垮	kxt
澳	aod
浙	ved
甸	dmb
绯	fws
鲍	bcy
刁	dnv
厥	jti
蚊	wfi
鞠	jug
茗	mkc
眷	jrj
戮	lux
骏	jym
踹	ikz
漓	lid
蝇	yki
擂	lwf
沌	dyd
凸	tul
蚩	iic
酿	nly
唾	tok
琐	sow
犀	xiu
澄	igd
猾	hxq
虾	xxi
钞	icj
瓣	bjx
觑	quh
哽	ggk
娥	een
耕	ggl
葫	huc
暧	aio
嗨	hdk
诵	ssy
𪨊	ssu
兢	jku
啼	tik
绅	ufs
炯	jsh
霎	uay
彷	phr
觅	miv
抿	mbf
稻	dch
怠	dds
龚	gsl
绒	rss
讳	hvy
勺	ucb
喳	vak
哒	dak
颂	ssg
搀	ijf
撩	lnf
擎	qkc
仔	zdr
仔	zir
镶	xlj
逞	igz
膏	gcw
戳	io
呛	qlk
凹	aol
叩	kzk
懊	aox
懈	xpx
亢	khw
呸	pwk
慑	uex
跺	doz
跄	qlz
铲	ijj
坪	pkt
顷	qkb
腮	sdo
踉	llz
狰	vgq
苑	yrc
猿	yrq
佟	tsr
悯	mbx
唠	lck
憨	hje
肘	vzo
拇	muf
僚	lnr
霹	piy
啃	kfk
匀	yyb
晖	hvo
聋	lsl
忿	fff
韧	rfw
邹	zzd
梢	ucm
肋	lwo
窘	jsb
浦	pud
炭	tju
簇	cuv
螺	loi
屯	tya
匡	klk
倔	jtr
橙	igm
陕	uje
髓	svg
淳	iyd
菱	lkc
浊	vod
囔	nhk
朔	uon
睫	jpo
睬	cdo
鸽	ger
臀	tyu
吨	dyk
笙	ugv
昕	xbo
祀	sip
懦	nox
厄	eei
峨	eeu
曹	ccc
轴	vzi
伽	gar
卵	lrp
捶	ivf
卍	wjv
钗	idj
袜	wap
炕	khh
窦	dzb
蝎	xpi
溶	rsd
幺	ycv
徊	hkr
衅	xbp
砂	uau
冇	mcu
舵	dov
斟	vfc
舆	yuj
靓	llf
旬	xyb
窑	ycb
涟	lmd
芠	wfc
瘩	dab
靴	xtg
匿	nik
镯	voj
兑	dvb
徘	pdr
芽	yac
闵	mbm
嗷	aok
禾	hep
澎	pgd
绊	bjs
憎	zgx
嚓	cak
嚓	iak
崽	zdu
贬	bmb
惮	djx
婵	ijn
涅	npd
恬	tmx
慷	khx
穹	qsb
渣	vad
屉	tiu
缭	lns
绢	jrs
袅	nnn
茄	jxc
茄	qpc
祟	svi
榻	tam
蛙	wai
唰	uxk
咏	ysk
凿	zcy
噪	zck
菌	jyc
蝙	bmi
攒	zjf
旱	hjo
虔	qmh
琛	ifw
忑	tex
匣	xxk
谬	mq
蟒	mhi
钝	dyj
悚	ssx
廓	kog
惘	whx
漉	lud
佬	lcr
曳	yey
赎	uub
壤	rht
忡	isx
筠	yyv
彤	tsd
竿	gjv
蜷	qri
癌	aib
嘈	cck
蚕	cjt
剖	pz
缀	vvs
汀	tkd
懵	mgx
缪	mzs
蔷	qlc
诫	jpy
恤	xux
馒	mju
矫	jnu
橘	jum
氧	yhq
贿	hvb
肮	aho
瑾	jbw
烙	lch
攘	rhf
攥	zrf
汰	tdd
芭	bac
石	dja
漩	xrd
蒜	src
棕	zsm
鹃	jrk
帜	vij
搐	iuf
怦	pgx
穗	svh
亩	muw
撰	vrf
梓	zim
绚	xrs
阀	fam
烘	hsh
炙	vix
惋	wjx
驯	xym
栩	xum
墟	xut
鬟	hre
褪	tvp
骸	hdg
峭	qnu
祯	vfp
韶	ucl
缎	drs
锥	vvj
辙	vei
惦	dmx
铛	dhj
枣	zcu
桦	hxm
搔	scf
遏	eez
庵	ang
率	ukw
嫖	pnn
苛	kec
锣	loj
蹑	npz
秽	hvh
殴	ouq
喋	dpk
糙	ccm
葵	kvc
榆	yum
皂	zcb
扼	eef
眺	tno
孜	ziz
簌	suv
偌	ror
蹿	crz
蓓	bwc
弛	iig
庇	big
枭	xnn
螂	lhi
趾	viz
醇	iyy
抡	lyf
酣	hjy
宦	hrb
筐	klv
琅	lhw
瞻	vjo
飙	bnq
湃	pdd
跷	qnz
栅	vam
呱	gxk
缰	jls
猝	cuq
衮	gyy
肴	ycx
殆	ddd
蔬	uuc
飒	sal
婧	jkn
阐	ijm
侈	iir
霏	fwy
瘟	wfb
芜	wuc
亥	hdw
畴	izt
杠	ghm
鬓	bbe
晏	yjo
瘸	qtb
钮	nqj
珏	jtw
傀	kvr
噔	dgk
靶	bag
韬	tcw
恙	yhy
懿	yit
荀	xyc
嘭	pgk
菇	guc
恃	uix
儡	lwr
瘪	bpb
榕	rsm
躇	iuz
烬	jbh
啰	lok
丙	bka
涎	xmd
鸾	lrw
烨	yeh
翟	vdx
咎	jqw
陨	yye
雌	civ
剃	tib
蹙	cuw
笃	duv
崛	jtu
勘	kjc
稼	jxh
桀	jpx
锈	xqj
磅	bhu
壕	hct
娄	lzm
撮	zof
玑	jiw
祠	cip
黏	nmh
珀	pow
睽	kvo
栓	ur
绫	lks
瑕	xxw
磋	cou
粟	sux
讷	ney
岑	cf
娼	ihn
鲸	jky
坝	bat
铐	kcj
洼	wad
蹊	qiz
寐	mwb
肾	ufl
崆	ksu
甭	bgb
哝	nsk
靳	jbg
差	idy
约	ycs
落	lac
婊	bnn
扉	fwh
坞	wut
膳	ujo
剌	lau
捺	naf
悼	dcx
簸	bov
忒	tw
忒	tvy
叟	szj
拴	urf
嬷	mon
蛤	hai
么	mep
羹	ggy
熔	rsh
惆	izx
饷	xlu
燎	lnh
籁	ldv
髦	mce
汩	gud
狩	uzq
惴	vvx
胯	kxo
烹	pgw
咣	glk
锄	iuj
硝	xnu
蕉	jnc
垢	gzt
楷	kdm
炊	ivh
忻	xbx
炳	bkh
腆	tmo
酋	qqb
赃	zhb
拈	nmf
抒	uuf
褂	gxp
孺	ruz
赘	vvf
嫡	din
珉	mbw
啜	iok
窿	lsb
度	dog
槛	kjm
莞	wjc
锯	juj
猖	ihq
遐	xxz
飕	szf
猥	wwq
篝	gzv
殉	xyd
枷	jxm
皎	jnb
檬	mgm
乒	pkq
溯	sud
凋	dnd
纺	fhs
泌	mid
刨	pcb
忏	ijx
盎	ahy
咀	juk
屹	yiu
挎	kxf
羔	gcy
庚	ggg
淼	mnu
淀	dmd
隘	aie
缨	yks
璨	cjw
跤	jnz
锵	qlj
摁	enf
嫔	pbn
臻	vfg
泯	mbd
睦	muo
喵	mnk
缥	pns
馋	iju
蜿	wji
墩	dyt
棣	dim
沓	dau
沓	tau
喏	nok
琶	paw
缈	mns
缔	dis
酝	yyy
耷	dad
柬	jmu
拷	kcf
琵	piw
蕙	hvc
闯	ilm
帛	bob
柠	nkm
饵	eru
娓	wwn
乓	phq
轲	kei
髯	rje
娉	pkn
圭	gvt
璀	cvw
苔	tdc
肪	fho
吮	uyk
瞩	vuo
啄	vok
帷	wwj
箍	guv
仇	qqr
蟑	vhi
炖	dyh
梗	ggm
捎	ucf
瞿	quo
鹊	qtc
羌	qly
骼	geg
伫	vur
舷	xmv
掣	ien
匾	bmk
瀛	ykd
珞	low
衲	nap
惰	dox
嘤	ykk
谛	diy
藻	zcc
啷	lhk
黠	xxl
饲	siu
虬	qqi
钵	boj
邯	hjg
笋	syv
舜	uyv
龌	wov
簪	zjv
蹂	rzz
恻	cex
簧	hlv
缤	bbs
潺	ijd
獠	lnq
筏	fav
阙	qtm
瞌	keo
龊	iov
椎	vvm
煦	xuo
躏	lbz
鼾	hjz
娆	rcn
蜻	qki
徨	hlr
碾	nmu
粼	lbm
啐	cvk
称	ifh
篡	crv
晤	wuo
肇	vch
咂	zak
帚	vze
瘤	lqb
瞠	igo
嚅	ruk
怆	ilx
镔	bbj
裆	dhp
箐	qkv
会	kkr
螃	phi
冢	vsb
锢	guj
晁	ico
蝗	hli
烽	fgh
辘	lui
撬	qnf
瓮	wgg
亘	gfa
钊	vcj
篓	lzv
缇	tis
宸	ifb
胄	vzy
鞑	dag
绥	svs
荤	hyc
慵	ysx
跚	ujz
袒	tjp
浣	hrd
荼	tuc
腋	yeo
骰	tzg
涮	urd
踵	vsz
炬	juh
瞑	mko
麓	lum
铿	kgj
埔	but
埔	put
涓	jrd
怏	yhx
莓	mwc
萃	cvc
呲	cik
蹒	pjz
睐	ldo
昱	yuo
摞	lof
谙	any
啕	tck
搪	thf
纨	wjs
皋	gcb
纶	lys
垛	dot
嗫	npk
拄	vuf
踝	hkz
臧	zhv
璞	puw
缄	jms
秧	yhh
翱	aob
逅	hzz
靥	yei
磐	pjv
斓	ljw
叁	sjs
佗	tor
垠	ybt
迥	jsz
咛	nkk
邂	xpz
臊	sco
藕	ouc
媲	pin
湄	mwd
癞	ldb
恪	kex
砾	liu
痉	jkb
蜕	tvi
椰	yem
仨	sar
纣	vzs
馁	nwu
蜈	wui
镐	gcj
悖	bwx
涔	cfd
汴	bmd
桅	wwm
隅	yue
卡	qxu
菡	hjc
昙	tjo
滤	lvd
潦	lnd
覃	qbx
覃	tjx
硫	lqu
俸	fgr
蟠	pji
驸	fum
胥	xuz
虑	lvh
窕	tnb
珅	ufw
徙	xir
舫	fhv
赣	gjl
逵	kvz
揩	kdf
霾	mdy
蔫	nmc
跛	boz
脐	qio
糗	qqm
螳	thi
哺	buk
萨	sac
鹭	luz
蚣	gsi
褶	vep
恸	tsx
玥	ytw
磷	lbu
娑	sod
谄	ijy
酪	lcy
溟	mkd
隼	syr
峒	dsu
芋	yuc
盹	dyo
劾	hew
趔	lpt
殇	uhd
噌	cgk
轧	vai
鸢	yry
玷	dmw
趄	qpt
杳	ycm
镀	duj
祎	yip
匍	pub
崴	wdu
幔	mjj
蝈	goi
镑	bhj
瞰	kjo
侬	nsr
搡	shf
缆	ljs
蟀	uki
瓒	zjw
邋	laz
竣	jyl
泗	sid
贲	bfu
胴	dso
谤	bhy
蛐	qui
糯	nom
愠	yyx
噙	qbk
嘣	bgk
诃	hey
脓	nso
瑙	ncw
荃	qrc
孵	ful
嗵	tsk
颀	qij
阿	eee
篆	vrv
揄	yuf
辎	zii
踮	dmz
犷	glq
鳅	qqy
馍	mou
蜃	ufi
遛	lqz
倌	grr
氤	ybq
戌	xuw
馗	kvj
匮	kvk
和	hoh
胚	pwo
啻	iiw
夙	suj
珈	jxw
锹	qnj
摒	bkf
迩	erz
啾	jqk
馥	fuh
槌	ivm
燮	xph
褛	lvp
豚	tyo
氲	yyq
湍	trd
陆	lqe
毗	pit
耙	bal
耙	pal
褴	ljp
恁	nfr
瘁	cvb
蚌	bhi
铝	lvj
蔻	kzc
濑	ldd
鬃	zse
祢	mip
苒	rjc
蘅	hgc
町	dkt
掇	dof
戛	jxb
贮	vub
孬	ncb
衩	iap
镣	lnj
斡	wou
潢	hld
黔	qml
臃	yso
轼	uii
嘹	lnk
阪	bje
冗	rsb
闳	hsm
皿	mbk
辍	ioi
浚	jyd
闰	rym
臼	jqp
囤	tyk
蚓	ybi
碴	iau
姒	sin
堑	qmi
箴	vfv
嵘	rsu
箩	lov
艮	gfo
谆	vyy
牒	dpp
蔺	lbc
刽	gvr
锷	eej
惇	dyx
缜	vfs
贰	ery
坳	aot
睑	jmo
镂	lzj
癸	gvb
笆	bav
壬	rfp
叵	pok
坨	tot
姹	ian
赳	jqt
恰	qx
琮	csw
焊	hjh
淬	cvd
圳	vft
恹	yjx
淙	csd
酵	jny
犒	kcn
饪	rfu
嗟	jpk
谚	yjy
鲲	kyy
谟	moy
馊	szu
虱	uiv
糠	khm
旮	gaj
骠	pnm
峋	xyu
跆	tdz
潸	ujd
偻	lzr
绺	lqs
沱	tod
囱	csp
铳	isj
兖	yjl
苯	bfc
佻	tnr
魈	xng
獗	jtq
鞅	yhg
壳	qnt
贾	gux
蹶	jtz
绔	kus
蔗	vec
奘	zhp
芍	ucc
淞	ssd
殒	yyd
麝	uel
蚤	zci
浃	jxd
坂	bjt
祗	vip
眦	zio
暹	xmz
赧	nji
佝	gzr
蒯	kkc
郦	lil
钺	ytj
硅	gvu
玳	ddw
蛹	ysi
睾	gcp
螭	iii
瑁	mcw
侗	dsr
宕	dhb
绰	ios
纂	zrv
厩	jqi
帔	pwj
熨	yyu
觐	jbc
阗	tmm
钏	irj
迳	jkz
缮	ujs
邕	ysv
柩	jqm
漕	ccd
鹄	hun
餮	tpd
幄	woj
爰	yrv
噻	sdk
锃	zgj
纰	pis
绡	xns
瞭	lno
氢	qkq
妫	gvn
岫	xqu
璜	hlw
聒	goe
椿	iym
谩	mjy
琊	yaw
闩	urm
踊	ysz
痿	wwb
啵	bok
昶	ihy
柚	yzm
祐	yzp
篑	kvv
陲	ive
亟	jil
樽	zym
遨	aoz
琨	kyw
邈	mnz
棂	lkm
抻	iff
铉	xrj
怩	nix
嚯	hok
茁	voc
膘	bno
酩	mky
榔	lhm
娩	mmn
忸	nqx
扪	mff
呶	nck
仃	dkr
佞	nkr
裨	pip
巽	xys
黜	iul
滂	phd
戕	qlp
埂	ggt
纫	rfs
溉	gdd
猊	niq
胛	jxo
遑	hlz
珣	xyw
妗	jbn
蒿	hcc
钛	tdj
掐	qxf
磺	hlu
岷	mbu
葩	pac
苋	xmc
肛	gho
桠	yam
铤	tkj
滦	lrd
稔	rfh
锲	qpj
哙	kkk
獐	vhq
讧	hsy
氨	anq
缯	zgs
褓	bcp
赊	ueb
鄱	poc
炅	jso
碜	ifu
戗	qlr
钠	naj
铀	yzj
挝	wof
衢	qur
狒	fwq
骞	qmb
卜	bol
省	xku
盥	grj
睚	yao
祚	zop
砣	tou
夯	hhd
驷	sim
掴	gof
蜞	qii
乜	mpv
荪	syc
蹴	cuz
鸵	ton
韫	yyw
祛	qup
黢	qul
仄	zei
孀	uln
斫	vou
牍	dup
佃	dmr
懋	mcm
赡	ujb
秣	moh
镭	lwj
铄	uoj
媾	gzn
嫒	ain
谌	ify
谌	ufy
尕	gan
蝼	lzi
篙	gcv
逡	qyz
膑	bbo
荥	xkc
隍	hle
罄	qkt
蕨	jtc
囵	lyk
睢	svo
绶	uzs
罹	lis
瑗	yrw
秸	jph
裱	bnp
牦	mcn
荑	tic
伯	bdr
砝	fau
秆	gjh
荏	rfc
芈	mic
邝	klg
狻	srq
麋	mil
锟	kyj
粑	bam
诳	kly
鹑	iyw
缙	jbs
徕	ldr
痢	lib
撺	crf
魉	llg
妊	rfn
婳	hxn
矍	jto
犸	maq
庖	pcg
俎	zur
墉	yst
觥	gsd
哞	mzk
旃	vjf
伉	khr
猷	yzb
怄	oux
锨	xmj
豢	hrj
泵	bgu
擀	gjf
绻	qrs
绌	ius
蓑	soc
纥	hes
釉	yzc
讫	qiy
砧	vfu
萼	eec
辔	pws
瘌	lab
缪	mqs
鹧	veg
蹉	coz
醍	tiy
泷	lsd
蓼	lnc
梏	gum
祜	hup
虺	hvw
嘬	zok
杲	gco
荞	qnc
涝	lcd
焖	mfh
魍	whg
跎	toz
锉	coj
喆	vet
镁	mwj
胱	glo
醐	huy
亲	qkl
笳	jxv
崂	lcu
揆	kvf
裾	jup
姮	hgn
椁	gom
羸	lww
谪	vey
狲	syq
珲	hyw
镫	dgj
鼹	yjj
懔	lbx
咩	mpk
誊	tgj
韪	wwo
噱	xtk
铩	uaj
硌	geu
脍	kko
淖	ncd
炘	xbh
聩	kve
泅	qqd
绦	tcs
铡	vaj
遒	qqz
蚪	dzi
煅	drh
悱	fwx
茕	qsc
妲	dan
璠	fjw
珥	erw
岬	jxu
舢	ujv
肱	gso
焙	bwh
逦	liz
冁	ijb
色	udd
蜢	mgi
旻	mbo
瑭	thw
踅	xtf
嶂	vhu
徭	ycr
狍	pcq
鹌	and
埙	xyt
缛	rus
椽	irm
酮	tsy
貉	hcv
貉	hev
玠	jpw
糨	jlm
畹	wjt
铖	igj
镝	dij
缦	mjs
轸	vfi
洽	qxd
舂	isi
黍	uuh
伽	qpr
氯	lvq
倬	vor
酡	toy
媞	tin
缱	qms
浜	bhd
鋆	yyt
柘	vem
猕	miq
桉	anm
蜮	yui
骢	csm
橐	tog
琚	juw
钿	dmj
貅	xqv
嫱	qln
笤	tnv
旸	yho
卅	saa
嗄	uak
艄	ucv
茏	lsc
辚	lbi
疟	ntb
筌	qrv
刹	iax
匙	iio
堡	bur
塞	seb
娜	non
扎	zaf
𤭢	cw
𤭢了	cww
傩	nor
珙	gsw
貊	mov
诟	gzy
鬣	lpe
鼐	ndn
獭	taq
獾	hrq
邛	qsg
擤	xkf
赅	gdb
稗	bdh
氮	djq
竽	yuv
箓	luv
铧	hxj
褡	dap
陂	bwe
陂	pie
蚺	rji
钨	wuj
綮	qkh
舛	irx
玕	gjw
媪	aon
笏	huv
晷	gvo
摈	bbf
儋	djr
葶	tkc
阡	qme
猗	yiq
粕	pom
睇	dio
虢	gov
珐	faw
髭	zie
龈	ybv
锒	lhj
钯	baj
菖	ihc
灞	bad
珺	jyw
畦	qit
腩	njo
蠹	dug
瓤	rhx
薨	hsc
祂	tap
镊	npj
镗	thj
稹	vfh
罅	xxf
螟	mki
祧	tnp
犴	hjq
玎	dkw
侉	kxr
厝	coi
兕	sia
胪	luo
抟	trf
鬈	qre
啬	set
烺	lhh
筇	qsv
忺	xmx
砭	bmu
挈	qpf
怼	dvy
镞	zuj
貔	piv
搠	uof
杷	pam
讴	ouy
铬	gej
歃	uaq
烷	wjh
箜	ksv
恂	xyx
燊	ufh
癯	qub
缟	gcs
廪	lbg
垓	gdt
瘙	scb
氖	ndq
铰	jnj
陉	xke
妯	vzn
耄	mcl
镛	ysj
烙	loh
镱	yij
竦	ssl
飨	xlx
猡	loq
讣	fuy
枰	pkm
馕	nhu
鲇	nmy
佤	war
枇	pim
垭	yat
鹳	grc
恚	hvt
帑	thn
侪	idr
穑	seh
脶	loo
娌	lin
砀	dhu
蚋	rvi
缁	zis
箬	rov
猱	ncq
掮	qmf
龃	juv
苣	quc
裢	lmp
郧	yyk
莴	woc
禳	rhp
夤	ybx
玢	ffw
镏	lqj
狯	kkq
焐	wuh
腭	eeo
淦	gjd
楝	lmm
艨	mgv
棹	vcm
睃	soo
庥	xqg
柞	zom
磔	veu
鞨	heg
锰	mgj
堞	dpt
橛	jtm
趺	fuz
倥	ksr
旒	lqf
耧	lzl
狴	biq
镕	rsj
欸	ei
欸	ais
欸	ees
穰	rhh
怛	dax
缃	xls
哏	gfk
逄	phz
岙	aoy
沤	oud
珰	dhw
叻	lek
耋	dpl
薮	szc
缗	mbs
蹁	pmz
脯	puo
祆	xmp
茛	gfc
莼	iyc
媸	iin
雱	phy
褫	iip
锛	bfj
熵	uhh
馑	jbu
轺	yci
塄	lgt
崮	guu
纮	hss
诂	guy
镢	jtj
氟	fuq
椹	ufm
栊	lsm
孢	bcz
郴	ifm
獬	xpq
箧	qpv
鳃	sdy
矸	gju
讵	juy
枋	fhm
璺	wfj
啭	vrk
鞣	rzg
耦	oul
蛉	lki
箪	djv
璈	aow
逋	buz
鳟	zyy
痱	fwb
戋	jmg
诔	lwy
曷	heo
髋	krg
铙	ncj
嫘	lwn
袆	hvp
瓘	grw
椴	drm
墒	uht
蹚	thz
阇	uem
龋	quv
悭	qmx
蠲	jrb
谝	pmy
撄	ykf
鬲	gea
圪	get
嬛	hrn
笮	zev
笮	zov
砷	ufu
锱	zij
糍	cim
芎	xsc
蛤	gei
尻	kcu
捩	lpf
蹼	puz
裰	dop
偬	zsr
榫	sym
茑	nnc
蓊	wgc
秭	zih
瘢	bjb
茼	tsc
旄	mcf
汊	iad
茝	idc
碇	dku
钡	bwj
凼	dhk
垆	lut
炔	qth
萘	ndc
蟮	uji
飧	syx
碓	dvu
孓	jtl
痧	uab
谰	ljy
唵	ank
嫚	mjn
钚	buj
痈	ysb
狷	jrq
酢	zoy
阍	hym
痤	cob
蔸	dzc
嘚	dek
盍	heq
赉	ldl
霪	yby
诹	zzy
糌	zjm
亶	djw
舸	gev
畈	fjt
笊	vcv
芏	duc
艉	wwv
阊	ihm
傧	bbr
攮	nhf
酚	ffy
叇	ddy
氦	hdq
笸	pov
禤	xrp
篌	hzv
谖	xry
髡	kye
酯	viy
髫	tne
镬	hoj
皴	cyy
鍪	mzm
锞	kej
昳	dpo
簟	dmv
鄄	jrx
郯	tjh
廋	szg
熜	csh
祼	grp
嘡	thk
萑	hrc
蚧	jpi
柰	ndm
遄	irz
麇	qyl
琤	igw
竑	hsl
趱	zjt
玭	pbw
裎	igp
儇	xrr
盉	heh
绀	gjs
倮	lor
岜	bau
谵	vjy
帻	zej
褊	bmp
梃	tkm
缵	zrs
礅	dyu
墡	ujt
缶	fzw
亍	iua
刖	yto
炻	uih
卬	ahp
荽	svc
磴	dgu
锶	sij
迓	yaz
炝	qlh
啉	lbk
驺	zzm
缫	scs
嗉	suk
殂	cud
铘	yej
辏	czi
悛	qrx
璩	quw
彟	yte
劢	mdw
尥	lny
轫	rfi
佺	qrr
熘	lqh
萏	djc
喾	kux
曩	nho
瑷	aiw
砗	ieu
蚍	pii
阃	kym
溲	szd
桡	rcm
耨	nz
鲢	lmy
豳	bbu
缑	gzs
蝾	rsi
榧	fwm
洫	xud
坜	lit
磙	gyu
粜	tni
庋	gvg
抔	pzf
铍	pij
蝣	yzi
柙	xxm
勰	xpl
獍	jkq
秾	nsh
锗	vej
漭	mhd
袢	pjp
鳎	tay
彖	trh
裉	kfp
澄	dgd
磅	phu
耜	sil
坼	iet
埕	igt
尜	gax
瘊	hzb
墁	mjt
铊	taj
锂	lij
克	kw
劬	quj
蔟	cuc
濞	bid
悃	kyx
蠖	hoi
谮	zfy
鲎	hzx
畀	bit
裒	pzy
蚬	xmi
锝	dej
镲	iaj
臜	zao
邡	fhf
怍	zox
螨	mji
陔	gde
汆	crr
呒	muk
钼	muj
肫	vyo
蝰	kvi
冏	jsk
胼	pmo
瘳	izb
锑	tij
尢	whu
芗	xlc
蒌	lzc
浈	vfd
靸	sag
碡	vzu
觇	ijv
埽	sct
谠	dhy
栲	kcm
袼	gep
踔	ioz
磻	pju
狨	rsq
疃	trt
飑	bnf
俵	bnr
溴	xqd
琇	xqw
畚	bfs
骖	cjm
堠	hzt
泖	mcd
隹	vvr
僦	jqr
哿	gel
馓	sju
嵫	ziu
隳	hve
篼	dzv
垴	nct
辊	gyi
绱	uhs
诎	quy
醢	hdy
埘	uit
昺	bko
陬	zze
啫	vek
菘	ssc
锕	aaj
侔	mzr
砼	tsu
蚶	hji
藁	gcc
镡	tjj
佴	ndr
昃	zeo
杪	mnm
耪	phl
鬏	jqe
橼	yrm
爨	crj
狃	nqq
萩	qqc
嘌	pnk
楯	uym
畎	qrt
蕞	zvc
脬	pco
缬	xps
荛	rcc
谇	svy
丏	mmg
廛	ijg
氚	irq
烃	tkh
焌	jyh
蒽	enc
铵	anj
岵	huu
绲	gys
诖	gxy
遘	gzz
钣	bjj
疔	dkb
刳	kud
虿	idw
匦	gvk
嫽	lnn
秕	bih
葑	fgc
铯	sej
钪	khj
崞	gou
牤	mhn
蛞	koi
颃	hhw
镆	moj
嫜	vhn
瑢	rsw
茺	isc
蒗	lhc
圹	klt
敉	mim
焜	kyh
鳔	bny
枹	bcm
晡	buo
鲀	tyy
砉	hxf
镚	bgj
龀	ifv
甾	zdv
鞔	mjg
钭	dzj
锘	noj
垱	dht
弢	tcg
猰	yaq
瘘	lzb
裥	jmp
邨	cyt
翃	hsu
宁	nkb
崾	ycu
髌	bbg
鲭	qky
悫	qtt
溻	tad
爝	jth
蛱	jxi
笾	bmv
罟	gus
埝	nmt
曛	xyo
楦	xrm
濉	svd
锳	ykj
幢	ilj
硭	mhu
轧	gai
钍	tuj
唪	fgk
栝	gxm
纩	kls
菹	zuc
趑	zit
馇	vau
莨	llc
鳊	bmy
尨	mhl
螽	vsd
昪	bmo
傉	nur
埭	ddt
枘	rvm
鞲	gzg
髹	xqe
氘	dcq
湓	pfd
栳	lcm
茈	zic
揸	vaf
犇	bfn
婼	ron
撙	zyf
擐	hrf
颥	ruy
悰	csx
桄	glm
烝	vgl
疳	gjb
慝	tek
烔	tsh
瀹	ytd
唛	mdk
扽	df
苤	ppc
蒇	ijc
蛘	yhi
觍	tmq
钋	poj
廆	wwg
攉	hof
钕	nvj
黪	cjl
缂	kes
骀	ddm
骀	tdm
坰	jst
肟	woo
鬷	zsg
哌	pdk
瘰	lob
籀	vzv
蜣	qli
薤	xpc
垌	dst
垌	tst
蛲	nci
俜	pkr
蟛	pgi
辋	whi
龠	ytr
猇	xnq
腠	czo
鞴	bwg
黉	hsx
垚	yct
恧	nve
杩	mam
胍	gxo
蒡	bhc
胲	hdo
檎	qbm
纻	vus
墚	llt
氡	dsq
瑱	tmw
甏	bgt
翛	xnr
觏	gzf
骺	hzg
鹨	lqx
岣	gzu
肷	qmo
蛑	mzi
裼	tip
铒	erj
坫	dmt
夬	gkv
胂	ufo
贶	klb
躜	zrz
钘	xkj
铪	haj
玱	qlw
訚	ybm
锊	ltj
碹	xru
肭	nao
坭	nit
脞	coo
饹	leu
骕	sum
嵝	lzu
瓞	dpg
躐	lpz
跐	ciz
铽	tej
阼	zoe
鸸	ere
埯	ant
迺	ndz
堍	tut
崒	zuu
硇	ncu
苄	bmc
酴	tuy
夼	kld
腘	goo
艚	ccv
鼗	tcv
圊	qkk
淠	pid
矻	kuu
迕	wuz
饸	heu
筘	kzv
蠊	lmi
躔	ijz
爚	yth
犏	pmn
镧	ljj
馘	gob
垲	kdt
瘥	idb
糇	hzm
绠	ggs
骦	ulm
齉	nhz
坌	bff
礓	jlu
钫	fhj
羰	thy
铋	bij
垞	iat
垟	yht
廙	yig
衄	nvp
酞	tdy
棁	vom
櫆	kvm
窀	vyb
赆	jbb
鹯	vjw
捃	jyf
罨	yjs
恝	jxf
蒴	uoc
轪	ddi
锿	aij
鲻	ziy
绗	hhs
掭	tmf
蛸	uci
蛸	xni
驵	zhm
崚	lgu
柊	vsm
瑆	xkw
眍	kzo
羧	soy
搋	ikf
汭	rvd
璮	tjw
瘭	bnb
趯	tit
阽	dme
𦶟	ro
泐	led
荬	mdc
偲	cdr
垯	dat
禘	dip
胩	kao
苎	nkc
迮	zez
钔	mfj
靬	qmg
碃	qku
耖	icl
亸	dow
廒	aog
葎	lvc
侘	iar
聍	nke
鬘	mje
斝	jxk
猹	iaq
窊	wab
篚	fwv
燋	jnh
玚	yhw
仫	mur
痄	vab
裈	kyp
蹅	iaz
偡	vjr
抃	bmf
砫	vuu
螬	cci
鳙	ysy
尪	why
帨	uvj
畯	jyt
瞵	lbo
硁	kgu
螵	pni
铑	lcj
麹	quf
囷	qyk
璪	zcw
钐	ujj
萳	njc
醭	buy
鱽	dcy
倻	yer
泂	jsd
泙	pkd
濩	hod
瀼	rhd
犋	jun
耠	hol
腽	wao
菼	tjc
镴	laj
鳓	ley
喤	hlk
噇	ilk
瞍	szo
萜	tpc
杄	qmm
翟	dix
脎	sao
蒻	roc
魋	tvg
僇	lur
滃	wgd
耵	dke
坉	tyt
煴	yyh
瑑	vrw
蔀	buc
鸧	chl
倕	ivr
耢	lcl
铌	nij
劄	vav
玼	ciw
睄	uco
籥	ytv
绖	dps
鲙	kky
麑	nil
仂	ler
怊	icx
悢	llx
惙	iox
耥	thl
铼	ldj
镄	fwj
慆	tcx
牁	kep
瑳	cow
缲	qns
脲	nno
诐	biy
鲌	boy
勍	qkw
娀	ssn
嬬	run
宬	igb
惛	hyx
慥	zcx
戤	gdn
矰	zgu
簉	zcv
翯	hex
褯	jpp
鼢	ffj
炟	dah
磉	shu
礞	mgu
窎	dnb
缞	cvs
姱	kxn
椀	wjm
耔	zil
膙	jlo
薿	nic
蘘	rhc
鞧	qqg
牚	igx
簰	pdv
臑	nco
衠	vyr
鞡	lag
鲗	zwy
俍	llr
梾	ldm
熥	tgh
筻	ghv
钖	yhj
镥	luj
髢	die
髽	vxe
剟	doy
坬	wat
嵚	qbu
忳	tyx
旵	ijo
浭	ggd
狉	piq
珖	glw
禚	vop
筜	dhv
簕	lev
簖	drv
藨	bnc
蚆	bai
讻	xsy
弨	icg
昒	huo
铷	ruj
啴	ijk
憭	lnx
昄	bjo
晙	jyo
晫	voo
煋	xkh
礵	ulu
萣	dkc
螋	szi
铈	uij
隩	aoe
鞳	tag
韨	fuw
馌	yeu
愐	mmx
氕	ppq
焞	tyh
猯	trq
珢	ybw
琫	bgw
胈	bao
苠	mbc
蒎	pdc
薁	aoc
驲	rim
堧	rrt
嶦	uju
帡	pkj
庱	igg
栐	ysm
橞	hvm
煃	kvh
祃	map
笯	nuv
簝	lnv
腒	juo
荙	dac
虷	gji
馞	boh
倴	bfr
咡	erk
噂	zyk
婘	qrn
崀	lhu
弸	pgg
昤	lko
溞	scd
漴	isd
爟	grh
猺	ycq
玤	bhw
璒	dgw
璲	svw
瓀	rrw
祋	dvp
祾	lkp
耇	gzl
貆	hrv
儴	rhr
呇	mfu
垏	lvt
堽	ght
墐	jbt
媓	hln
愭	qix
暅	ggo
栟	bfm
涐	eed
湴	bjd
滆	ged
焆	jrh
疁	lqt
癗	lwb
祊	bgp
腙	zso
腨	uro
腯	tuo
荄	gdc
荮	vzc
襚	svp
踒	woz
铥	dqj
靽	bjg
𰻝	bl
乜	npv
乸	nay
偭	mmr
儳	ijr
凹	wal
南	nau
却	qtq
参	cfs
叶	xpk
吭	hhk
哪	nek
唷	yok
啁	vck
啜	ikk
喔	ook
嘚	dw
圌	ivk
圲	qmt
塅	drt
奘	vlp
姈	lkn
婍	qin
婻	njn
嬢	nln
屯	vya
峘	hru
嵲	npu
巷	hhg
帱	izj
帱	dcj
忒	tey
戆	ghl
戛	gab
挼	rx
数	uom
杉	uam
杻	izm
杻	nqm
梌	tum
楪	dpm
槜	zvm
殷	yjp
沌	vrd
浍	kkd
涡	god
瀌	bnd
瀑	bcd
牟	mus
牠	tan
犍	qmn
琀	hjw
瑔	qrw
番	pjc
睆	hro
种	ish
筠	jyv
粘	nmm
糁	sjm
纶	grs
络	lcs
绰	ics
绿	lus
缩	sus
脟	lpo
腌	aao
臭	xqz
苕	tnc
萚	toc
葜	qxc
虹	jli
蚌	bgi
蚲	pki
袷	qxp
褪	typ
诶	eiy
读	dzy
豸	vdp
趄	jut
迫	pdz
铊	toj
镐	hcj
陂	poe
隃	uue
鞘	ucg
颈	ggj
颉	xpt
驮	dom
髂	qxg
