的	d
我	w
是	u
了	l
你	n
在	z
和	h
都	db
不	b
有	y
就	j
也	yt
好	ha
个	g
人	r
说	uo
用	ya
他	t
这	v
来	la
要	yj
去	q
会	hc
看	k
中	vs
想	x
没	m
啊	a
那	nl
吧	ba
给	gc
能	nh
对	dc
上	ug
到	dj
多	do
吗	ma
里	lp
被	bm
做	zi
又	yv
过	gi
让	rg
还	haz
她	ta
打	dd
把	bd
而	e
着	ve
大	dl
从	c
它	tab
写	xv
再	zk
字	zu
得	de
搞	ga
狗	gm
猫	mk
一	yi
真	vf
下	xq
但	dh
叫	jx
很	hh
比	bp
呢	ne
最	zc
更	gf
地	du
地	det
等	djv
吃	i
像	xs
后	hv
时	uoo
只	vp
点	dx
先	xm
话	hq
与	yn
快	kt
玩	wk
当	dhx
已	yp
问	wd
完	wkb
以	ypl
将	jd
您	nm
找	va
爱	au
太	tk
谁	ux
才	ca
年	nz
新	xn
跟	gfz
别	bc
学	xy
哇	wa
按	ab
哎	ai
前	qz
睡	uc
加	jw
所	s
为	wx
为	wml
可	ktd
出	iu
嗯	ef
该	gl
向	xsp
却	qr
哦	o
小	xb
天	tm
高	gk
买	ms
呀	yak
刚	gh
事	uu
好	hjn
坏	ht
发	f
全	qt
开	kl
万	wh
之	vi
心	xnd
帮	bh
回	hb
得	drr
牛	nw
家	jwb
长	ij
月	yr
卖	mku
岁	sc
成	ih
唉	auk
跑	p
走	zm
早	za
连	lz
滴	di
越	yrt
无	wi
阿	aa
送	sa
分	ff
黑	hz
额	er
妈	man
换	he
们	mf
难	nk
同	td
祝	vy
恩	en
干	gha
算	se
路	ly
并	bt
呗	bz
少	ua
猜	cl
放	fg
擦	caf
转	vyi
错	ci
脸	lx
贴	tx
陪	px
带	dk
笑	xx
敢	gle
谱	po
拿	ns
二	ee
煮	vo
鸡	ji
或	hi
书	uuv
每	mc
画	hqa
坐	zit
咯	kd
掉	dxf
讲	jg
梦	mfm
冷	lj
花	hw
于	yb
手	um
咋	zd
哟	yo
爆	bj
站	vh
变	bn
看	kju
哥	ge
版	bl
水	un
起	qp
图	ti
弄	na
住	vyr
啦	lak
够	gv
咩	mx
累	lm
倒	djr
肉	rv
毛	ml
神	ugp
请	qi
拉	laf
肿	vfo
听	ty
内	nmk
噢	oo
唱	ig
骂	mlk
装	vd
三	sj
蛮	mkw
腿	tn
正	vfa
瘦	uv
卤	lo
俺	az
老	lal
俩	lr
抱	bjf
忙	mj
超	ik
疼	th
胖	pg
喔	wo
车	ie
某	mm
第	duv
教	jc
进	jb
假	jr
差	il
忘	wg
热	rw
选	xyz
啥	us
微	wz
求	qw
若	ri
些	xxv
久	je
苦	ko
米	mp
约	yts
飞	fz
吓	xqk
亲	qn
照	vj
赢	yu
饿	ew
读	diy
秒	mb
信	xbr
另	lt
儿	et
靠	kj
聊	lv
远	yy
懂	df
羯	jcy
低	dir
呆	dlk
晒	uk
追	vv
见	jn
跳	txz
挂	gq
哪	nd
鸟	nb
呃	ewk
挺	tif
贵	gcv
元	yta
摩	mpg
疯	fgb
张	vhg
萌	mh
头	tnd
活	hp
行	xu
哒	da
次	cu
本	bhm
骗	pn
店	dn
考	ka
歌	gek
喂	wm
强	qf
死	sp
收	ub
贱	jnb
噗	pu
恨	hd
撸	lu
喵	mck
亮	ls
弱	rig
破	pi
哼	hg
拍	pl
躺	tku
抢	qg
吐	to
日	ru
谈	tky
饭	fh
帅	ut
离	low
号	hj
闹	nj
办	bhl
还	htz
养	yk
红	hds
猪	vu
刷	uw
呐	nlk
姐	jv
洗	xp
种	vah
喝	hek
菜	ck
如	rin
赞	zh
丢	dq
捏	nx
非	fzl
粉	fhm
怕	plx
坑	kg
网	wkk
总	zf
曾	ch
蛋	dhz
型	xuk
咱	zkk
屎	up
纸	vps
杀	uax
自	zup
白	bap
急	jo
催	cv
吖	aak
改	gs
特	tw
包	bk
愿	ye
妹	mmn
唔	wik
受	uvv
抓	vw
钱	qzj
者	vt
喷	pf
鱼	ybd
瞎	xw
此	cp
乱	le
滚	gw
呦	ybk
晚	wl
留	lw
晕	ypo
风	fgj
抽	ib
块	ktt
怪	gt
度	dy
戳	io
往	wkr
便	bnr
楼	ln
党	dkx
吹	iv
练	lns
删	uj
条	tv
耶	yre
丫	yab
系	xup
君	jp
丑	im
件	jnr
近	jbz
两	lg
雨	yna
力	luv
面	mn
球	qww
重	id
火	hqb
爬	ps
脚	jbo
管	gy
偶	oor
行	hjr
黄	hf
嘴	zn
戴	dkg
情	qu
各	gww
门	mg
卡	kdu
倒	dar
跪	gcz
道	djz
病	btb
边	bmz
搜	sb
短	dyu
混	ho
指	vpf
翻	fj
词	co
招	vk
尿	nxu
摸	mo
嘤	yyk
撒	sd
毁	hn
顶	did
马	md
喊	hl
由	ynl
悲	bzf
组	zo
帖	tvj
则	zr
爪	vr
配	pm
乃	nsv
斤	jni
秀	xph
伤	uh
喽	lb
蓝	lk
及	jop
谢	xz
因	ynk
泡	pj
未	wma
款	ky
定	dt
深	uf
渣	vad
粗	cum
咔	kak
爸	blf
输	uui
床	if
碗	wlu
外	wkx
宅	vab
纯	iq
熊	xd
汗	hhd
搭	daf
药	yjc
使	upr
感	glw
宫	gsb
双	ud
演	yl
木	my
粑	bam
班	bjw
赚	veb
货	hir
亿	yur
拼	pnf
嗨	hlk
其	qo
名	mu
类	lmm
棒	bg
王	wj
骑	qom
片	pnp
茶	is
处	iy
砸	zs
查	ism
光	gd
气	qup
枪	qd
句	jcb
扔	rgf
试	uuy
嫁	jq
且	qv
切	qzq
醒	xi
惹	rt
停	tu
树	uy
爽	ugd
台	tas
口	km
半	bhb
鞋	xc
雪	xuy
任	rd
摔	uyf
接	jxf
操	ckf
娶	qne
入	ry
提	tof
狠	hhq
背	bzb
挖	waf
烂	lh
级	jos
间	jm
乖	gyq
达	ds
云	yq
冲	isd
团	tt
瓶	pub
主	vow
踢	tiz
硬	ytu
嘞	lzk
女	nn
动	day
剪	jxb
线	xns
叔	uuu
念	nnr
表	bb
挑	tc
致	vug
槽	clm
满	mld
甩	ui
油	ynd
省	uju
皮	pop
子	zp
酒	jed
救	jpq
穷	qdb
亦	yuw
忍	rh
妞	nq
反	fl
呜	wu
部	by
借	jz
插	ia
街	jxr
烦	fk
关	gr
草	cac
诗	uiy
直	vou
踩	cs
嘿	hzk
课	kw
臭	ivz
城	iht
票	pxx
剩	ufq
趣	qc
握	wif
李	lpm
嘛	mak
撞	vsf
汤	thd
刀	dkv
挤	jpf
替	tuf
夜	yw
扯	it
懒	ll
腰	yko
房	fjh
香	xdh
安	an
奔	bf
穿	ir
凭	pur
咦	yok
杯	bzm
泪	lmd
慢	mhx
虐	nr
逛	gsz
碎	scu
既	ju
痘	dv
题	too
舔	txu
即	jog
凉	lf
准	vwd
占	vhb
屁	puu
记	juy
胸	xso
摆	bs
国	gp
蛇	ur
派	pk
称	igh
盘	pkv
控	kaf
血	xvp
咧	lvk
忒	tvy
味	wmk
交	jcw
四	su
投	tnf
偷	tb
涨	vkd
躲	dqu
推	tvf
抹	mq
副	fy
咪	mi
尽	jbi
堵	dot
藏	cj
山	ujk
虎	hoh
乐	lwp
左	zq
吵	iak
岂	qpu
欠	qnd
传	itr
笨	bdv
寄	jub
修	xqr
烧	ukh
眼	ylo
机	jim
相	xdm
套	tj
撑	igf
蝎	xxi
落	li
绿	lc
折	vrf
甜	tz
糖	tjm
奥	aip
鬼	gn
份	fd
烤	kah
命	mt
补	bo
象	xsd
节	jxc
惨	clx
熟	unw
瞧	qvo
群	qq
海	hs
墙	qft
作	zir
鸭	yaj
样	yg
圆	ytk
嫌	xzn
身	ufz
逗	dvz
旧	jpl
断	dev
歪	wlb
段	dep
罗	lps
窝	wob
盖	gky
羊	yjb
闲	xzm
美	mcy
夹	jea
觉	jy
炒	iah
仍	rhr
莫	mic
排	pa
五	woa
傻	udr
篇	pmv
性	xt
租	zuh
几	jpp
周	vb
桥	qvm
区	qvk
队	dce
碰	pfu
蹭	cf
哈	hak
拆	ilf
哭	ku
卷	jyj
场	ikt
吻	whk
男	nkt
应	yyg
哄	hfk
签	qm
法	fdd
色	sw
需	xvy
流	lwd
杨	yjm
逼	bi
娃	ws
劝	qe
圈	qrk
集	jor
语	yny
涂	tid
平	pua
期	qic
暖	ny
座	zig
缺	qtf
矮	ap
空	ks
软	ryi
憋	bx
肥	fx
退	tcz
扑	puf
耍	ure
牌	pap
烟	yjh
狼	ljq
减	jxd
抄	ikf
理	lpw
劈	piu
印	ybp
望	wgw
陈	ige
郑	vfb
整	vju
郭	go
蹲	dp
恋	lnw
兔	tyd
知	viu
娘	nf
驴	lbm
辣	llx
偏	pmr
噶	gsk
据	jcf
数	uym
清	qy
粮	lfm
归	gvl
灰	hvu
姓	xtn
绝	jys
么	me
欲	yc
豆	dva
剧	jcu
待	dkr
待	dlr
那	nav
师	uil
犯	fhq
位	wmr
捉	vof
扣	kv
较	jxi
齐	qow
灯	dg
明	muo
酸	sr
帝	duw
值	vor
论	loy
季	juh
土	tou
右	yvu
啃	kh
熬	apf
揍	zv
赶	glt
银	ym
合	hr
细	xus
厚	hvi
西	xia
南	nku
朝	ilu
狂	kf
随	sbe
瞅	imo
界	jzt
盯	dyo
趁	idt
淡	dhd
轻	qyi
岛	dan
嗷	apk
拔	bsf
猛	mjq
扒	baf
宝	bab
方	fhw
刮	gwu
费	fm
遍	bnz
抠	kb
霜	udy
零	luy
星	xyo
夸	kwd
睇	duo
汪	whd
菇	gu
易	yuo
蒸	vg
愁	in
化	hqr
足	zik
揉	rn
佛	fp
码	mdu
龙	ld
糗	qem
馋	iku
刘	lww
服	fi
蟹	xzd
牙	ys
富	fyb
吾	wiw
冰	byd
七	qia
常	ijx
底	dpg
仅	jzr
习	xo
粘	vjm
奖	jgl
妆	vdl
爷	yrf
吼	hm
弯	wjw
炖	doh
嫩	ndn
基	jic
坨	tp
射	uwu
单	djb
薄	blc
隔	gre
史	upk
伞	sl
搓	cof
跌	dxz
雾	wy
必	bu
呸	pz
捧	pjf
似	sur
困	kok
掰	blu
令	ltr
怎	zhv
刺	cuu
答	dsv
冒	mjo
凶	xsk
船	itv
酱	js
趴	paz
闪	ul
昂	aj
紧	jzl
贼	zx
电	dny
声	ugt
具	jcq
压	yai
雷	lxy
钻	zrj
湿	uid
登	dgb
啪	pak
百	bsa
终	vss
哆	dok
酷	kyy
波	bod
治	vud
醉	zcy
唯	wxk
弹	tkg
砍	klu
原	yti
咳	kr
猿	ytq
秤	ifh
害	hk
甚	udc
锅	goj
官	grb
遭	zkz
赌	dob
怒	nyn
炸	vl
飘	pc
胡	hig
村	cpm
仔	zpr
解	jvd
订	dty
卧	wii
捂	wof
播	bof
伐	fs
量	lfo
割	geb
淘	tl
埋	mat
塞	slb
略	lrt
淫	ymd
宽	krb
透	tvz
凑	cvd
劲	jbj
重	vaq
届	jzu
倍	bmr
胃	wmt
嬛	xr
举	jnx
灭	mz
残	ckd
封	fgt
属	uou
粥	vbg
脑	nao
福	fip
扫	saf
韩	hku
废	fmg
煎	jmb
征	vgr
捞	lkf
罚	fss
慌	hdx
价	jqr
叠	dcy
饼	biu
母	mom
勒	lwg
存	cq
杜	dym
胜	ufo
虽	sv
毒	dif
妖	ykn
叼	dck
根	gfm
负	fyd
春	ip
虾	xwi
迷	moz
啰	lok
寸	cou
体	tpr
供	gsr
抛	pkf
烫	tg
拽	vtf
炮	pjh
防	fje
冻	dad
编	bms
侠	xe
勿	wyb
共	gac
纹	wgs
闻	wgm
北	bcl
守	umb
挡	dkf
拌	bhf
甄	vfx
牵	qmd
发	flf
克	kwu
摄	uwf
布	byu
降	jse
怂	sf
笔	bpv
奶	nsn
霾	may
颗	ke
九	jep
泥	no
於	ybf
教	jxl
瑟	sww
遮	vez
澡	zad
痒	ykb
锁	sq
吸	xik
敷	fu
德	dr
踹	itz
吊	dxk
舞	wop
含	hkr
浓	ndd
料	lxm
蹦	bfz
嘎	gak
潮	ild
现	xnw
长	vkp
壳	krt
调	dxy
罪	zcs
证	vfy
亏	kva
剃	tub
摇	ylf
素	sy
肾	udl
填	tzt
精	jym
沾	vjd
盒	hrr
闷	mdm
犬	qyd
通	ts
架	jql
腻	nu
露	lvy
著	vyc
晃	hso
铺	puj
潘	pjd
砖	vru
孔	kfz
乳	ro
食	uor
建	jnz
垫	dnf
键	jnj
捅	tf
饱	bau
欧	ou
伪	wc
兽	uvb
盼	ph
滑	hed
运	yoz
绕	rj
戒	jzg
缠	iks
散	slc
散	shc
拜	bku
嘘	xvk
枰	pum
赵	vjt
脏	zho
页	ywa
范	fhc
逃	tlz
结	jcs
馆	gyu
领	lir
巨	jck
处	iow
言	ykw
梗	gj
攒	zl
翘	qx
挠	nlf
溜	lq
市	uuw
伴	bhr
剑	jnq
分	fdb
初	iup
啧	zrk
利	luh
针	vfj
掐	qwf
啵	bok
博	bpu
否	fmb
虚	xvh
造	zj
巧	qb
寻	xqe
蠢	iw
朵	dqj
逆	nuz
骚	sk
层	chu
测	cw
局	jbu
剁	dij
般	bjv
诺	ni
叶	ywk
均	jpt
肌	jio
东	dsa
端	drl
宠	ifb
税	uch
容	rdb
斯	si
物	wyn
录	lye
丽	lua
盐	ykt
败	bkb
咸	xzw
摘	vlf
矣	yps
众	var
惊	jyx
竟	jt
敲	qcw
嗲	drk
干	gja
漏	lvd
湖	hid
沉	igd
截	jcg
朱	vup
付	fyr
醋	cy
撕	sif
获	hic
朕	vdo
冥	mub
丝	sis
轮	lqi
河	hrd
炫	xeh
塔	tdt
袁	ytt
喜	xpt
魂	hqy
挣	vff
赔	pxb
耳	ey
撤	iwf
碧	buw
贪	tjr
扛	kjf
镇	vdj
肺	fmo
祸	hip
果	gqt
怀	hu
嚯	hik
拱	gff
顺	uoi
器	quk
秋	qqh
孙	spz
巴	bas
捐	jrf
屋	wuu
沪	hy
猴	hnq
夏	xqb
龟	gvd
转	vei
耐	nke
仨	sar
争	vgd
肯	khv
歇	xxo
板	blm
极	jom
案	abb
扭	nef
观	gry
卸	xzv
设	uwy
趟	tgt
攻	gsg
抖	dm
静	jtf
除	ii
旁	pjw
稳	whh
董	dfc
逢	fhz
浅	qxd
环	htw
申	uft
遇	ycz
绑	bks
乘	ihq
缩	so
泰	tki
紫	zpv
认	rdy
串	iek
痣	vub
沙	uad
友	ymu
战	vhv
尼	nou
臀	tq
丁	dya
股	goo
步	byv
档	dgm
鼻	boz
识	uoy
叻	lwk
限	xne
幅	fij
响	xg
旅	lnf
跨	kq
意	yul
崔	cvu
侬	ndr
哩	lik
威	wzw
糕	gkm
赛	skb
麻	msg
瓜	gwi
拧	nif
室	uub
愣	lfx
尊	zpb
寒	hkb
广	gg
率	lcw
品	pzk
凹	ao
维	wxs
裤	kyp
蒙	mhc
搂	lbf
斜	xcr
苏	suc
免	mxd
居	jvu
餐	cjd
膏	gkw
染	rl
轰	hsi
唐	tjg
婚	hpn
摊	tjf
瑕	xew
皂	zjb
桶	tfm
立	luw
客	kwb
状	vsl
枕	vhm
闯	igm
扶	fif
故	gyg
尾	wcu
千	qmp
震	vdy
粽	zam
叹	thk
古	gou
灵	lue
堆	dvt
恶	ewy
损	swf
呼	huk
琴	qmw
虫	idv
展	vlu
善	uhy
芙	fic
狮	uiq
抗	kgf
科	keh
松	ss
乡	xdv
充	isw
嗒	dak
弄	law
衫	ujp
尖	jmx
森	sfm
扎	vaf
膜	mpo
晴	quo
婊	bbn
衣	yiw
迟	ioz
酥	suy
章	vhl
僧	sg
产	ilw
竖	uyl
横	hhm
聚	jce
娇	jcn
十	uoa
宋	sab
尚	ugx
依	yir
瞄	mv
旺	wgo
妙	mxn
甘	gjc
啾	jqk
膘	bco
田	tzk
噜	luk
悬	xtq
距	jcz
己	jpk
青	qyf
郎	ljl
糟	zkm
雅	yd
惯	gex
噻	slk
麦	mkf
侃	klr
钓	dxj
罢	bls
京	jyw
添	tmd
丹	djk
曲	qnk
扇	uhh
嚼	jvk
芯	xnc
许	xny
赖	lku
葱	csc
丸	wkl
搁	gef
娜	nln
揪	jqf
榜	bkm
遛	lpz
宰	zsb
俩	lgr
赏	ukx
谷	gob
曝	bjo
赐	cub
黏	nzh
腹	fyo
桌	vob
消	xcd
勺	ulb
江	jdd
兵	byq
裙	qqp
饮	yz
蝶	dci
蔡	ckc
侧	cwr
告	gjn
寺	sut
仙	xmr
甲	jrt
赴	fyt
角	jbd
钗	ilj
薛	xtc
止	vpl
磕	keu
港	gkd
曹	clc
崽	zsu
评	puy
坎	klt
巾	jnk
勾	gb
窗	idb
艾	auc
斗	dvu
凡	fkj
继	jus
刻	kww
保	bar
厄	ewi
蕾	lcc
抬	taf
驻	vym
弟	dub
喘	iyk
皱	vvd
喇	ldk
扎	zaf
唰	uwk
格	grm
附	fye
失	uip
暗	abo
野	ytl
橙	ihm
裸	lqp
蘸	vhc
桑	sh
嘉	jwt
沟	gbd
民	mmv
厂	ika
靴	xtg
涅	nzd
弃	quw
汁	vid
列	lzd
梨	loh
灌	ged
净	jtd
温	wf
批	pif
互	hya
罩	vjs
尔	eyd
帐	vgj
圣	ufy
馅	xnu
柜	gcm
粪	fdm
挫	cif
曼	mho
肝	gjo
然	rk
梁	lfd
仇	inr
邪	xcy
扁	bxh
翔	xf
肩	jmh
液	ywd
掏	tkf
末	mia
院	yee
杠	ggm
姜	jdy
谨	jzy
瓦	wda
焦	jcr
湾	wjd
堂	tjx
智	vuu
湘	xdd
钟	vsj
辆	lsi
莎	uac
联	lze
瞪	dfo
祭	jux
项	xsg
壶	hit
奇	qod
枚	mxm
兮	xib
薇	wzc
镜	jtj
拐	gif
兜	dbp
俄	err
优	ybr
贺	hwl
崩	bgu
工	gsa
剥	bke
吞	tpt
盗	djd
窄	vsb
军	jpb
携	xcf
痴	iib
影	yio
煲	bkr
当	dgx
舌	urq
衰	uyy
骨	gog
铅	qmj
划	heg
礼	lpp
裹	gqy
饶	rlu
鼠	uoj
砂	uau
盆	pgf
恕	uyn
搅	jbf
专	vrt
浪	lgd
卯	map
菊	jbc
沈	uhd
判	phb
引	yzg
制	vun
复	fyp
漂	pcd
族	zif
稿	gah
漫	mhd
摁	eb
绛	jss
核	hrm
郝	hai
挨	aif
挨	aof
脉	mko
妮	nin
标	bcm
创	isr
鹅	erw
哔	buk
颤	ihw
乔	qvy
睁	vgo
梳	uum
思	sit
舒	uur
凸	tul
移	yoh
框	ksm
泼	pod
邓	dfy
俗	sir
恰	qqx
阴	yne
鲜	xmy
碟	dcu
患	hei
帽	mjj
柳	lem
斩	vli
忌	juj
鲍	bjy
侯	hnr
熏	xpq
彭	pht
册	cwk
邀	ykz
晾	lso
掌	vkx
玉	ycw
弦	xzg
楞	lhm
业	ywl
汇	hcd
社	uwp
塌	tat
骆	lim
吨	dpk
坡	pot
懵	mjx
蒜	sec
财	cab
赠	zfb
持	iof
怨	yex
涮	ue
墨	mil
注	vyd
庙	mxg
靓	lsf
呲	cik
吉	jot
券	qej
迎	yuz
玻	bow
筋	jnv
霍	hiy
嗑	kwk
视	uup
洒	sdd
乜	mxv
译	yuy
夫	fue
柴	iav
蒋	jgc
悟	wyx
兰	lkb
茬	isc
漆	qid
恤	xcx
华	her
孤	guz
屯	tqa
叉	iay
普	pob
英	yyc
州	vbd
志	vut
商	uhw
禁	jbm
厅	tyi
载	zkg
私	sih
浇	jcd
腚	dto
户	hyd
独	diq
脆	cc
蒂	duc
壹	yit
徒	tir
胎	tlo
欸	eo
世	uuc
简	jxv
佬	lar
锤	ibj
亚	yla
蛆	qvi
嘚	dek
唇	iqi
捶	ibf
宁	nub
增	zg
禅	ikp
县	xnq
忧	ybx
仿	fkr
铊	taj
葬	zgc
权	qtm
龚	gsl
羞	xqy
童	tdl
希	xix
蹬	dgz
癖	pp
职	voe
瘫	tjb
粒	lum
渡	dyd
绣	xps
敌	dou
毕	bub
实	uob
腐	fo
杂	zsj
藕	ooc
糊	him
逮	dkz
讯	xoy
墓	myc
萱	xrc
浮	fid
哉	zlg
源	ytd
织	vis
籽	zpm
岗	gku
腔	qdo
蒙	mgc
喃	nkk
扬	yjf
备	bmw
雄	xdu
眠	mzo
牢	llb
迈	mkz
漂	pxd
焖	mdh
严	yka
奏	zvi
续	xcs
系	jup
沃	wid
呈	ihk
押	yaf
种	vfh
冯	fhd
购	gvb
倩	qnr
愈	ycr
憨	hje
脖	bpo
嫖	pv
川	irp
鹿	lyg
嗦	sok
窜	ce
樱	yym
皇	hfb
镐	gaj
忆	yux
挽	wlf
讨	tay
庆	qtg
胶	jco
敬	jtc
润	rod
永	yf
咒	vvk
棍	gom
袭	xol
噎	yek
嘭	pgk
陶	tle
厝	cii
嗅	xpk
痰	tkb
乌	wup
险	xxe
俾	bpr
邱	qqq
钢	ghj
坤	kp
碳	thu
采	csv
伸	ufr
孟	mfz
鼓	got
贝	bmk
缓	hys
蚝	hli
咽	yh
纵	zas
卒	ziw
吱	vik
钙	gkj
翅	iuv
耗	hjl
雀	qrx
棵	kem
挪	np
始	upn
皿	mzk
钉	dyj
冬	dsw
洋	yjd
苗	mvc
盛	ufi
袜	wlp
纳	nls
啤	pok
暂	zhi
妥	tqv
盲	mjw
误	wyy
菌	jpc
浴	ycd
勇	yfs
孽	nzc
枉	wkm
峰	fgu
晏	yho
嚷	rkk
研	yku
库	kyg
榛	vfm
叽	jik
噔	dgk
陌	mie
吒	vak
护	hyf
闭	bum
贾	jrx
捎	ukf
垵	ant
抵	dpf
莲	lzc
冤	yrb
臣	igk
椒	jcm
葛	grc
仓	chr
朗	lkl
义	yud
尸	uik
辛	xnl
唠	llk
唠	ljk
轴	vn
煞	uld
胆	dlo
枣	zau
稀	xih
晨	igo
仁	rgr
庄	vdg
撩	lvf
秃	tuh
乙	ypv
临	lml
嗔	ifk
婶	uhn
灸	jej
宴	yhb
币	bup
速	syz
索	squ
佳	jwr
姬	jin
咕	guk
返	flz
禾	hrp
链	lnj
誓	uuf
眯	mio
瓷	cod
绘	hcs
恃	uux
吕	lnk
探	thf
番	fjc
哀	aiy
乎	hup
蛙	wai
置	vus
氪	kwq
掀	xmf
埃	ait
芊	qmc
裆	dhp
镁	mcj
卢	lib
兑	dcb
阔	ki
谜	moy
差	ily
昏	hpu
谓	wmy
承	ihl
忠	vsv
潜	qzd
瞟	pb
驼	tpm
欢	hry
巫	wug
悔	hnx
诚	ihy
崴	wsu
呛	qdk
呛	qsk
涩	swd
曾	zgb
轶	yui
递	duz
烙	ljh
棉	mzm
句	gbb
霸	bly
缝	fhs
缝	ffs
切	qxq
祛	qvp
舟	vbp
鞭	bmg
瘾	yzb
亭	tuw
荼	tic
呕	ook
顾	gyi
雇	gyh
舍	utr
质	vui
镶	xdj
背	bmb
剂	juq
昨	zpo
帖	tzj
叮	dyk
姚	yln
乍	vlp
谎	hgy
阳	yje
亲	qtl
荤	hpc
忽	huw
账	vgb
枝	vim
剥	boe
舍	uwr
桃	tlm
荡	dgc
嗝	grk
嘟	duk
奉	ffi
孝	xxl
桩	vdm
挑	tbf
售	uvr
拳	qtj
犊	din
溅	jnd
助	vyq
铜	tdj
泯	mzd
盾	doi
焉	yjv
悦	yrx
夺	dpd
伦	lqr
诸	vuy
瑞	rc
萧	xcc
宜	yob
跶	daz
拾	uof
珠	vuw
凤	ffj
揽	llf
圭	gvt
弓	gsv
池	iod
境	jtt
钩	gbj
谦	qmy
阅	yrm
莪	erc
匿	nuk
审	uhb
隆	lde
渤	bpd
妾	qzl
硅	gvu
叭	bak
触	iyd
喏	nik
缸	ghf
坊	fht
嚓	cak
旗	qof
窦	dvb
颠	dmu
莱	lac
嗡	wgk
哑	ydk
裁	cag
淌	tkd
吆	ykk
危	wzd
硕	uiu
颈	jij
倔	jyr
荣	rdc
泉	qtb
卵	lyp
钵	boj
谣	yly
债	vkr
恒	hhx
肠	ijo
拟	npf
拴	urf
垂	ibq
伏	fir
撬	qxf
妃	fzn
恐	kfg
媛	ytn
菲	fzc
矗	iyu
晓	xbo
搏	bpf
抡	lpf
睿	rcb
腌	yjo
程	ihh
撇	pvf
筒	tfv
鸣	muk
娟	jrn
搽	isf
目	myk
揣	iif
彪	bch
兹	zib
绳	uhs
脾	poo
囤	tqk
姆	mon
蒽	enc
涌	yfd
妻	qiu
迁	qmz
姨	yon
秦	qmi
序	xcg
异	yus
束	uyg
康	khg
嗓	skk
觅	muv
篮	lkv
营	yuc
镑	bgj
俏	qxr
掺	ijf
珊	ujw
螨	mli
贫	pmf
傍	bgr
司	siv
崖	ysu
芭	bac
嘣	bgk
传	ver
叁	sjs
哗	hwk
辨	bnx
兆	vje
瘪	bv
枯	kum
芮	rcc
犹	ynq
誉	ycx
蜡	lli
僵	jdr
阵	vde
府	fog
坛	tkt
煨	wzh
吡	bpk
幸	xtt
栋	dam
刨	bjb
刨	plb
瑛	yyw
努	non
赫	hwi
椅	ypm
袄	aq
玛	mdw
晋	jby
氧	ykq
吽	hsk
武	wog
作	zor
瘟	wfb
矬	cpu
卫	wme
坠	vc
蜀	uos
柚	yvm
辱	roi
吟	ymk
轩	xri
廖	lxg
竹	vig
柔	rnm
祖	zop
棕	zsm
咚	dsk
洪	hdd
斋	vlw
浑	hqd
眉	mxu
穴	xyb
卿	qyp
燥	zjh
佑	yvr
奔	bdd
尘	igx
校	xxm
迪	doz
雌	cov
姿	zid
馊	sbu
沿	ykd
栏	lkm
席	xog
确	qru
胯	kqo
擤	xif
嗖	sbk
燕	yhc
遂	scz
逾	ybz
兴	xtx
咿	yik
焗	jbh
摞	lif
应	ytg
炕	kgh
奸	jmn
避	buz
贰	eey
缁	zis
厌	yhi
颓	tbh
殿	dnu
隐	yze
掂	dmf
宣	xrb
呱	gwk
馍	mpu
绮	qps
荒	hdc
掖	ywf
累	lxt
魏	wmh
豪	hlw
糙	ckm
砰	pgu
砌	quu
瑜	ybw
翁	wgg
瘸	qyb
飙	bcq
畅	igu
预	ycy
腮	slo
宇	ynb
蛹	yfi
空	kab
施	uif
唬	hok
袅	nbn
糯	nim
参	cjs
嫂	san
艘	sbv
阮	rye
拥	ysf
倾	qyr
扩	kif
叨	tkk
挥	hvf
豁	hob
啷	lhk
楚	iom
莉	luc
厮	sii
滩	tjd
辽	lvz
例	lur
貂	dcv
玄	xtw
歼	jmd
宥	yvb
噌	cg
耙	bll
脂	vio
捋	lof
积	jih
醇	iqy
幺	ykv
纱	uas
蚊	wgi
痕	hgb
鳖	bxx
颂	sag
数	uom
齁	hbz
玮	wcw
霉	mxy
杆	gjm
杆	glm
栓	urm
炝	qs
珂	kew
裱	bbp
苯	bhc
厨	iii
筐	kdv
寨	vkb
岭	liu
享	xgw
濯	vpd
璐	lyw
囊	njg
瓣	bhx
籍	jov
映	yto
符	fiv
煤	mxh
幼	yvy
蔫	nmc
呷	xwk
怡	yox
辈	bmf
斌	bnw
蛊	goi
激	jid
韵	yol
佟	tdr
酿	nsy
歉	qnj
衬	idp
覆	fyx
访	fky
埸	yut
仪	yor
弗	fig
浩	hjd
谋	mny
遵	zpz
谤	bgy
簋	gnv
尿	svu
辟	buu
妇	fyn
杏	xtm
耸	sfr
啖	dhk
碑	bzu
农	ndb
坪	put
贬	bxb
嗜	uuk
皎	jbb
珞	liw
蝉	iki
姑	gun
帘	lzb
堪	kjt
耽	dje
捆	kwf
恼	nax
倚	ypr
筛	ulv
碘	dxu
棚	phm
缇	tos
蚺	rki
町	dyt
绞	jbs
扰	ra
笛	dov
苑	yec
笼	ldv
傲	air
尺	ipu
劳	llc
磡	khu
茨	coc
穆	myh
撂	lxf
巢	ilv
寝	qzb
涠	wxd
蕉	jcc
粤	yrp
闰	rom
沐	myd
帕	plj
佐	zqr
葵	kbc
刊	kjg
跋	bsz
坚	jml
讹	ery
岸	abu
绷	bgs
荷	hrc
堕	die
凯	ksu
笋	swv
攀	pjm
亨	hgw
绒	rds
棣	dum
幽	ybu
愚	ybt
鹏	pho
咏	yfk
熙	xii
碍	auu
虹	hdi
洛	lid
妓	jun
彦	yhw
焕	heh
啄	vpk
琳	lmw
癌	aob
霆	tuy
祇	qop
悌	tux
拘	jvf
脓	ndo
闫	ykm
膈	gro
杖	vgm
腾	tho
匪	fc
葡	pic
碇	dtu
膝	xio
拈	nmf
蹄	toz
灾	zlb
绊	bhs
惧	jcx
嘬	zok
晶	jyo
掷	vuf
谗	iky
郡	joy
幻	hey
卜	bol
羹	ggy
孬	nkb
铬	gwj
宿	syb
奈	nkd
哏	ggk
癫	dmb
稠	inh
擀	glf
嘈	clk
饬	iuu
舱	chv
馕	nju
攥	ze
肘	vm
辰	igi
茎	jyc
箍	guv
吠	fmk
尻	kk
导	das
谴	qxy
钻	zej
惟	wxx
验	yhm
粿	gqm
婆	ppd
犟	jsg
玫	mxw
钛	tkj
息	xiz
弹	dhg
区	ouk
溶	rdd
捯	dlf
锥	vvj
慎	udx
渊	yrd
撵	nxf
逝	uuz
昆	kpo
滇	dmd
陀	tpe
泽	zrd
屈	qvu
察	isb
炸	vsh
艳	yhf
仔	zsr
溺	nud
嘶	sik
啐	cck
翠	ccx
种	idh
栖	qim
柄	bim
肛	gho
抻	iff
咣	gdk
徽	hvr
坞	wyt
掘	jyf
估	gur
逑	qwz
逐	viz
诉	syy
剽	pcx
炎	ykh
允	yws
烩	hch
萎	wcc
袖	xpp
聂	nze
羽	ynx
律	lcr
芽	ysc
俯	for
瘤	lwb
娥	ern
赤	iut
禹	ynp
钞	ikj
咂	zak
仰	ykr
喧	xrk
瀑	py
宏	hdb
廋	sbg
丰	fgs
剖	pbl
暨	jug
黍	uoh
盈	yun
苍	chc
夕	xip
熨	you
鑫	xnj
蔻	kvc
吭	kgk
苔	tac
湉	tzd
铛	igj
藤	thc
叩	kvk
螺	lpi
褪	tcp
锯	jcj
榨	vlm
薜	buc
锦	jzj
竞	jtl
啫	vtk
邹	zb
韦	wxf
藓	xxc
澳	aid
炜	wch
鲸	jyy
匀	yqb
曝	pyo
囡	njk
溪	xid
朴	pom
杭	hjm
鳓	lwy
屙	eeu
楹	yum
魅	mmg
倪	nor
屑	xzu
益	yub
殴	ouq
纠	jqs
艋	mjv
燃	rkh
聋	ldl
规	gvf
狐	hiq
盏	vlj
瓢	pvx
论	lqy
脐	qoo
寰	htb
茜	xic
於	yvf
镕	rdj
庵	ang
鸠	jqj
狷	jeq
炆	wgh
宾	bnb
抹	maf
宵	xcb
姝	uun
蟒	mki
鼬	yvj
历	lui
皓	hjb
瘆	udb
煸	bmh
肱	gso
蚶	hji
孰	uiw
俚	lpr
落	ljc
薰	xpc
壳	qxt
戚	qiw
喉	hnk
翟	dox
倦	jer
氢	qyq
诵	say
模	mpm
烘	hsh
渍	zud
决	jyd
跃	yrz
浆	jdl
塑	syn
嵌	qnu
锉	cij
匹	ppk
敝	bux
霏	fzy
韬	tkw
政	vfv
担	djf
釉	yvc
铺	pyj
酌	vpy
匙	ioo
暇	xeo
淑	uud
硪	wiu
蓬	phc
巳	suk
痧	uab
炅	jf
丧	sgt
逄	pjz
柏	bsm
寿	uvf
舅	jpj
汞	gfg
滥	lhd
蘼	moc
昕	xno
儒	rir
庭	tug
航	hjv
函	hkk
廊	ljg
鲤	lpy
怜	lzx
坦	tlt
攒	ctf
秆	glh
炉	lih
齿	ipv
玖	jew
肋	lmo
伢	ysr
嗄	ulk
窥	kvb
啼	tok
樊	fkm
屡	lnu
溜	lpd
固	gyk
缀	vcs
径	jtr
陡	dme
墩	dpt
泵	bfu
箸	vyv
斧	fof
喻	yck
绾	wls
耻	ipe
淤	yvd
掴	gyf
屠	tiu
嘁	qik
瓮	wfg
腊	llo
赣	ghl
辉	hvg
违	wxz
慧	hcf
荐	jnc
偈	jur
蟑	vhi
击	jif
竿	gjv
纲	ghs
寐	mmb
陋	lve
挈	qzf
蚤	zai
帖	txj
埵	dqt
珍	vfw
钝	doj
耄	mjl
贤	xzl
胚	pzo
灿	chh
耒	lcf
昙	tko
婵	ikn
聘	pbe
坍	tjt
敛	lxq
饵	eyu
伍	wor
促	cyr
琛	ifw
嗤	iik
枭	xcn
舀	yav
窑	ylb
缰	jds
沫	mid
恢	hvx
砣	tpu
迩	eyz
秾	ndh
锡	xij
莓	mxc
惠	hci
寮	lvb
览	lll
遥	ylz
狸	loq
铢	vuj
阻	zoe
诈	vly
涉	uwd
统	tfs
孑	jcl
睬	cso
堇	jzc
牧	myn
乾	qzu
蹿	cr
髂	qqg
卅	sla
央	yhk
焐	wyh
涯	ysd
祢	mop
锕	aaj
猎	lzq
丘	qqj
琼	qdw
烹	pgw
壕	hlt
煽	ujh
幌	hgj
糍	com
醍	toy
技	juf
铃	luj
轨	gni
脊	jpr
崇	idu
鉴	jnl
菖	ihc
驳	bpm
凳	dfb
敏	mzp
荫	ybc
蕊	rnc
挞	tlf
垚	ylt
蠃	lqw
炼	lnh
融	rdg
哐	kdk
瑾	jzw
婷	tun
榴	lwm
舵	div
昌	iho
鼯	wij
癸	gnb
缅	mxs
卓	vpb
槛	klm
灞	bld
骟	uhm
菲	fcc
讷	nwy
姘	pnn
泫	xed
抿	mzf
查	vam
玥	yrw
旋	xtf
枫	fgm
黯	abl
狄	doq
务	wyw
棘	jou
唵	azk
乜	nzv
橹	lom
碌	lyu
嗫	nzk
匠	jsk
孵	ful
萝	lpc
箩	lpv
泷	ldd
晗	hko
昇	ugo
鼎	dip
启	qph
胤	ybe
锐	rcj
销	xcj
检	jxm
躁	zjz
泠	lud
台	tls
骁	xcm
寞	mib
搋	iyf
甯	nt
描	mvf
窘	jfb
率	utw
濮	pid
酮	tdy
糁	slm
赎	uib
筷	ktv
朔	uin
漂	pbd
绗	hjs
择	zrf
狙	jvq
闸	vsm
娼	ihn
唛	mkk
诡	gny
挎	kqf
陕	ule
谛	duy
浜	bhd
铭	muj
祥	xfp
硼	phu
馨	xnt
茅	mlc
亩	mow
褶	vtp
综	zss
爰	ytv
埂	gjt
丙	bia
枷	jwm
剌	llu
壬	rgp
企	qpr
霖	lmy
冏	jfk
逊	xoz
彧	ycg
澜	lkd
岗	ghu
阶	jxe
矛	mly
擒	qmf
巡	xqz
臻	vfg
厕	cwi
楠	nkm
昵	nuo
龌	wiv
垒	lcs
蛾	eri
援	ytf
旱	hho
淼	mbu
膳	uho
澄	ihd
嫣	yjn
纽	nes
邵	ujd
袍	plp
渗	udd
效	xxw
炙	vux
倡	igr
鲞	xgj
跺	diz
典	dxq
怵	iyx
碱	jxu
蹉	coz
鹤	hwb
摧	cvf
哞	mbk
锈	xpj
嚼	jyk
褒	bky
疾	job
策	cwv
糜	mog
繁	fkp
悯	mzx
矜	jnm
娜	npn
戈	gey
怯	qzx
趾	vpz
钾	jrj
豚	tqo
炳	bih
娄	lnm
蚕	ckt
廷	tuz
饥	jiu
钠	nlj
呒	mik
钚	byj
株	vum
蜂	fgi
夷	yoa
贩	fhb
剔	tio
庸	ysg
芋	ycc
睹	doo
亥	hkw
芬	ffc
酉	ymx
嗟	jxk
呤	ltk
雯	wgy
腩	nlo
拢	lff
仆	pir
梯	tim
绫	lus
伟	wcr
坯	pit
澈	iwd
汾	fgd
葩	pac
霞	xey
堤	dit
哂	uhk
邻	lmr
莰	klc
浒	hod
苟	gmc
鸽	ger
蜷	qti
旦	dho
裘	qwq
寅	ymb
韧	rdw
猾	heq
炊	ivh
馁	nc
肤	fuo
慰	wmu
绢	jes
斥	iuj
诓	kdy
姊	zpn
缈	mbs
恪	kwx
炷	vyh
湜	uod
裴	pxf
狱	ycq
箫	xcv
衿	jnp
焊	hhh
沁	qbd
猹	isq
芝	vic
瞻	vjo
哝	ndk
蔷	qfc
璞	piw
洺	mud
趸	dw
瞳	tdo
凿	zly
瑶	ylw
梭	som
搔	skf
阙	qrm
盖	gty
瓤	rjx
谶	idy
裕	ycp
庹	tqg
妲	dsn
廉	lzg
昧	mmo
颖	yib
暧	auo
芸	yqc
钼	myj
仄	zw
锝	drj
瑷	auw
璟	jiw
蚁	ypi
檀	tkm
簪	zjv
鬓	bbe
沸	fmd
葭	jwc
漪	yid
鹃	jrk
萁	qoc
稻	djh
冉	rlk
涝	ljd
痞	ppb
揩	klf
焯	ikh
糠	khm
兀	wya
彬	bnm
瞭	lxo
槿	jzm
跎	tpz
耕	ggl
腆	txo
穗	sch
硝	xcu
磷	lmu
苛	kec
跷	qcz
筠	yqv
钣	blj
擅	uhf
缚	fys
腕	who
渺	mbd
贯	gem
爻	ylx
陆	lpe
蜇	vef
昭	vko
卑	bzp
铐	kjj
锄	iij
慑	uwx
渚	vod
辑	joi
祗	vip
芈	mpc
狨	rdq
耨	nv
淞	ssd
悭	qmx
岳	yrq
珑	ldw
契	quf
杉	ujm
涡	wod
熹	xit
呋	fuk
肇	vjh
枞	csm
域	yct
禽	qmr
衔	xzr
乏	fsp
贡	gag
培	pxt
牟	mns
况	ksd
坝	blt
奢	ued
艮	gdo
椰	yem
苕	ulc
秘	muh
帆	fjj
镖	bcj
储	ior
迫	piz
泣	qud
匾	bxk
姥	lan
郁	ycu
戊	wyg
滤	lcd
萍	puc
隼	swr
髻	jue
窟	kub
述	uyz
霓	noy
盹	dwo
蒿	hkc
痿	wcb
诌	vby
茗	muc
斐	fcf
胧	ldo
齉	ng
劁	qcr
茑	nbc
禀	biw
磊	lcu
丛	cd
耀	yjg
锣	lpj
艇	tiv
横	hfm
蜱	poi
氨	anq
剋	kz
遣	qxz
耿	gje
噪	zjk
闺	gvm
钮	nej
蹼	poz
虱	uiv
瑰	gvw
昱	yco
蕙	hcc
淳	iqd
庥	xqg
锵	qdj
予	yns
藉	joc
漾	ygd
蔚	wmc
恬	tzx
酣	hjy
嘱	vok
踝	huz
欸	aps
欸	eps
硒	xiu
琅	ljw
耪	pkl
戟	jpu
鞠	jvg
庞	pjg
矢	upp
婴	yyb
靶	bdg
囚	qwk
虑	lch
济	jud
篓	lmv
乞	qpp
稚	vuh
舜	uov
昀	yqo
茄	qcc
敦	dpw
圜	htk
尕	gdn
涐	erd
琶	psw
逞	ijz
臊	sko
抑	yuf
愤	fdx
轧	yli
戌	xvw
峡	xeu
栾	ltw
载	zsg
翕	xir
肓	hdw
芒	mjc
硫	lwu
宁	ntb
橱	iim
辅	foi
祠	cop
辙	vri
禅	uhp
杳	yam
恺	ksx
龊	iiv
铊	tpj
洹	htd
枳	vpm
材	cam
示	uue
侣	lnr
獾	hrq
详	xfy
氮	dhq
憎	zgx
翀	isx
楸	qqm
亟	jol
豳	bnu
尢	whu
昴	mao
簇	cyv
振	vdf
赦	uwi
岑	cgu
栗	lux
鼋	yty
嘲	ilk
珰	dhw
怖	byx
涵	hkd
氟	fiq
污	wud
灼	vph
镰	lzj
夭	ykp
雍	ysw
绺	les
冈	ghk
鲜	xxy
赟	ypw
纬	wcs
铎	dpj
髋	krg
侨	qvr
钡	bmj
撮	zqf
祕	mup
茕	qdc
铪	haj
剜	wjb
慈	cob
笙	ugv
甫	fou
筝	vgv
掣	iwn
衮	gwy
厥	jyi
麓	lym
沦	lqd
沌	dod
彤	tdd
畀	but
遢	taz
虞	ybh
佘	urr
婢	bun
擂	lmf
暄	xro
扼	ewf
叟	sm
蹚	thz
旷	kso
咆	plk
绯	fzs
铂	bpj
岫	xpu
攮	nkf
芷	vpc
圙	lrk
鹀	wig
蹙	cyw
啸	xxk
筹	inv
谅	lsy
梢	ukm
漱	uyd
箕	jiv
兴	xyx
跛	bq
庚	ggg
卉	hcu
佰	bsr
沽	gud
啡	fzk
滨	bnd
疱	pjb
祐	yvp
圐	kuk
玚	yjw
觜	ziv
掠	lrf
褚	iop
扉	fzh
嗽	svk
绵	mzs
铀	ynj
嫉	jon
镊	nzj
婧	jtn
琯	gyw
佺	qtr
忻	xnx
迹	juz
巽	xos
蚌	bgi
障	vge
椎	vvm
盛	ihi
扫	sjf
绅	ufs
脯	pio
糊	hym
址	vpt
媳	xon
逮	dsz
纨	wks
啰	lpk
孖	ziz
昊	hjo
躬	gsu
氦	hkq
芡	qnc
汲	jod
榕	rdm
贾	gox
寓	ycb
猩	xyq
桓	htm
葛	gtc
逍	xcz
蓑	soc
颐	yoi
嚷	rhk
乸	ndy
瑄	xrw
茴	hbc
凰	hfj
趋	qvt
锚	mlj
殉	xod
苞	bkc
晖	hvo
堡	bor
堃	kpf
腋	ywo
妤	ybn
侪	iar
岬	jru
祼	gep
蕖	qbc
醪	lly
鸦	yay
粟	syx
喙	hck
丈	vga
熘	lqh
眯	moo
襦	rip
庇	bug
宸	igb
碴	isu
胞	bko
番	pjc
庾	yng
汆	crr
醺	xpy
鹭	lyz
愀	qbx
腓	fxo
蒹	jmc
瑗	yew
槐	hum
植	vom
蜕	tci
烛	vih
雏	iid
驶	upm
尬	gly
貘	miv
蕃	boc
毋	wim
羲	xiy
肆	sue
怛	dsx
勘	kjc
聪	cse
薯	uoc
娑	sod
爨	cej
厦	uli
撼	hhf
婉	wln
飒	sll
椿	ipm
谏	jny
诳	kfy
曳	ywy
麝	uwl
煌	hfh
绦	tks
拇	mof
镲	idj
悼	djx
迦	jwz
皙	xim
铱	yij
俶	iyr
濠	hld
邨	cpt
龅	bkv
䁖	lbo
镚	bfj
饸	hru
饹	leu
淦	ghd
噙	qmk
淮	hud
笺	jmv
昼	vvi
荀	xqc
厢	xdi
俑	yfr
虔	qzh
晦	hco
飨	xgx
酪	ljy
呓	yuk
谙	any
垃	lat
踅	xyf
荚	jec
腭	ewo
屿	ynu
椴	dem
铸	vyj
镯	vpj
桐	tdm
狈	bmq
赊	ueb
佯	yjr
邝	ksg
铉	xej
赘	vcf
茹	ric
嵩	ssu
盂	yby
翰	hhu
弁	bns
檄	xom
祯	vfp
镬	hij
珈	jww
菀	wlc
娆	rln
腙	zso
谝	pxy
馃	gqu
驭	ycm
彻	iwr
擎	quc
髅	lng
溯	syd
乓	phq
坊	fjt
娲	wan
纶	lqs
谬	mpy
殆	dkd
摒	btf
疵	cib
睾	gkp
粲	chd
缶	fmw
廿	nnc
乂	yup
囿	yvk
啉	lmk
鹳	gec
螃	pji
跐	ciz
檬	mhm
泮	phd
硐	dau
箧	qzv
铠	ksj
诏	vjy
魁	kbg
褐	hwp
诊	vhy
究	jqb
镂	lvj
椽	itm
慷	khx
碜	ihu
迂	yvz
缦	mhs
陇	lfe
姻	ynn
彷	pjr
铅	ykj
羸	lxw
沱	tpd
毳	ccm
镉	grj
嫚	mhn
仂	lwr
蛟	jci
铳	iaj
溃	kc
督	duu
舂	isi
鸢	yry
秧	yhh
凋	dcd
驹	jvm
沓	tlu
晤	wyo
蜗	woi
淋	lbd
讳	hcy
沤	oy
钰	ycj
创	idr
惶	hfx
俅	qwr
懈	xzx
艏	umv
醅	pzy
栊	ldm
戕	qdp
醛	qty
笳	jwv
偲	clr
烨	ywh
陨	ywe
偃	ylr
熔	rdh
炽	iuh
叱	iuk
奚	xiv
劣	lzu
嬉	xin
迭	dcz
艰	jmy
氯	lcq
厘	loi
惰	dix
燔	fkh
猥	wcq
驷	sum
麒	qol
锑	tij
茵	ync
磅	pju
侉	krr
苡	ypc
蕴	yoc
琢	vpw
蹩	bcx
缨	yys
络	lis
鳗	mky
氐	dpu
妒	dyn
恍	hgx
罕	hlb
镗	tjj
娣	dun
倘	tkr
涕	tud
褂	gqp
倔	jrr
砺	luu
侩	ktr
笏	hyv
砷	ufu
胍	gwo
炯	jfh
奘	zgp
隈	wze
埗	byt
珺	jow
琇	xpw
蟀	uti
鹾	cpb
窍	qxb
嫡	don
锹	qcj
愧	kcx
砚	yhu
嗵	tsk
鹫	jpw
奎	kbd
石	dha
纺	fks
宪	xnb
辜	gug
铍	poj
钕	nnj
绚	xes
铵	azj
锎	klj
骞	qmb
圩	wxt
蚂	mdi
嫫	mpn
蚴	yvi
琨	kpw
羌	qdy
莽	mkc
爵	jyv
鳍	qoy
骇	hkm
鞑	dsg
骸	hag
阀	fsm
哽	gjk
狭	xeq
绰	iis
篡	cev
唾	tik
槌	ibm
秉	biq
咴	hvk
噼	pik
煜	ych
鳃	sly
镭	lxj
靥	ywi
诞	dhy
怠	dks
戗	qdr
徵	vpr
耙	psl
刹	ilx
氘	dkq
萼	ewc
哙	ktk
喟	kck
阪	ble
馥	fyh
缳	hts
衢	qbr
溴	xpd
犇	bfn
皴	cpy
瞰	kho
镓	jwj
俵	bxr
冼	xxd
戋	jmg
晡	buo
祎	yip
筜	dhv
羟	qgy
谠	dky
髎	lvg
髓	sn
纤	xms
缉	jis
芜	wic
偿	ijr
夔	kbb
鸮	xck
讽	fjy
濡	rid
悄	qcx
渭	wmd
祟	sci
箬	riv
悚	sfx
蜃	udi
采	ckv
懦	nix
钯	bdj
鲔	wcy
跖	voz
亢	kgw
桦	hqm
胴	dao
戢	jok
煦	xco
尴	gjy
獭	tdq
琐	sqw
蓼	lbc
铯	swj
鸯	yhy
姒	sun
惦	dnx
怄	oyx
橡	xsm
殳	uuj
眭	svo
玘	qpw
藜	loc
邋	laz
垞	ist
昉	fko
燊	ufh
癿	bcb
瞋	ifo
胩	kdo
脞	cqo
骺	hng
剿	jbv
膛	tjo
疆	jdg
蝠	fii
绽	vhs
匕	bpp
舆	ybj
燎	lvh
藻	zac
呻	ufk
弘	hdg
歧	qov
璨	chw
漕	cld
顽	wky
昝	zlw
奠	dnb
魍	wkg
耧	lnl
辔	pms
霹	piy
嚏	tuk
颈	gjj
荷	hwc
扽	ddf
噱	xyk
靳	jbg
杈	iam
鸵	tpn
氰	quq
酚	ffy
荠	juc
叨	dkk
褙	bmp
龈	ymv
芗	xdc
吏	lug
匣	xek
鞘	qxg
衷	vsy
踱	dpz
敞	ikx
饲	suu
漩	xtd
筏	fsv
颔	hhr
酬	iny
贸	mjp
豉	ipd
舫	fkv
蹂	rnz
骰	tng
蘅	hhc
鹜	wym
丐	gka
圾	jit
氩	ylq
胫	jto
纂	zy
蠹	dyg
泗	sud
绉	vvs
奄	yld
榆	ybm
噤	jbk
邈	mbz
髦	mle
忑	twx
惆	inx
窿	ldb
龋	qnv
囱	csp
泚	cpd
珲	hqw
痈	ysb
钆	gsj
钊	vkj
阆	lgm
浔	xqd
湃	pkd
湫	qqd
脲	nxo
釐	xiw
锻	dej
绸	ins
斟	vfc
冕	mxo
隙	xue
钨	wuj
岐	qou
帷	wxj
烁	uih
芦	lic
垄	lfl
韭	jef
堰	yht
绷	bjs
翩	pmh
赃	zhb
裾	jvp
讫	quy
匈	xsb
崛	jyu
钿	dnj
忝	txt
扪	mgf
沂	yod
迥	jfz
魑	iig
堠	hvt
诟	gvy
涓	jrd
巷	hgg
莘	ufc
睦	myo
遑	hfz
箜	ksv
鞣	rng
戛	jeb
丕	pib
壸	kwt
涞	lad
烝	vgl
玳	dkw
邂	xzz
刿	gcu
喹	kbk
氾	fkd
澌	sid
烀	huh
瑀	ynw
蠊	lzi
鸲	qbj
眸	mno
墟	xvt
邬	wuw
愕	ewx
盔	kvu
饷	xgu
轲	kei
蝗	hfi
犸	mdq
庐	lig
朽	xem
幔	mhj
铛	dhj
悖	bmx
狡	jbq
阐	ilm
斫	vpu
讥	jiy
猗	yiq
虺	hnw
誊	thj
牲	ugn
胰	yoo
锃	zfj
锟	kpj
眦	zuo
巍	wzu
骷	kug
霭	apy
鲈	liy
冗	rf
稼	jqh
褪	top
吭	hjk
嫒	aun
龛	kjr
胳	geo
螂	lji
湍	tr
绥	sbs
胛	jro
蜘	vii
亳	bpw
曷	hro
狲	spq
酢	ziy
苔	tlc
埒	lzt
屃	xuu
斓	lkw
殂	cid
珩	hhw
祉	vpp
苒	rlc
颧	qtc
鹧	vwg
坭	not
尜	gsx
惋	wlx
秣	mih
糇	hnm
肫	vpo
菰	guc
蕞	zcc
蚧	jzi
蠓	mji
谖	xry
馇	iau
淬	ccd
戮	lyx
鬃	zse
帛	bpb
篷	phv
殃	yhd
沛	pmd
担	dhf
瞿	qbo
湛	vhd
乒	pyq
惭	ckx
洼	wad
矩	jnu
矾	fku
弛	iog
赁	lbr
蹶	jyz
黜	iyl
皋	gkb
丧	sht
恸	tax
钏	iej
翟	vax
揣	itf
菘	ssc
恚	hct
氖	nsq
簸	bqv
蝙	bmi
堡	pyr
隧	sce
忏	ihx
杞	qpm
淖	njd
漉	lyd
簟	dnv
耘	yql
赅	glb
骋	ijm
貉	hrv
囟	xbp
椭	tqm
绌	iys
骀	tam
俳	par
喾	kyx
徊	hur
撺	crf
攉	hof
璁	csw
砼	tdu
蔸	dbc
锗	vtj
哌	pkk
埭	dkt
庠	xfg
忞	mmw
栳	lam
潽	pud
焓	hkh
瑙	naw
篼	dbv
簏	lyv
綮	qth
荻	doc
诒	yoy
谮	zdy
锇	erj
鹣	jmj
揖	yif
踪	zsz
鲲	kpy
裳	uhx
虻	mhi
锭	dtj
缎	des
辖	xei
蝰	kbi
宦	heb
磬	qtt
钺	yrj
徙	xpr
遂	sbz
嫔	pmn
窠	keb
囔	nhk
诬	wuy
珽	tiw
蛄	gui
鹄	hin
哚	dqk
缟	gas
驮	dim
忖	cwx
氚	irq
柩	jpm
蠡	lph
拯	vjf
篦	buv
韶	ull
鹊	qrc
烷	wkh
诹	zby
匐	fib
飕	sbf
刖	yro
婳	hqn
脘	wlo
纪	jps
瘩	dab
岷	mmu
庖	plg
钍	toj
朴	pvm
刳	kud
疥	jzb
纾	uus
貔	pov
钭	dmj
荑	toc
俣	ynr
姮	hhn
榄	llm
槭	qum
琚	jvw
痉	jtb
蒌	lnc
蔟	cyc
蝤	qwi
裎	ihp
镛	ysj
鹑	iqw
咀	znk
坼	iwt
夼	kgd
嬿	yhn
峄	yuu
慝	twk
潟	xud
玎	dyw
瘙	sjb
蒐	sbc
蓓	bmc
逅	hvz
酊	dyy
镆	mij
镱	yuj
阡	qme
霪	ymy
亓	qoa
谪	vry
祀	sup
蚯	qqi
铿	kgj
篆	vev
髯	rke
俸	ffr
儇	xrr
绍	ujs
峥	vgu
睑	jxo
旋	xef
麋	mol
攘	rkf
忿	fdf
赭	vti
亍	iya
鸩	vdb
妨	fjn
倌	grr
儆	jir
夙	syj
醮	jxy
罴	pos
蹴	cyz
壤	rkt
腑	foo
缄	jms
缭	lvs
蚩	iic
揆	kbf
桡	rlm
觥	gsd
曛	xpo
柠	num
疃	tyt
痢	lub
祆	xmp
咤	vlk
埘	uot
氛	ffq
璠	fkw
桴	fim
稗	bkh
艚	clv
筱	xbv
篁	hfv
踊	yfz
髁	keg
鲢	lzy
砵	bou
绻	qys
茱	vuc
萘	nkc
髭	zie
鬏	jqe
麸	fuf
芫	ytc
慊	qnx
圮	ppt
婀	een
岢	ktu
惚	hux
狍	plq
甾	zlv
竦	sfl
缞	cvs
蟆	msi
鄱	ppc
镥	loj
陂	poe
饨	tqu
糁	ufm
媄	mcn
嫱	qfn
孛	bmu
崚	lhu
捃	jof
捩	lzf
浃	jwd
淝	fxd
炣	kth
焜	kph
珅	ufw
珒	jnw
琬	wlw
睐	lko
筘	kvv
艿	nsc
苄	bnc
茏	ldc
蚪	dmi
铒	eyj
靬	qzg
飑	bcf
馇	vau
龠	yrr
酋	qwb
觑	qch
晁	ilo
蕈	xoc
脍	kto
偎	wzr
炬	jch
箐	qtv
镫	dfj
獠	lvq
蠕	rii
屉	tuu
袂	mmp
铆	maj
黥	qul
啬	swt
霎	uly
厩	jpi
亵	xzy
胥	xvz
垆	lit
薨	hsc
锢	gyj
贿	hcb
忤	wox
燚	yuh
籴	dor
蔑	mzc
顷	qib
鬟	hte
洄	hbd
凫	fin
魉	lgg
佞	ntr
宙	vvb
泅	qwd
狒	fmq
蝴	hii
躏	lbz
迄	quz
瑭	tjw
噩	eww
榫	swm
氲	ypq
篾	mzv
鳅	qqy
叆	auy
耦	ool
琮	cdw
祚	zip
萃	ccc
遐	xez
馔	veu
帚	vme
氡	dsq
猬	wmq
猱	nlq
胪	lio
蟊	mlm
襄	xdy
傣	dsr
崤	xvu
庋	gng
彖	te
氙	xmq
珥	eyw
隘	aue
腌	aao
圹	kst
滓	zpd
濞	bud
牖	ymp
莼	iqc
蜓	tui
衲	nlp
鲌	bpy
黝	yml
黻	fiy
匙	uio
卬	ajp
呙	gok
圪	get
埯	azt
埼	qot
徨	hfr
懊	aix
樯	qfm
汩	god
煳	hih
珐	flw
瘳	ibb
眇	mbo
腘	gpo
荞	qvc
蛔	hbi
诔	lcy
铑	laj
阄	jqm
陟	vue
颡	sky
髌	bbg
䶮	yll
刬	ihj
圬	wut
圳	vdt
墒	uht
夥	hqg
姗	ujn
娉	pyn
媖	yyn
宬	ihb
嵘	rdu
嶝	dfu
怙	hyx
慵	ysx
戥	djo
扃	jsh
摽	bxf
昳	dco
椪	pfm
汶	wdd
溲	sbd
濉	svd
烜	xyh
瓿	byl
皛	xbb
簕	lwv
缱	qxs
耋	dcl
耔	zpl
肟	wio
脬	pko
芎	xsc
苤	pvc
莛	tuc
蛩	qdg
蟮	uhi
郤	xug
郴	ifm
铕	ymj
铽	twj
镮	htj
隹	vvr
靺	mig
鞨	hrg
驸	fym
鲃	bay
鲼	fdy
鹈	tob
桉	anm
勐	mjz
陛	bue
噘	jtk
诅	zoy
嵬	wxu
掾	yef
褥	ryp
姹	iln
吝	lbw
胄	vvy
锊	lrj
僚	lvr
恙	ygy
罹	los
豕	upa
踵	vfz
豢	hej
橇	qcm
鼾	hjz
牯	gon
猡	lpq
予	ybs
亘	gda
狺	ymq
侦	vfr
奡	aib
疟	nrb
艉	wcv
薮	smc
藐	mbc
闳	hdm
隳	hve
匏	pld
篱	lov
蹽	lcz
堑	qni
竽	ybv
峭	qxu
殄	txd
獬	xzq
竺	viv
诽	fcy
抟	ttf
肮	ah
腴	ybo
臊	sjo
穰	rjh
蓍	uic
侥	jbr
怏	ygx
惇	dpx
瞩	voo
缯	zgs
辘	lyi
骥	jum
绷	bfs
怦	pgx
柘	vwm
犒	kjn
郦	lul
鲀	tqy
麈	vol
济	jpd
幢	ifj
淀	dnd
盎	ag
罘	fis
诨	hoy
贮	vyb
轧	vsi
蔓	whc
啭	vek
嗉	syk
峁	mau
徂	cir
樗	ium
瞌	keo
笥	suv
绲	gws
缗	mms
蚜	ysi
镞	zij
鳔	bxy
鼐	nkn
模	mim
宿	xeb
宿	xpb
兕	sua
埴	vot
崾	yju
沆	hgd
煊	xrh
狁	ywq
琤	igw
琵	pow
璀	cn
缃	xds
缥	pcs
舸	gtv
钬	hqj
膻	ujo
杻	imm
杻	nem
叵	pq
塄	lht
姤	gvn
孓	jyl
怍	zix
懋	mjm
懑	mdd
拤	qef
杲	gao
榔	ljm
槁	gam
璋	vhw
瘁	ccb
绨	tus
膑	bbo
芑	qpc
茛	gdc
蔌	syc
蝽	ipi
褡	dap
谇	scy
谧	muy
辏	cvi
锘	nij
馄	hqu
驺	zbm
芥	gkc
伽	gar
㸆	kjh
侏	vur
吣	qbk
哃	tdk
唢	sqk
啶	dtk
嗾	smk
嘌	pxk
囷	qpk
垯	dat
垸	yet
埌	lgt
墈	kht
墼	jii
妊	rdn
妯	vnn
娌	lpn
峣	ylu
崀	lgu
巯	qwj
忸	nex
慥	zjx
戽	hyh
揿	qbf
昪	bno
杷	psm
栟	bfm
梃	ttm
橥	vuq
氕	pxq
渼	mcd
湓	pgd
漤	lld
炘	xnh
烃	tyh
煺	tch
爝	jyh
猃	xxq
猕	moq
甏	bft
甦	sug
畲	uer
疔	dyb
瘰	lqb
矻	kuu
硗	qcu
禤	xrp
穑	swh
窊	wab
窕	tbb
笆	bav
笊	vjv
翾	xrs
耑	dru
腧	uyo
舻	liv
荮	vvc
萜	txc
葑	fgc
蒉	kcc
蛸	xci
蜾	gqi
衄	ncp
褯	jzp
诂	goy
贶	ksb
跞	luz
迮	zrz
鄞	ymc
锶	sij
霈	pmy
靸	sdg
馓	slu
驲	rum
黪	cll
狩	uvq
戍	uyw
漭	mkd
惩	ihr
蒯	kic
牒	dcp
蟠	pki
佃	dnr
遏	ewz
湟	hfd
煅	deh
睃	soo
璜	hfw
猊	noq
腱	jno
倜	tur
缆	lls
殡	bbd
桅	wxm
篙	gkv
邕	ysv
蔼	apc
螳	tji
铌	noj
镴	llj
蚣	gsi
馈	kcu
徇	xor
馗	kbj
撄	yyf
袒	tlp
鳜	gcy
旖	ypf
牦	mln
獐	vhq
襕	lkp
橐	tpg
甥	ugu
窨	ybb
绶	uvs
鼍	tpk
晌	uko
疽	jvb
逵	kbz
嚅	rik
梏	gym
猝	cyq
颉	xct
簌	syv
觊	juu
迳	jtz
钇	ypj
纤	qns
琢	zpw
瓒	zhw
紊	whw
蔗	vwc
趺	fuz
堞	dct
舢	ujv
苴	jvc
蜮	yci
铩	uaj
蚌	bfi
匆	csb
埽	sjt
妩	won
忪	ssx
楪	dcm
裈	kpp
貅	xqv
镧	lkj
骖	cjm
燎	lbh
偾	fdr
堙	ynt
孺	riz
睥	puo
窣	sub
蜩	tvi
铫	ylj
咐	fyk
峨	eru
烽	fgh
礌	lxu
绔	kys
薤	xzc
蚋	rci
蚓	yzi
鄄	jex
酡	tpy
馐	xqu
骍	xym
钐	uhj
憔	qvx
楯	uwm
淆	xvd
潺	ikd
燮	xzh
璩	qbw
糌	zjm
繇	ynv
羧	soy
聒	goe
臃	yso
蕤	rb
褫	ipp
讴	ouy
谌	igy
醢	hsy
锜	qoj
阱	jie
隍	hfe
颙	ydt
飧	spx
鹂	lol
黼	foy
沓	dsu
纶	grs
柞	zim
玢	ffw
镏	lwj
佣	yar
澄	dfd
戗	qsr
繁	ppp
枸	gmm
仃	dyr
仳	ppr
咡	eek
圯	yot
垠	ymt
垡	fsr
帱	inj
怩	nox
曩	nko
柢	dpm
檩	lzm
滦	ltd
牂	zhp
畴	int
畹	wlt
砝	fdu
础	iou
笾	bmv
筢	psv
篝	gbv
纰	pis
绱	ugs
缊	yos
缵	zys
艄	ukv
荬	msc
菟	tyc
蠲	jrb
诋	dpy
跂	qoz
轫	rdi
钷	pqj
锪	hoj
锼	sbj
阍	hpm
韫	yow
馘	gpb
朴	pim
综	zfs
戛	gab
嫚	mjn
碌	lpu
仫	myr
侔	mnr
侘	ilr
偬	zfr
囵	lqk
圊	qyk
圌	ibk
坌	bdf
坬	wat
垟	yjt
垱	dgt
垾	hht
埆	qrt
埝	nnt
堐	yst
堽	ght
塝	bgt
墚	lft
夐	xa
妗	jbn
妘	yqn
妣	bpn
姱	kwn
娓	wcn
娵	jvn
孀	udn
尪	why
屼	wyu
岍	qmu
岣	gmu
峘	htu
帼	gpj
庼	qig
忾	kkx
恂	xqx
悱	fcx
惙	iix
憬	jix
戤	gkn
扂	dnh
捽	zpf
搛	jmf
摈	bbf
擞	smf
敩	xxx
暹	xmz
杄	qmm
栲	kam
洸	gdd
涔	cgd
溚	dsd
溻	tad
溽	ryd
漴	idd
漼	cnd
澉	gld
烔	tdh
烺	lkh
熇	hwh
牁	kep
牿	gyn
猇	xcq
玕	gjw
琔	dnw
瑱	tnw
璈	apw
璪	zaw
痫	xzb
瘃	vib
睽	kbo
矧	uhu
砟	vdu
磉	sku
祲	jbp
窎	dxb
竑	hdl
筦	gyv
箢	yrv
篌	hnv
糨	jsm
绁	xzs
绖	dcs
绠	gjs
缂	kws
缔	dus
缛	rys
翃	hdu
耏	ete
耵	dye
臜	zao
舴	zrv
艟	isv
芠	wgc
茌	ioc
荏	rhc
荪	spc
莞	gyc
萩	qqc
蒎	pkc
蕗	lyc
蘩	fkc
蝻	nli
螋	sbi
螬	cli
蟫	ymi
蠼	qbi
衒	xer
袷	qwp
裉	kdp
褟	tap
襜	ijp
襻	php
诙	hvy
谰	lky
趯	tut
跣	xxz
跬	kn
踦	ypz
躐	lzz
躔	ikz
轪	dki
辋	wki
遨	apz
遴	lmz
鄹	zbe
酤	guy
酩	miy
酴	tiy
醭	biy
鋆	yqt
钌	lbj
钔	mgj
锍	lej
锒	ljj
锿	aij
镤	pij
陞	uge
鞲	gbg
饹	geu
鬘	mke
鲙	kty
鲭	qyy
鹌	and
麑	nol
黇	tmc
婠	wjn
傀	knr
晷	gno
锏	jxj
郧	yqk
咫	vpi
狞	nuq
邴	bib
橼	ytm
魃	bsg
恫	dax
傩	npr
纥	hrs
劾	hrw
姽	gnn
佝	gbr
苌	ijc
亸	dqw
隗	wce
悢	lsx
狰	vgq
钽	tlj
伉	kgr
螟	mui
鞘	ukg
蝮	fyi
鹱	hyn
廓	kig
虿	ikw
廙	yug
蝼	lni
蹑	nzz
辚	lmi
镔	bnj
琥	how
骈	pzm
旒	lwf
瑚	hiw
禳	rjp
鲇	nzy
鳟	zpy
恹	yjx
胙	zio
辎	zii
锷	ewj
毐	apt
覃	tkx
缑	gbs
孢	bkz
翱	apb
粜	txi
跄	qsz
阃	kwm
掇	dof
殓	lnd
洮	tld
砧	vfu
谩	mhy
跻	jiz
鋈	wyd
鬲	gra
吩	ffk
啻	iuw
媪	aqn
旄	mlf
纻	vys
鏖	apl
齑	jiq
殷	yjp
帔	pmj
泞	ntd
涢	yqd
狻	srq
盥	gej
褛	lnp
赂	lyb
隰	xoe
鸱	iiu
骠	pxm
钥	yjj
亶	dlw
侈	ipr
墁	mht
妪	ycn
甗	ylh
砫	vyu
籀	vvv
纡	yvs
舄	xuj
衽	rdp
袈	jwl
逡	qpz
铄	uij
铋	buj
锞	kwj
陲	ibe
拶	zlf
岵	hyu
牝	pbn
缫	sks
罨	yls
蜒	yki
蝓	ybi
踉	lsz
踌	inz
逶	wzz
阋	xum
骼	grg
鳊	bmy
鳙	ysy
趄	qzt
仞	rdr
佻	tcr
匦	gnk
媸	iin
嫪	ljn
廒	apg
擐	hef
栝	gwm
歃	ulq
焞	tph
犴	abq
玃	jyq
珣	xqw
畿	jig
疳	gjb
砀	dgu
砬	lsu
秭	zph
稔	rhh
罅	xqf
翂	ffx
翥	vyl
耜	sul
芘	bpc
蓊	wjc
蓐	ryc
蕹	wfc
蝣	yni
袆	hvp
袤	mjy
襁	qgp
讣	fyy
踣	bpz
蹯	fkz
躇	iiz
郯	tkh
鍪	mnm
锨	xmj
髡	kpe
黠	xel
迫	psz
伺	cur
啜	itk
荥	xuc
莨	lgc
络	ljs
苫	uhc
膀	pjo
啁	vkk
啁	vbk
劼	jct
勰	xcl
哿	gtl
唪	fjk
啕	tlk
噀	xok
垧	ukt
墀	iot
媲	pun
崿	ewu
帑	tkn
帨	ucj
廛	ikg
彟	yte
惴	vcx
杪	mbm
椀	wlm
椸	yom
榱	cvm
汭	rcd
泂	jfd
泔	gjd
泖	mad
漓	lod
烠	hbh
熜	csh
犷	ggq
狯	ktq
玿	ulw
珙	gfw
琎	jbw
璮	tlw
瓞	dcg
畛	vht
瘛	iub
硭	mju
硿	kau
祜	hyp
秕	bph
笤	tvv
籼	xmm
缲	qcs
罟	gos
耇	gml
耠	hol
聍	nue
聩	kce
肪	fjo
芟	ujc
芴	wyc
荄	glc
莶	xmc
萑	htc
虢	gpv
蛴	qoi
裒	pny
裢	lzp
裣	lxp
裥	jxp
褊	bxp
詟	vrl
诐	buy
跚	ujz
踬	vuz
蹁	pzz
遘	gvz
钫	fhj
闶	kgm
阗	tzm
髃	ybg
鬈	qte
鳇	hfy
黟	yil
鼗	tlv
什	ugr
脏	zgo
蛤	gri
场	ijt
挣	vgf
唉	aik
露	lyy
塞	swb
阿	eee
扒	psf
炮	plh
埋	mkt
晃	hgo
咽	yjk
臭	xpz
拧	nuf
合	gtr
占	vjb
答	dav
结	jxs
参	cfs
色	usd
读	dvy
圈	jek
片	pmp
降	xfe
累	lct
几	jip
约	yks
哇	wak
绿	lys
爪	vai
们	mgr
朝	vku
强	qgg
少	ujx
冲	iad
难	nhy
无	mpa
跑	plz
解	jzd
别	bzk
车	jva
更	gga
便	pzr
大	dka
哦	oik
见	xnk
打	dsf
说	ucy
要	ykx
与	ycv
了	lba
和	hph
都	dul
将	jsl
着	vky
的	dib
觉	jxx
谁	uby
桧	hcm
簸	biv
犍	qzn
瘩	dsb
芾	fmc
烊	ygh
趄	jvt
钐	ujj
坷	ket
芫	ykc
锔	jvj
骀	dkm
颏	krw
貉	hlv
蹊	qiz
厦	xqi
莨	lfc
㕮	fok
㛚	tfn
㛹	pzn
㟃	siu
㠓	mhu
㤘	vvx
㧐	sff
㫰	lgo
㬊	hyo
㬚	iwo
㭎	ghm
㶲	yah
㿠	hsb
䃅	diu
䅟	clh
䌹	jfs
䎃	rlr
䏝	vro
䏡	uuo
䐃	joo
䗖	dui
䢺	iui
䦃	voj
䲠	ipy
䴘	tii
上	ukb
丽	loa
估	gyr
佖	bur
佤	wdr
佴	nkr
佸	hpr
侂	tor
侴	imr
俍	lfr
俟	qor
俱	jvr
倕	ibr
倥	kfr
倴	bdr
倻	yer
偓	wir
偡	vhr
偭	mxr
傃	syr
傉	nyr
傺	iur
僇	lyr
僔	zwr
儦	bcr
儳	ikr
儴	rjr
冁	ilb
凉	lsd
刷	uqu
刺	ciu
刽	gcr
剕	fmf
剟	doy
劈	ppu
劐	hoc
匼	kek
单	ikb
南	nau
叉	isy
同	tak
吐	tyk
吗	msk
吗	mdk
吲	yzk
吵	ikk
呢	nok
咧	lxk
咪	mpk
哈	hdk
哦	erk
哪	nak
哪	nrk
哼	hgk
啊	ask
啊	adk
啊	alk
喋	vsk
喷	pdk
嗯	ehk
嗯	ejk
嘚	dzk
噂	zwk
囊	nhg
圢	tit
圫	tot
圲	qmt
坉	tqt
坋	fdt
坜	lut
坫	dnt
坰	jst
垍	jut
垎	hwt
垙	gdt
垭	yat
垴	nat
垺	fit
埇	yft
埏	ujt
堌	gyt
堧	rtt
堨	ewt
堼	hft
堾	ipt
塆	wjt
塥	grt
墐	jbt
墦	fkt
夹	gaa
夹	jwa
奘	vgp
妭	bsn
姈	lun
姶	ewn
娀	ssn
娠	ufn
婍	qpn
婘	qtn
婤	vbn
婫	kpn
婻	nhn
媆	ryn
媓	hfn
媛	yen
嫘	lxn
嫜	vhn
嫦	ijn
嫽	lvn
嬥	tbn
孅	xmn
尺	itu
尾	ypu
岞	ziu
崃	lau
崄	xxu
嵲	nzu
嶍	xou
嶟	zpu
差	ciy
帱	djj
并	byb
庱	ijg
廆	wcg
弸	phg
得	dcr
忳	tqx
忺	xmx
怫	fix
恔	jbx
恧	nce
恶	ety
悈	jzx
悝	kvx
悰	cdx
惛	hpx
愃	xrx
愐	mxx
愭	qox
慭	ybl
憭	lbx
戌	qvw
扆	yph
抃	bnf
抢	qdf
抹	mif
拧	ntf
挡	dgf
挦	xzf
挲	sad
捎	ujf
揳	xxf
搁	grf
搒	bgf
搒	phf
摩	mag
摴	iuf
撙	zwf
擞	svf
数	uim
斶	iyj
旞	scf
旴	xvo
旿	woo
昃	zwo
昄	blo
昒	huo
昣	vho
昤	luo
昺	bio
晊	vuo
晐	glo
晱	ulo
暅	gfo
暶	xto
暾	tpo
朏	fco
朓	tbo
杉	uam
枘	rcm
枸	gbm
柖	ulm
柚	ynm
栐	yfm
栒	xqm
栩	xnm
桄	gdm
桄	gsm
桯	tym
棓	bmm
棤	cim
棪	ylm
椅	yim
椆	inm
椹	udm
楒	sim
榅	wfm
榇	idm
榧	fcm
槚	jrm
槜	zcm
槟	bym
槱	ymm
橑	lvm
櫆	kbm
欸	eis
欸	eus
沌	ved
洘	kad
洚	jsd
洣	mpd
洧	wcd
洭	kdd
浈	vfd
浭	ggd
涄	pyd
淙	cdd
溞	skd
溠	vld
溹	sqd
滃	wgd
滆	grd
滉	hsd
滏	fod
潖	psd
瀌	bcd
瀑	bjd
瀼	rjd
瀼	rgd
炅	gco
炌	kkh
炟	dsh
烶	tih
焆	jrh
焌	joh
焌	qvh
煃	knh
煓	trh
熥	tgh
爚	yrh
爟	geh
牚	ifx
牟	mys
牥	fhn
犴	hjq
狃	neq
狉	piq
狳	ybq
狴	buq
猁	luq
猞	ueq
猯	trq
獍	jtq
玞	fuw
玤	bgw
玭	pmw
玶	puw
玼	cpw
珇	zow
珋	lew
珖	gdw
珢	ymw
珦	xsw
珷	wow
琈	fiw
琟	wxw
琡	iyw
瑃	ipw
瑅	tow
瑆	xyw
瑑	vew
瑔	qtw
瑖	dew
瑳	cow
璒	dgw
璲	scw
璺	wdj
瓀	ryw
瓖	xdw
瓘	gew
瓦	wla
畎	qyt
疁	lwt
疭	zab
疸	dlb
痃	xtb
痄	vlb
痼	gyb
瘅	dhb
瘊	hnb
癗	lcb
癯	qbb
盉	hrh
盦	anr
盷	tzo
眵	iio
瞍	smo
矰	zgu
矸	gju
砆	fuu
砉	hwf
砗	ieu
硁	kgu
硇	nlu
硔	gfu
碃	qtu
碡	vnu
碥	bxu
磲	qbu
磻	pku
礓	jdu
礵	udu
祃	mlp
祊	bgp
祏	uop
祾	lup
禒	xxp
禘	dup
秘	buh
秸	jxh
稃	fuh
稑	lyh
稹	vhh
穙	pih
竘	qnl
笯	niv
笱	gmv
笸	pqv
笼	lfv
筇	qdv
筠	jpv
筤	ljv
筻	ggv
篑	kcv
篚	fcv
篪	iov
簃	yov
簝	lvv
簠	fov
簰	pav
粘	nzm
纩	kss
纭	yqs
纼	vds
经	jts
缉	qis
缧	lxs
缩	sys
缪	mps
羰	thy
翯	hwx
耖	ijl
耥	thl
肷	qxo
胂	udo
胈	bso
胣	ipo
脟	lzo
脶	lpo
腒	jvo
腠	cvo
腨	ueo
膙	jgo
臑	njo
艨	mhv
芄	wkc
芏	dyc
芯	xbc
苠	mmc
苧	nuc
茈	zpc
茋	dpc
茓	xyc
茳	jdc
茼	tdc
茽	vac
荙	dsc
荨	qzc
荽	svc
莝	cic
莴	woc
莿	cuc
菝	bsc
菹	zuc
萏	dhc
萣	dtc
葜	qwc
葰	sqc
蒇	ilc
蒈	ksc
蒡	bgc
蓏	lqc
蓢	lkc
蓿	xvc
蔀	byc
蔈	pxc
蔊	hlc
蔹	lxc
薁	aic
薄	bic
薿	npc
藨	bcc
蘘	rjc
虷	gji
虷	hki
虸	zpi
虹	jsi
蚄	fhi
蚆	bai
蚲	pui
蛃	bii
蛑	mni
蛘	yji
蛞	kii
蛱	jei
蛸	uki
蜎	yri
蜚	fzf
蜣	qdi
蜿	wji
螵	pci
螽	vsd
蟛	phi
衃	pzp
衎	khr
衩	ilp
袗	vhp
裰	dop
裼	tup
襚	scp
觃	yhj
觇	ijv
讧	hay
讻	xsy
诇	xay
豁	hib
貆	htv
赒	vbb
赗	ffb
赜	zri
赳	jqt
趱	zlt
趵	bjz
趼	jxz
踒	woz
蹅	idz
蹐	joz
蹒	pkz
轳	lii
轷	hui
辀	vbi
辌	lfi
辒	wfi
过	goz
迺	nsz
逭	hez
邗	hkg
邡	fhf
邿	uit
郎	lgl
郾	ylk
鄗	hjw
鄠	hyy
酂	zhn
酏	ypy
酦	poy
钢	ggj
铷	rij
锫	pxj
锳	yyj
镄	fmj
镅	mxj
镎	nsj
镩	crj
阽	dne
隃	uye
隩	aie
雊	gvj
雱	phy
靽	bhg
鞅	yhg
鞅	ygg
鞒	qvg
鞔	mkg
鞡	lag
鞮	dig
鞳	tlg
韂	ihg
韪	wco
顸	hjg
颥	riy
馌	ywu
骅	hem
骎	qnm
骕	sym
髢	doe
髫	tve
髽	vwe
鬒	vhe
魆	xvg
魋	tbg
鱾	jpy
鲗	zxy
鲬	yfy
鲴	gyy
鲿	ijy
鳁	wfy
鳂	wzy
鳑	pjy
鸧	chl
鸼	vbv
鹨	lpx
鹯	vjw
麇	qql
麹	qvf
黢	qvl
黩	dil
鼒	zic
齇	vaz
鿍	ggt
鿏	mkj
𠅤	xow
𠳐	bhk
𥕢	clu
𥖨	zju
𦈡	xvs
𦝼	lno
𦰡	nlc
𨐈	gdi
𨟠	qro
𨱏	daj
𨱔	zpj
𩾌	khy
𪣻	lnt
𪨶	ueu
𫍲	xby
𫐐	noi
𫐓	rni
𫑡	mhk
𫓧	fuj
𫓶	xrj
𫗧	syu
𫘨	tom
𫚖	cpv
𫛭	kfq
𫞩	mgw
𫟅	lfs
𫟹	hdj
𫟼	dsj
𫠆	knv
𫠜	nov
𫢸	dhr
𫭟	out
𫭼	llt
𫰛	xun
𫷷	xng
𬇙	bmd
𬇹	gpd
𬉼	ooh
𬊈	xqh
𬊤	ilh
𬍡	dgd
𬘓	xqs
𬘘	dls
𬘩	tys
𬘭	ifs
𬘯	vws
𬙊	mis
𬞟	pmc
𬟽	dsi
𬣞	voy
𬣳	hhy
𬬭	lqj
𬬸	uyj
𬬹	ugj
𬬻	lij
𬭁	moj
𬭚	iqj
𬭤	hnj
𬭩	wgj
𬭬	hcj
𬭯	pvj
𬭶	hzj
𬭸	lmj
𬭼	scj
𬮿	gke
𬯎	tbe
𬴂	fzm
𬴃	hom
𬶋	jvy
𬶏	wxy
𬶠	lny
𬸣	xmb
〇	xyv
㐁	tna
㐄	kqu
㐌	yop
㐜	inq
㐬	lws
㐭	lzw
㐳	wyr
㐷	mdr
㐺	ymr
㐻	nmr
㐼	ifr
㑃	aqr
㑌	kdr
㑌	whr
㑎	nar
㑔	xnr
㑞	ytr
㑟	bjr
㑣	lkr
㑤	mvr
㑰	hcr
㑱	rar
㑶	xur
㑻	mlr
㑿	vjr
㒀	vlr
㒀	vdr
㒃	eer
㒍	lxr
㒎	slr
㒓	tlr
㒔	uir
㒔	tyr
㒗	tar
㒙	mzr
㒛	dxr
㒝	wlr
㒟	nbr
㒥	fgr
㒲	car
㒳	lgk
㒴	gor
㒵	mjb
㒸	scb
㒿	loo
㓈	btd
㓋	gad
㓞	qqf
㓠	dxv
㓡	gwf
㓣	qqr
㓤	qqt
㓦	blb
㓧	gjr
㓭	uro
㓱	tnr
㓸	dby
㓹	cci
㓹	jui
㔀	lro
㔃	xts
㔋	jmi
㔋	lki
㔌	zve
㔌	cme
㔍	iwv
㔏	lqu
㔑	iuc
㔓	jxq
㔕	joq
㔘	iyi
㔙	bgb
㔜	bsv
㔠	xwo
㔦	yky
㔩	ewb
㔪	lob
㔭	iwb
㔯	xtk
㔰	hhk
㔶	glk
㔾	xmv
㔾	jcv
㔿	zva
㕆	hyi
㕇	lai
㕉	kwi
㕊	fui
㕌	aui
㕐	xvi
㕐	xzi
㕒	wzi
㕕	hes
㕚	vay
㕜	upv
㕟	kcb
㕟	ktb
㕡	hrb
㕦	hqk
㕨	fhk
㕫	fkk
㕫	fgk
㕬	sak
㕭	aok
㕯	nwn
㕵	gpk
㕶	ez
㕶	ej
㕹	fsk
㖁	lbk
㖃	hmk
㖇	etk
㖐	wck
㖑	xzk
㖖	nzx
㖘	vfk
㖞	wlk
㖟	uvk
㖢	qok
㖣	tvk
㖦	dfk
㖧	hpk
㖨	lyk
㖭	txk
㖷	uok
㖸	nwk
㖹	pfk
㖹	fdk
㖺	iwk
㖻	rvk
㖿	yrk
㗌	vuk
㗑	blk
㗕	gvk
㗕	gbk
㗥	kik
㗫	qzk
㗰	cdk
㗷	ssk
㗿	hrk
㘂	cok
㘇	rdk
㘈	npk
㘐	pjk
㘓	lkk
㘢	wjk
㘨	nzt
㘪	hjt
㘷	aut
㘸	zgd
㘺	fst
㙀	lpt
㙁	mxt
㙁	myt
㙂	wft
㙅	bat
㙇	iyt
㙈	xqt
㙊	vgt
㙓	kbt
㙔	wct
㙔	hkt
㙗	wzt
㙚	xyt
㙛	bot
㙟	lkt
㙩	lvt
㙸	bjt
㙺	gct
㙾	xut
㚂	ngt
㚃	ypt
㚆	fyw
㚇	zsx
㚊	klx
㚌	hqx
㚍	knx
㚖	zrb
㚗	qcd
㚢	nir
㚣	xvn
㚫	sln
㚬	jpn
㚱	qqn
㚲	dxn
㚲	dnn
㚴	byn
㚷	eyn
㚹	len
㚽	qbg
㚿	pln
㛁	pgn
㛂	nqn
㛄	yin
㛆	dqn
㛍	xxn
㛍	xen
㛏	qwn
㛐	smn
㛒	dvn
㛔	fgn
㛔	phn
㛖	son
㛗	qxn
㛗	zon
㛘	pin
㛙	xnn
㛚	yfn
㛛	xbn
㛝	bmn
㛥	tln
㛦	lln
㛨	qgn
㛬	lyn
㛯	ven
㛱	wzn
㛲	fln
㛴	nan
㛵	ign
㛶	thn
㛼	ian
㛼	uln
㜃	lnn
㜄	xqn
㜆	mun
㜇	hcn
㜇	ywn
㜈	mym
㜊	vln
㜌	nmt
㜌	kvt
㜍	tjn
㜕	lzn
㜖	cln
㜗	cjn
㜗	sfn
㜘	qcn
㜘	isn
㜜	ain
㜝	azn
㜞	cki
㜣	rkn
㜤	nxn
㜤	txn
㜧	yrn
㜪	ufl
㜮	lhn
㜮	lkn
㜳	hun
㜴	mfn
㜷	xxg
㜹	qbn
㜼	von
㝂	vwz
㝃	mxz
㝈	ltx
㝋	lbb
㝍	xvb
㝎	dtb
㝗	ljb
㝘	ydb
㝝	lmb
㝟	mlb
㝡	zcb
㝥	mpb
㝧	whb
㝩	khb
㝯	qvb
㝰	mzb
㝱	mfb
㝵	drd
㝵	aud
㝶	aus
㝹	nnu
㝽	iby
㝾	zqy
㝿	bqy
㞁	yjy
㞂	tny
㞂	tcy
㞎	bdu
㞎	pau
㞗	qwu
㞞	sdu
㞪	nle
㞲	yau
㞶	mzu
㞷	hfc
㞻	hju
㞽	xru
㟀	lzh
㟂	mou
㟄	xfu
㟆	heu
㟊	fiu
㟍	lju
㟎	tnu
㟖	ldu
㟘	tvu
㟙	zru
㟛	zhu
㟝	pxu
㟞	vhu
㟟	xsu
㟩	mmm
㟬	smu
㟰	miu
㟼	apu
㟽	bbu
㟽	bcu
㠅	fyu
㠈	rou
㠑	zcu
㠗	aiu
㠙	hlu
㠜	nuu
㠝	ct
㠟	lou
㠡	nbu
㠢	huu
㠭	vlg
㠯	ypk
㠸	kyj
㠺	mvj
㡁	krj
㡄	xqj
㡅	nqj
㡇	vrj
㡉	xzj
㡋	anj
㡏	xvj
㡏	tnj
㡙	bij
㡪	ncj
㡭	juv
㡯	vag
㡱	jeg
㡲	htg
㡳	vpg
㡸	isg
㡽	vjg
㡿	iug
㢀	cug
㢁	ipg
㢁	upg
㢂	ylg
㢂	dvg
㢊	ypg
㢍	yig
㢎	vrg
㢓	yag
㢔	zfg
㢙	qmg
㢚	log
㢡	jgp
㢨	hhg
㢩	dug
㢵	uwg
㢻	rcg
㢼	bzg
㢽	eyg
㣂	ewg
㣅	zhg
㣈	suh
㣌	uhv
㣎	myb
㣒	cfb
㣚	tfr
㣝	ssr
㣞	dpr
㣣	uhr
㣪	hyr
㣬	qur
㣱	zrr
㣲	wxr
